STATE,CD_MUN,NM_MUN,VOTES_INCUMBENT,VOTES_CHALLENGER,QT_ABST,QT_APT,QT_ATTEND,QT_BLANK,QT_NULL
AC,1007,BUJARI,1628,1925,984,6902,5918,74,303
AC,1015,CAPIXABA,1344,2475,1241,6941,5700,57,227
AC,1023,PORTO ACRE,3131,3512,2108,11434,9326,127,467
AC,1031,SANTA ROSA DO PURUS,612,257,856,2783,1927,21,143
AC,1040,MARECHAL THAUMATURGO,2909,2425,2408,8799,6391,19,208
AC,1058,BRASILÉIA,4616,5252,3616,17126,13510,145,549
AC,1066,PORTO WALTER,2134,1388,1381,5444,4063,25,159
AC,1074,CRUZEIRO DO SUL,12561,15165,12504,51461,38957,410,1233
AC,1082,RODRIGUES ALVES,3466,2351,2206,9731,7525,45,284
AC,1090,MÂNCIO LIMA,4348,2306,2270,10818,8548,70,280
AC,1104,JORDÃO,1372,859,1047,4311,3264,11,130
AC,1112,EPITACIOLÂNDIA,2057,2868,2097,10408,8311,116,376
AC,1120,ACRELÂNDIA,2293,3464,2144,9143,6999,108,341
AC,1139,FEIJÓ,7129,3038,4565,18595,14030,101,857
AC,1392,RIO BRANCO,35802,44676,25660,232220,206560,2174,6243
AC,1457,SENA MADUREIRA,5013,7034,6206,25964,19758,229,974
AC,1473,TARAUACÁ,8629,4185,6063,23055,16992,209,941
AC,1490,XAPURI,3785,2341,2340,11344,9004,57,464
AC,1511,PLÁCIDO DE CASTRO,2322,3269,2575,12516,9941,113,453
AC,1538,SENADOR GUIOMARD,2845,4685,3146,16632,13486,157,431
AC,1554,MANOEL URBANO,1716,1028,1464,5992,4528,58,275
AC,1570,ASSIS BRASIL,1929,1606,906,5186,4280,18,201
AL,27006,PARIPUEIRA,2408,1795,1175,8056,6881,399,527
AL,27014,ÁGUA BRANCA,7724,736,3063,13647,10584,204,789
AL,27022,PARICONHA,4473,308,1282,7146,5864,95,541
AL,27030,ANADIA,4276,1572,3472,12013,8541,403,864
AL,27049,ESTRELA DE ALAGOAS,4977,733,3078,10714,7636,245,799
AL,27057,ARAPIRACA,44462,23376,20303,128775,108472,4390,7956
AL,27065,JEQUIÁ DA PRAIA,2795,853,1299,6812,5513,148,393
AL,27073,ATALAIA,9726,5066,6051,28031,21980,1140,1912
AL,27081,CAMPESTRE,1587,445,1012,4627,3615,134,302
AL,27090,BARRA DE SANTO ANTÔNIO,3783,1237,1801,9802,8001,476,654
AL,27111,BARRA DE SÃO MIGUEL,1842,1296,757,5610,4853,153,309
AL,27138,BATALHA,5401,1107,2063,11049,8986,180,734
AL,27154,BELÉM,1820,475,892,4457,3565,140,344
AL,27170,BELO MONTE,2451,330,849,4328,3479,68,247
AL,27197,BOCA DA MATA,6448,2621,4227,18557,14330,738,1242
AL,27219,BRANQUINHA,2889,870,2112,7378,5266,254,500
AL,27235,CACIMBINHAS,3427,595,1543,7260,5717,102,541
AL,27251,CAJUEIRO,3598,3081,2786,13074,10288,542,894
AL,27278,CAMPO ALEGRE,7576,3578,4585,20988,16403,492,1314
AL,27294,CAMPO GRANDE,4214,531,1381,7242,5861,146,463
AL,27316,CANAPI,6542,450,2957,11722,8765,198,869
AL,27332,CAPELA,4127,2174,2405,11935,9530,374,860
AL,27359,CARNEIROS,3244,419,1237,5745,4508,57,378
AL,27375,CHÃ PRETA,2256,698,1311,5391,4080,164,416
AL,27391,COITÉ DO NÓIA,4187,640,1633,7845,6212,175,551
AL,27413,COLÔNIA LEOPOLDINA,3634,2591,2855,13168,10313,475,871
AL,27430,COQUEIRO SECO,1792,655,460,4113,3653,256,353
AL,27456,CORURIPE,10566,6214,7637,36985,29348,1607,2278
AL,27472,DELMIRO GOUVEIA,18857,1970,6417,33644,27227,661,1897
AL,27499,DOIS RIACHOS,3787,639,2003,7848,5845,125,541
AL,27510,FEIRA GRANDE,8109,1379,2660,14748,12088,494,975
AL,27537,FELIZ DESERTO,1185,383,781,3151,2370,123,237
AL,27553,FLEXEIRAS,1591,1531,1796,7814,6018,228,679
AL,27570,GIRAU DO PONCIANO,12514,1520,5405,22708,17303,478,1390
AL,27596,IBATEGUARA,2798,1823,1895,9567,7672,420,867
AL,27618,IGACI,8994,1077,5010,17868,12858,479,1235
AL,27634,IGREJA NOVA,7974,1374,2968,15476,12508,789,1009
AL,27650,INHAPI,6503,445,2448,10983,8535,198,829
AL,27677,JACARÉ DOS HOMENS,2293,347,860,4306,3446,49,278
AL,27693,JACUÍPE,1833,446,891,4722,3831,157,305
AL,27715,JAPARATINGA,1107,572,1159,5685,4526,262,364
AL,27731,JARAMATAIA,2154,351,794,4202,3408,96,317
AL,27758,JOAQUIM GOMES,4526,1351,2432,11811,9379,381,963
AL,27774,JUNDIÁ,924,596,971,3826,2855,117,257
AL,27790,JUNQUEIRO,6624,3094,3982,17049,13067,531,980
AL,27812,LAGOA DA CANOA,6452,1586,1954,12380,10426,310,819
AL,27839,LIMOEIRO DE ANADIA,7526,1696,2953,15261,12308,409,1015
AL,27855,MACEIÓ,126159,116834,89721,551962,462241,25148,36913
AL,27871,MAJOR ISIDORO,6062,1902,3072,13519,10447,264,804
AL,27898,MARAGOGI,3222,1406,3151,17351,14200,824,1020
AL,27910,MARAVILHA,3054,827,1568,7089,5521,125,496
AL,27936,MARECHAL DEODORO,9467,5973,6280,31717,25437,1372,2054
AL,27952,MARIBONDO,3738,1665,2059,9847,7788,313,765
AL,27979,MAR VERMELHO,1469,357,563,3007,2444,90,215
AL,27995,MATA GRANDE,8140,977,3642,15096,11454,325,1092
AL,28010,MATRIZ DE CAMARAGIBE,4806,2232,3658,16484,12826,594,862
AL,28037,MESSIAS,3891,2106,2060,11413,9353,423,775
AL,28053,MINADOR DO NEGRÃO,1881,367,689,3790,3101,81,338
AL,28070,MONTEIRÓPOLIS,2708,631,1131,5238,4107,106,316
AL,28096,MURICI,5795,3005,3407,17759,14352,683,1501
AL,28118,NOVO LINO,2336,1510,1772,8338,6566,286,581
AL,28134,OLHO D'ÁGUA DAS FLORES,4170,2874,3056,13503,10447,345,956
AL,28150,OLHO D'ÁGUA DO CASADO,3708,235,1304,6077,4773,97,448
AL,28177,OLHO D'ÁGUA GRANDE,2145,263,821,3792,2971,83,260
AL,28193,OLIVENÇA,3754,770,1538,7713,6175,100,639
AL,28215,OURO BRANCO,3896,501,1313,7095,5782,118,444
AL,28231,PALESTINA,2059,416,820,3847,3027,51,192
AL,28258,PALMEIRA DOS ÍNDIOS,20278,7693,8688,46881,38193,1471,2914
AL,28274,PÃO DE AÇÚCAR,8306,1509,3574,16430,12856,352,957
AL,28290,PASSO DE CAMARAGIBE,4017,1325,2016,10336,8320,442,632
AL,28312,PAULO JACINTO,2421,940,1260,5919,4659,205,427
AL,28339,PENEDO,15846,3470,9248,39012,29764,1302,2080
AL,28355,PIAÇABUÇU,5281,1143,2891,12003,9112,339,802
AL,28371,PILAR,6877,4394,4524,23176,18652,1232,1629
AL,28398,PINDOBA,1060,278,341,2236,1895,61,214
AL,28410,PIRANHAS,9334,668,3337,15550,12213,191,1019
AL,28436,POÇO DAS TRINCHEIRAS,5345,597,1812,8915,7103,133,526
AL,28452,PORTO CALVO,2932,2703,4083,18207,14124,908,1132
AL,28479,PORTO DE PEDRAS,1399,1139,1186,6113,4927,280,350
AL,28495,PORTO REAL DO COLÉGIO,6821,1312,2437,13158,10721,469,817
AL,28517,QUEBRANGULO,4304,1175,1726,8851,7125,178,616
AL,28533,RIO LARGO,16097,7495,7908,48337,40429,2478,2972
AL,28550,ROTEIRO,1389,485,680,3854,3174,126,345
AL,28576,SANTA LUZIA DO NORTE,2267,892,641,5027,4386,204,364
AL,28592,SANTANA DO IPANEMA,14751,3521,5264,28075,22811,480,1709
AL,28614,SANTANA DO MUNDAÚ,3183,1011,1608,7107,5499,205,508
AL,28630,SÃO BRÁS,2672,531,965,5220,4255,199,328
AL,28657,SÃO JOSÉ DA LAJE,5148,2342,2846,15387,12541,491,1110
AL,28673,SÃO JOSÉ DA TAPERA,9205,1330,4699,18315,13616,358,1214
AL,28690,SÃO LUÍS DO QUITUNDE,6093,3008,4472,20559,16087,908,1303
AL,28711,SÃO MIGUEL DOS CAMPOS,6720,6364,6138,35545,29407,1224,2128
AL,28738,SÃO MIGUEL DOS MILAGRES,1226,910,1133,5680,4547,325,478
AL,28754,SÃO SEBASTIÃO,11072,2864,4586,22243,17657,600,1468
AL,28770,SATUBA,3186,1281,1340,9050,7710,436,489
AL,28797,TANQUE D'ARCA,2160,387,1093,4774,3681,207,355
AL,28819,TAQUARANA,4566,1399,2441,12185,9744,390,975
AL,28835,TRAIPU,8239,1163,3821,15834,12013,213,1050
AL,28851,UNIÃO DOS PALMARES,14727,7038,8612,40396,31784,1482,2854
AL,28878,VIÇOSA,5985,3655,3665,18241,14576,735,1346
AL,28894,CRAÍBAS,8502,1185,3188,15760,12572,500,1109
AL,28916,SENADOR RUI PALMEIRA,4219,398,1717,7849,6132,93,582
AL,28932,TEOTÔNIO VILELA,7745,4748,5603,25481,19878,904,1611
AM,2003,APUÍ,3801,1947,3101,9485,6384,72,351
AM,2011,NOVO AIRÃO,4042,1529,1132,7676,6544,53,352
AM,2020,GUAJARÁ,3482,972,3343,8659,5316,34,356
AM,2038,ANORI,4145,1386,2530,9328,6798,55,292
AM,2046,CAREIRO DA VÁRZEA,7952,1295,1610,12802,11192,99,470
AM,2054,ATALAIA DO NORTE,2578,613,2184,6919,4735,7,254
AM,2070,AUTAZES,12147,1635,5666,22305,16639,131,746
AM,2097,BARCELOS,2944,1467,3162,9227,6065,61,333
AM,2119,BARREIRINHA,9886,655,4513,16916,12403,75,551
AM,2135,BENJAMIN CONSTANT,11603,1156,4424,18891,14467,84,693
AM,2151,BOCA DO ACRE,8228,3175,5193,18823,13630,132,936
AM,2178,BORBA,10047,1328,5103,18757,13654,70,670
AM,2194,CANUTAMA,3373,678,2432,7171,4739,39,333
AM,2216,CARAUARI,8414,1185,6526,17731,11205,58,615
AM,2232,CAREIRO,11137,1981,5697,21450,15753,148,1009
AM,2259,COARI,18929,5105,13796,46097,32301,328,1636
AM,2275,CODAJÁS,6836,1228,4391,14131,9740,51,441
AM,2291,EIRUNEPÉ,8501,1739,7930,20280,12350,148,952
AM,2313,ENVIRA,5348,610,3723,10492,6769,41,455
AM,2330,FONTE BOA,7828,873,3801,13463,9662,39,537
AM,2356,HUMAITÁ,13400,4086,6758,26562,19804,202,824
AM,2372,SANTA ISABEL DO RIO NEGRO,2591,668,2756,6863,4107,41,252
AM,2399,IPIXUNA,4720,671,3409,9566,6157,38,472
AM,2410,ITACOATIARA,32500,7645,6679,55262,48583,472,1578
AM,2437,ITAPIRANGA,3592,640,1451,6666,5215,26,150
AM,2453,JAPURÁ,1700,441,1232,3815,2583,17,100
AM,2470,JURUÁ,2541,1177,2374,6610,4236,35,275
AM,2496,JUTAÍ,5757,424,3399,10630,7231,42,556
AM,2518,LÁBREA,10591,1927,7792,22260,14468,110,876
AM,2534,MANACAPURU,28605,7084,5940,52230,46290,443,2157
AM,2550,MANAUS,407714,231578,181029,1244405,1063376,30130,42225
AM,2577,MANICORÉ,12841,3250,7270,25437,18167,83,854
AM,2593,MARAÃ,4514,318,2931,8445,5514,14,297
AM,2615,MAUÉS,15624,1614,8335,28916,20581,159,1002
AM,2631,NHAMUNDÁ,6638,914,3377,12139,8762,31,308
AM,2658,NOVA OLINDA DO NORTE,8302,1103,4385,15508,11123,76,551
AM,2674,NOVO ARIPUANÃ,5738,803,3751,11384,7633,72,381
AM,2690,PARINTINS,31770,6391,17153,64215,47062,520,1355
AM,2712,PAUINI,3894,576,3274,9146,5872,33,304
AM,2739,SANTO ANTÔNIO DO IÇÁ,6371,887,3074,12055,8981,80,598
AM,2755,SÃO PAULO DE OLIVENÇA,8648,1088,2976,14756,11780,75,857
AM,2771,SILVES,4121,280,1364,6462,5098,31,165
AM,2798,TAPAUÁ,5401,1069,4054,11880,7826,55,461
AM,2810,TEFÉ,18734,3761,10016,37434,27418,243,1209
AM,2836,SÃO GABRIEL DA CACHOEIRA,14203,1618,8210,26780,18570,99,621
AM,2852,URUCARÁ,6338,604,2715,10817,8102,48,327
AM,2879,URUCURITUBA,6688,619,3115,11595,8480,51,298
AM,2895,ALVARÃES,5086,655,2427,9057,6630,29,329
AM,2917,AMATURÁ,2816,358,1112,5112,4000,25,264
AM,2933,ANAMÃ,3437,507,1850,6734,4884,30,232
AM,2950,BERURI,6338,625,2307,10092,7785,35,368
AM,2976,BOA VISTA DO RAMOS,5353,470,2783,9572,6789,20,272
AM,2992,CAAPIRANGA,4140,392,1910,7237,5327,38,249
AM,98353,IRANDUBA,13013,2133,1395,20899,19504,191,921
AM,98370,ITAMARATI,2497,744,1900,5997,4097,18,223
AM,98396,MANAQUIRI,6981,697,2991,12005,9014,67,431
AM,98418,PRESIDENTE FIGUEIREDO,9362,1966,2345,16729,14384,165,642
AM,98434,RIO PRETO DA EVA,6293,1847,1487,11987,10500,133,699
AM,98450,SÃO SEBASTIÃO DO UATUMÃ,2774,645,1406,5494,4088,36,153
AM,98477,TABATINGA,13857,2216,6969,28416,21447,285,1475
AM,98493,UARINI,3996,588,1788,6997,5209,25,249
AM,98515,TONANTINS,4599,621,2198,8268,6070,21,367
AP,6009,PRACUÚBA,1543,303,166,2471,2305,11,54
AP,6017,AMAPÁ,3079,801,528,5301,4773,36,156
AP,6025,PORTO GRANDE,6436,1913,1476,11533,10057,101,447
AP,6033,CALÇOENE,3363,1457,1019,6777,5758,53,216
AP,6041,ITAUBAL,2324,568,392,4037,3645,22,98
AP,6050,MACAPÁ,105408,64960,26279,268474,242195,3240,7707
AP,6068,CUTIAS,2034,493,279,3357,3078,16,84
AP,6076,MAZAGÃO,7905,1484,994,12257,11263,60,287
AP,6084,PEDRA BRANCA DO AMAPARI,4027,1171,1209,7745,6536,70,244
AP,6092,OIAPOQUE,6291,2210,3658,15974,12316,246,608
AP,6106,SERRA DO NAVIO,1540,654,317,3079,2762,17,90
AP,6114,FERREIRA GOMES,2429,713,905,5435,4530,48,127
AP,6122,VITÓRIA DO JARI,5629,857,1027,8668,7641,64,267
AP,6130,LARANJAL DO JARI,13285,4314,3299,26137,22838,333,814
AP,6157,SANTANA,29514,16268,5342,67380,62038,665,2038
AP,6173,TARTARUGALZINHO,4209,959,673,7055,6382,63,236
BA,30007,LUÍS EDUARDO MAGALHÃES,11032,10343,8968,39378,30410,867,1183
BA,30058,EUNÁPOLIS,17401,14226,20087,74025,53938,1469,3271
BA,30660,IUIU,4222,1084,2180,8255,6075,100,320
BA,30678,JABORANDI,3992,845,931,6539,5608,139,410
BA,30694,JUSSARI,2004,759,1572,4962,3390,50,256
BA,30716,AMÉRICA DOURADA,6690,698,3545,12361,8816,167,473
BA,30732,ARATACA,2723,832,433,5000,4567,53,306
BA,30759,BARRO ALTO,5209,742,2024,9267,7243,158,359
BA,30775,BARROCAS,6765,1355,2494,12173,9679,129,598
BA,30791,BURITIRAMA,6632,2133,4695,14827,10132,83,838
BA,30813,CAPELA DO ALTO ALEGRE,3793,1154,2329,9075,6746,271,600
BA,30830,CAPIM GROSSO,7894,2945,5244,20808,15564,510,1083
BA,30856,CANUDOS,6580,560,3319,12057,8738,103,519
BA,30872,DIAS D'ÁVILA,18935,4300,9161,43915,34754,1560,2196
BA,30899,FÁTIMA,6942,1372,4042,14546,10504,372,755
BA,30910,FILADÉLFIA,6069,1596,3625,13557,9932,237,767
BA,30937,GAVIÃO,1670,680,984,4063,3079,63,272
BA,30953,GUAJERU,3594,380,2797,7452,4655,45,361
BA,30970,HELIÓPOLIS,5761,896,3465,11255,7790,157,447
BA,30996,JOÃO DOURADO,8070,1425,4465,17115,12650,221,524
BA,33014,ABAÍRA,2928,1047,1741,6739,4998,124,442
BA,33030,ABARÉ,6901,848,1845,11806,9961,65,738
BA,33057,ACAJUTIBA,4513,1543,2721,10801,8080,235,689
BA,33065,ADUSTINA,6192,780,1457,9948,8491,223,693
BA,33073,ÁGUA FRIA,4580,1152,3067,11912,8845,223,936
BA,33090,ÉRICO CARDOSO,3270,1324,3387,9044,5657,118,512
BA,33111,AIQUARA,1919,301,1374,4417,3043,65,238
BA,33138,ALAGOINHAS,37064,12650,22591,106317,83726,3815,5785
BA,33154,ALCOBAÇA,7927,1489,5483,17502,12019,377,813
BA,33170,ALMADINA,2047,773,1639,5215,3576,70,311
BA,33197,AMARGOSA,9602,2717,5812,24713,18901,658,1408
BA,33219,AMÉLIA RODRIGUES,7864,2007,3171,17343,14172,633,992
BA,33235,ANAGÉ,7432,2801,4434,17738,13304,277,1108
BA,33251,ANDARAÍ,5241,353,3426,10179,6753,99,453
BA,33260,ANDORINHA,7287,594,1108,10357,9249,199,576
BA,33278,ANGICAL,7232,826,2432,11699,9267,121,615
BA,33294,ANGUERA,4832,646,1859,8832,6973,168,511
BA,33316,ANTAS,5145,1202,2292,10069,7777,141,520
BA,33332,ANTÔNIO CARDOSO,6483,483,1784,10266,8482,184,450
BA,33359,ANTÔNIO GONÇALVES,3770,735,1897,7741,5844,123,427
BA,33375,APORÁ,5347,1961,4307,13386,9079,265,685
BA,33383,ARAÇÁS,4546,1158,2658,10233,7575,318,450
BA,33391,ARACATU,6185,958,3258,12286,9028,181,596
BA,33405,APUAREMA,2002,809,1776,5573,3797,86,369
BA,33413,ARACI,19925,2570,12057,38916,26859,410,1742
BA,33430,ARAMARI,4231,697,1503,8160,6657,206,489
BA,33456,ARATUÍPE,3550,731,1890,7637,5747,198,446
BA,33472,AURELINO LEAL,4092,549,1357,7760,6403,102,506
BA,33499,BAIANÓPOLIS,6361,890,2131,10735,8604,162,494
BA,33510,BAIXA GRANDE,5761,2167,4305,15505,11200,379,975
BA,33529,BANZAÊ,4383,1052,2881,9820,6939,174,510
BA,33537,BARRA,19116,1949,9542,34725,25183,257,1852
BA,33553,BARRA DA ESTIVA,8002,3091,3389,17542,14153,381,905
BA,33570,BARRA DO CHOÇA,10290,3172,6948,25787,18839,420,1523
BA,33596,BARRA DO MENDES,6446,478,3640,11668,8028,172,451
BA,33618,BARRA DO ROCHA,1742,230,387,3336,2949,33,200
BA,33634,BARREIRAS,39538,13743,19164,89969,70805,2064,3573
BA,33650,BARRO PRETO,2271,1064,1275,5470,4195,103,285
BA,33677,BELMONTE,5865,1636,4111,14696,10585,264,820
BA,33693,BELO CAMPO,4948,2281,4696,14274,9578,185,665
BA,33715,BIRITINGA,6294,612,2861,11593,8732,227,786
BA,33731,BOA NOVA,5704,846,5119,13267,8148,171,786
BA,33758,BOA VISTA DO TUPIM,5696,2290,3521,13124,9603,119,807
BA,33774,BOM JESUS DA LAPA,24000,3347,12254,44730,32476,654,1590
BA,33782,BOM JESUS DA SERRA,4288,470,2888,8633,5745,83,496
BA,33790,BONINAL,4400,1047,3030,9809,6779,142,594
BA,33804,BONITO,5814,968,2918,11230,8312,157,485
BA,33812,BOQUIRA,8200,757,4604,15392,10788,165,773
BA,33839,BOTUPORÃ,4429,1106,2839,9411,6572,91,526
BA,33855,BREJÕES,4728,902,3813,11420,7607,184,551
BA,33871,BREJOLÂNDIA,3634,978,1875,7594,5719,170,441
BA,33898,BROTAS DE MACAÚBAS,4092,1427,2202,8734,6532,94,452
BA,33910,BRUMADO,20820,4262,7630,45605,37975,921,2290
BA,33936,BUERAREMA,2103,5444,1503,10720,9217,197,849
BA,33952,CAATIBA,2893,942,2581,7638,5057,86,417
BA,33960,CABACEIRAS DO PARAGUAÇU,5942,1172,1176,9653,8477,145,660
BA,33979,CACHOEIRA,11326,2722,4718,24149,19431,708,1033
BA,33995,CACULÉ,6278,3948,3366,15871,12505,323,953
BA,34010,CAEM,3872,705,2290,8107,5817,79,521
BA,34029,CAETANOS,4833,436,3074,9157,6083,54,466
BA,34037,CAETITÉ,18293,5833,7372,37036,29664,626,2227
BA,34053,CAFARNAUM,6221,1071,3488,12655,9167,226,507
BA,34070,CAIRU,4928,1401,2446,11849,9403,349,619
BA,34096,CALDEIRÃO GRANDE,4536,953,2557,8835,6278,71,378
BA,34118,CAMACAN,6323,2965,4888,17689,12801,323,886
BA,34134,CAMAÇARI,50952,19429,26068,151897,125829,5421,8067
BA,34150,CAMAMU,7762,2567,8241,24855,16614,523,1431
BA,34177,CAMPO ALEGRE DE LOURDES,12098,1030,7048,22129,15081,141,1000
BA,34193,CAMPO FORMOSO,25276,6615,10130,49073,38943,850,3001
BA,34215,CANÁPOLIS,4252,682,1648,7683,6035,111,504
BA,34231,CANARANA,9228,1591,3470,16521,13051,241,700
BA,34258,CANAVIEIRAS,9086,3011,3027,18848,15821,346,1164
BA,34274,CANDEAL,3981,649,1076,6781,5705,102,408
BA,34290,CANDEIAS,29592,4792,11612,59472,47860,2371,3128
BA,34312,CANDIBA,5926,868,1877,10210,8333,206,583
BA,34339,CÂNDIDO SALES,8669,2248,2144,14984,12840,199,871
BA,34355,CANSANÇÃO,14312,953,7547,25807,18260,273,1298
BA,34363,CARAÍBAS,3178,1481,2167,7956,5789,73,492
BA,34371,CARAVELAS,7134,1071,3328,13791,10463,201,804
BA,34398,CARDEAL DA SILVA,2965,460,2094,7029,4935,173,489
BA,34410,CARINHANHA,9188,2636,5753,20513,14760,171,968
BA,34436,CASA NOVA,29630,2636,8859,48956,40097,724,2795
BA,34452,CASTRO ALVES,11349,2409,5299,21981,16682,324,1023
BA,34479,CATOLÂNDIA,1737,179,412,2768,2356,59,150
BA,34495,CATU,15473,3294,6885,38761,31876,2081,2567
BA,34509,CATURAMA,3406,556,2105,6943,4838,126,387
BA,34517,CENTRAL,6754,1119,2755,12528,9773,228,572
BA,34533,CHORROCHÓ,4766,523,1840,8602,6762,72,475
BA,34550,CÍCERO DANTAS,11592,2957,5859,24123,18264,771,1230
BA,34576,CIPÓ,5911,1322,3224,12909,9685,169,700
BA,34592,COARACI,6230,3076,4562,16719,12157,253,724
BA,34614,COCOS,5933,2038,1757,11637,9880,193,802
BA,34630,CONCEIÇÃO DA FEIRA,7762,1438,2398,14754,12356,527,785
BA,34657,CONCEIÇÃO DO ALMEIDA,7668,1186,3507,14590,11083,319,684
BA,34673,CONCEIÇÃO DO COITÉ,22196,9539,7432,47298,39866,943,2357
BA,34690,CONCEIÇÃO DO JACUÍPE,10051,2771,3801,21934,18133,795,1194
BA,34711,CONDE,7422,1191,4568,16433,11865,366,977
BA,34738,CONDEÚBA,6170,1885,4644,14765,10121,232,812
BA,34754,CONTENDAS DO SINCORÁ,1764,444,702,3541,2839,53,167
BA,34770,CORAÇÃO DE MARIA,11045,1496,4366,20307,15941,511,868
BA,34797,CORDEIROS,2358,1233,1929,6438,4509,62,409
BA,34819,CORIBE,6380,1185,1578,10393,8815,141,583
BA,34835,CORONEL JOÃO SÁ,6405,1276,3428,13094,9666,206,1027
BA,34851,CORRENTINA,10652,4116,7123,25356,18233,474,1423
BA,34878,COTEGIPE,5890,591,2833,10536,7703,122,498
BA,34894,CRAVOLÂNDIA,1680,417,1223,4211,2988,149,294
BA,34916,CRISÓPOLIS,7514,1316,5552,16315,10763,227,735
BA,34932,CRISTÓPOLIS,6097,1035,2618,11280,8662,131,643
BA,34959,CRUZ DAS ALMAS,19606,6052,6533,41918,35385,1174,1849
BA,34975,CURAÇÁ,13830,1424,5421,24065,18644,222,1008
BA,34991,DÁRIO MEIRA,3807,522,3231,8995,5764,146,563
BA,35017,DOM BASÍLIO,5781,779,1867,9419,7552,219,425
BA,35033,DOM MACEDO COSTA,1841,268,345,3256,2911,68,216
BA,35050,ELÍSIO MEDRADO,3498,658,1981,7498,5517,184,447
BA,35076,ENCRUZILHADA,5838,2254,1916,12181,10265,177,983
BA,35092,ENTRE RIOS,11019,2885,8846,30016,21170,1112,1703
BA,35114,ESPLANADA,10880,2350,5502,23122,17620,732,1326
BA,35130,EUCLIDES DA CUNHA,22809,2460,9895,40607,30712,543,2118
BA,35149,FEIRA DA MATA,2172,831,1275,4707,3432,36,152
BA,35157,FEIRA DE SANTANA,149718,48635,66632,388012,321380,10857,19779
BA,35173,FIRMINO ALVES,1683,720,1281,4354,3073,70,220
BA,35190,FLORESTA AZUL,2938,1098,2068,7342,5274,122,432
BA,35211,FORMOSA DO RIO PRETO,7583,1820,4315,16689,12374,176,917
BA,35238,GANDU,7276,2997,4764,20137,15373,406,1200
BA,35254,GENTIO DO OURO,5107,676,1801,8625,6824,99,325
BA,35270,GLÓRIA,7320,709,2767,12266,9499,225,633
BA,35297,GONGOGI,2353,381,941,4327,3386,53,283
BA,35319,GOVERNADOR MANGABEIRA,6765,2342,1728,13339,11611,388,768
BA,35335,GUANAMBI,29006,8838,10822,57669,46847,1027,2837
BA,35351,GUARATINGA,7192,1314,4190,15090,10900,231,793
BA,35378,IAÇU,8490,1620,7836,21016,13180,350,1131
BA,35394,IBIASSUCÊ,3614,2053,2094,8607,6513,83,491
BA,35416,IBICARAÍ,6572,3784,4665,18230,13565,303,945
BA,35432,IBICOARA,5919,1804,2757,12419,9662,298,724
BA,35459,IBICUÍ,4420,1621,3117,11037,7920,198,562
BA,35475,IBIPEBA,7276,743,3387,12737,9350,176,529
BA,35491,SANTA RITA DE CÁSSIA,11164,1620,6359,21840,15481,343,1029
BA,35513,IBIPITANGA,5531,991,3535,11594,8059,137,436
BA,35530,IBIQUERA,1550,193,932,3288,2356,28,253
BA,35556,IBIRAPITANGA,5534,1323,3555,13606,10051,183,859
BA,35572,IBIRAPUÃ,2066,1247,1380,6117,4737,130,395
BA,35599,IBIRATAIA,5742,1861,1478,12598,11120,284,1174
BA,35610,IBITIARA,5376,1116,2993,11152,8159,139,583
BA,35637,IBITITÁ,8695,601,2946,13977,11031,180,585
BA,35653,IBOTIRAMA,8487,3037,4067,17987,13920,231,859
BA,35670,ICHU,2582,706,708,4866,4158,116,260
BA,35696,IGAPORÃ,6452,782,2124,10815,8691,193,614
BA,35700,IGRAPIÚNA,4393,624,3069,9857,6788,194,478
BA,35718,IGUAÍ,7805,1733,7074,19634,12560,213,1121
BA,35734,ILHÉUS,38547,19908,37671,133393,95722,3776,5633
BA,35750,INHAMBUPE,10347,3759,6148,24988,18840,745,1615
BA,35777,IPECAETÁ,6300,1511,3012,12682,9670,205,618
BA,35793,IPIAÚ,11504,3338,2899,25705,22806,613,1841
BA,35815,IPIRÁ,17885,6254,11061,43517,32456,884,2574
BA,35831,IPUPIARA,3843,796,1741,7314,5573,106,274
BA,35858,IRAJUBA,2728,541,1307,5297,3990,77,353
BA,35874,IRAMAIA,3724,1300,2845,9033,6188,137,484
BA,35890,IRAQUARA,10028,780,3200,15492,12292,186,600
BA,35912,IRARÁ,10908,1902,5153,22230,17077,449,1143
BA,35939,IRECÊ,20871,4209,10979,44298,33319,777,1929
BA,35947,ITABELA,7858,3280,7342,22505,15163,583,1127
BA,35955,ITABERABA,17390,5271,8597,40198,31601,1072,2653
BA,35971,ITABUNA,45863,36145,35183,148827,113644,3308,6319
BA,35998,ITACARÉ,5844,1027,3504,13466,9962,244,675
BA,36013,ITAETÉ,4756,916,3020,10117,7097,148,583
BA,36030,ITAGI,4011,1405,2983,10489,7506,116,679
BA,36056,ITAGIBÁ,5284,882,3344,12056,8712,170,764
BA,36072,ITAGIMIRIM,1645,994,1814,5780,3966,105,332
BA,36080,ITAGUAÇU DA BAHIA,5723,387,2190,9386,7196,92,527
BA,36099,ITAJU DO COLÔNIA,1670,895,1222,4540,3318,40,237
BA,36110,ITAJUÍPE,6233,2872,4402,16622,12220,326,792
BA,36137,ITAMARAJU,12899,8725,11098,42294,31196,967,2187
BA,36153,ITAMARI,2860,711,2026,6711,4685,79,346
BA,36170,ITAMBÉ,7229,2649,5481,18056,12575,233,884
BA,36196,ITANAGRA,2154,468,1384,4784,3400,97,250
BA,36218,ITANHÉM,5948,2749,4433,15691,11258,276,1006
BA,36234,ITAPARICA,8246,1021,4179,16380,12201,317,610
BA,36250,ITAPÉ,3509,1206,2690,8995,6305,145,522
BA,36277,ITAPEBI,3009,987,2893,8166,5273,117,386
BA,36293,ITAPETINGA,13080,9962,9140,44526,35386,733,2127
BA,36315,ITAPICURU,11324,1045,7336,23128,15792,366,1331
BA,36331,ITAPITANGA,2565,791,2471,6819,4348,78,248
BA,36358,ITAQUARA,2560,1145,1581,6245,4664,114,387
BA,36374,ITARANTIM,4951,2104,3223,13110,9887,224,933
BA,36382,ITATIM,5395,1796,2336,11133,8797,215,624
BA,36390,ITIRUÇU,3805,1066,2980,9587,6607,226,542
BA,36412,ITIÚBA,11221,4513,8455,28255,19800,519,1300
BA,36439,ITORORÓ,4448,3194,5389,16090,10701,250,827
BA,36455,ITUAÇU,5050,3350,2689,14042,11353,387,940
BA,36471,ITUBERÁ,7510,2551,5786,19391,13605,427,924
BA,36498,JACARACI,5638,959,3297,11426,8129,133,723
BA,36510,JACOBINA,25426,5835,13220,55249,42029,1059,3140
BA,36536,JAGUAQUARA,14457,4497,10397,35393,24996,765,2128
BA,36552,JAGUARARI,10687,2714,4090,21404,17314,383,1064
BA,36579,JAGUARIPE,6343,1078,2660,12022,9362,374,643
BA,36595,JANDAÍRA,3842,699,2147,7839,5692,109,486
BA,36617,JEQUIÉ,43663,11499,23140,106634,83494,3033,5747
BA,36633,JEREMOABO,14926,1588,5832,25462,19630,280,1455
BA,36650,JIQUIRIÇÁ,4150,1587,3167,10606,7439,256,609
BA,36676,JITAÚNA,4670,1305,5047,14117,9070,155,889
BA,36692,JUAZEIRO,67404,11473,25805,139556,113751,2106,4830
BA,36706,JUCURUÇU,3836,782,2307,7929,5622,62,458
BA,36714,JUSSARA,6948,544,2661,11516,8855,134,705
BA,36730,JUSSIAPE,3236,804,1625,6459,4834,114,365
BA,36757,LAFAIETE COUTINHO,2135,264,592,3492,2900,71,184
BA,36765,LAGOA REAL,5395,862,2463,9882,7419,103,637
BA,36773,LAJE,7478,2582,4407,18355,13948,309,1145
BA,36790,LAJEDÃO,1791,636,997,4278,3281,54,345
BA,36811,LAJEDINHO,1761,153,723,3082,2359,22,240
BA,36820,LAJEDO DO TABOCAL,2899,442,1601,5854,4253,148,319
BA,36838,LAMARÃO,3612,408,2394,7264,4870,121,336
BA,36854,LAURO DE FREITAS,43506,13592,21386,112519,91133,4180,6585
BA,36870,LENÇÓIS,3519,474,2156,7091,4935,102,397
BA,36897,LICÍNIO DE ALMEIDA,4525,1394,2062,9012,6950,152,427
BA,36919,LIVRAMENTO DE NOSSA SENHORA,16371,3238,8414,32406,23992,800,1754
BA,36935,MACAJUBA,3789,1102,3403,9718,6315,136,691
BA,36951,MACARANI,3916,2593,3998,13324,9326,259,1085
BA,36978,MACAÚBAS,14813,4463,10003,33118,23115,463,1735
BA,36994,MACURURÉ,3334,441,1775,6564,4789,56,351
BA,37010,MAIQUINIQUE,2680,1085,1720,6895,5175,75,514
BA,37036,MAIRI,6457,1436,4364,14211,9847,322,768
BA,37052,MALHADA,6237,1611,3335,12449,9114,118,635
BA,37079,MALHADA DE PEDRAS,3316,848,1479,6905,5426,89,341
BA,37095,MANOEL VITORINO,6160,731,2350,10686,8336,80,545
BA,37117,MARACÁS,7192,2769,6405,20229,13824,392,1041
BA,37133,MARAGOGIPE,17571,3889,6051,32064,26013,715,1656
BA,37150,MARAÚ,5698,805,3896,12229,8333,189,667
BA,37176,MARCIONÍLIO SOUZA,3683,571,2427,7610,5183,100,396
BA,37192,MASCOTE,3630,1028,2821,8992,6171,117,452
BA,37214,MATA DE SÃO JOÃO,12034,4838,6816,33911,27095,1521,1832
BA,37222,MATINA,4920,394,2358,8717,6359,111,554
BA,37230,MEDEIROS NETO,7077,2985,4364,17614,13250,299,1254
BA,37257,MIGUEL CALMON,9601,2030,7021,21765,14744,243,1350
BA,37273,MILAGRES,4091,769,1954,8781,6827,113,548
BA,37290,MIRANGABA,5975,1139,3438,11977,8539,134,800
BA,37303,MIRANTE,3215,800,2324,7354,5030,65,432
BA,37311,MONTE SANTO,22758,1796,13082,42063,28981,599,2060
BA,37338,MORPARÁ,3628,790,1860,6954,5094,68,379
BA,37354,MORRO DO CHAPÉU,11473,2465,5352,22916,17564,306,1566
BA,37370,MORTUGABA,3380,2259,2663,9291,6628,86,533
BA,37397,MUCUGÊ,3428,1944,1769,8308,6539,145,582
BA,37419,MUCURI,8490,3227,8552,26508,17956,484,1066
BA,37427,MULUNGU DO MORRO,5146,535,2571,9189,6618,90,308
BA,37435,MUNDO NOVO,7139,1237,4723,15301,10578,204,995
BA,37451,MUNIZ FERREIRA,3455,755,1498,7019,5521,187,383
BA,37460,MUQUÉM DO SÃO FRANCISCO,4051,1302,2170,8476,6306,75,331
BA,37478,MURITIBA,9682,2289,2380,18008,15628,501,1082
BA,37494,MUTUÍPE,6019,3375,4955,17419,12464,325,1005
BA,37516,NAZARÉ,10767,1851,4814,21236,16422,627,1097
BA,37532,NILO PEÇANHA,3920,1018,1734,8063,6329,204,547
BA,37559,NOVA CANAÃ,5809,878,3769,12453,8684,145,849
BA,37567,NOVA FÁTIMA,3056,1186,1362,6916,5554,114,421
BA,37575,NOVA ITARANA,2404,750,1473,5446,3973,113,373
BA,37583,NOVA REDENÇÃO,3397,191,1599,5886,4287,64,349
BA,37591,NOVA SOURE,9846,1277,4898,18667,13769,310,1061
BA,37613,NOVA VIÇOSA,8572,4253,8061,28098,20037,528,1435
BA,37621,NOVO TRIUNFO,3328,1013,2584,7736,5152,52,341
BA,37630,OLINDINA,9644,959,6580,19938,13358,329,1000
BA,37656,OLIVEIRA DOS BREJINHOS,8245,1334,4087,15889,11802,278,802
BA,37672,OURIÇANGAS,3020,1032,1762,6834,5072,124,403
BA,37680,OUROLÂNDIA,4999,2225,3915,12939,9024,177,748
BA,37699,PALMAS DE MONTE ALTO,9772,1061,3508,16187,12679,209,951
BA,37710,PALMEIRAS,3536,486,1305,6111,4806,86,351
BA,37737,PARAMIRIM,7986,1284,4833,16067,11234,222,756
BA,37753,PARATINGA,12213,1506,5787,21488,15701,272,868
BA,37770,PARIPIRANGA,11647,2085,3196,19849,16653,436,1155
BA,37796,PAU BRASIL,3044,836,2039,7340,5301,90,281
BA,37818,PAULO AFONSO,41240,4810,19303,77751,58448,1581,3110
BA,37834,PEDRÃO,3149,414,1503,5904,4401,114,273
BA,37850,PEDRO ALEXANDRE,4870,485,2645,9235,6590,126,610
BA,37877,PIATÃ,7301,1326,4267,15000,10733,221,985
BA,37893,PILÃO ARCADO,13754,1020,5903,23571,17668,177,1160
BA,37915,PINDAÍ,6623,726,2872,11940,9068,187,722
BA,37931,PINDOBAÇU,6458,2346,3578,14552,10974,266,739
BA,37940,PIRAÍ DO NORTE,2577,703,1132,5430,4298,107,286
BA,37958,PIRIPÁ,3356,1061,3508,9095,5587,59,469
BA,37974,PIRITIBA,6508,1169,3458,13253,9795,149,724
BA,37990,PLANALTINO,3288,757,1419,6124,4705,116,374
BA,38016,PLANALTO,7603,3306,3550,17172,13622,292,1029
BA,38032,POÇÕES,13063,4260,10814,33862,23048,546,2007
BA,38059,POJUCA,6978,3535,4507,25061,20554,1652,1798
BA,38067,PONTO NOVO,4805,1523,3944,12122,8178,171,694
BA,38075,PORTO SEGURO,26375,9670,22713,82450,59737,2225,3767
BA,38091,POTIRAGUÁ,2921,1300,3215,8792,5577,111,490
BA,38113,PRADO,7707,2594,6960,20844,13884,314,980
BA,38130,PRESIDENTE DUTRA,6355,446,2268,10633,8365,177,541
BA,38156,PRESIDENTE JÂNIO QUADROS,4841,681,4396,11128,6732,65,556
BA,38164,PRESIDENTE TANCREDO NEVES,6040,4368,5104,19059,13955,473,1214
BA,38172,QUEIMADAS,9359,1525,5022,18844,13822,311,931
BA,38199,QUINJINGUE,9300,2761,4722,20132,15410,225,1036
BA,38210,REMANSO,15636,2363,7068,28818,21750,290,1426
BA,38237,RETIROLÂNDIA,6153,973,1637,10359,8722,189,520
BA,38253,RIACHÃO DAS NEVES,9808,1079,4027,17261,13234,252,1059
BA,38270,RIACHÃO DO JACUÍPE,12485,3665,3899,24209,20310,632,1546
BA,38296,RIACHO DE SANTANA,12342,2034,5156,22315,17159,434,1192
BA,38318,RIBEIRA DO AMPARO,6279,483,3329,11403,8074,188,617
BA,38334,RIBEIRA DO POMBAL,16769,4657,11399,39356,27957,718,2018
BA,38342,RIBEIRÃO DO LARGO,3514,798,881,6430,5549,98,480
BA,38350,RIO DE CONTAS,5655,1167,2981,11517,8536,163,614
BA,38377,RIO DO ANTÔNIO,5707,778,3534,11203,7669,164,584
BA,38393,RIO DO PIRES,4100,1315,3768,10282,6514,138,498
BA,38415,RIO REAL,11681,3091,7790,28424,20634,915,1465
BA,38431,RODELAS,3112,388,1126,5913,4787,55,245
BA,38458,RUY BARBOSA,10507,2520,7237,23666,16429,349,1263
BA,38474,SALINAS DA MARGARIDA,6637,566,1930,10975,9045,266,502
BA,38490,SALVADOR,644619,277855,390030,1923853,1533823,79733,146486
BA,38512,SANTA BÁRBARA,10289,1244,3297,16929,13632,255,877
BA,38539,SANTA BRÍGIDA,6487,631,3315,11667,8352,166,563
BA,38555,SANTA CRUZ CABRÁLIA,4492,2548,5291,17512,12221,391,841
BA,38571,SANTA CRUZ DA VITÓRIA,1497,673,1742,4686,2944,69,251
BA,38598,SANTA INÊS,3999,537,2448,8041,5593,155,398
BA,38610,SANTALUZ,12752,4565,6203,28212,22009,617,1608
BA,38636,SANTA MARIA DA VITÓRIA,13859,3922,7524,29462,21938,476,1500
BA,38652,SANTANA,9393,2618,4629,19178,14549,307,1070
BA,38679,SANTANÓPOLIS,4506,618,1799,8324,6525,220,482
BA,38695,SANTA TEREZINHA,4073,768,2325,8435,6110,146,496
BA,38717,SANTO AMARO,22188,3638,8448,44852,36404,1482,2217
BA,38733,SANTO ANTÔNIO DE JESUS,25456,7464,5417,55269,49852,1714,3770
BA,38750,SANTO ESTEVÃO,17018,2992,9484,35623,26139,740,1517
BA,38776,SÃO DESIDÉRIO,9594,2624,2689,18004,15315,382,994
BA,38792,SÃO FÉLIX,5423,1181,1695,9893,8198,163,458
BA,38806,SÃO DOMINGOS,3300,1319,1324,6912,5588,121,336
BA,38814,SÃO FELIPE,6715,2934,3979,16648,12669,432,848
BA,38822,SÃO FÉLIX DO CORIBE,4813,1845,2000,10187,8187,198,477
BA,38830,SÃO FRANCISCO DO CONDE,13011,2708,4486,28739,24253,1163,1381
BA,38857,SÃO GONÇALO DOS CAMPOS,12705,1975,3531,23842,20311,803,1170
BA,38865,SÃO JOSÉ DO JACUÍPE,3422,1037,1961,7503,5542,171,459
BA,38873,SÃO MIGUEL DAS MATAS,3828,1120,1552,8278,6726,156,511
BA,38890,SÃO SEBASTIÃO DO PASSÉ,16132,2368,5482,31179,25697,1129,1747
BA,38911,SAPEAÇU,6702,1846,2588,13660,11072,338,697
BA,38938,SÁTIRO DIAS,5351,1707,4000,13029,9029,273,941
BA,38946,SAUBARA,5529,762,2467,11019,8552,318,447
BA,38954,SAÚDE,3779,838,2544,8541,5997,178,495
BA,38970,SEABRA,16231,2115,6413,29262,22849,565,1518
BA,38997,SEBASTIÃO LARANJEIRAS,3689,563,1871,6834,4963,104,305
BA,39012,SENHOR DO BONFIM,21336,7407,4268,42084,37816,1250,2545
BA,39039,SENTO SÉ,13662,3027,8251,27848,19597,242,984
BA,39047,SERRA DO RAMALHO,11979,1377,7413,23309,15896,282,1008
BA,39055,SERRA DOURADA,6482,2332,4358,14949,10591,160,582
BA,39071,SERRA PRETA,8396,1095,4228,16231,12003,290,951
BA,39098,SERRINHA,27287,5908,10466,54459,43993,1069,3469
BA,39110,SERROLÂNDIA,4036,1370,3044,10069,7025,173,577
BA,39136,SIMÕES FILHO,35492,5933,13949,77043,63094,2891,4353
BA,39144,SÍTIO DO MATO,5365,517,2776,9550,6774,75,301
BA,39152,SOUTO SOARES,6945,914,2589,11534,8945,127,378
BA,39179,TABOCAS DO BREJO VELHO,5154,769,2949,9843,6894,145,444
BA,39195,TANHAÇU,7164,3525,3074,16257,13183,177,968
BA,39217,TANQUINHO,3640,773,1093,6413,5320,79,261
BA,39233,TAPEROÁ,5412,1614,2786,12118,9332,262,698
BA,39250,TAPIRAMUTÁ,4828,833,3799,10877,7078,139,696
BA,39276,TEODORO SAMPAIO,3598,359,1419,6428,5009,126,310
BA,39292,TEOFILÂNDIA,8089,2008,4982,17035,12053,302,850
BA,39314,TEOLÂNDIA,4460,1238,2410,9840,7430,176,619
BA,39330,TERRA NOVA,4171,892,1968,9460,7492,348,542
BA,39357,TREMEDAL,6027,1669,5143,15477,10334,166,1114
BA,39373,TUCANO,17543,2476,11681,38072,26391,707,2217
BA,39390,UAUÁ,11178,1130,5363,20355,14992,295,791
BA,39411,UBAÍRA,6295,2713,3992,15330,11338,276,897
BA,39438,UBAITABA,4662,2129,2025,12224,10199,199,901
BA,39454,UBATÃ,4512,1522,3917,13014,9097,213,780
BA,39470,UIBAÍ,5773,589,2463,10747,8284,145,487
BA,39489,UMBURANAS,4220,1825,2832,10265,7433,88,591
BA,39497,UNA,5148,2613,1838,12193,10355,291,939
BA,39519,URANDI,6991,596,3237,12127,8890,225,554
BA,39535,URUÇUCA,5556,3447,4838,17479,12641,233,1014
BA,39551,UTINGA,6119,1087,3755,12787,9032,196,717
BA,39578,VALENÇA,21954,7608,15125,60929,45804,2348,4102
BA,39594,VALENTE,7890,4451,2909,17830,14921,298,950
BA,39616,VÁRZEA DO POÇO,2963,936,1641,6619,4978,132,450
BA,39624,VARZEDO,3297,1310,628,6638,6010,97,406
BA,39632,VERA CRUZ,14724,1788,7995,30228,22233,797,1020
BA,39640,VEREDA,2682,865,1755,6160,4405,62,388
BA,39659,VITÓRIA DA CONQUISTA,69496,44967,47103,224770,177667,4531,10380
BA,39675,WAGNER,2909,748,2248,6939,4691,91,343
BA,39691,WENCESLAU GUIMARÃES,6400,1980,3517,14600,11083,206,978
BA,39713,XIQUE-XIQUE,15406,3232,9582,33600,24018,394,2039
BA,39730,LAPÃO,11400,1410,4920,20456,15536,275,862
BA,39748,MADRE DE DEUS,5417,1552,2512,13798,11286,423,709
BA,39756,MAETINGA,2490,880,2589,6841,4252,51,448
BA,39772,MANSIDÃO,4585,368,3459,9225,5766,97,369
BA,39799,NORDESTINA,4800,525,3320,9907,6587,132,541
BA,39810,PÉ DE SERRA,4465,2408,2165,10405,8240,134,559
BA,39837,PINTADAS,2976,1673,2207,8059,5852,111,472
BA,39845,QUIXABEIRA,3203,1519,2008,7615,5607,154,365
BA,39853,RAFAEL JAMBEIRO,7131,2854,5015,17241,12226,229,1056
BA,39870,SANTA LUZIA,3146,1047,3749,9168,5419,86,399
BA,39896,SÃO GABRIEL,9615,732,2975,14965,11990,236,769
BA,39900,SÍTIO DO QUINTO,4292,1102,2713,9468,6755,125,614
BA,39918,TANQUE NOVO,6212,1441,3084,12080,8996,286,648
BA,39926,SÃO JOSÉ DA VITÓRIA,1893,986,426,3968,3542,63,245
BA,39934,TEIXEIRA DE FREITAS,28864,17469,26938,97406,70468,2499,4537
BA,39942,NOVO HORIZONTE,4331,847,1553,7926,6373,133,465
BA,39950,VÁRZEA NOVA,4051,962,2929,9216,6287,143,532
BA,39969,NOVA IBIÁ,1986,642,1530,5265,3735,91,307
BA,39977,VÁRZEA DA ROÇA,4825,1259,2763,10333,7570,291,590
BA,39985,SOBRADINHO,9394,953,3418,17166,13748,210,659
BA,39993,WANDERLEY,5060,1124,2293,9641,7348,104,453
CE,13005,JIJOCA DE JERICOACOARA,5991,1626,3082,12793,9711,318,706
CE,13013,ABAIARA,4120,290,1619,6820,5201,134,378
CE,13021,MADALENA,7975,718,3259,13481,10222,167,631
CE,13030,ACARAÚ,23139,2919,11303,42997,31694,774,1942
CE,13048,PIRES FERREIRA,4488,670,1896,7633,5737,45,270
CE,13056,ACOPIARA,22990,2211,7227,36815,29588,775,2312
CE,13064,GRAÇA,6228,481,4458,12628,8170,164,738
CE,13072,AIUABA,6282,477,3295,11286,7991,137,733
CE,13080,TURURU,7728,970,2142,12719,10577,282,630
CE,13099,ALCÂNTARAS,4812,589,1182,7850,6668,182,486
CE,13102,QUITERIANÓPOLIS,8593,1324,4446,16017,11571,272,941
CE,13110,ALTANEIRA,3233,589,1457,5944,4487,105,315
CE,13129,BARREIRA,9239,1533,3129,17624,14495,392,995
CE,13137,ALTO SANTO,7405,808,2916,12487,9571,240,624
CE,13145,ACARAPE,5751,922,1989,11179,9190,313,531
CE,13153,ANTONINA DO NORTE,3272,372,2176,6536,4360,86,359
CE,13161,CHOROZINHO,9749,1022,2495,16089,13594,491,870
CE,13170,APUIARÉS,7060,1013,2690,12140,9450,185,451
CE,13188,HORIZONTE,23965,5629,7763,47751,39988,1715,2153
CE,13196,AQUIRAZ,24776,5104,4172,44750,40578,1623,2997
CE,13200,ERERÊ,2684,554,1399,5218,3819,74,247
CE,13218,ARACATI,28129,5020,9816,53057,43241,1862,2064
CE,13226,EUSÉBIO,16477,3499,4129,32758,28629,1046,1671
CE,13234,ARACOIABA,13898,2125,3592,22612,19020,447,951
CE,13242,GUAIÚBA,10583,2133,3239,18448,15209,287,922
CE,13250,ARARIPE,9727,727,5137,17338,12201,167,922
CE,13269,POTIRETAMA,3365,281,1033,5149,4116,45,258
CE,13277,ARATUBA,5983,807,2136,10382,8246,186,587
CE,13285,PINDORETAMA,9458,1314,2780,16608,13828,315,844
CE,13293,ARNEIROZ,3727,500,1795,6747,4952,63,372
CE,13307,OCARA,12747,1667,2692,21070,18378,408,925
CE,13315,ASSARÉ,9313,1467,5479,18657,13178,307,914
CE,13323,TEJUÇUOCA,8918,980,2753,14378,11625,176,677
CE,13331,AURORA,10290,2282,5265,20769,15504,313,1135
CE,13340,IPAPORANGA,4654,759,1235,7738,6503,89,614
CE,13358,BAIXIO,3139,207,1367,5377,4010,77,254
CE,13366,TARRAFAS,3540,689,2263,7538,5275,135,384
CE,13374,BARBALHA,20223,7114,7794,41719,33925,922,1944
CE,13382,BANABUIÚ,8503,851,3214,14013,10799,160,609
CE,13390,BARRO,9185,853,4892,17038,12146,297,883
CE,13404,BARROQUINHA,6669,624,3201,12033,8832,262,619
CE,13412,BATURITÉ,14688,2644,6712,27936,21224,779,1125
CE,13420,ARARENDÁ,4326,733,2463,8707,6244,86,433
CE,13439,BEBERIBE,21663,3958,8327,40856,32529,1040,1797
CE,13447,CATUNDA,4817,412,2416,8405,5989,109,324
CE,13455,BELA CRUZ,10186,3371,6168,22218,16050,475,1066
CE,13463,CHORÓ,6989,542,2953,11691,8738,168,570
CE,13471,BOA VIAGEM,22954,2269,12292,42317,30025,651,2070
CE,13480,ITAITINGA,13680,2783,4053,25889,21836,667,1369
CE,13498,BREJO SANTO,19627,2791,7724,34247,26523,486,1625
CE,13501,FORTIM,7402,988,1924,12388,10464,257,508
CE,13510,CAMOCIM,24949,3917,11049,47182,36133,920,2073
CE,13536,CAMPOS SALES,10697,1468,5808,20378,14570,301,1082
CE,13552,CANINDÉ,31334,4082,14822,56986,42164,937,2537
CE,13579,CAPISTRANO,9017,844,2974,15145,12171,311,722
CE,13595,CARIDADE,9815,909,2851,15428,12577,254,813
CE,13617,CARIRÉ,7955,2255,3691,15564,11873,228,786
CE,13633,CARIRIAÇU,11549,2741,6793,23803,17010,278,1326
CE,13650,CARIÚS,8487,1037,4580,16145,11565,315,792
CE,13676,CARNAUBAL,6497,933,4623,13524,8901,186,692
CE,13692,CASCAVEL,26036,4910,11088,53293,42205,1830,2709
CE,13714,CATARINA,4785,610,2542,8932,6390,98,545
CE,13730,CAUCAIA,105863,17127,32181,203868,171687,5929,10990
CE,13757,CEDRO,11391,1794,4414,20307,15893,265,1228
CE,13773,CHAVAL,5411,728,3240,10729,7489,234,543
CE,13811,COREAÚ,9085,2663,4276,18464,14188,294,1182
CE,13838,CRATEÚS,28563,4870,7058,49520,42462,1312,3699
CE,13854,CRATO,49827,6993,16340,87678,71338,1873,4135
CE,13870,FARIAS BRITO,9244,1116,3560,16475,12915,349,1017
CE,13897,FORTALEZA,638594,249231,273911,1658701,1384790,53652,93320
CE,13919,FRECHEIRINHA,6040,1052,2383,11086,8703,212,669
CE,13935,GENERAL SAMPAIO,3485,769,1130,6501,5371,115,384
CE,13951,GRANJA,21900,2668,9609,39909,30300,997,2602
CE,13978,GRANJEIRO,2494,443,1553,5145,3592,78,270
CE,13994,GROAÍRAS,3834,1270,1928,8689,6761,382,536
CE,14010,GUARACIABA DO NORTE,15649,2278,10000,31900,21900,455,1552
CE,14036,GUARAMIRANGA,3009,492,1088,5483,4395,130,260
CE,14052,HIDROLÂNDIA,7714,1402,4687,15980,11293,217,648
CE,14060,IBARETAMA,7452,729,1755,11257,9502,191,600
CE,14079,IBIAPINA,8153,2002,5837,18406,12569,406,926
CE,14095,ICÓ,28164,2608,15444,52548,37104,777,2472
CE,14117,IGUATU,35141,8086,16382,70758,54376,1790,3992
CE,14133,INDEPENDÊNCIA,10855,2531,5981,21757,15776,352,1089
CE,14150,IPAUMIRIM,5342,537,2214,9262,7048,169,533
CE,14176,IPU,16632,2412,10335,32995,22660,500,1540
CE,14192,IPUEIRAS,14901,2367,11764,33081,21317,518,1724
CE,14214,IRACEMA,6435,791,2885,11325,8440,167,537
CE,14230,IRAUÇUBA,10182,1221,3851,17695,13844,257,765
CE,14257,ITAIÇABA,3401,927,1053,6266,5213,125,229
CE,14273,ITAPAGÉ,20651,3357,7625,38432,30807,874,1573
CE,14290,ITAPIPOCA,47818,8752,17163,85483,68320,1376,3511
CE,14311,ITAPIÚNA,8984,1343,3670,16261,12591,276,896
CE,14338,ITATIRA,10430,716,4217,16747,12530,125,788
CE,14354,JAGUARETAMA,8920,1056,4164,15872,11708,269,751
CE,14370,JAGUARIBARA,4758,576,1656,7961,6305,172,389
CE,14397,JAGUARIBE,15879,2083,8033,29643,21610,455,1302
CE,14419,JAGUARUANA,12649,3826,6099,27578,21479,1271,1325
CE,14435,JARDIM,12101,1239,6216,22220,16004,320,1194
CE,14451,JATI,4268,221,1421,6612,5191,63,355
CE,14478,JUAZEIRO DO NORTE,86038,17451,13666,147655,133989,4494,8081
CE,14494,JUCÁS,9100,2539,6174,20080,13906,378,1054
CE,14516,LAVRAS DA MANGABEIRA,13596,1375,7390,25087,17697,331,1366
CE,14532,LIMOEIRO DO NORTE,24472,3600,8564,44396,35832,1340,2082
CE,14559,MARANGUAPE,41186,5938,11721,72902,61181,1834,3292
CE,14575,MARCO,9264,5134,3359,20355,16996,449,956
CE,14591,MARTINÓPOLE,5392,601,1576,8888,7312,115,443
CE,14613,MASSAPÊ,12578,6519,5657,28237,22580,850,1362
CE,14630,MAURITI,17218,4849,8336,34165,25829,490,1486
CE,14656,MERUOCA,5784,827,1737,10583,8846,363,574
CE,14672,MILAGRES,13335,1149,6039,22827,16788,246,1208
CE,14680,MIRAÍMA,6591,779,2828,11370,8542,105,461
CE,14699,MISSÃO VELHA,15735,1425,7265,28149,20884,504,1571
CE,14710,MOMBAÇA,17553,2454,9640,33641,24001,586,2114
CE,14737,MONSENHOR TABOSA,8003,796,4544,14695,10151,167,689
CE,14753,MORADA NOVA,29499,5652,12877,57373,44496,1100,2872
CE,14770,MORAÚJO,3526,942,1486,6831,5345,133,321
CE,14796,MORRINHOS,6556,3247,2451,15211,12760,250,675
CE,14818,MUCAMBO,5295,1231,4056,12590,8534,244,732
CE,14834,MULUNGU,5057,496,1995,8659,6664,138,366
CE,14850,NOVA OLINDA,6878,942,2650,11994,9344,194,567
CE,14877,NOVA RUSSAS,11627,1939,6955,23693,16738,435,1158
CE,14893,NOVO ORIENTE,10598,1558,7015,21817,14802,446,1347
CE,14915,ORÓS,10645,913,4787,18139,13352,233,902
CE,14931,PACAJUS,24960,4510,7794,47103,39309,1628,2286
CE,14958,PACATUBA,21833,4505,6938,43652,36714,1249,2384
CE,14974,PACOTI,5632,1080,2017,10441,8424,229,592
CE,14990,PACUJÁ,3404,349,1206,5686,4480,78,312
CE,15016,PALHANO,4946,777,1232,8131,6899,160,354
CE,15032,PALMÁCIA,5220,542,1511,8565,7054,165,468
CE,15059,PARACURU,15122,1855,5233,27627,22394,702,1360
CE,15075,PARAMBU,8652,6280,8484,27790,19306,682,1674
CE,15091,PARAMOTI,5880,875,2302,10280,7978,107,447
CE,15113,PEDRA BRANCA,19225,1776,11329,36198,24869,487,2151
CE,15130,PENAFORTE,4351,479,1058,6796,5738,149,293
CE,15156,PENTECOSTE,17438,2477,5568,30714,25146,565,1321
CE,15172,PEREIRO,7448,1258,4169,14191,10022,151,625
CE,15199,PIQUET CARNEIRO,6921,542,2209,10857,8648,225,603
CE,15210,PORANGA,4722,730,3045,9763,6718,112,647
CE,15237,PORTEIRAS,7962,569,3518,13476,9958,151,769
CE,15253,POTENGI,4217,394,1977,7516,5539,149,409
CE,15270,QUIXADÁ,28003,8424,12465,57179,44714,1571,2493
CE,15296,QUIXERAMOBIM,30016,4676,12754,55222,42468,887,2377
CE,15318,QUIXERÉ,8610,1307,3317,17072,13755,568,884
CE,15334,REDENÇÃO,12359,1917,4948,24031,19083,792,1521
CE,15350,RERIUTABA,8264,1057,4871,16207,11336,294,810
CE,15377,RUSSAS,27371,5641,9447,51881,42434,1447,2385
CE,15393,SABOEIRO,6993,745,3796,13287,9491,181,900
CE,15415,SANTANA DO ACARAÚ,15475,1625,4263,24313,20050,508,1158
CE,15431,SANTANA DO CARIRI,7666,808,3845,13706,9861,124,730
CE,15440,SALITRE,7308,766,2946,12424,9478,188,483
CE,15458,SANTA QUITÉRIA,18204,3908,9587,35150,25563,523,1402
CE,15474,SÃO BENEDITO,17649,3518,11777,37733,25956,814,2000
CE,15490,SÃO GONÇALO DO AMARANTE,18513,5121,6790,37683,30893,907,1885
CE,15512,SÃO JOÃO DO JAGUARIBE,4338,417,1614,7337,5723,139,315
CE,15539,SÃO LUÍS DO CURU,6652,904,2111,11554,9443,302,523
CE,15555,SENADOR POMPEU,10014,3013,5234,21672,16438,354,1060
CE,15571,SENADOR SÁ,3276,483,884,5455,4571,87,374
CE,15598,SOBRAL,64932,13736,9766,120503,110737,5980,7152
CE,15610,SOLONÓPOLE,8279,913,3914,14619,10705,165,683
CE,15636,TABULEIRO DO NORTE,13708,1824,5390,24779,19389,563,1066
CE,15652,TAMBORIL,10957,2165,5473,21041,15568,233,1163
CE,15679,TAUÁ,18529,5977,11520,44345,32825,1051,2698
CE,15695,TIANGUÁ,25157,6110,10056,50216,40160,1400,2903
CE,15717,TRAIRI,21778,3308,9131,40261,31130,921,1643
CE,15733,UBAJARA,11776,2572,5953,24852,18899,840,1455
CE,15750,UMARI,3335,381,1499,6298,4799,87,360
CE,15776,URUBURETAMA,9234,1491,2642,16314,13672,490,850
CE,15792,URUOCA,6010,948,2765,11329,8564,161,620
CE,15814,VÁRZEA ALEGRE,15204,2996,7420,30927,23507,704,1787
CE,15830,VIÇOSA DO CEARÁ,23044,3947,10353,42946,32593,767,2430
CE,15857,MARACANAÚ,73422,13071,23827,152580,128753,5116,8461
CE,15873,AMONTADA,16077,2714,7897,31677,23780,466,1221
CE,15881,CROATÁ,6671,785,5464,14537,9073,230,747
CE,15890,CRUZ,8932,3347,5305,19784,14479,352,772
CE,15911,FORQUILHA,9323,1225,1419,15419,14000,586,874
CE,15920,IBICUITINGA,7048,1205,1940,11784,9844,273,563
CE,15938,ICAPUÍ,7620,2438,2921,15709,12788,497,601
CE,15954,ITAREMA,15093,2833,6756,29029,22273,529,1368
CE,15970,MILHÃ,6898,549,2830,11323,8493,101,522
CE,15989,DEPUTADO IRAPUAN PINHEIRO,3971,797,1399,6886,5487,97,436
CE,15997,PARAIPABA,12451,2478,4100,22931,18831,594,994
CE,98531,QUIXELÔ,7970,1237,2185,13102,10917,282,934
CE,98558,UMIRIM,8833,1076,3445,15212,11767,230,781
CE,98574,VARJOTA,6556,1587,4362,14937,10575,337,757
DF,97012,BRASÍLIA,363861,570494,221769,1901499,1679730,38453,61585
ES,56006,SÃO DOMINGOS DO NORTE,2907,2007,1351,7292,5941,167,225
ES,56014,AFONSO CLÁUDIO,6272,7298,5938,24890,18952,672,903
ES,56022,ÁGUA DOCE DO NORTE,4221,1830,2743,10345,7602,176,435
ES,56030,ALEGRE,6571,6205,2924,21411,18487,684,1041
ES,56049,IRUPI,2339,2738,2195,9170,6975,213,388
ES,56057,ALFREDO CHAVES,1778,4539,2097,11452,9355,446,445
ES,56065,ALTO RIO NOVO,2862,950,1138,5947,4809,72,241
ES,56073,ANCHIETA,4912,4988,3706,21544,17838,665,716
ES,56081,VILA PAVÃO,3342,1745,1138,7345,6207,163,202
ES,56090,APIACÁ,1867,1123,935,5597,4662,92,305
ES,56103,MARECHAL FLORIANO,2528,4912,2583,12930,10347,580,465
ES,56111,ARACRUZ,12854,16218,13296,64047,50751,2320,2895
ES,56120,MARATAÍZES,6435,6045,5704,26307,20603,575,717
ES,56138,ATÍLIO VIVÁCQUA,2769,2183,1348,8181,6833,172,242
ES,56146,BREJETUBA,2414,2558,2466,9163,6697,231,380
ES,56154,BAIXO GUANDU,7234,5628,2441,20496,18055,655,826
ES,56162,SÃO ROQUE DO CANAÃ,2432,3796,1954,9669,7715,295,361
ES,56170,BARRA DE SÃO FRANCISCO,12741,6154,7875,32972,25097,556,998
ES,56189,SOORETAMA,6106,3431,4593,18080,13487,670,706
ES,56197,BOA ESPERANÇA,4091,1892,990,9311,8321,244,356
ES,56200,PONTO BELO,2685,952,1588,6331,4743,89,253
ES,56219,BOM JESUS DO NORTE,2059,1349,820,6145,5325,152,367
ES,56227,VILA VALÉRIO,6112,2283,2326,12168,9842,203,299
ES,56235,CACHOEIRO DE ITAPEMIRIM,27148,42467,25583,134622,109039,4430,4089
ES,56251,CARIACICA,65895,52235,42093,250924,208831,9553,9038
ES,56278,CASTELO,4492,11091,4426,27371,22945,903,953
ES,56294,COLATINA,15446,30783,16757,85806,69049,2845,3042
ES,56308,GOVERNADOR LINDENBERG,3478,2342,1840,8847,7007,185,305
ES,56316,CONCEIÇÃO DA BARRA,7194,2903,6723,22340,15617,553,852
ES,56332,CONCEIÇÃO DO CASTELO,1368,3529,1814,9117,7303,323,450
ES,56359,DIVINO DE SÃO LOURENÇO,826,1488,929,3941,3012,85,167
ES,56375,DOMINGOS MARTINS,4135,12456,2232,23770,21538,931,908
ES,56391,DORES DO RIO PRETO,2059,1057,889,5309,4420,182,318
ES,56413,ECOPORANGA,7628,3855,3831,18089,14258,261,504
ES,56430,FUNDÃO,3392,3253,2395,12923,10528,419,566
ES,56456,GUAÇUÍ,4452,6679,5491,21443,15952,722,982
ES,56472,GUARAPARI,13883,23160,18143,85361,67218,2821,3242
ES,56499,IBIRAÇU,1785,2690,1004,8238,7234,302,446
ES,56502,IBITIRAMA,1904,2215,1945,7585,5640,217,331
ES,56510,ICONHA,2935,3521,1551,10683,9132,333,437
ES,56537,ITAGUAÇU,3784,3625,1357,10495,9138,349,436
ES,56553,ITAPEMIRIM,6024,5805,2643,22708,20065,562,817
ES,56570,ITARANA,2461,3785,922,8571,7649,258,344
ES,56596,IÚNA,4601,6918,4952,20973,16021,548,789
ES,56618,JERÔNIMO MONTEIRO,2892,2667,1582,9363,7781,244,479
ES,56626,JOÃO NEIVA,2747,3833,2659,13341,10682,456,651
ES,56634,LINHARES,19724,35780,21487,105914,84427,3880,4791
ES,56650,MANTENÓPOLIS,3874,2034,2451,10602,8151,160,385
ES,56677,MIMOSO DO SUL,6924,5037,5231,21847,16616,619,949
ES,56693,MONTANHA,5253,2247,3435,14003,10568,375,570
ES,56715,MUCURICI,1943,671,437,4085,3648,60,150
ES,56731,MUNIZ FREIRE,3504,4476,1976,13015,11039,398,637
ES,56758,MUQUI,3525,2953,1703,10848,9145,317,386
ES,56774,NOVA VENÉCIA,12615,8831,7801,36436,28635,915,1042
ES,56790,PANCAS,5592,4138,3987,16064,12077,244,512
ES,56812,PINHEIROS,5736,2665,3738,16983,13245,367,627
ES,56839,PIÚMA,2776,2834,3067,13749,10682,390,514
ES,56855,PRESIDENTE KENNEDY,2457,3007,2228,10538,8310,196,313
ES,56871,RIO NOVO DO SUL,1871,3289,831,8437,7606,306,319
ES,56898,SANTA LEOPOLDINA,3435,2575,993,8962,7969,300,384
ES,56910,SANTA TERESA,3183,8042,2032,17019,14987,612,809
ES,56936,SÃO GABRIEL DA PALHA,7136,7759,5120,24618,19498,674,708
ES,56952,SÃO JOSÉ DO CALÇADO,3385,1593,1897,9081,7184,261,558
ES,56979,SÃO MATEUS,25309,12172,17629,77587,59958,1969,2484
ES,56995,SERRA,72852,46798,51734,289225,237491,10253,10686
ES,57010,VIANA,12310,8516,5680,41674,35994,1534,1420
ES,57037,VILA VELHA,61099,77965,54500,304163,249663,9423,10452
ES,57053,VITÓRIA,46384,76049,48747,260729,211982,6530,7777
ES,57070,MARILÂNDIA,2970,3812,1801,10407,8606,352,406
ES,57096,IBATIBA,3948,5213,4076,17230,13154,390,719
ES,57118,RIO BANANAL,5993,3826,2976,14716,11740,452,446
ES,57134,JAGUARÉ,8415,3561,3885,19712,15827,618,630
ES,57150,PEDRO CANÁRIO,5652,2452,5513,17851,12338,433,707
ES,57916,LARANJA DA TERRA,2913,3752,1708,9517,7809,216,282
ES,57932,SANTA MARIA DE JETIBÁ,6632,12968,3383,26637,23254,751,756
ES,57959,VARGEM ALTA,2425,6080,2838,14773,11935,446,461
ES,57975,VENDA NOVA DO IMIGRANTE,1796,8136,3392,16838,13446,423,538
ES,57991,ÁGUIA BRANCA,4148,1673,1461,8152,6691,117,171
GO,92010,ABADIÂNIA,1741,4197,1940,9693,7753,264,282
GO,92029,BONFINÓPOLIS,1153,2023,954,5947,4993,141,283
GO,92037,ÁGUA LIMPA,703,784,344,2128,1784,25,67
GO,92053,ALEXÂNIA,3174,7010,3118,17405,14287,493,698
GO,92061,CAMPOS VERDES,1862,872,1195,4413,3218,36,197
GO,92096,ALOÂNDIA,699,620,351,2004,1653,50,104
GO,92100,CEZARINA,2267,2232,1518,7516,5998,184,296
GO,92118,ALTO PARAÍSO DE GOIÁS,1272,1163,1585,5199,3614,85,202
GO,92126,COLINAS DO SUL,1449,520,1039,3386,2347,35,125
GO,92150,ALVORADA DO NORTE,1802,1834,1318,6104,4786,107,279
GO,92169,MORRO AGUDO DE GOIÁS,722,844,343,2381,2038,28,99
GO,92177,AMORINÓPOLIS,1142,1426,691,3820,3129,60,140
GO,92207,EDEALINA,1339,1014,614,3535,2921,77,159
GO,92215,ANÁPOLIS,47149,94365,34324,247358,213034,7655,8318
GO,92223,FAINA,2832,1291,1325,6287,4962,69,172
GO,92231,ANHANGÜERA,358,248,179,995,816,16,28
GO,92258,ANICUNS,4260,5723,3433,16626,13193,336,570
GO,92266,GOUVELÂNDIA,1449,1175,730,3874,3144,85,204
GO,92274,APARECIDA DE GOIÂNIA,62431,63568,32291,257445,225154,8250,12196
GO,92282,ITAGUARI,1473,1260,716,4202,3486,82,160
GO,92290,APORÉ,795,907,1139,3406,2267,67,125
GO,92312,ARAÇU,1329,1462,697,4215,3518,85,172
GO,92320,MATRINCHÃ,1019,1388,974,3903,2929,44,106
GO,92339,ARAGARÇAS,4066,3459,3735,14349,10614,324,436
GO,92347,MIMOSO DE GOIÁS,859,753,510,2617,2107,31,97
GO,92355,ARAGOIÂNIA,2101,2255,716,6686,5970,172,316
GO,92363,MONTIVIDIU,2027,3504,1734,8645,6911,149,253
GO,92444,NOVO PLANALTO,1425,758,681,3307,2626,74,105
GO,92460,PALESTINA DE GOIÁS,1109,1042,836,3472,2636,45,92
GO,92495,ARUANÃ,1653,1711,1313,5617,4304,88,149
GO,92517,AURILÂNDIA,1343,899,599,3331,2732,53,101
GO,92550,AVELINÓPOLIS,794,1380,525,3274,2749,51,101
GO,92568,SANTA FÉ DE GOIÁS,1320,992,1083,4172,3089,82,130
GO,92614,BALIZA,1107,683,903,3034,2131,31,90
GO,92622,SÃO JOÃO DA PARAÚNA,684,596,381,1967,1586,28,63
GO,92630,BARRO ALTO,2107,2226,1568,7358,5790,152,218
GO,92649,SÃO LUIZ DO NORTE,1257,1251,957,4125,3168,103,235
GO,92657,BELA VISTA DE GOIÁS,4266,6722,2778,18298,15520,576,922
GO,92665,SÃO MIGUEL DO PASSA QUATRO,1019,1443,570,3593,3023,50,119
GO,92673,BOM JARDIM DE GOIÁS,2662,1758,1592,6925,5333,93,250
GO,92690,BOM JESUS DE GOIÁS,3957,4992,3593,15823,12230,539,628
GO,92703,SENADOR CANEDO,12339,12171,7353,57295,49942,1716,2031
GO,92711,BRAZABRANTES,879,787,279,2576,2297,79,81
GO,92720,SIMOLÂNDIA,1768,1562,1349,5431,4082,106,243
GO,92754,BRITÂNIA,1460,1496,1168,4829,3661,72,184
GO,92762,TERESINA DE GOIÁS,732,618,863,2593,1730,18,85
GO,92770,BURITI ALEGRE,2081,2653,1319,7358,6039,239,358
GO,92789,TROMBAS,1068,707,812,2928,2116,31,110
GO,92797,CABECEIRAS,1817,2179,1097,6039,4942,145,211
GO,92800,TURVELÂNDIA,1489,1258,1395,4803,3408,62,153
GO,92819,CACHOEIRA ALTA,2258,2338,1785,7535,5750,165,289
GO,92827,RIO QUENTE,667,1036,698,3351,2653,71,130
GO,92835,CACHOEIRA DE GOIÁS,506,437,285,1525,1240,27,46
GO,92851,CAÇU,1931,3473,1849,9100,7251,240,421
GO,92860,GUARINOS,832,652,309,1987,1678,23,77
GO,92878,CAIAPÔNIA,3790,3583,2614,12370,9756,199,447
GO,92886,COCALZINHO DE GOIÁS,3244,4061,2083,12480,10397,375,567
GO,92894,CALDAS NOVAS,11114,16158,12614,55765,43151,1859,2573
GO,92908,SANTO ANTÔNIO DE GOIÁS,1359,1535,545,4641,4096,112,222
GO,92916,CAMPESTRE DE GOIÁS,894,1097,353,2960,2607,70,102
GO,92924,CHAPADÃO DO CÉU,1494,2009,1421,5862,4441,113,132
GO,92932,CAMPINORTE,2562,2878,1956,8775,6819,145,247
GO,92940,ALTO HORIZONTE,1426,2008,1103,5427,4324,62,139
GO,92959,CAMPO ALEGRE DE GOIÁS,1816,1414,890,4683,3793,83,140
GO,92967,CASTELÂNDIA,1127,947,951,3631,2680,63,107
GO,92975,CAMPOS BELOS,5298,2585,4164,14526,10362,232,613
GO,92983,JESÚPOLIS,390,968,566,2424,1858,59,77
GO,92991,CARMO DO RIO VERDE,2265,2291,1362,7169,5807,156,273
GO,93009,APARECIDA DO RIO DOCE,874,690,535,2544,2009,45,118
GO,93017,CATALÃO,18826,16027,11646,64615,52969,2291,3447
GO,93025,CIDADE OCIDENTAL,9527,7280,7494,35851,28357,1099,1281
GO,93033,CATURAÍ,1360,1164,428,3748,3320,135,220
GO,93041,PROFESSOR JAMIL,1162,882,722,3311,2589,45,130
GO,93050,CAVALCANTE,2683,785,2918,7231,4313,65,354
GO,93068,PEROLÂNDIA,873,812,904,3096,2192,52,126
GO,93076,CERES,3972,6015,2598,15755,13157,341,536
GO,93084,NOVA IGUAÇU DE GOIÁS,673,1144,535,2649,2114,33,65
GO,93092,DIVINÓPOLIS DE GOIÁS,1722,993,1218,4690,3472,73,250
GO,93106,BURITI DE GOIÁS,834,903,590,2906,2316,46,106
GO,93122,CALDAZINHA,754,939,344,2634,2290,63,88
GO,93149,GUARAÍTA,807,703,298,2386,2088,49,87
GO,93157,CÓRREGO DO OURO,555,1021,470,2621,2151,61,75
GO,93165,INACIOLÂNDIA,1679,1264,1069,4860,3791,128,262
GO,93173,CORUMBÁ DE GOIÁS,1443,2713,1243,6912,5669,193,322
GO,93181,MONTIVIDIU DO NORTE,1216,741,855,3253,2398,22,148
GO,93190,CORUMBAÍBA,1836,2017,1210,6278,5068,135,299
GO,93203,SANTO ANTÔNIO DA BARRA,1508,1110,660,3706,3046,59,145
GO,93220,TEREZÓPOLIS DE GOIÁS,1578,1612,525,5041,4516,162,229
GO,93246,UIRAPURU,1158,455,548,2434,1886,20,86
GO,93254,CRISTALINA,5262,11893,7410,30946,23536,1031,993
GO,93262,BURITINÓPOLIS,759,906,924,3145,2221,26,127
GO,93270,CRISTIANÓPOLIS,715,1215,533,3079,2546,61,106
GO,93289,VILA BOA,1168,796,950,3420,2470,47,134
GO,93297,CRIXÁS,4459,3163,2758,12363,9605,226,399
GO,93300,VALPARAÍSO DE GOIÁS,19699,16090,14237,72906,58669,2181,2269
GO,93319,CROMÍNIA,1028,1278,486,3395,2909,67,117
GO,93327,NOVO GAMA,11412,10044,10479,48459,37980,1854,1550
GO,93335,CUMARI,918,583,481,2554,2073,74,107
GO,93343,ÁGUAS LINDAS DE GOIÁS,23514,13791,15388,77611,62223,2896,2442
GO,93351,DAMIANÓPOLIS,1188,784,780,3251,2471,55,130
GO,93360,ABADIA DE GOIÁS,1486,2457,752,6351,5599,174,241
GO,93378,DAMOLÂNDIA,704,1364,247,2866,2619,73,145
GO,93386,AMARALINA,1007,754,595,2682,2087,11,110
GO,93394,DAVINÓPOLIS,926,808,422,2446,2024,36,90
GO,93408,BONÓPOLIS,1410,406,689,2758,2069,22,71
GO,93424,PORTEIRÃO,1159,686,738,2990,2252,39,74
GO,93432,DIORAMA,806,709,352,2194,1842,32,75
GO,93440,SANTA RITA DO NOVO DESTINO,945,748,482,2621,2139,47,122
GO,93483,SÃO PATRÍCIO,474,796,302,1945,1643,41,81
GO,93491,EDÉIA,2297,3101,1663,8924,7261,216,416
GO,93505,VILA PROPÍCIO,1410,1109,826,4011,3185,67,196
GO,93513,ESTRELA DO NORTE,932,930,679,2951,2272,38,105
GO,93530,FAZENDA NOVA,1721,1491,1236,5479,4243,90,195
GO,93548,IPIRANGA DE GOIÁS,989,775,537,2792,2255,47,102
GO,93564,GAMELEIRA DE GOIÁS,788,1091,399,2649,2250,26,80
GO,93572,FIRMINÓPOLIS,2387,2556,1461,8111,6650,156,334
GO,93580,CAMPO LIMPO DE GOIÁS,1341,2074,544,4770,4226,115,182
GO,93599,FLORES DE GOIÁS,2412,1479,1729,6671,4942,88,268
GO,93602,LAGOA SANTA,336,493,304,1406,1102,13,56
GO,93610,FORMOSA,15834,22653,13604,68750,55146,1976,2800
GO,93637,FORMOSO,1683,1105,1003,4332,3329,44,133
GO,93670,GOIANÁPOLIS,2173,3656,1121,8956,7835,236,289
GO,93696,GOIANDIRA,1407,1265,741,4287,3546,128,237
GO,93718,GOIANÉSIA,12358,14370,9258,46159,36901,1685,1807
GO,93734,GOIÂNIA,142171,308948,158406,932925,774519,22871,39609
GO,93750,GOIANIRA,7190,7249,4435,27118,22683,732,1151
GO,93777,GOIÁS,6608,5870,4640,20195,15555,288,593
GO,93793,GOIATUBA,5509,9798,6047,26801,20754,920,1240
GO,93815,GUAPÓ,3462,3826,1612,11067,9455,264,551
GO,93831,GUARANI DE GOIÁS,1424,1128,804,3762,2958,30,146
GO,93874,HEITORAÍ,1135,1068,719,3605,2886,69,138
GO,93890,HIDROLÂNDIA,3255,4736,2280,13926,11646,399,644
GO,93912,HIDROLINA,1502,1163,724,3845,3121,65,173
GO,93939,IACIARA,3042,1999,2237,8322,6085,128,304
GO,93955,INHUMAS,8801,14203,5373,37125,31752,1260,1833
GO,93971,IPAMERI,5043,6154,4886,20110,15224,490,879
GO,93998,IPORÁ,7330,7188,5408,24600,19192,512,766
GO,94013,ISRAELÂNDIA,1053,757,604,2828,2224,32,102
GO,94030,ITABERAÍ,8575,8879,5796,27998,22202,796,930
GO,94072,ITAGUARU,1905,1384,807,5071,4264,115,186
GO,94110,ITAJÁ,961,1400,987,4001,3014,70,163
GO,94137,ITAPACI,4397,4124,3316,14423,11107,381,564
GO,94153,ITAPIRAPUÃ,1906,2304,1760,7044,5284,103,273
GO,94196,ITAPURANGA,7550,5303,3748,21241,17493,663,815
GO,94218,ITARUMÃ,1360,1475,1360,4890,3530,68,188
GO,94234,ITAUÇU,2083,2309,1089,6930,5841,155,209
GO,94250,ITUMBIARA,15557,25356,15000,71894,56894,2501,2682
GO,94277,IVOLÂNDIA,1165,782,713,3055,2342,50,71
GO,94293,JANDAIA,1837,1929,1136,6071,4935,117,252
GO,94315,JARAGUÁ,6655,11933,6167,30926,24759,911,979
GO,94331,JATAÍ,15434,20366,15088,66060,50972,2128,2729
GO,94358,JAUPACI,1055,753,624,2844,2220,34,96
GO,94374,JOVIÂNIA,1507,1964,1264,5895,4631,161,264
GO,94390,JUSSARA,4540,5074,3183,14999,11816,272,533
GO,94439,LEOPOLDO DE BULHÕES,1561,2256,1114,5970,4856,131,218
GO,94455,LUZIÂNIA,22058,34338,22630,113683,91053,4251,5081
GO,94471,MAIRIPOTABA,591,1021,436,2471,2035,42,81
GO,94498,MAMBAÍ,1469,1757,1423,5640,4217,74,225
GO,94510,MARA ROSA,3096,2115,2032,8240,6208,128,313
GO,94536,MARZAGÃO,643,541,423,1992,1569,27,53
GO,94552,PARANAIGUARA,2775,2031,1376,7451,6075,150,330
GO,94579,MAURILÂNDIA,2730,2791,2162,8804,6642,192,326
GO,94595,MINEIROS,9298,11667,9229,39527,30298,1467,1762
GO,94650,MOIPORÁ,505,730,450,2178,1728,26,97
GO,94676,MONTE ALEGRE DE GOIÁS,2085,1079,1552,5499,3947,57,259
GO,94714,MONTES CLAROS DE GOIÁS,2334,1808,1375,6457,5082,88,207
GO,94730,MORRINHOS,9737,11147,6298,33474,27176,905,1246
GO,94757,MOSSÂMEDES,1379,1339,832,4390,3558,111,204
GO,94773,MOZARLÂNDIA,3086,3302,2661,10753,8092,230,426
GO,94790,MUTUNÓPOLIS,1130,1297,687,3547,2860,34,120
GO,94854,NAZÁRIO,1642,2613,1417,7090,5673,156,263
GO,94870,NERÓPOLIS,5151,7348,2674,18903,16229,544,941
GO,94897,NIQUELÂNDIA,10076,7344,6906,29816,22910,627,969
GO,94919,NOVA AMÉRICA,638,847,369,2186,1817,27,129
GO,94935,NOVA AURORA,761,585,283,1912,1629,34,98
GO,94951,NOVA ROMA,864,853,805,2829,2024,29,115
GO,94978,NOVA VENEZA,1779,2435,651,6200,5549,145,291
GO,95010,NOVO BRASIL,1264,1113,604,3443,2839,39,136
GO,95036,ORIZONA,2724,4826,1780,11198,9418,302,510
GO,95052,OURO VERDE DE GOIÁS,752,1425,292,3076,2784,92,154
GO,95079,OUVIDOR,2075,1367,711,5504,4793,155,266
GO,95095,PADRE BERNARDO,4524,4579,4192,16824,12632,308,606
GO,95117,PALMEIRAS DE GOIÁS,3529,7837,3254,18780,15526,328,548
GO,95133,PALMELO,518,707,377,2128,1751,35,74
GO,95150,PALMINÓPOLIS,1106,1441,678,3816,3138,39,76
GO,95176,PANAMÁ,693,847,545,2512,1967,82,104
GO,95230,PARAÚNA,2772,2845,2134,9000,6866,161,310
GO,95311,PETROLINA DE GOIÁS,1441,3288,1635,7793,6158,217,343
GO,95354,PILAR DE GOIÁS,1183,703,516,2726,2210,46,108
GO,95397,PIRACANJUBA,5472,6301,4355,19300,14945,472,667
GO,95419,PIRANHAS,3425,2609,2059,9516,7457,157,397
GO,95435,PIRENÓPOLIS,6004,6210,3097,18317,15220,454,584
GO,95451,PIRES DO RIO,4042,7486,4985,22248,17263,803,1130
GO,95494,PONTALINA,4971,4409,2957,14548,11591,303,509
GO,95559,PORANGATU,11042,7510,7653,30828,23175,469,890
GO,95575,PORTELÂNDIA,925,1136,779,3454,2675,115,168
GO,95613,POSSE,6736,8283,5211,23096,17885,389,690
GO,95630,QUIRINÓPOLIS,9444,10310,7397,34143,26746,1254,1600
GO,95656,RIALMA,2123,2922,1904,8729,6825,186,361
GO,95672,RIANÁPOLIS,815,1538,892,3958,3066,86,174
GO,95710,RIO VERDE,23306,43932,22621,118486,95865,3879,4390
GO,95737,RUBIATABA,3398,5745,3164,15209,12045,380,647
GO,95753,SANCLERLÂNDIA,2062,2484,1278,7091,5813,110,209
GO,95770,SANTA BÁRBARA DE GOIÁS,1268,1415,911,4804,3893,103,145
GO,95796,SANTA CRUZ DE GOIÁS,600,1082,753,3044,2291,60,93
GO,95818,SANTA HELENA DE GOIÁS,8559,7855,4781,28528,23747,1335,1294
GO,95834,SANTA RITA DO ARAGUAIA,1060,1314,1137,4201,3064,90,150
GO,95850,SANTA ROSA DE GOIÁS,890,1095,518,3069,2551,109,127
GO,95877,SANTA TEREZA DE GOIÁS,741,1026,903,3333,2430,83,154
GO,95893,SANTA TEREZINHA DE GOIÁS,3362,2242,1799,8239,6440,92,303
GO,95915,SÃO DOMINGOS,2340,1718,2337,7489,5152,114,430
GO,95931,SÃO FRANCISCO DE GOIÁS,1044,2015,976,4916,3940,121,201
GO,95958,PLANALTINA,14371,11945,10891,53268,42377,1892,1838
GO,95974,SÃO JOÃO D'ALIANÇA,1679,1816,1584,6187,4603,143,210
GO,95990,SÃO LUÍS DE MONTES BELOS,4539,8491,4965,23529,18564,630,922
GO,96016,SÃO MIGUEL DO ARAGUAIA,5692,5074,4976,18452,13476,279,597
GO,96059,SÃO SIMÃO,6032,2643,3276,14506,11230,248,418
GO,96075,SERRANÓPOLIS,1714,1490,1267,5457,4190,90,249
GO,96091,SILVÂNIA,3948,5822,2573,14820,12247,327,442
GO,96113,SÍTIO D'ABADIA,847,662,846,2685,1839,22,123
GO,96172,TAQUARAL DE GOIÁS,922,1502,744,3946,3202,87,178
GO,96237,TRÊS RANCHOS,1090,925,655,3245,2590,76,112
GO,96253,TRINDADE,19627,22897,8853,72027,63174,2132,3227
GO,96318,TURVÂNIA,1321,1481,711,4493,3782,73,149
GO,96334,URUAÇU,7798,8212,6134,26418,20284,618,875
GO,96350,URUANA,2845,3520,2722,11284,8562,274,476
GO,96377,URUTAÍ,629,981,534,2784,2250,76,101
GO,96393,VARJÃO,728,1509,747,3724,2977,103,160
GO,96415,VIANÓPOLIS,1636,4943,1688,9540,7852,159,309
GO,96458,ACREÚNA,4318,4968,3735,15965,12230,470,690
GO,96474,MINAÇU,9308,5013,8293,26557,18264,516,716
GO,96512,MUNDO NOVO,1839,1244,1352,5152,3800,39,186
GO,96539,NOVA CRIXÁS,3107,2108,2332,8726,6394,113,277
GO,96555,NOVA GLÓRIA,2218,1993,1677,7203,5526,150,263
GO,96571,VICENTINÓPOLIS,1573,2429,1023,5923,4900,108,246
GO,96610,AMERICANO DO BRASIL,1301,2179,915,5148,4233,95,135
GO,96695,ARAGUAPAZ,2024,1942,1338,6146,4808,71,230
GO,96717,ARENÓPOLIS,1335,854,686,3330,2644,32,62
GO,96733,CACHOEIRA DOURADA,2499,1979,1886,7614,5728,203,313
GO,96750,DOVERLÂNDIA,2147,1832,1017,5869,4852,77,213
GO,96776,SANTO ANTÔNIO DO DESCOBERTO,10095,9682,8621,39983,31362,1348,1261
GO,96814,INDIARA,4193,2301,2290,10722,8432,287,373
GO,96873,CAMPINAÇU,1364,616,787,3209,2422,32,83
GO,96890,SANTA ISABEL,1014,1328,689,3495,2806,65,138
GO,96911,ADELÂNDIA,693,1045,440,2634,2194,22,92
GO,96938,ÁGUA FRIA DE GOIÁS,926,1673,1229,4495,3266,65,147
MA,7005,ÁGUA DOCE DO MARANHÃO,5161,463,3435,10433,6998,218,564
MA,7013,AFONSO CUNHA,3472,111,1324,5552,4228,39,354
MA,7021,ALTO ALEGRE DO MARANHÃO,8217,708,4384,15517,11133,158,956
MA,7030,ALCÂNTARA,9420,456,4271,16637,12366,353,680
MA,7048,ALTO ALEGRE DO PINDARÉ,10065,987,6855,20525,13670,187,1273
MA,7056,ALDEIAS ALTAS,8061,803,4965,16788,11823,208,1195
MA,7064,APICUM-AÇU,5705,636,2295,10173,7878,101,334
MA,7072,ALTAMIRA DO MARANHÃO,2564,321,1504,5242,3738,70,347
MA,7080,AMAPÁ DO MARANHÃO,2117,413,1276,4837,3561,53,295
MA,7099,ALTO PARNAÍBA,3262,1011,2151,7535,5384,82,445
MA,7102,ARAGUANÃ,4071,243,2106,7188,5082,50,322
MA,7110,AMARANTE DO MARANHÃO,11668,3293,5885,24014,18129,291,1296
MA,7129,BACABEIRA,7589,456,1757,11896,10139,313,563
MA,7137,ANAJATUBA,10952,587,4864,19077,14213,260,841
MA,7145,BACURITUBA,2772,193,1580,5303,3723,67,205
MA,7153,ANAPURUS,7278,697,1849,11287,9438,203,599
MA,7161,BELÁGUA,3593,81,868,5157,4289,44,345
MA,7170,ARAIOSES,15902,1580,9108,30895,21787,683,1939
MA,7188,BELA VISTA DO MARANHÃO,4879,341,2405,8824,6419,87,368
MA,7196,ARARI,10817,1271,5755,21528,15773,438,854
MA,7200,BERNARDO DO MEARIM,2739,243,1221,4861,3640,41,247
MA,7218,AXIXÁ,5656,354,2056,9394,7338,134,324
MA,7226,CACHOEIRA GRANDE,3835,150,2111,7004,4893,71,322
MA,7234,BACABAL,30599,5740,17701,66473,48772,1101,2935
MA,7242,DAVINÓPOLIS,4733,843,2360,10038,7678,143,277
MA,7250,BACURI,6621,543,3776,13138,9362,145,568
MA,7269,BOM JESUS DAS SELVAS,8550,1729,3902,16322,12420,149,852
MA,7277,BALSAS,23120,9266,11640,55135,43495,1061,2193
MA,7285,BOM LUGAR,5532,718,2899,10289,7390,73,434
MA,7293,BARÃO DE GRAJAÚ,7120,982,3212,13248,10036,204,796
MA,7307,BREJO DE AREIA,3085,587,1886,6628,4742,96,511
MA,7315,BARRA DO CORDA,25835,5866,7777,48644,40867,1037,2567
MA,7323,BOA VISTA DO GURUPI,2681,357,1205,4976,3771,24,179
MA,7331,BARREIRINHAS,23444,1680,8927,38896,29969,346,1477
MA,7340,BURITICUPU,20280,3472,10687,39773,29086,470,1820
MA,7358,BENEDITO LEITE,1950,314,759,3659,2900,46,281
MA,7366,BURITIRANA,4528,1003,2347,9709,7362,148,661
MA,7374,BEQUIMÃO,8015,656,3847,15873,12026,378,737
MA,7382,CAMPESTRE DO MARANHÃO,5039,643,2755,9495,6740,96,316
MA,7390,BREJO,13134,1398,5814,23596,17782,353,1232
MA,7404,CAPINZAL DO NORTE,3855,446,1866,8144,6278,128,551
MA,7412,BURITI,10601,869,5397,19754,14357,310,1208
MA,7420,CENTRAL DO MARANHÃO,3320,98,2398,6508,4110,61,324
MA,7439,BURITI BRAVO,8253,726,5234,16416,11182,118,1084
MA,7447,CENTRO DO GUILHERME,4098,325,1292,6399,5107,46,297
MA,7455,CAJAPIÓ,4731,219,1864,7975,6111,155,386
MA,7463,CENTRO NOVO DO MARANHÃO,5527,517,2186,9548,7362,60,535
MA,7471,CAJARI,8248,250,2400,12649,10249,161,664
MA,7480,CIDELÂNDIA,4879,1047,2506,9768,7262,153,393
MA,7498,CÂNDIDO MENDES,6923,689,4038,14235,10197,127,617
MA,7501,CONCEIÇÃO DO LAGO-AÇU,5360,380,2405,9865,7460,90,649
MA,7510,CANTANHEDE,6712,424,3370,12285,8915,101,678
MA,7528,FEIRA NOVA DO MARANHÃO,2559,1099,1543,5975,4432,49,307
MA,7536,CAROLINA,7560,1848,4854,17136,12282,206,872
MA,7544,FERNANDO FALCÃO,3829,440,583,5839,5256,54,282
MA,7552,CARUTAPERA,7739,1163,3912,15654,11742,194,688
MA,7560,FORMOSA DA SERRA NEGRA,5753,1506,2424,11416,8992,64,392
MA,7579,CAXIAS,52689,5633,29636,107694,78058,1608,5420
MA,7595,CEDRAL,4428,191,2145,8099,5954,175,263
MA,7609,GOVERNADOR EDISON LOBÃO,5363,1652,2489,11897,9408,204,471
MA,7617,CHAPADINHA,27443,2947,13145,51230,38085,875,2207
MA,7625,GOVERNADOR LUIZ ROCHA,2883,456,1646,6010,4364,111,386
MA,7633,CODÓ,32973,4359,29921,81122,51201,1093,4070
MA,7641,GOVERNADOR NEWTON BELLO,3878,421,2324,7691,5367,58,441
MA,7650,COELHO NETO,16763,1704,11117,34733,23616,418,1731
MA,7668,GOVERNADOR NUNES FREIRE,9081,1044,3786,16104,12318,108,680
MA,7676,COLINAS,13821,1693,8269,26808,18539,277,1457
MA,7684,IGARAPÉ DO MEIO,5510,314,2957,10162,7205,83,589
MA,7692,COROATÁ,21777,2392,14032,45486,31454,452,2675
MA,7706,ITAIPAVA DO GRAJAÚ,5299,653,2543,9482,6939,55,374
MA,7714,CURURUPU,12079,776,8035,24326,16291,447,931
MA,7722,ITINGA DO MARANHÃO,6382,2944,4586,16797,12211,217,772
MA,7730,DOM PEDRO,8853,1798,4138,17641,13503,263,739
MA,7749,JATOBÁ,3447,286,1383,5850,4467,79,320
MA,7757,DUQUE BACELAR,4813,306,2427,8875,6448,79,516
MA,7765,JENIPAPO DOS VIEIRAS,5414,742,1189,9069,7880,117,519
MA,7773,ESPERANTINÓPOLIS,7455,744,3935,13957,10022,178,780
MA,7781,JUNCO DO MARANHÃO,2739,322,1012,4610,3598,32,180
MA,7790,FORTALEZA DOS NOGUEIRAS,4677,1281,2197,9354,7157,165,379
MA,7803,LAGO DOS RODRIGUES,4129,450,1568,7320,5752,79,357
MA,7811,FORTUNA,6196,536,3396,11874,8478,214,686
MA,7820,LAGOA DO MATO,4036,387,2233,7837,5604,117,652
MA,7838,GODOFREDO VIANA,3482,492,1846,6984,5138,84,338
MA,7846,LAGOA GRANDE DO MARANHÃO,4650,512,2067,8183,6116,93,400
MA,7854,GONÇALVES DIAS,6532,709,3364,12063,8699,136,554
MA,7862,LAJEADO NOVO,2726,880,1399,5887,4488,39,248
MA,7870,GOVERNADOR ARCHER,4080,506,2012,7762,5750,107,425
MA,7889,MARACAÇUMÉ,6167,893,3774,13000,9226,136,667
MA,7897,GOVERNADOR EUGÊNIO BARROS,6036,532,3244,11231,7987,134,527
MA,7900,MARAJÁ DO SENA,3482,404,1718,6394,4676,61,398
MA,7919,GRAÇA ARANHA,3244,275,1378,5560,4182,34,228
MA,7927,MARANHÃOZINHO,4397,413,1233,6815,5582,52,240
MA,7935,GRAJAÚ,20256,4565,10220,42918,32698,454,1897
MA,7943,MATÕES DO NORTE,3663,177,2272,6983,4711,64,393
MA,7951,GUIMARÃES,5287,282,3169,10206,7037,249,439
MA,7960,MILAGRES DO MARANHÃO,2996,176,1294,5148,3854,62,275
MA,7978,HUMBERTO DE CAMPOS,11041,731,5107,20165,15058,239,994
MA,7986,NOVA COLINAS,2105,491,860,4150,3290,78,194
MA,7994,ICATU,11870,492,4369,19744,15375,244,1031
MA,8001,NOVA OLINDA DO MARANHÃO,6592,583,3200,12173,8973,155,741
MA,8010,IGARAPÉ GRANDE,4334,567,1748,7927,6179,100,505
MA,8028,OLINDA NOVA DO MARANHÃO,4859,241,3001,9361,6360,152,520
MA,8036,IMPERATRIZ,53457,31482,33132,164408,131276,2883,4753
MA,8044,PAULINO NEVES,6823,512,3351,12168,8817,107,513
MA,8052,SÃO LUÍS GONZAGA DO MARANHÃO,9811,609,5727,18345,12618,180,1086
MA,8060,PEDRO DO ROSÁRIO,9360,409,4117,15911,11794,108,856
MA,8079,ITAPECURU MIRIM,20641,2052,10672,41302,30630,713,2085
MA,8087,PERITORÓ,8918,554,4435,15720,11285,149,851
MA,8095,JOÃO LISBOA,8795,2153,4917,19805,14888,361,1009
MA,8109,PORTO RICO DO MARANHÃO,2785,192,1916,6280,4364,165,225
MA,8117,JOSELÂNDIA,6357,708,3241,11816,8575,201,480
MA,8125,PRESIDENTE MÉDICI,2730,286,1261,4993,3732,38,262
MA,8133,LAGO DA PEDRA,14161,3719,10281,34013,23732,392,1516
MA,8141,PRESIDENTE SARNEY,7054,439,3722,12941,9219,98,613
MA,8150,LAGO DO JUNCO,4160,533,2085,7937,5852,154,433
MA,8168,RAPOSA,8767,893,2323,15484,13161,296,583
MA,8176,LAGO VERDE,6367,453,3285,11535,8250,80,505
MA,8184,RIBAMAR FIQUENE,3033,896,1622,6402,4780,71,252
MA,8192,LIMA CAMPOS,3871,823,2465,9414,6949,223,613
MA,8206,SANTA FILOMENA DO MARANHÃO,2788,312,1341,5231,3890,93,291
MA,8214,LORETO,4244,724,2097,8046,5949,92,468
MA,8222,SANTANA DO MARANHÃO,3449,233,2263,7171,4908,51,400
MA,8230,LUÍS DOMINGUES,2498,484,1412,5428,4016,75,219
MA,8249,SANTO AMARO DO MARANHÃO,5339,249,1672,8494,6822,102,336
MA,8257,MAGALHÃES DE ALMEIDA,5316,803,3651,12121,8470,181,624
MA,8265,SÃO DOMINGOS DO AZEITÃO,3187,309,569,4676,4107,52,332
MA,8273,MATA ROMA,7749,589,2249,12470,10221,209,636
MA,8281,SÃO FRANCISCO DO BREJÃO,2998,918,1474,6738,5264,97,326
MA,8290,MATINHA,10374,586,4281,18034,13753,349,718
MA,8303,SÃO JOÃO DO CARÚ,4425,1010,3234,9683,6449,75,628
MA,8311,MATÕES,12176,728,7411,23651,16240,244,1494
MA,8320,SÃO JOÃO DO PARAÍSO,3952,1212,1915,8252,6337,63,353
MA,8338,MIRADOR,7732,839,4319,14635,10316,165,879
MA,8346,SÃO JOÃO DO SOTER,6701,245,2954,11196,8242,81,725
MA,8354,MIRINZAL,5431,401,3344,10845,7501,206,412
MA,8362,SÃO JOSÉ DOS BASÍLIOS,3922,224,2025,6822,4797,59,270
MA,8370,MONÇÃO,10878,727,5754,19866,14112,195,1097
MA,8389,SÃO PEDRO DA ÁGUA BRANCA,3844,813,2852,8443,5591,96,334
MA,8397,MONTES ALTOS,3187,1131,1672,7356,5684,93,345
MA,8400,SÃO PEDRO DOS CRENTES,1141,556,894,3639,2745,30,178
MA,8419,MORROS,7551,389,3315,13400,10085,144,770
MA,8427,SÃO RAIMUNDO DO DOCA BEZERRA,2522,301,1441,4852,3411,64,277
MA,8435,NINA RODRIGUES,4686,256,2346,8716,6370,63,574
MA,8443,SÃO ROBERTO,2320,202,1136,4184,3048,42,258
MA,8451,NOVA IORQUE,1976,221,521,3196,2675,34,203
MA,8460,SATUBINHA,2851,315,1461,5333,3872,49,344
MA,8478,OLHO D'ÁGUA DAS CUNHÃS,7623,922,4009,14068,10059,166,838
MA,8486,SENADOR ALEXANDRE COSTA,3648,384,1880,6940,5060,50,383
MA,8494,PAÇO DO LUMIAR,25481,4082,6345,52914,46569,1614,1997
MA,8508,SENADOR LA ROCQUE,6588,1041,3727,13542,9815,218,717
MA,8516,PALMEIRÂNDIA,8718,305,4749,15840,11091,238,770
MA,8524,SERRANO DO MARANHÃO,4444,111,2039,7639,5600,119,557
MA,8532,PARAIBANO,6895,821,5325,15000,9675,203,856
MA,8540,SUCUPIRA DO RIACHÃO,2116,246,1227,4229,3002,60,296
MA,8559,PARNARAMA,12804,943,7824,25198,17374,372,1515
MA,8567,TRIZIDELA DO VALE,6766,1149,2803,13830,11027,236,795
MA,8575,PASSAGEM FRANCA,6241,879,3263,12576,9313,241,1084
MA,8583,TUFILÂNDIA,3508,195,1816,6233,4417,50,314
MA,8591,PASTOS BONS,6503,1049,1956,11208,9252,200,671
MA,8605,TURILÂNDIA,6723,508,4621,13701,9080,118,639
MA,8613,PEDREIRAS,12837,2630,8156,29962,21806,518,1354
MA,8621,VILA NOVA DOS MARTÍRIOS,3087,935,1743,6716,4973,73,332
MA,8630,PENALVA,13176,543,8759,25266,16507,230,1233
MA,8656,PERI MIRIM,5649,480,3175,10843,7668,256,397
MA,8672,PINDARÉ-MIRIM,12764,1145,6039,23526,17487,319,1188
MA,8699,PINHEIRO,25275,3725,14600,54972,40372,670,2032
MA,8710,PIO XII,10344,836,5200,19135,13935,204,1202
MA,8737,PIRAPEMAS,6441,403,3843,12231,8388,152,703
MA,8753,POÇÃO DE PEDRAS,7818,1072,4672,15782,11110,227,698
MA,8770,PORTO FRANCO,6475,3230,3775,16613,12838,138,596
MA,8796,PRESIDENTE DUTRA,15128,3171,8159,31239,23080,471,1087
MA,8818,PRESIDENTE JUSCELINO,5088,160,2435,8732,6297,60,377
MA,8834,PRESIDENTE VARGAS,5265,325,2262,9243,6981,116,533
MA,8850,PRIMEIRA CRUZ,5683,335,2299,9497,7198,96,453
MA,8877,RIACHÃO,6954,1363,4043,14335,10292,135,781
MA,8893,SÃO JOSÉ DE RIBAMAR,43855,5557,7799,80924,73125,2693,3566
MA,8915,ROSÁRIO,16060,988,6848,29053,22205,556,1137
MA,8931,SAMBAÍBA,2725,486,886,4909,4023,32,257
MA,8958,SANTA HELENA,10295,1227,7785,23237,15452,281,855
MA,8974,SANTA LUZIA,24147,2640,14393,46601,32208,479,1787
MA,8990,SANTA QUITÉRIA DO MARANHÃO,11206,768,5320,19940,14620,302,1137
MA,9016,SANTA RITA,11885,1394,5179,21864,16685,535,1010
MA,9032,SANTO ANTÔNIO DOS LOPES,5850,1020,2619,11729,9110,197,656
MA,9059,SÃO BENEDITO DO RIO PRETO,8129,379,2752,12972,10220,142,742
MA,9075,SÃO BENTO,13876,918,9023,27390,18367,468,1036
MA,9091,SÃO BERNARDO,9750,1373,5562,20014,14452,302,1212
MA,9113,SÃO DOMINGOS DO MARANHÃO,12649,2623,7214,26607,19393,358,1389
MA,9130,SÃO FÉLIX DE BALSAS,1996,207,1048,3832,2784,81,263
MA,9156,SÃO FRANCISCO DO MARANHÃO,4901,329,2507,9107,6600,161,660
MA,9172,SÃO JOÃO BATISTA,10839,474,3468,17137,13669,251,847
MA,9199,SÃO JOÃO DOS PATOS,8285,1837,5730,19282,13552,401,831
MA,9210,SÃO LUÍS,254776,79555,61853,620127,558274,18980,24764
MA,9237,SÃO MATEUS DO MARANHÃO,12984,1462,10264,29195,18931,377,1479
MA,9253,SÃO RAIMUNDO DAS MANGABEIRAS,6531,1693,3198,13651,10453,191,698
MA,9270,SÃO VICENTE FERRER,7980,407,3894,14308,10414,316,709
MA,9296,SÍTIO NOVO,6327,1959,3032,12980,9948,103,602
MA,9318,SUCUPIRA DO NORTE,4592,419,2243,8362,6119,130,512
MA,9334,TASSO FRAGOSO,2820,706,1327,6072,4745,55,313
MA,9350,TIMBIRAS,9372,634,2662,14949,12287,165,1147
MA,9377,TIMON,55394,5792,21069,107647,86578,2000,5651
MA,9393,TUNTUM,11878,2949,8160,27951,19791,429,1522
MA,9415,TURIAÇU,13120,1159,7923,25462,17539,299,904
MA,9431,TUTÓIA,15540,3098,11806,37266,25460,930,1863
MA,9458,URBANO SANTOS,11487,497,3646,18287,14641,256,1075
MA,9474,VARGEM GRANDE,14807,1584,8700,29719,21019,363,1882
MA,9490,VIANA,18111,1719,9480,35780,26300,526,1564
MA,9512,VITÓRIA DO MEARIM,11315,1130,7830,24936,17106,502,1135
MA,9539,VITORINO FREIRE,10827,2128,6774,23504,16730,331,1362
MA,9555,BOM JARDIM,12929,1477,8097,26379,18282,363,1476
MA,9571,SANTA INÊS,27776,4908,13953,57399,43446,1106,2289
MA,9598,PAULO RAMOS,7828,835,4150,15069,10919,169,891
MA,9610,AÇAILÂNDIA,30189,13938,16851,74729,57878,1786,2640
MA,9636,ESTREITO,8840,3644,5523,21586,16063,211,951
MA,9652,SANTA LUZIA DO PARUÁ,8812,924,3878,15868,11990,206,697
MA,9679,ARAME,9454,2325,5741,20385,14644,155,866
MA,9695,MIRANDA DO NORTE,7039,656,3878,14143,10265,162,680
MA,9717,ZÉ DOCA,16384,2166,10137,32463,22326,370,1372
MG,40002,ALFREDO VASCONCELOS,2568,1019,652,5112,4460,146,256
MG,40010,ABADIA DOS DOURADOS,2478,1461,864,5633,4769,158,236
MG,40029,ARAPORÃ,1544,1657,554,4942,4388,111,179
MG,40037,ABAETÉ,4649,7671,3949,18384,14435,557,442
MG,40045,BRASILÂNDIA DE MINAS,5430,1609,2376,10454,8078,147,174
MG,40053,ABRE CAMPO,4732,2556,2579,11174,8595,238,403
MG,40061,CAPITÃO ANDRADE,1446,1052,906,3919,3013,72,135
MG,40070,ACAIACA,1639,654,891,3484,2593,69,100
MG,40088,CARNEIRINHO,3906,1764,1197,7574,6377,108,129
MG,40096,AÇUCENA,3114,1370,2938,8666,5728,273,315
MG,40100,CATUJI,3139,1538,1898,7248,5350,89,308
MG,40118,ÁGUA BOA,4897,1875,4217,11824,7607,130,423
MG,40126,DIVISA ALEGRE,1713,854,1499,4915,3416,64,217
MG,40134,ÁGUA COMPRIDA,692,551,464,2129,1665,76,90
MG,40142,DIVISÓPOLIS,2732,1136,1544,6118,4574,79,254
MG,40150,AGUANIL,1770,725,651,3802,3151,109,141
MG,40169,DURANDÉ,2928,1036,1422,6057,4635,121,232
MG,40177,ÁGUAS FORMOSAS,5206,3000,4640,14623,9983,172,551
MG,40185,ENTRE FOLHAS,2114,1030,1278,5417,4139,112,190
MG,40193,ÁGUAS VERMELHAS,3913,1627,3535,10106,6571,133,402
MG,40207,FERVEDOURO,4083,1407,1854,8355,6501,154,256
MG,40215,AIMORÉS,7352,3551,4231,18581,14350,377,542
MG,40223,FRANCISCÓPOLIS,1998,580,1745,4834,3089,71,188
MG,40231,AIURUOCA,1541,1702,1300,5158,3858,122,204
MG,40240,ICARAÍ DE MINAS,4343,982,1778,7441,5663,33,161
MG,40258,ALAGOA,343,1388,465,2386,1921,49,34
MG,40266,IPABA,5668,1624,2705,13193,10488,316,340
MG,40274,ALBERTINA,265,1538,487,2454,1967,30,53
MG,40282,JAÍBA,13007,2218,5171,22895,17724,346,825
MG,40290,ALÉM PARAÍBA,10826,4700,6390,28264,21874,595,855
MG,40304,JAMPRUCA,2115,497,872,4035,3163,66,201
MG,40312,ALFENAS,14577,20017,11902,57162,45260,1976,1634
MG,40320,JUATUBA,5670,4707,2958,17777,14819,728,744
MG,40339,ALMENARA,13676,3592,8526,29146,20620,301,1075
MG,40347,LAGOA GRANDE,2822,1807,1410,6642,5232,112,178
MG,40355,ALPERCATA,2839,1092,1560,6393,4833,148,213
MG,40363,LIMEIRA DO OESTE,3070,1029,754,5414,4660,98,112
MG,40371,ALPINÓPOLIS,6733,3605,2609,14780,12171,353,398
MG,40380,LONTRA,4088,684,2330,7761,5431,79,232
MG,40398,ALTEROSA,4656,3917,1915,11381,9466,214,206
MG,40401,MAMONAS,3329,557,1381,5730,4349,35,146
MG,40410,ALTO RIO DOCE,4232,2412,2448,10127,7679,203,401
MG,40428,MATA VERDE,2223,1605,957,5550,4593,44,319
MG,40436,ALVARENGA,1780,1318,894,4287,3393,51,111
MG,40444,MATIAS CARDOSO,3409,616,1593,6230,4637,66,206
MG,40452,ALVINÓPOLIS,6061,2456,2911,13145,10234,285,686
MG,40460,MONTEZUMA,2691,711,1148,5064,3916,60,261
MG,40479,ALVORADA DE MINAS,1495,716,1135,3783,2648,81,180
MG,40487,NAQUE,2236,785,1288,5120,3832,110,141
MG,40495,AMPARO DO SERRA,2295,778,937,4543,3606,152,153
MG,40509,NOVO ORIENTE DE MINAS,3201,1397,3365,8869,5504,115,489
MG,40517,ANDRADAS,5343,13861,4718,28276,23558,958,1050
MG,40525,PALMÓPOLIS,2122,1279,2338,6216,3878,58,312
MG,40533,CACHOEIRA DE PAJEÚ,3123,1173,1853,6726,4873,68,314
MG,40541,PEDRAS DE MARIA DA CRUZ,4264,540,2453,7681,5228,46,190
MG,40550,ANDRELÂNDIA,3105,2689,2430,9633,7203,234,359
MG,40568,PERIQUITO,2396,1312,1765,6274,4509,105,202
MG,40576,ANTÔNIO CARLOS,4573,1710,1613,9375,7762,324,414
MG,40584,PONTO DOS VOLANTES,3347,1754,2376,8256,5880,92,392
MG,40592,ANTÔNIO DIAS,3375,1633,2024,8772,6748,209,309
MG,40606,RIACHINHO,2653,864,1399,5218,3819,53,116
MG,40614,ANTÔNIO PRADO DE MINAS,600,608,283,1733,1450,17,37
MG,40622,ROSÁRIO DA LIMEIRA,2371,809,873,4871,3998,114,137
MG,40630,ARAÇAÍ,688,965,618,2596,1978,52,99
MG,40649,SANTA BÁRBARA DO LESTE,2751,1489,1484,6894,5410,172,302
MG,40657,ARACITABA,953,491,453,2208,1755,69,98
MG,40665,SANTA RITA DE MINAS,1924,1491,1083,5668,4585,140,271
MG,40673,ARAÇUAÍ,10134,5887,9693,27790,18097,366,772
MG,40681,SANTANA DO PARAÍSO,6001,3118,3515,16965,13450,468,576
MG,40690,ARAGUARI,28618,19362,16345,85827,69482,2733,3360
MG,40703,SÃO JOÃO DA LAGOA,2270,598,1120,4402,3282,52,123
MG,40711,ARANTINA,1279,477,540,2684,2144,74,110
MG,40720,SÃO JOÃO DO MANHUAÇU,3891,1413,1354,7672,6318,99,265
MG,40738,ARAPONGA,3560,864,1562,6572,5010,109,274
MG,40746,SÃO JOÃO DO MANTENINHA,2489,879,1032,4946,3914,78,119
MG,40754,ARAPUÁ,693,1191,631,3023,2392,115,163
MG,40762,SÃO JOÃO DO PACUÍ,2154,335,841,3611,2770,23,126
MG,40770,ARAÚJOS,1082,3166,1052,6138,5086,222,155
MG,40789,SÃO JOSÉ DA LAPA,4950,5405,2519,16415,13896,493,517
MG,40797,ARAXÁ,21151,25334,13412,73364,59952,2345,2722
MG,40800,SARZEDO,5174,5473,2330,17611,15281,737,727
MG,40819,ARCEBURGO,1269,3295,1120,6925,5805,246,341
MG,40827,SEM PEIXE,1298,699,1163,3470,2307,84,89
MG,40835,ARCOS,9497,9696,4564,29825,25261,1528,1420
MG,40843,SENADOR AMARAL,1757,1635,720,4605,3885,101,114
MG,40851,AREADO,1993,5358,2164,11447,9283,317,313
MG,40860,UBAPORANGA,3176,3021,2420,9865,7445,167,299
MG,40878,ARGIRITA,1182,659,510,2743,2233,58,94
MG,40886,URUCUIA,3560,890,1887,6771,4884,28,133
MG,40894,ARINOS,6015,2269,3940,13489,9549,133,394
MG,40908,VARGEM ALEGRE,2437,1118,1843,6394,4551,97,250
MG,40916,ASTOLFO DUTRA,4546,2669,1836,10646,8810,244,268
MG,40924,JOSENÓPOLIS,1603,448,1253,3599,2346,23,140
MG,40932,ATALÉIA,5405,1154,3908,11716,7808,107,443
MG,40940,JUVENÍLIA,2382,883,1685,5315,3630,32,124
MG,40959,AUGUSTO DE LIMA,1647,922,1327,4337,3010,91,100
MG,40967,LEME DO PRADO,1398,964,1363,3978,2615,40,112
MG,40975,BAEPENDI,5209,4016,2798,15311,12513,414,560
MG,40983,LUISBURGO,1993,1630,989,5208,4219,103,155
MG,40991,BALDIM,2178,2471,1276,6740,5464,185,142
MG,41009,LUISLÂNDIA,3272,364,1732,5677,3945,37,138
MG,41017,BAMBUÍ,6763,5578,4099,18774,14675,533,588
MG,41025,MÁRIO CAMPOS,2840,3119,1541,9800,8259,422,423
MG,41033,BANDEIRA,2062,571,1204,4244,3040,46,190
MG,41041,MARTINS SOARES,2966,1305,1255,6246,4991,113,184
MG,41050,BANDEIRA DO SUL,1322,2122,835,5009,4174,159,153
MG,41068,MIRAVÂNIA,1947,400,1308,3889,2581,22,130
MG,41076,BARÃO DE COCAIS,6911,7339,3833,22514,18681,929,923
MG,41084,MONTE FORMOSO,1420,599,1388,3992,2604,38,135
MG,41092,BARÃO DE MONTE ALTO,2589,878,807,5010,4203,103,126
MG,41106,NATALÂNDIA,1606,469,615,2893,2278,29,65
MG,41114,BARBACENA,36908,21910,16729,96396,79667,3636,6673
MG,41122,NINHEIRA,2806,1236,2690,7604,4914,160,336
MG,41130,BARRA LONGA,2418,1272,1254,5502,4248,133,211
MG,41149,NOVA BELÉM,1489,862,961,3711,2750,54,142
MG,41157,TRÊS MARIAS,6431,6716,5229,22393,17164,619,661
MG,41165,NOVA PORTEIRINHA,3686,587,1166,6153,4987,83,201
MG,41173,BARROSO,6378,3885,2908,16661,13753,842,873
MG,41181,NOVORIZONTE,1737,915,1097,4281,3184,53,222
MG,41190,BELA VISTA DE MINAS,3665,1197,1133,7285,6152,213,273
MG,41203,OLHOS D'ÁGUA,2493,553,1270,4846,3576,46,215
MG,41211,BELMIRO BRAGA,1347,695,468,2929,2461,55,93
MG,41220,ORATÓRIOS,2089,771,904,4191,3287,87,145
MG,41238,BELO HORIZONTE,360345,773674,345313,1912589,1567276,55647,75845
MG,41246,ORIZÂNIA,3101,787,1323,6020,4697,102,144
MG,41254,BELO ORIENTE,8044,2626,4181,18473,14292,568,658
MG,41262,PADRE CARVALHO,1804,894,1641,4748,3107,40,149
MG,41270,BELO VALE,2740,2428,1487,7722,6235,263,256
MG,41289,PAI PEDRO,2627,417,1075,4581,3506,42,228
MG,41297,BERILO,3623,1428,3917,9700,5783,134,322
MG,41300,PATIS,2466,658,1081,4447,3366,35,104
MG,41319,BERTÓPOLIS,1441,799,1146,3687,2541,36,160
MG,41327,PEDRA BONITA,2510,1518,1085,5562,4477,61,148
MG,41335,BETIM,89559,64555,40076,267513,227437,10735,12653
MG,41343,PIEDADE DE CARATINGA,2586,1553,1243,6330,5087,136,219
MG,41351,BIAS FORTES,1611,831,707,3537,2830,73,157
MG,41360,PINGO D'ÁGUA,1692,856,1107,4113,3006,56,154
MG,41378,BICAS,3278,2926,2448,11367,8919,269,639
MG,41386,PINTÓPOLIS,3078,694,1895,6014,4119,51,147
MG,41394,BIQUINHAS,1008,884,630,2813,2183,59,73
MG,41408,PONTO CHIQUE,1875,493,1089,3699,2610,31,91
MG,41416,BOA ESPERANÇA,9403,11642,6528,30773,24245,836,702
MG,41424,REDUTO,2338,1156,1143,5464,4321,99,164
MG,41432,BOCAINA DE MINAS,1038,1964,945,4496,3551,108,179
MG,41440,SANTA BÁRBARA DO MONTE VERDE,1293,864,747,3343,2596,44,89
MG,41459,BOCAIÚVA,16216,5229,8456,34760,26304,665,1101
MG,41467,SANTA CRUZ DE MINAS,1816,2473,944,6393,5449,221,254
MG,41475,BOM DESPACHO,5947,17429,6832,36544,29712,1495,1153
MG,41483,SANTA CRUZ DE SALINAS,2253,400,1354,4332,2978,43,206
MG,41491,BOM JARDIM DE MINAS,2203,1289,1214,5573,4359,162,248
MG,41505,SANTA HELENA DE MINAS,1990,1041,1249,4703,3454,32,249
MG,41513,BOM JESUS DA PENHA,1102,1295,544,3304,2760,80,116
MG,41521,SANTO ANTÔNIO DO RETIRO,2939,556,1674,5631,3957,55,258
MG,41530,BOM JESUS DO AMPARO,1761,1425,656,4434,3778,145,204
MG,41548,SÃO DOMINGOS DAS DORES,2138,1422,1099,5190,4091,91,152
MG,41556,BOM JESUS DO GALHO,4805,3211,2253,11555,9302,252,495
MG,41564,SÃO FÉLIX DE MINAS,1172,663,885,3226,2341,39,92
MG,41572,BOM REPOUSO,3288,3194,1137,8349,7212,187,229
MG,41580,SÃO GERALDO DO BAIXIO,1193,819,565,2851,2286,23,81
MG,41599,BOM SUCESSO,4005,5448,3315,15085,11770,593,504
MG,41602,SÃO JOÃO DAS MISSÕES,4560,798,2047,8219,6172,84,408
MG,41610,BONFIM,2047,2149,1165,6389,5224,350,343
MG,41629,SÃO JOAQUIM DE BICAS,6934,3816,3404,17628,14224,678,691
MG,41637,BONFINÓPOLIS DE MINAS,1718,1332,1467,5024,3557,63,103
MG,41645,SÃO JOSÉ DA BARRA,2390,1358,1290,5970,4680,169,151
MG,41653,BORDA DA MATA,3582,4963,2434,12977,10543,334,444
MG,41661,ALTO CAPARAÓ,1233,1247,532,3853,3321,67,94
MG,41670,BOTELHOS,4944,3413,2702,12616,9914,332,318
MG,41688,ANGELÂNDIA,2400,1244,2087,6254,4167,75,223
MG,41696,BOTUMIRIM,2342,828,1585,5158,3573,47,197
MG,41700,ARICANDUVA,1863,778,1314,4286,2972,84,141
MG,41718,BRASÍLIA DE MINAS,12676,3103,7430,25878,18448,418,795
MG,41726,BERIZAL,1752,625,707,3512,2805,39,150
MG,41734,BRÁS PIRES,1367,1381,893,3983,3090,64,145
MG,41742,BONITO DE MINAS,3931,489,2211,7033,4822,32,249
MG,41750,BRAÚNAS,1519,867,968,3918,2950,107,183
MG,41769,BUGRE,1380,1210,995,4422,3427,78,137
MG,41777,BRAZÓPOLIS,2810,5482,2730,12809,10079,355,392
MG,41785,CABECEIRA GRANDE,1616,1747,1239,5138,3899,95,109
MG,41793,BRUMADINHO,6342,9799,4069,25702,21633,987,1302
MG,41807,CAMPO AZUL,1860,500,1023,3604,2581,33,92
MG,41815,BUENO BRANDÃO,1560,4300,1695,8691,6996,312,278
MG,41823,CANTAGALO,1455,818,1055,3800,2745,83,167
MG,41831,BUENÓPOLIS,2714,1686,3113,8377,5264,204,303
MG,41840,CATAS ALTAS,1345,1534,706,4405,3699,151,195
MG,41858,BURITIS,6255,4965,4212,17275,13063,219,405
MG,41866,CATUTI,2129,455,1247,4179,2932,42,173
MG,41874,BURITIZEIRO,8536,2819,5459,19575,14116,458,660
MG,41882,CHAPADA GAÚCHA,3968,1166,1814,7497,5683,74,199
MG,41890,CABO VERDE,4029,2811,1932,9786,7854,225,217
MG,41904,CÔNEGO MARINHO,3202,547,1475,5577,4102,44,196
MG,41912,CACHOEIRA DA PRATA,844,1343,551,3380,2829,101,114
MG,41920,CONFINS,1221,2671,738,5475,4737,165,180
MG,41939,CACHOEIRA DE MINAS,2068,4238,1438,8964,7526,276,272
MG,41947,CÓRREGO FUNDO,1460,1826,678,4928,4250,219,228
MG,41955,CACHOEIRA DOURADA,943,325,442,2053,1611,35,36
MG,41963,CRISÓLITA,1961,816,1266,4464,3198,34,216
MG,41971,CAETANÓPOLIS,2004,2895,1434,7950,6516,282,364
MG,41980,CUPARAQUE,1234,1423,858,3992,3134,48,118
MG,41998,CAETÉ,8646,13175,5897,32935,27038,1099,1280
MG,42005,CURRAL DE DENTRO,2173,1407,1616,5806,4190,70,235
MG,42013,CAIANA,1987,470,580,3683,3103,81,154
MG,42021,DELTA,1989,991,1081,5307,4226,148,162
MG,42030,CAJURI,1660,832,637,3825,3188,176,183
MG,42048,DOM BOSCO,1244,910,740,3201,2461,27,83
MG,42056,CALDAS,3252,4212,1778,10537,8759,229,375
MG,42064,FREI LAGONEGRO,1481,628,781,3277,2496,54,193
MG,42072,CAMACHO,1131,1207,547,3180,2633,107,80
MG,42080,FRUTA DE LEITE,2087,595,1966,5089,3123,40,235
MG,42099,CAMANDUCAIA,4450,6103,3261,16426,13165,682,575
MG,42102,GAMELEIRAS,2245,598,1020,4193,3173,39,185
MG,42110,CAMBUÍ,4522,7920,4076,20655,16579,567,857
MG,42129,GLAUCILÂNDIA,1835,515,545,3272,2727,59,91
MG,42137,CAMBUQUIRA,1926,4577,2045,10055,8010,239,335
MG,42145,GOIABEIRA,982,906,563,2864,2301,67,113
MG,42153,CAMPANÁRIO,1347,690,894,3270,2376,47,129
MG,42161,GOIANÁ,1138,949,775,3685,2910,120,161
MG,42170,CAMPANHA,2239,5591,2441,11852,9411,268,375
MG,42188,GUARACIAMA,3022,626,1049,5109,4060,65,143
MG,42196,CAMPESTRE,3446,6824,2887,16167,13280,644,420
MG,42200,IBIRACATU,2572,819,1855,5699,3844,74,224
MG,42218,CAMPINA VERDE,5126,5239,3234,15058,11824,298,444
MG,42226,IMBÉ DE MINAS,2532,1348,1424,5738,4314,55,186
MG,42234,CAMPO BELO,12924,10422,7884,39397,31513,1634,1556
MG,42242,INDAIABIRA,2217,1240,1919,5972,4053,57,266
MG,42250,CAMPO DO MEIO,4213,1997,2262,9811,7549,292,294
MG,42269,JAPONVAR,4076,583,2432,7657,5225,95,214
MG,42277,CAMPO FLORIDO,1929,1467,1002,5390,4388,107,143
MG,42285,JENIPAPO DE MINAS,1786,1102,2364,5658,3294,66,190
MG,42293,CAMPOS ALTOS,2889,3519,2586,10253,7667,321,270
MG,42307,JOSÉ GONÇALVES DE MINAS,1344,915,1221,3719,2498,38,128
MG,42315,CAMPOS GERAIS,5815,7250,4538,20419,15881,611,653
MG,42323,JOSÉ RAYDAN,1544,770,1319,4016,2697,54,168
MG,42331,CANAÃ,1970,976,586,3934,3348,79,142
MG,42340,SÃO SEBASTIÃO DA VARGEM ALEGRE,1246,628,485,2785,2300,45,104
MG,42358,CANÁPOLIS,4146,1837,2298,9395,7097,154,253
MG,42366,SÃO SEBASTIÃO DO ANTA,2213,1128,1161,5106,3945,71,139
MG,42374,CANA VERDE,2287,844,666,4599,3933,118,179
MG,42382,SERRANÓPOLIS DE MINAS,2015,515,836,3683,2847,51,144
MG,42390,CANDEIAS,3644,3498,2337,11877,9540,665,540
MG,42404,SETUBINHA,3516,993,3055,8305,5250,60,508
MG,42412,CAPARAÓ,2001,793,805,4206,3401,88,120
MG,42420,TAPARUBA,1262,889,784,3301,2517,58,74
MG,42439,CAPELA NOVA,1467,1282,627,4054,3427,229,197
MG,42447,UNIÃO DE MINAS,1647,583,902,3486,2584,63,85
MG,42455,CAPELINHA,9017,6712,6852,25442,18590,585,929
MG,42463,URUANA DE MINAS,1323,616,876,3164,2288,30,76
MG,42471,CAPETINGA,1711,2114,1472,5909,4437,148,157
MG,42480,VARGEM GRANDE DO RIO PARDO,1557,1032,877,3792,2915,37,161
MG,42498,CAPIM BRANCO,1931,2879,1127,7303,6176,307,260
MG,42501,VARJÃO DE MINAS,1927,1441,904,5192,4288,157,129
MG,42510,CAPINÓPOLIS,4996,2414,2073,11223,9150,219,229
MG,42528,VERDELÂNDIA,3416,587,1750,6305,4555,89,197
MG,42536,CAPITÃO ENÉAS,5481,2175,2864,11646,8782,167,417
MG,42544,VEREDINHA,2214,976,1228,4701,3473,62,143
MG,42552,CAPITÓLIO,2581,2285,1442,7156,5714,154,228
MG,42560,VERMELHO NOVO,2000,1206,894,4548,3654,123,134
MG,42579,CAPUTIRA,3657,1164,1616,7593,5977,261,287
MG,42587,TOCOS DO MOJI,1662,1293,465,3727,3262,81,80
MG,42595,CARAÍ,6475,1706,5321,14868,9547,149,717
MG,42617,CARANAÍBA,1176,909,432,2989,2557,137,138
MG,42633,CARANDAÍ,7900,5061,2550,19026,16476,1069,839
MG,42650,CARANGOLA,9999,4096,6159,25057,18898,561,1108
MG,42676,CARATINGA,19411,14991,14278,60516,46238,1791,2819
MG,42692,CARBONITA,2929,2013,2262,7705,5443,103,171
MG,42714,CAREAÇU,1436,2051,925,4898,3973,68,107
MG,42730,CARLOS CHAGAS,5215,4132,5556,16704,11148,314,574
MG,42757,CARMÉSIA,622,710,562,2130,1568,33,82
MG,42773,CARMO DA CACHOEIRA,3060,3331,1962,9620,7658,263,312
MG,42790,CARMO DA MATA,2811,3686,1439,9259,7820,320,375
MG,42811,CARMO DE MINAS,2335,4151,1695,9612,7917,238,301
MG,42838,CARMO DO CAJURU,5210,5640,2438,16702,14264,850,754
MG,42854,CARMO DO PARANAÍBA,5872,7258,5075,21755,16680,1039,822
MG,42870,CARMO DO RIO CLARO,5296,5327,3157,15512,12355,342,391
MG,42897,CARMÓPOLIS DE MINAS,4178,4556,1968,12555,10587,460,535
MG,42919,CARRANCAS,972,1330,583,3200,2617,50,117
MG,42935,CARVALHÓPOLIS,1028,1183,573,3141,2568,52,74
MG,42951,CARVALHOS,1237,1298,802,3901,3099,129,219
MG,42978,CASA GRANDE,781,785,393,2307,1914,84,88
MG,42994,CASCALHO RICO,1137,624,555,2819,2264,55,85
MG,43010,CÁSSIA,5021,4376,2972,14061,11089,315,449
MG,43036,CONCEIÇÃO DA BARRA DE MINAS,1308,1290,456,3433,2977,74,107
MG,43052,CATAGUASES,24775,7265,10418,53250,42832,1501,2211
MG,43079,CATAS ALTAS DA NORUEGA,1684,813,573,3445,2872,89,130
MG,43095,CAXAMBU,5490,4845,4414,17876,13462,434,609
MG,43117,CEDRO DO ABAETÉ,258,627,411,1416,1005,42,34
MG,43133,CENTRAL DE MINAS,2815,790,1395,5953,4558,141,207
MG,43150,CENTRALINA,3385,1144,1209,6794,5585,177,204
MG,43176,CHÁCARA,1121,628,390,2674,2284,64,114
MG,43192,CHALÉ,2304,732,826,4542,3716,139,119
MG,43214,CHAPADA DO NORTE,3828,1337,4068,9928,5860,123,338
MG,43230,CHIADOR,761,1254,615,3069,2454,53,103
MG,43257,CIPOTÂNEA,1467,1629,1755,5450,3695,240,180
MG,43273,CLARAVAL,762,2597,748,4529,3781,57,77
MG,43290,CLARO DOS POÇÕES,3137,1654,1848,7581,5733,143,234
MG,43311,CLÁUDIO,2376,12467,2740,19545,16805,551,527
MG,43338,COIMBRA,2113,1562,603,5660,5057,306,366
MG,43354,COLUNA,2719,1158,2231,6858,4627,124,295
MG,43370,COMENDADOR GOMES,975,767,542,2533,1991,46,41
MG,43397,COMERCINHO,3329,783,2303,6900,4597,61,210
MG,43419,CONCEIÇÃO DA APARECIDA,3379,2219,1544,7844,6300,148,131
MG,43435,CONCEIÇÃO DAS PEDRAS,890,982,450,2587,2137,92,70
MG,43451,CONCEIÇÃO DAS ALAGOAS,7645,3738,3946,18185,14239,439,490
MG,43478,CONCEIÇÃO DE IPANEMA,1860,669,640,3673,3033,62,122
MG,43494,CONCEIÇÃO DO MATO DENTRO,5260,2954,4396,14793,10397,493,703
MG,43516,CONCEIÇÃO DO PARÁ,1118,1939,814,4694,3880,188,187
MG,43532,CONCEIÇÃO DO RIO VERDE,2586,3784,2188,9946,7758,309,262
MG,43559,CONCEIÇÃO DOS OUROS,2230,3569,1355,8406,7051,207,235
MG,43575,CONGONHAL,2180,3300,1088,7677,6589,207,197
MG,43591,CONGONHAS,11562,10473,4995,38525,33530,2018,2270
MG,43613,CONGONHAS DO NORTE,1698,697,1240,4029,2789,62,233
MG,43630,CONQUISTA,1543,1801,680,5002,4322,147,209
MG,43656,CONSELHEIRO LAFAIETE,34140,21762,12379,89899,77520,3829,5219
MG,43672,CONSELHEIRO PENA,5377,4119,4382,16640,12258,385,538
MG,43699,CONSOLAÇÃO,403,770,322,1687,1365,42,35
MG,43710,CONTAGEM,119989,132777,71937,443730,371793,16532,22322
MG,43737,COQUEIRAL,2486,2922,1621,7654,6033,200,174
MG,43753,CORAÇÃO DE JESUS,11742,1977,5468,20961,15493,233,630
MG,43770,CORDISBURGO,2356,2209,1627,6999,5372,210,219
MG,43796,CORDISLÂNDIA,981,1201,728,3116,2388,35,56
MG,43818,CORINTO,7276,4311,5662,19966,14304,435,486
MG,43834,COROACI,3483,2121,2752,9416,6664,223,402
MG,43850,COROMANDEL,8141,6098,4708,22670,17962,681,779
MG,43877,CORONEL FABRICIANO,22671,16708,16647,79716,63069,2454,2950
MG,43893,CORONEL MURTA,3396,1212,1776,6898,5122,88,214
MG,43915,CORONEL PACHECO,964,631,330,2569,2239,75,123
MG,43931,CORONEL XAVIER CHAVES,848,1013,448,2740,2292,68,85
MG,43958,CÓRREGO DANTA,1095,954,772,3105,2333,49,87
MG,43974,CÓRREGO DO BOM JESUS,916,1403,625,3591,2966,84,125
MG,43990,CÓRREGO NOVO,1603,618,1169,3816,2647,69,131
MG,44016,COUTO DE MAGALHÃES DE MINAS,1453,688,1185,3779,2594,91,151
MG,44032,CRISTAIS,2995,2101,1509,8120,6611,343,363
MG,44059,CRISTÁLIA,2643,635,1295,4891,3596,49,147
MG,44075,CRISTIANO OTONI,1678,1191,574,4212,3638,233,227
MG,44091,CRISTINA,1394,3933,1683,8054,6371,168,288
MG,44113,CRUCILÂNDIA,1085,1954,846,4662,3816,202,156
MG,44130,CRUZEIRO DA FORTALEZA,1149,1354,855,3781,2926,90,87
MG,44156,CRUZÍLIA,4740,3598,2297,11915,9618,319,340
MG,44172,CURVELO,20629,16223,10179,54491,44312,1693,1471
MG,44199,DATAS,1857,1023,1359,4732,3373,113,223
MG,44210,DELFIM MOREIRA,1673,2886,1171,6586,5415,174,168
MG,44237,DELFINÓPOLIS,1569,2401,1411,5992,4581,137,149
MG,44253,DESCOBERTO,1252,1317,675,4362,3687,129,189
MG,44270,DESTERRO DE ENTRE RIOS,1116,2933,889,5684,4795,343,180
MG,44296,DESTERRO DO MELO,1103,1174,389,3021,2632,74,119
MG,44318,DIAMANTINA,13330,8297,9499,35810,26311,833,1388
MG,44334,DIOGO DE VASCONCELOS,1852,662,721,3806,3085,57,211
MG,44350,DIONÍSIO,2603,1085,2269,7279,5010,238,284
MG,44377,DIVINÉSIA,1221,1332,459,3447,2988,56,107
MG,44393,DIVINO,7031,2254,3666,14950,11284,264,448
MG,44415,DIVINO DAS LARANJEIRAS,1443,895,995,4251,3256,96,217
MG,44431,DIVINOLÂNDIA DE MINAS,2190,1375,1740,6083,4343,121,276
MG,44458,DIVINÓPOLIS,51302,43479,15490,152052,136562,7767,10229
MG,44474,DIVISA NOVA,1731,1660,857,4679,3822,80,111
MG,44490,DOM CAVATI,1586,1600,1049,4834,3785,87,142
MG,44512,DOM JOAQUIM,1479,938,929,3745,2816,102,193
MG,44539,DOM SILVÉRIO,1691,1234,760,4429,3669,132,278
MG,44555,DOM VIÇOSO,657,1475,373,2679,2306,41,46
MG,44571,DONA EUSÉBIA,2353,929,765,5120,4355,105,136
MG,44598,DORES DE CAMPOS,1940,2630,835,7355,6520,499,470
MG,44610,DORES DE GUANHÃES,2384,694,1292,4881,3589,74,216
MG,44636,DORES DO INDAIÁ,2445,4862,2863,11272,8409,288,270
MG,44652,DORES DO TURVO,2116,1319,680,4569,3889,69,157
MG,44679,DORESÓPOLIS,499,621,440,1734,1294,43,35
MG,44695,DOURADOQUARA,724,607,369,1916,1547,46,37
MG,44717,ELÓI MENDES,4288,8729,3060,19019,15959,625,565
MG,44733,ENGENHEIRO CALDAS,2474,2210,1673,7534,5861,165,325
MG,44750,ENGENHEIRO NAVARRO,3025,608,1474,5860,4386,112,263
MG,44776,ENTRE RIOS DE MINAS,3513,4417,1694,11464,9770,425,538
MG,44792,ERVÁLIA,7437,3370,2858,15904,13046,551,632
MG,44814,ESMERALDAS,15198,10555,7681,41441,33760,1694,1630
MG,44830,ESPERA FELIZ,7727,2216,2738,15534,12796,438,645
MG,44857,ESPINOSA,11683,3084,8330,25302,16972,357,594
MG,44873,ESPÍRITO SANTO DO DOURADO,786,2357,541,4235,3694,122,157
MG,44890,ESTIVA,2510,3632,1388,8756,7368,318,301
MG,44911,ESTRELA DALVA,1072,428,634,2601,1967,48,91
MG,44938,ESTRELA DO INDAIÁ,557,1388,792,3075,2283,97,90
MG,44954,ESTRELA DO SUL,2573,956,1378,5964,4586,183,188
MG,44970,EUGENÓPOLIS,3614,1569,1522,8317,6795,189,276
MG,44997,EWBANK DA CÂMARA,1916,550,662,3677,3015,96,142
MG,45012,EXTREMA,4555,9809,5131,25203,20072,863,787
MG,45039,FAMA,892,842,552,2720,2168,69,74
MG,45055,FARIA LEMOS,1675,339,382,2831,2449,44,115
MG,45071,FELÍCIO DOS SANTOS,1241,1510,1679,4753,3074,50,145
MG,45098,SÃO GONÇALO DO RIO PRETO,1077,674,871,2908,2037,65,96
MG,45110,FELISBURGO,1866,1127,1793,5182,3389,52,208
MG,45136,FELIXLÂNDIA,3679,3610,2807,11527,8720,351,245
MG,45152,FERNANDES TOURINHO,999,779,588,2708,2120,45,122
MG,45179,FERROS,3542,1760,2107,8503,6396,212,438
MG,45195,FLORESTAL,1985,1605,1044,5880,4836,232,301
MG,45217,FORMIGA,13752,19487,9516,53613,44097,2120,2178
MG,45233,FORMOSO,2267,1622,1204,5426,4222,36,218
MG,45250,FORTALEZA DE MINAS,937,1143,808,3505,2697,168,147
MG,45276,FORTUNA DE MINAS,955,772,508,2696,2188,70,62
MG,45292,FRANCISCO BADARÓ,2209,1834,2848,7333,4485,89,229
MG,45314,FRANCISCO DUMONT,1705,649,1402,4362,2960,77,140
MG,45330,FRANCISCO SÁ,9799,2043,4118,18244,14126,306,830
MG,45357,FREI GASPAR,2307,692,1312,4883,3571,65,262
MG,45373,FREI INOCÊNCIO,3145,1032,1728,6873,5145,95,228
MG,45390,FRONTEIRA,3767,1602,2452,10018,7566,183,319
MG,45411,FRUTAL,12639,9313,8684,40183,31499,1494,1177
MG,45438,FUNILÂNDIA,1217,1267,826,4049,3223,100,157
MG,45454,GALILÉIA,1944,1343,1137,5182,4045,83,180
MG,45470,GONÇALVES,418,2126,727,3659,2932,75,107
MG,45497,GONZAGA,1413,1320,1152,4635,3483,106,282
MG,45519,GOUVEIA,4426,1940,2655,10089,7434,164,391
MG,45535,GOVERNADOR VALADARES,59998,59778,48273,201799,153526,4727,5382
MG,45551,GRÃO MOGOL,4968,1957,3287,11423,8136,144,524
MG,45578,GRUPIARA,407,608,287,1495,1208,38,36
MG,45594,GUANHÃES,6550,7198,6368,24014,17646,699,1097
MG,45616,GUAPÉ,3761,3623,2060,10375,8315,295,236
MG,45632,GUARACIABA,3690,1915,1665,8136,6471,151,379
MG,45659,GUARANÉSIA,6412,3105,2895,14861,11966,459,531
MG,45675,GUARANI,2699,2052,1301,7080,5779,152,245
MG,45691,GUARARÁ,1090,834,608,3462,2854,88,175
MG,45713,GUARDA-MOR,2121,1415,1341,5584,4243,97,139
MG,45730,GUAXUPÉ,12316,10870,7451,37951,30500,1300,1571
MG,45756,GUIDOVAL,2461,1746,1087,6340,5253,173,177
MG,45772,GUIMARÂNIA,2201,1936,1347,6407,5060,193,209
MG,45799,GUIRICEMA,3548,1503,830,6882,6052,228,259
MG,45810,GURINHATÃ,2058,1207,1469,5272,3803,73,82
MG,45837,HELIODORA,1540,2148,818,4986,4168,154,153
MG,45853,IAPU,2745,1630,1767,8086,6319,220,276
MG,45870,IBERTIOGA,2378,940,894,4678,3784,100,159
MG,45896,IBIÁ,5586,4742,4456,17500,13044,519,579
MG,45918,IBIAÍ,3537,481,1830,6285,4455,43,170
MG,45934,IBIRACI,2090,4038,1721,8844,7123,193,219
MG,45950,IBIRITÉ,34052,25518,16096,104659,88563,4717,4679
MG,45977,IBITIÚRA DE MINAS,779,1469,612,3312,2700,113,116
MG,45993,IBITURUNA,671,1039,508,2487,1979,53,54
MG,46019,IGARAPÉ,8496,7070,4868,26291,21423,1089,1176
MG,46035,IGARATINGA,2560,1603,1125,6743,5618,512,303
MG,46051,IGUATAMA,2159,2502,1098,6668,5570,174,175
MG,46078,IJACI,1180,2205,527,4877,4350,252,190
MG,46094,ILICÍNEA,3729,3043,1606,9199,7593,198,162
MG,46116,INCONFIDENTES,1856,2347,931,6105,5174,147,131
MG,46132,INDIANÓPOLIS,1958,1091,1185,5012,3827,126,166
MG,46159,INGAÍ,782,1236,481,2831,2350,68,68
MG,46175,INHAPIM,7829,4368,4640,19695,15055,489,710
MG,46191,INHAÚMA,1571,1571,1062,5190,4128,163,169
MG,46213,INIMUTABA,2509,1419,1217,5754,4537,149,126
MG,46230,IPANEMA,5600,3688,3514,15196,11682,308,511
MG,46256,IPATINGA,46570,40128,35988,181060,145072,5514,6726
MG,46272,IPIAÇU,1513,783,813,3613,2800,50,69
MG,46299,IPUIÚNA,2884,2860,1129,7605,6476,109,134
MG,46310,IRAÍ DE MINAS,2375,1383,1241,5769,4528,108,166
MG,46337,ITABIRA,25186,28417,14788,89310,74522,3308,4463
MG,46353,ITABIRINHA,2853,2316,1962,8317,6355,170,299
MG,46370,ITABIRITO,8514,14629,5698,37623,31925,1824,1796
MG,46396,ITACAMBIRA,2316,688,1276,4629,3353,41,139
MG,46418,ITACARAMBI,6137,1631,3944,13114,9170,198,615
MG,46434,ITAGUARA,2410,4059,1015,9337,8322,524,495
MG,46450,ITAIPÉ,2355,2484,2836,8409,5573,136,285
MG,46477,ITAJUBÁ,13005,25906,13849,70743,56894,2171,2622
MG,46493,ITAMARANDIBA,10536,4259,5973,23299,17326,523,781
MG,46515,ITAMARATI DE MINAS,1686,662,565,3670,3105,71,138
MG,46531,ITAMBACURI,8256,2272,5957,18222,12265,203,790
MG,46558,ITAMBÉ DO MATO DENTRO,1067,583,488,2407,1919,52,115
MG,46574,ITAMOGI,2686,3022,2020,9270,7250,274,506
MG,46590,ITAMONTE,2057,4993,1921,10940,9019,340,515
MG,46612,ITANHANDU,2438,5244,2048,11737,9689,319,401
MG,46639,ITANHOMI,3478,2522,2208,9565,7357,189,391
MG,46655,ITAOBIM,5229,4182,5280,16740,11460,315,575
MG,46671,ITAPAGIPE,3731,2811,2176,10076,7900,191,225
MG,46698,ITAPECERICA,4648,6897,2902,17276,14374,715,760
MG,46710,ITAPEVA,1501,2789,910,6340,5430,160,244
MG,46736,ITATIAIUÇU,2376,2903,1459,8393,6934,423,367
MG,46752,ITAÚNA,10264,31603,9940,66458,56518,2875,3629
MG,46779,ITAVERAVA,2611,1215,975,5482,4507,247,204
MG,46795,ITINGA,4834,1761,3546,10891,7345,120,397
MG,46817,ITUETA,1936,1388,1311,5375,4064,107,168
MG,46833,ITUIUTABA,34849,13602,16679,76578,59899,1631,1644
MG,46850,ITUMIRIM,1433,2430,1021,5718,4697,258,169
MG,46876,ITURAMA,12343,5135,5935,28302,22367,698,743
MG,46892,ITUTINGA,937,1329,705,3576,2871,102,105
MG,46914,JABOTICATUBAS,4414,4578,2171,12956,10785,316,448
MG,46930,JACINTO,3186,2155,2503,8754,6251,113,360
MG,46957,JACUÍ,1091,2775,1337,6227,4890,216,251
MG,46973,JACUTINGA,1824,9205,3047,17010,13963,378,470
MG,46990,JAGUARAÇU,916,648,456,2767,2311,123,94
MG,47015,JANAÚBA,24507,7512,10776,49458,38682,1129,1609
MG,47031,JANUÁRIA,25173,4472,14239,47979,33740,642,1312
MG,47058,JAPARAÍBA,957,1201,416,3183,2767,104,76
MG,47074,JECEABA,1563,1901,1084,5453,4369,254,161
MG,47090,JEQUERI,4243,1815,2322,9827,7505,282,462
MG,47112,JEQUITAÍ,3388,533,2192,6820,4628,115,236
MG,47139,JEQUITIBÁ,1592,1945,1039,5385,4346,156,149
MG,47155,JEQUITINHONHA,7757,2522,5886,17836,11950,188,841
MG,47171,JESUÂNIA,1175,1657,882,4324,3442,92,198
MG,47198,JOAÍMA,4594,1471,3968,11158,7190,172,520
MG,47210,JOANÉSIA,1587,991,1361,4822,3461,181,251
MG,47236,JOÃO MONLEVADE,16400,16702,11517,58305,46788,2341,3075
MG,47252,JOÃO PINHEIRO,15093,7698,8399,35750,27351,901,769
MG,47279,JOAQUIM FELÍCIO,1199,906,1174,3631,2457,56,126
MG,47295,JORDÂNIA,3299,1322,2466,7936,5470,103,295
MG,47317,NOVA UNIÃO,2105,1406,1161,5412,4251,188,149
MG,47333,JUIZ DE FORA,125174,78148,73233,392970,319737,14368,23547
MG,47350,JURAMENTO,2321,830,904,4498,3594,99,122
MG,47376,JURUAIA,2423,2577,1193,7361,6168,210,192
MG,47392,LADAINHA,4532,2402,4141,12207,8066,94,729
MG,47414,LAGAMAR,2529,1716,1251,6299,5048,158,161
MG,47430,LAGOA DA PRATA,7246,14056,6165,33586,27421,1436,1117
MG,47457,LAGOA DOS PATOS,1693,667,1130,3876,2746,33,130
MG,47473,LAGOA DOURADA,2942,3814,1280,9557,8277,498,438
MG,47490,LAGOA FORMOSA,4620,4263,1915,12921,11006,713,394
MG,47511,LAGOA SANTA,6946,18471,6632,39771,33139,1297,1343
MG,47538,LAJINHA,6428,3284,3330,15405,12075,336,637
MG,47554,LAMBARI,4633,5833,3275,15946,12671,412,692
MG,47570,LAMIM,1575,691,579,3216,2637,119,122
MG,47597,LARANJAL,2474,1208,974,5565,4591,109,228
MG,47619,LASSANCE,2428,935,1483,5499,4016,114,150
MG,47635,LAVRAS,16011,24766,12187,69256,57069,2844,3776
MG,47651,LEANDRO FERREIRA,612,1517,539,3061,2522,93,78
MG,47678,LEOPOLDINA,16926,6798,8255,40009,31754,1202,1193
MG,47694,LIBERDADE,1514,1177,882,4313,3431,122,192
MG,47716,LIMA DUARTE,5766,2735,2836,13572,10736,385,579
MG,47732,LUMINÁRIAS,1156,2016,684,4190,3506,94,115
MG,47759,LUZ,3300,6062,3244,14582,11338,547,435
MG,47775,MACHACALIS,2265,1294,1453,5476,4023,64,202
MG,47791,MACHADO,6615,12441,5373,29058,23685,860,987
MG,47813,MADRE DE DEUS DE MINAS,1338,1531,880,4332,3452,141,185
MG,47830,MALACACHETA,5790,2681,5654,15699,10045,311,658
MG,47856,MANGA,7658,2010,4608,15859,11251,173,482
MG,47872,MANHUAÇU,20390,12739,10708,55083,44375,1797,1956
MG,47899,MANHUMIRIM,5749,3743,3759,16277,12518,435,641
MG,47910,MANTENA,7751,4501,4297,19309,15012,355,618
MG,47937,MARAVILHAS,2163,2072,993,5893,4900,125,131
MG,47953,MAR DE ESPANHA,3098,3174,1837,9704,7867,167,297
MG,47970,MARIA DA FÉ,3570,5083,1877,12061,10184,269,292
MG,47996,MARIANA,16403,9455,7763,44510,36747,2023,2798
MG,48011,MARILAC,1563,943,1048,3978,2930,121,153
MG,48038,MARIPÁ DE MINAS,1106,731,522,2854,2332,51,111
MG,48054,MARLIÉRIA,1308,914,702,3829,3127,117,153
MG,48070,MARMELÓPOLIS,919,910,322,2515,2193,89,71
MG,48097,MARTINHO CAMPOS,2193,4232,2510,10774,8264,503,428
MG,48119,MATERLÂNDIA,1727,565,1634,4338,2704,93,194
MG,48135,MATEUS LEME,5461,7659,3955,21916,17961,1158,1146
MG,48151,MATIAS BARBOSA,4312,2363,1796,11135,9339,369,603
MG,48178,MATIPÓ,6638,2713,3110,14560,11450,407,639
MG,48194,MATO VERDE,5274,1731,2460,10447,7987,159,337
MG,48216,MATOZINHOS,8074,10323,4647,28240,23593,1227,1323
MG,48232,MATUTINA,1029,1102,727,3351,2624,79,160
MG,48259,MEDEIROS,798,1272,640,3005,2365,75,93
MG,48275,MEDINA,6931,2642,4319,15737,11418,317,655
MG,48291,MENDES PIMENTEL,1950,1191,1235,5218,3983,134,165
MG,48313,MERCÊS,3702,1810,1551,8005,6454,220,321
MG,48330,MESQUITA,1778,1158,1494,5308,3814,200,215
MG,48356,MINAS NOVAS,8958,2365,9345,22475,13130,328,820
MG,48372,MINDURI,969,1083,709,3207,2498,42,93
MG,48399,MIRABELA,5685,1191,2967,10753,7786,140,221
MG,48410,MIRADOURO,3684,1766,1756,8565,6809,267,417
MG,48437,MIRAÍ,3923,1985,2379,10208,7829,225,387
MG,48453,MOEDA,1273,1827,959,4846,3887,127,169
MG,48470,MOEMA,2007,2210,1361,6351,4990,120,148
MG,48496,MONJOLOS,799,570,680,2263,1583,42,72
MG,48518,MONSENHOR PAULO,2269,2378,1111,6541,5430,154,196
MG,48534,MONTALVÂNIA,5614,1895,4116,12719,8603,125,439
MG,48550,MONTE ALEGRE DE MINAS,6244,3046,3592,15101,11509,439,489
MG,48577,MONTE AZUL,9864,1908,3788,17605,13817,235,602
MG,48593,MONTE BELO,3740,3520,2087,10700,8613,422,302
MG,48615,MONTE CARMELO,14322,6981,8116,35929,27813,1246,1398
MG,48631,MONTE SANTO DE MINAS,4513,5360,3781,16855,13074,672,837
MG,48658,MONTES CLAROS,100085,58081,43420,255345,211925,7252,11321
MG,48674,MONTE SIÃO,3122,7165,3445,16970,13525,410,471
MG,48690,MORADA NOVA DE MINAS,2554,2252,1852,7329,5477,158,221
MG,48712,MORRO DA GARÇA,1291,548,671,2774,2103,46,48
MG,48739,MORRO DO PILAR,965,1146,635,3137,2502,77,190
MG,48755,MUNHOZ,1434,2597,1083,5630,4547,151,157
MG,48771,MURIAÉ,27855,14651,14469,75532,61063,2124,3103
MG,48798,MUTUM,8515,4128,4246,20792,16546,580,763
MG,48810,MUZAMBINHO,6367,5240,3518,17312,13794,492,440
MG,48836,NACIP RAYDAN,1184,414,960,2793,1833,33,125
MG,48852,NANUQUE,9987,6477,9665,31293,21628,653,942
MG,48879,NATÉRCIA,830,2187,694,4143,3449,130,139
MG,48895,NAZARENO,2226,1989,1183,6157,4974,141,162
MG,48917,NEPOMUCENO,6297,6799,3902,20273,16371,714,780
MG,48933,NOVA ERA,5583,3459,3258,14903,11645,463,532
MG,48950,NOVA LIMA,15195,22002,9119,61901,52782,2223,2855
MG,48976,NOVA MÓDICA,1298,828,866,3326,2460,38,159
MG,48992,NOVA PONTE,3646,2281,2355,10713,8358,298,230
MG,49018,NOVA RESENDE,4448,4433,1712,11824,10112,294,280
MG,49034,NOVA SERRANA,7171,20741,7720,46351,38631,2186,1200
MG,49050,NOVO CRUZEIRO,8452,3561,9703,23810,14107,274,1104
MG,49077,OLARIA,864,462,437,2082,1645,49,70
MG,49093,OLÍMPIO NORONHA,671,876,430,2295,1865,52,85
MG,49115,OLIVEIRA,6995,13038,5371,31846,26475,1410,1263
MG,49131,OLIVEIRA FORTES,1041,416,298,2068,1770,57,93
MG,49158,ONÇA DE PITANGUI,718,1229,503,2962,2459,96,94
MG,49174,OURO BRANCO,8124,8686,4630,28268,23638,999,1095
MG,49190,OURO FINO,3919,10935,4821,24512,19691,800,754
MG,49212,OURO PRETO,20680,15118,9757,58344,48587,2379,2890
MG,49239,OURO VERDE DE MINAS,2466,1306,2054,6460,4406,92,271
MG,49255,PADRE PARAÍSO,5837,1737,5027,14286,9259,193,581
MG,49271,PAINEIRAS,1517,1202,952,4265,3313,121,143
MG,49298,PAINS,2006,2766,1086,6653,5567,142,175
MG,49310,PAIVA,541,515,285,1620,1335,67,83
MG,49336,PALMA,2567,904,942,5104,4162,65,162
MG,49352,FRONTEIRA DOS VALES,1868,628,1297,4134,2837,41,173
MG,49379,PAPAGAIOS,4539,3851,1716,11018,9302,234,261
MG,49395,PARACATU,18334,18816,12102,61844,49742,2167,1486
MG,49417,PARÁ DE MINAS,13853,19721,8008,59034,51026,3709,6249
MG,49433,PARAGUAÇU,4642,6529,3105,16520,13415,393,378
MG,49450,PARAISÓPOLIS,2612,7313,2916,15856,12940,412,607
MG,49476,PARAOPEBA,5809,6152,3169,18352,15183,724,685
MG,49492,PASSABÉM,664,506,397,1835,1438,32,106
MG,49514,PASSA QUATRO,3181,4789,2259,12852,10593,481,525
MG,49530,PASSA TEMPO,2204,2440,1520,7212,5692,268,369
MG,49557,PASSA VINTE,496,885,384,2068,1684,31,80
MG,49573,PASSOS,26965,25329,14045,78241,64196,2252,2165
MG,49590,PATOS DE MINAS,34225,31834,20701,105062,84361,4112,3551
MG,49611,PATROCÍNIO,19109,17710,11813,61933,50120,2717,2375
MG,49638,PATROCÍNIO DO MURIAÉ,2224,936,963,5110,4147,126,210
MG,49654,PAULA CÂNDIDO,3690,1270,1438,7389,5951,150,314
MG,49670,PAULISTAS,1806,601,1373,4220,2847,72,200
MG,49697,PAVÃO,2152,1707,1713,6167,4454,76,311
MG,49719,PEÇANHA,5045,2035,4446,12964,8518,151,448
MG,49735,PEDRA AZUL,6950,3512,6620,18985,12365,208,838
MG,49751,PEDRA DO ANTA,1811,593,629,3452,2823,77,157
MG,49778,PEDRA DO INDAIÁ,1136,1253,611,3621,3010,173,147
MG,49794,PEDRA DOURADA,1093,497,279,2162,1883,37,66
MG,49816,PEDRALVA,2000,4309,1779,9472,7693,289,310
MG,49832,PEDRINÓPOLIS,1068,970,622,3108,2486,85,86
MG,49859,PEDRO LEOPOLDO,11845,17061,6719,45428,38709,1944,1960
MG,49875,PEDRO TEIXEIRA,907,562,218,1938,1720,30,60
MG,49891,PEQUERI,1016,873,560,2929,2369,57,87
MG,49913,PEQUI,1423,1072,588,3543,2955,88,107
MG,49930,PERDIGÃO,849,3843,1278,7250,5972,283,267
MG,49956,PERDIZES,2246,4668,2641,10972,8331,232,260
MG,49972,PERDÕES,5625,4308,2795,16380,13585,744,818
MG,49999,PESCADOR,1160,1018,815,3363,2548,30,178
MG,50016,PIAU,1226,654,575,2971,2396,102,142
MG,50032,PIEDADE DE PONTE NOVA,1677,916,736,3758,3022,93,115
MG,50059,PIEDADE DO RIO GRANDE,1433,1235,947,4034,3087,93,173
MG,50075,PIEDADE DOS GERAIS,1555,1311,824,4364,3540,259,173
MG,50091,PIMENTA,2178,2299,1254,6638,5384,307,202
MG,50113,PIRACEMA,2564,1472,949,5730,4781,197,227
MG,50130,PIRAJUBA,1315,1058,765,3754,2989,108,94
MG,50156,PIRANGA,4873,2898,3886,13574,9688,467,696
MG,50172,PIRANGUÇU,1169,2053,830,4598,3768,88,101
MG,50199,PIRANGUINHO,1964,2508,1148,6745,5597,151,201
MG,50210,PIRAPETINGA,4247,1814,1353,9096,7743,287,379
MG,50237,PIRAPORA,12742,9703,9866,40462,30596,1066,1343
MG,50253,PIRAÚBA,3736,2526,1677,9304,7627,248,335
MG,50270,PITANGUI,4082,9212,3269,20015,16746,606,639
MG,50296,PIUMHI,6474,9411,5420,25020,19600,832,879
MG,50318,PLANURA,2798,1424,2043,8093,6050,225,197
MG,50334,POÇO FUNDO,4968,4321,1984,12605,10621,379,304
MG,50350,POÇOS DE CALDAS,29563,39227,21892,113370,91478,3273,4898
MG,50377,POCRANE,2828,2018,1795,7366,5571,117,189
MG,50393,POMPÉU,9874,5338,4359,22350,17991,829,697
MG,50415,PONTE NOVA,20101,8828,7053,42447,35394,1138,1368
MG,50431,PORTEIRINHA,16548,3443,7285,30314,23029,492,898
MG,50458,PORTO FIRME,3803,1554,1862,8410,6548,252,335
MG,50474,POTÉ,4312,2970,3691,12208,8517,163,577
MG,50490,POUSO ALEGRE,22198,37849,16846,97472,80626,3089,3652
MG,50512,POUSO ALTO,981,2388,962,5364,4402,143,164
MG,50539,PRADOS,2248,2436,947,6678,5731,327,300
MG,50555,PRATA,8709,4285,4288,19917,15629,518,424
MG,50571,PRATÁPOLIS,2432,2484,1343,7450,6107,236,293
MG,50598,PRATINHA,899,995,619,2833,2214,78,109
MG,50610,PRESIDENTE BERNARDES,1953,1494,1270,5293,4023,99,152
MG,50636,PRESIDENTE JUSCELINO,1887,723,1212,4088,2876,54,111
MG,50652,PRESIDENTE KUBITSCHEK,1166,521,564,2594,2030,41,130
MG,50679,PRESIDENTE OLEGÁRIO,6731,2944,3955,16294,12339,509,543
MG,50695,ALTO JEQUITIBÁ,2215,1944,1369,6845,5476,182,266
MG,50717,PRUDENTE DE MORAIS,2261,2806,1175,7924,6749,378,407
MG,50733,QUARTEL GERAL,1128,1015,637,3199,2562,119,107
MG,50750,QUELUZITO,831,679,333,2162,1829,57,92
MG,50776,RAPOSOS,4852,3112,1276,12006,10730,503,579
MG,50792,RAUL SOARES,7439,4180,3610,17338,13728,430,711
MG,50814,RECREIO,3460,1379,1576,7701,6125,165,260
MG,50830,RESENDE COSTA,3069,3218,1479,8841,7362,272,280
MG,50857,RESPLENDOR,3695,3468,3182,13058,9876,257,396
MG,50873,RESSAQUINHA,1891,983,412,3936,3524,106,191
MG,50890,RIACHO DOS MACHADOS,3865,800,1874,7333,5459,82,321
MG,50911,RIBEIRÃO DAS NEVES,58060,48948,31060,185429,154369,8838,8297
MG,50938,RIBEIRÃO VERMELHO,880,1121,492,3190,2698,113,166
MG,50954,RIO ACIMA,2190,2413,859,7455,6596,295,373
MG,50970,RIO CASCA,4421,2671,3184,11612,8428,330,453
MG,50997,RIO DOCE,852,765,367,2241,1874,45,74
MG,51012,RIO DO PRADO,1996,618,1133,4112,2979,68,193
MG,51039,RIO ESPERA,1774,1632,951,4900,3949,150,185
MG,51055,RIO MANSO,1710,1331,646,4318,3672,104,165
MG,51071,RIO NOVO,2062,2400,1243,7018,5775,221,343
MG,51098,RIO PARANAÍBA,3312,2685,2190,9606,7416,394,396
MG,51110,RIO PARDO DE MINAS,9660,2992,5385,20521,15136,168,1365
MG,51136,RIO PIRACICABA,4662,2925,2675,12370,9695,429,518
MG,51152,RIO POMBA,4188,3057,2850,13728,10878,635,662
MG,51179,RIO PRETO,2103,1230,1064,5131,4067,68,167
MG,51195,RIO VERMELHO,3466,2045,4386,11030,6644,245,531
MG,51217,RITÁPOLIS,1346,1727,680,4407,3727,114,188
MG,51233,ROCHEDO DE MINAS,758,666,407,2262,1855,51,102
MG,51250,RODEIRO,1996,1632,812,5666,4854,189,193
MG,51276,ROMARIA,1424,704,762,3342,2580,75,86
MG,51292,RUBELITA,3410,1033,2577,7660,5083,71,349
MG,51314,RUBIM,2386,1704,1875,6656,4781,105,327
MG,51330,SABARÁ,20876,29435,13826,87754,73928,4435,4403
MG,51357,SABINÓPOLIS,4544,2383,3990,12347,8357,365,585
MG,51373,SACRAMENTO,5616,6452,4174,19168,14994,460,725
MG,51390,SALINAS,11887,6631,7707,30608,22901,683,1146
MG,51411,SALTO DA DIVISA,1933,1068,1365,4893,3528,44,207
MG,51438,SANTA BÁRBARA,8502,6184,3742,22105,18363,661,803
MG,51454,SANTA BÁRBARA DO TUGÚRIO,2268,820,540,4114,3574,77,178
MG,51470,SANTA CRUZ DO ESCALVADO,2354,831,947,4577,3630,70,139
MG,51497,SANTA EFIGÊNIA DE MINAS,1684,586,928,3727,2799,142,207
MG,51519,SANTA FÉ DE MINAS,1700,451,1130,3483,2353,44,76
MG,51535,SANTA JULIANA,2865,2644,1437,8418,6981,301,246
MG,51551,SANTA LUZIA,38451,50505,24315,150778,126463,6541,6329
MG,51578,SANTA MARGARIDA,5752,2582,2228,11979,9751,264,395
MG,51594,SANTA MARIA DE ITABIRA,3539,2092,1755,8598,6843,254,409
MG,51616,SANTA MARIA DO SALTO,1342,914,1488,4375,2887,101,198
MG,51632,SANTA MARIA DO SUAÇUÍ,4482,2256,4716,12451,7735,127,418
MG,51659,SANTANA DA VARGEM,2124,2208,821,5748,4927,134,146
MG,51675,SANTANA DE CATAGUASES,1370,1031,359,3281,2922,39,88
MG,51691,SANTANA DE PIRAPAMA,2927,1567,1789,7452,5663,194,236
MG,51713,SANTANA DO DESERTO,1360,833,540,3186,2646,60,91
MG,51730,SANTANA DO GARAMBÉU,691,820,323,2020,1697,52,73
MG,51756,SANTANA DO JACARÉ,1397,1053,788,3888,3100,184,141
MG,51772,SANTANA DO MANHUAÇU,3410,1072,1710,6898,5188,130,178
MG,51799,SANTANA DO RIACHO,1273,1666,1213,4702,3489,119,125
MG,51810,SANTANA DOS MONTES,1236,1250,611,3554,2943,158,136
MG,51837,SANTA RITA DE CALDAS,2298,3080,1244,7319,6075,124,183
MG,51853,SANTA RITA DE JACUTINGA,1656,1478,925,4616,3691,73,136
MG,51870,SANTA RITA DE IBITIPOCA,1547,642,652,3180,2528,44,126
MG,51896,SANTA RITA DO ITUETO,1726,1297,773,4407,3634,93,186
MG,51918,SANTA RITA DO SAPUCAÍ,2767,17090,4898,28686,23788,850,681
MG,51934,SANTA ROSA DA SERRA,1150,691,852,3054,2202,81,54
MG,51950,SANTA VITÓRIA,7737,2444,3025,15251,12226,329,349
MG,51977,SANTO ANTÔNIO DO AMPARO,5889,3341,2459,13416,10957,537,468
MG,51993,SANTO ANTÔNIO DO AVENTUREIRO,1044,1049,465,3209,2744,107,143
MG,52019,SANTO ANTÔNIO DO GRAMA,1441,1266,746,3793,3047,84,132
MG,52035,SANTO ANTÔNIO DO ITAMBÉ,1350,623,1418,3732,2314,66,187
MG,52051,SANTO ANTÔNIO DO JACINTO,2485,2733,2739,8743,6004,107,394
MG,52078,SANTO ANTÔNIO DO MONTE,3141,9186,3385,18995,15610,823,684
MG,52094,SANTO ANTÔNIO DO RIO ABAIXO,466,771,341,1725,1384,36,57
MG,52116,SANTO HIPÓLITO,1110,733,1072,3167,2095,55,77
MG,52132,SANTOS DUMONT,15474,6627,7190,38627,31437,1469,2120
MG,52159,SÃO BENTO ABADE,1135,1706,766,3994,3228,96,99
MG,52175,SÃO BRÁS DO SUAÇUÍ,949,1040,504,3091,2587,146,139
MG,52191,SÃO DOMINGOS DO PRATA,5455,3419,2302,13540,11238,327,672
MG,52213,SÃO FRANCISCO,20215,3869,11829,38846,27017,312,871
MG,52230,SÃO FRANCISCO DE PAULA,2568,1388,982,5646,4664,159,165
MG,52256,SÃO FRANCISCO DE SALES,2437,731,795,4387,3592,79,108
MG,52272,SÃO FRANCISCO DO GLÓRIA,2377,722,680,4313,3633,67,140
MG,52299,SÃO GERALDO,2473,1774,1141,6516,5375,195,277
MG,52310,SÃO GERALDO DA PIEDADE,1657,653,1053,3766,2713,87,165
MG,52337,SÃO GONÇALO DO ABAETÉ,1751,1197,1029,4691,3662,101,134
MG,52353,SÃO GONÇALO DO PARÁ,1747,3294,1216,7735,6519,377,380
MG,52370,SÃO GONÇALO DO RIO ABAIXO,2538,3563,919,8845,7926,309,375
MG,52396,SÃO GONÇALO DO SAPUCAÍ,5034,6597,3582,18229,14647,449,590
MG,52418,SÃO GOTARDO,6711,8172,5497,24576,19079,1036,997
MG,52434,SÃO JOÃO BATISTA DO GLÓRIA,1612,2691,938,5816,4878,165,166
MG,52450,SÃO JOÃO DA MATA,779,1221,428,2789,2361,64,86
MG,52477,SÃO JOÃO DA PONTE,11322,1586,7444,22141,14697,201,773
MG,52493,SÃO JOÃO DEL REI,15861,27413,9883,65022,55139,2253,2713
MG,52515,SÃO JOÃO DO ORIENTE,3164,1280,1334,6949,5615,204,254
MG,52531,SÃO JOÃO DO PARAÍSO,5503,3631,5346,17128,11782,539,931
MG,52558,SÃO JOÃO EVANGELISTA,5159,2296,3017,11695,8678,170,449
MG,52574,SÃO JOÃO NEPOMUCENO,6245,4906,3869,20072,16203,610,944
MG,52590,SÃO JOSÉ DA SAFIRA,1488,988,1032,3737,2705,31,105
MG,52612,SÃO JOSÉ DA VARGINHA,913,1143,634,3450,2816,138,185
MG,52639,SÃO JOSÉ DO ALEGRE,657,1683,602,3548,2946,160,123
MG,52655,SÃO JOSÉ DO DIVINO,1220,1105,676,3297,2621,36,142
MG,52671,SÃO JOSÉ DO GOIABAL,2004,852,1228,4753,3525,108,239
MG,52698,SÃO JOSÉ DO JACURI,1946,1073,1327,4926,3599,136,247
MG,52710,SÃO JOSÉ DO MANTIMENTO,900,775,459,2401,1942,37,66
MG,52736,SÃO LOURENÇO,4965,14055,6329,32306,25977,797,1205
MG,52752,SÃO MIGUEL DO ANTA,2929,1316,860,5802,4942,115,257
MG,52779,SÃO PEDRO DA UNIÃO,1485,1470,900,4288,3388,127,166
MG,52795,SÃO PEDRO DOS FERROS,2781,1428,1908,6945,5037,179,335
MG,52817,SÃO PEDRO DO SUAÇUÍ,1649,1209,1137,4400,3263,51,199
MG,52833,SÃO ROMÃO,2921,875,2231,6567,4336,65,242
MG,52850,SÃO ROQUE DE MINAS,891,3028,1157,5461,4304,130,133
MG,52876,SÃO SEBASTIÃO DA BELA VISTA,1901,1391,711,4560,3849,76,79
MG,52892,SÃO SEBASTIÃO DO MARANHÃO,2323,2231,3280,8445,5165,99,304
MG,52914,SÃO SEBASTIÃO DO OESTE,2370,1495,1037,5984,4947,233,221
MG,52930,SÃO SEBASTIÃO DO PARAÍSO,12824,16105,10030,49036,39006,1464,1916
MG,52957,SÃO SEBASTIÃO DO RIO PRETO,328,672,366,1496,1130,31,45
MG,52973,SÃO SEBASTIÃO DO RIO VERDE,467,972,277,1945,1668,30,48
MG,52990,SÃO TIAGO,1779,4219,1375,8556,7181,360,250
MG,53015,SÃO TOMÁS DE AQUINO,1706,2202,1172,5777,4605,112,191
MG,53031,SÃO THOMÉ DAS LETRAS,1953,1452,1338,5433,4095,135,207
MG,53058,SÃO VICENTE DE MINAS,888,2840,1170,5602,4432,119,228
MG,53074,SAPUCAÍ-MIRIM,1269,2126,1023,5101,4078,84,148
MG,53090,SARDOÁ,1797,988,1138,4575,3437,172,255
MG,53112,SENADOR CORTES,887,638,539,2470,1931,34,115
MG,53139,SENADOR FIRMINO,2761,1763,837,6055,5218,116,245
MG,53155,SENADOR JOSÉ BENTO,838,775,530,2434,1904,48,65
MG,53171,SENADOR MODESTINO GONÇALVES,1487,1129,1626,4580,2954,78,152
MG,53198,SENHORA DE OLIVEIRA,2163,1372,1255,5355,4100,166,179
MG,53210,SENHORA DO PORTO,1061,794,790,3079,2289,68,175
MG,53236,SENHORA DOS REMÉDIOS,3322,2278,1225,7594,6369,124,326
MG,53252,SERICITA,2531,1967,1282,6178,4896,105,96
MG,53279,SERITINGA,561,662,364,1870,1506,46,68
MG,53295,SERRA AZUL DE MINAS,1229,680,1345,3609,2264,69,188
MG,53317,SERRA DA SAUDADE,267,494,269,1103,834,16,18
MG,53333,SERRA DOS AIMORÉS,2229,1001,1582,5850,4268,72,223
MG,53350,SERRA DO SALITRE,3279,2087,1955,8388,6433,248,205
MG,53376,SERRANIA,1946,2393,1392,6412,5020,139,149
MG,53392,SERRANOS,680,627,433,1947,1514,46,62
MG,53414,SERRO,6344,3017,5251,16522,11271,360,868
MG,53430,SETE LAGOAS,42071,50949,24466,158224,133758,8576,8651
MG,53457,SILVEIRÂNIA,1148,595,376,2486,2110,50,89
MG,53473,SILVIANÓPOLIS,1186,2125,807,4741,3934,85,151
MG,53490,SIMÃO PEREIRA,980,724,585,2851,2266,67,76
MG,53511,SIMONÉSIA,5995,3467,3174,14792,11618,509,555
MG,53538,SOBRÁLIA,1744,995,1092,4527,3435,92,189
MG,53554,SOLEDADE DE MINAS,1029,2409,833,4933,4100,106,140
MG,53570,TABULEIRO,1594,1097,843,4163,3320,132,162
MG,53597,TAIOBEIRAS,6115,9116,6117,24329,18212,392,870
MG,53619,TAPIRA,1128,1706,475,3743,3268,54,71
MG,53635,TAPIRAÍ,965,522,554,2199,1645,24,26
MG,53651,TAQUARAÇU DE MINAS,1119,1759,833,4181,3348,79,151
MG,53678,TARUMIRIM,3483,3350,2357,10320,7963,175,402
MG,53694,TEIXEIRAS,4242,2118,1978,9975,7997,314,435
MG,53716,TEÓFILO OTONI,34981,25348,27686,102765,75079,2539,3907
MG,53732,TIMÓTEO,16228,12484,11404,59892,48488,1833,2305
MG,53759,TIRADENTES,1531,2273,854,5890,5036,184,279
MG,53775,TIROS,1486,2110,1390,5628,4238,121,207
MG,53791,TOCANTINS,4510,3673,2177,12997,10820,544,505
MG,53813,TOLEDO,963,2826,1061,5344,4283,104,116
MG,53830,TOMBOS,2809,1740,1734,7285,5551,107,257
MG,53856,TRÊS CORAÇÕES,12893,21883,9618,54305,44687,1813,2034
MG,53872,TRÊS PONTAS,13627,15317,7150,42135,34985,1310,1021
MG,53899,TUMIRITINGA,1991,1306,1261,5145,3884,68,143
MG,53910,TUPACIGUARA,8321,3924,4140,19631,15491,583,630
MG,53937,TURMALINA,6784,2517,3394,14162,10768,266,371
MG,53953,TURVOLÂNDIA,1364,1312,831,3968,3137,94,119
MG,53970,UBÁ,22113,17811,12679,68941,56262,2632,2775
MG,53996,UBAÍ,4540,1596,2044,8745,6701,79,265
MG,54011,UBERABA,69861,52941,41815,219355,177540,8268,11416
MG,54038,UBERLÂNDIA,139464,113916,81800,463076,381276,16839,22898
MG,54054,UMBURATIBA,930,624,611,2420,1809,52,112
MG,54070,UNAÍ,14897,22140,12365,58164,45799,1397,1377
MG,54097,URUCÂNIA,3516,1870,1759,8368,6609,223,388
MG,54119,VARGEM BONITA,616,956,423,2177,1754,33,45
MG,54135,VARGINHA,21972,36378,18068,95704,77636,3246,3237
MG,54151,VÁRZEA DA PALMA,10350,5202,7068,27207,20139,815,860
MG,54178,VARZELÂNDIA,6966,2057,5036,15284,10248,175,503
MG,54194,VAZANTE,8194,2272,3121,15822,12701,426,390
MG,54216,WENCESLAU BRAZ,664,980,418,2589,2171,50,91
MG,54232,VERÍSSIMO,987,832,535,2663,2128,63,49
MG,54259,VESPASIANO,19161,24314,12890,72988,60098,2782,2665
MG,54275,VIÇOSA,20544,11721,10398,54672,44274,2388,2289
MG,54291,VIEIRAS,1818,796,645,3653,3008,49,125
MG,54313,MATHIAS LOBATO,1427,547,794,3174,2380,46,91
MG,54330,VIRGEM DA LAPA,3822,1864,3702,10243,6541,135,375
MG,54356,VIRGÍNIA,1879,3139,1293,7043,5750,153,155
MG,54372,VIRGINÓPOLIS,2599,2127,2139,8222,6083,275,440
MG,54399,VIRGOLÂNDIA,1968,642,1026,4143,3117,88,214
MG,54410,VISCONDE DO RIO BRANCO,11851,7369,4727,29464,24737,1070,980
MG,54437,VOLTA GRANDE,1577,759,1116,4285,3169,87,141
MG,54453,ITAÚ DE MINAS,2826,4086,2508,12313,9805,405,472
MS,55000,NOVA ALVORADA DO SUL,5335,3478,3409,14037,10628,225,281
MS,55018,ALCINÓPOLIS,938,1102,838,3356,2518,48,103
MS,55026,LAGUNA CARAPÃ,1607,1656,923,4728,3805,50,116
MS,55034,JAPORÃ,2537,984,1088,5364,4276,49,137
MS,55042,NOVO HORIZONTE DO SUL,1497,1250,717,3893,3176,86,94
MS,55050,PARAÍSO DAS ÁGUAS,1126,1061,972,3603,2631,40,112
MS,55069,FIGUEIRÃO,690,938,558,2469,1911,24,72
MS,90034,ÁGUA CLARA,3315,2236,3077,10331,7254,155,194
MS,90115,AMAMBAI,8105,7136,5765,24091,18326,351,632
MS,90131,ANASTÁCIO,6152,3637,4327,18126,13799,257,407
MS,90158,ANAURILÂNDIA,2138,1881,1503,6495,4992,69,171
MS,90174,ANTÔNIO JOÃO,1853,2632,1410,6812,5402,87,204
MS,90190,APARECIDA DO TABOADO,3932,5869,4174,17369,13195,426,621
MS,90212,AQUIDAUANA,10403,6928,8636,33870,25234,469,837
MS,90298,BANDEIRANTES,1935,1598,702,5154,4452,81,178
MS,90379,BATAGUASSU,4621,4447,4203,16411,12208,343,365
MS,90395,BATAYPORÃ,3160,2289,2052,8842,6790,216,278
MS,90417,BELA VISTA,5011,4814,4347,16716,12369,266,333
MS,90433,BONITO,4798,5078,3993,16450,12457,218,380
MS,90450,BRASILÂNDIA,2294,2374,2853,9601,6748,182,290
MS,90492,CAMAPUÃ,4085,3610,2024,11002,8978,145,268
MS,90514,CAMPO GRANDE,138099,199432,98286,582419,484133,14195,18497
MS,90530,CARACOL,1485,1583,981,4532,3551,35,80
MS,90557,CAARAPÓ,5848,5536,3580,18591,15011,420,528
MS,90573,CASSILÂNDIA,2826,6576,4172,16508,12336,330,589
MS,90611,CORGUINHO,1210,1032,730,3561,2831,35,88
MS,90638,CORUMBÁ,21349,14952,17247,69935,52688,1612,1582
MS,90654,COXIM,8904,5199,6557,25065,18508,436,718
MS,90735,DOURADOS,35621,48869,27964,147506,119542,4030,4828
MS,90751,FÁTIMA DO SUL,5447,5544,2462,15553,13091,298,325
MS,90794,GLÓRIA DE DOURADOS,2479,2331,1399,7560,6161,220,241
MS,90816,GUIA LOPES DA LAGUNA,2548,2259,1739,7671,5932,147,204
MS,90859,IGUATEMI,2721,4054,2942,10887,7945,131,296
MS,90875,INOCÊNCIA,1606,2058,1705,6393,4688,117,191
MS,90891,ITAPORÃ,4665,4640,2552,13604,11052,308,304
MS,90930,IVINHEMA,6048,5491,2918,17643,14725,614,649
MS,90972,JARAGUARI,1620,1234,514,4104,3590,82,138
MS,90999,JARDIM,5621,5222,4422,18100,13678,301,428
MS,91014,JATEÍ,1555,1049,552,3763,3211,38,46
MS,91030,LADÁRIO,4184,2414,3491,13109,9618,239,271
MS,91073,MARACAJU,8509,8952,5228,26528,21300,514,537
MS,91111,MIRANDA,6564,3777,4635,18792,14157,268,469
MS,91138,NAVIRAÍ,9849,11387,7982,35442,27460,896,977
MS,91154,NIOAQUE,3983,2473,2463,10495,8032,158,226
MS,91235,NOVA ANDRADINA,9778,9515,7802,32739,24937,795,859
MS,91251,PARANAÍBA,8612,9679,7068,30419,23351,763,872
MS,91278,PEDRO GOMES,2012,1901,1584,6238,4654,82,179
MS,91316,PONTA PORÃ,14439,21750,12551,58227,45676,1445,1531
MS,91375,PORTO MURTINHO,2225,2354,2591,8774,6183,66,176
MS,91413,RIBAS DO RIO PARDO,4631,3664,2994,13624,10630,248,397
MS,91430,RIO BRILHANTE,7504,7218,4297,23188,18891,556,654
MS,91456,RIO NEGRO,1377,1025,832,4073,3241,75,167
MS,91472,RIO VERDE DE MATO GROSSO,4915,3433,3626,14217,10591,217,357
MS,91499,ROCHEDO,794,1343,724,3791,3067,57,123
MS,91570,SIDROLÂNDIA,9757,6740,4984,28263,23279,695,724
MS,91596,TERENOS,4186,3001,2368,12326,9958,248,315
MS,91650,TRÊS LAGOAS,16331,18229,16054,72663,56609,2372,2375
MS,91693,ANGÉLICA,2725,1884,1503,7580,6077,209,292
MS,91715,ARAL MOREIRA,2738,2125,1281,6713,5432,57,140
MS,91731,ELDORADO,1898,3203,2363,9230,6867,209,280
MS,91758,DEODÁPOLIS,3332,3092,1703,9683,7980,254,294
MS,91782,CHAPADÃO DO SUL,3110,5388,3492,14423,10931,319,393
MS,91790,MUNDO NOVO,4067,4604,2640,13580,10940,241,454
MS,91804,DOIS IRMÃOS DO BURITI,3519,1475,1859,7898,6039,114,200
MS,91820,JUTI,2150,1056,937,4813,3876,66,196
MS,91847,PARANHOS,2837,2263,1925,7834,5909,53,396
MS,91863,SANTA RITA DO PARDO,1255,1559,1225,4863,3638,38,145
MS,91880,SONORA,3180,2464,2999,10761,7762,137,296
MS,91901,VICENTINA,2027,1531,516,4920,4404,116,127
MS,98019,BODOQUENA,2384,1512,1763,6724,4961,71,179
MS,98035,COSTA RICA,4330,4944,3867,16192,12325,327,531
MS,98051,DOURADINA,1398,1358,507,3981,3474,91,129
MS,98078,ITAQUIRAÍ,4872,3508,3509,13617,10108,249,301
MS,98094,SÃO GABRIEL DO OESTE,4304,6516,4247,17762,13515,328,367
MS,98116,SELVÍRIA,1845,1292,1215,5542,4327,110,166
MS,98132,SETE QUEDAS,2242,2792,1621,7441,5820,112,296
MS,98159,TACURU,3122,1417,1708,6862,5154,45,202
MS,98175,TAQUARUSSU,1343,844,489,2980,2491,61,59
MS,98590,CORONEL SAPUCAIA,3551,3085,2365,10014,7649,88,345
MT,89788,COLNIZA,6071,4822,5551,17651,12100,314,542
MT,89796,COLÍDER,3276,10728,6237,22979,16742,558,896
MT,89800,CURVELÂNDIA,1086,1304,882,3846,2964,58,162
MT,89818,NOVA BRASILÂNDIA,999,1203,889,3508,2619,52,129
MT,89826,NOVA SANTA HELENA,846,1020,857,2972,2115,35,128
MT,89834,PARANATINGA,2453,4946,3917,13603,9686,293,598
MT,89843,SANTO ANTÔNIO DO LESTE,490,685,832,2407,1575,41,117
MT,89850,SINOP,19530,32492,22053,85425,63372,2012,2913
MT,89877,ALTA FLORESTA,10629,13420,9617,37548,27931,782,1502
MT,89893,ARAPUTANGA,2619,3931,2998,11848,8850,262,555
MT,89915,JAURU,1771,3006,2196,8113,5917,118,321
MT,89931,SÃO JOSÉ DOS QUATRO MARCOS,3951,4331,3841,14403,10562,451,665
MT,89958,RIO BRANCO,1083,1306,972,4014,3042,70,193
MT,89960,RONDOLÂNDIA,705,596,975,2657,1682,20,102
MT,89974,SALTO DO CÉU,669,1221,587,2826,2239,45,106
MT,89990,PONTES E LACERDA,5690,11169,4158,26000,21842,610,1080
MT,90018,ACORIZAL,2683,938,569,5220,4651,62,267
MT,90026,SÃO JOSÉ DO POVO,1115,664,569,2788,2219,61,133
MT,90042,ALTO BOA VISTA,303,1766,1142,3408,2266,34,93
MT,90050,ALTO ARAGUAIA,2719,3571,3087,12176,9089,259,563
MT,90069,QUERÊNCIA,1499,4104,3005,9887,6882,200,315
MT,90077,ALTO GARÇAS,1785,2458,1620,6960,5340,149,333
MT,90085,CANABRAVA DO NORTE,640,1597,1187,3739,2552,36,123
MT,90093,ALTO PARAGUAI,2405,1382,1097,5815,4718,103,198
MT,90107,SANTA CARMEM,847,1230,755,3123,2368,29,78
MT,90123,NOVA MARINGÁ,1198,1216,1142,3835,2693,32,115
MT,90140,NOVA GUARITA,1220,1260,871,3680,2809,84,112
MT,90166,NOVA MARILÂNDIA,645,761,704,2507,1803,59,82
MT,90182,PORTO ESTRELA,1492,530,744,3092,2348,31,150
MT,90204,GLÓRIA D'OESTE,744,909,522,2490,1968,48,119
MT,90220,TABAPORÃ,1314,2787,2147,6711,4564,88,171
MT,90239,ARAGUAINHA,343,204,223,898,675,14,37
MT,90247,SÃO JOSÉ DO XINGU,786,1250,1410,4053,2643,59,169
MT,90255,ARENÁPOLIS,2048,2388,2075,7765,5690,149,283
MT,90263,APIACÁS,1824,1686,1393,5262,3869,78,187
MT,90271,ARIPUANÃ,2839,4640,4877,13238,8361,211,363
MT,90280,CONFRESA,3694,6415,4706,16745,12039,323,562
MT,90301,LAMBARI D'OESTE,1185,1290,1336,4546,3210,85,218
MT,90310,BARÃO DE MELGAÇO,3186,757,1355,6063,4708,88,204
MT,90328,SANTO AFONSO,742,656,565,2232,1667,39,58
MT,90336,BARRA DO BUGRES,7666,5759,5919,22939,17020,418,836
MT,90344,PLANALTO DA SERRA,732,548,267,1931,1664,46,92
MT,90352,BARRA DO GARÇAS,11211,11108,10465,41517,31052,1039,1671
MT,90360,NOVA MONTE VERDE,1710,1756,1765,5592,3827,73,155
MT,90387,NOVA BANDEIRANTES,2065,3339,2756,8833,6077,154,324
MT,90409,SÃO PEDRO DA CIPA,1307,724,661,3270,2609,63,95
MT,90425,COTRIGUAÇU,2405,2999,2612,8582,5970,123,259
MT,90441,RIBEIRÃOZINHO,592,562,506,1972,1466,18,85
MT,90468,BRASNORTE,2406,3708,3037,10097,7060,124,318
MT,90476,CÁCERES,20944,14050,16925,61491,44566,753,1755
MT,90484,CAMPO NOVO DO PARECIS,3873,6878,5233,18825,13592,458,548
MT,90506,CAMPO VERDE,6816,8644,5238,24771,19533,547,813
MT,90522,CLÁUDIA,1597,3249,2280,7713,5433,107,278
MT,90549,CASTANHEIRA,1750,2138,1274,5628,4354,108,192
MT,90565,JANGADA,2656,1049,901,5809,4908,78,268
MT,90581,JURUENA,1602,2235,1816,6132,4316,72,212
MT,90590,CHAPADA DOS GUIMARÃES,5698,3082,2547,13573,11026,199,614
MT,90603,LUCAS DO RIO VERDE,8843,12556,5751,33589,27838,866,1063
MT,90620,MATUPÁ,3153,3809,2647,10551,7904,198,333
MT,90646,NOVA MUTUM,4798,9528,5970,23808,17838,518,584
MT,90662,RIBEIRÃO CASCALHEIRA,1134,2721,1665,6280,4615,65,281
MT,90670,CUIABÁ,114522,118003,74405,410539,336134,9174,15747
MT,90689,TAPURAH,1662,2747,1891,7016,5125,105,212
MT,90697,DIAMANTINO,4056,4878,3718,15007,11289,284,397
MT,90700,PONTAL DO ARAGUAIA,1389,1161,795,4193,3398,73,183
MT,90719,DOM AQUINO,1881,2046,1458,6281,4823,81,304
MT,90727,SAPEZAL,2765,4079,4054,12569,8515,292,350
MT,90743,CAMPOS DE JÚLIO,981,1374,500,3352,2852,84,109
MT,90760,CARLINDA,2367,2353,1782,7268,5486,142,308
MT,90778,GENERAL CARNEIRO,1094,758,685,3414,2729,65,156
MT,90786,FELIZ NATAL,1638,1795,1909,5983,4074,80,178
MT,90808,NOVO MUNDO,1375,1696,1396,4921,3525,67,169
MT,90824,GAÚCHA DO NORTE,352,1611,1298,4132,2834,55,187
MT,90832,GUIRATINGA,2206,2825,1992,8640,6648,144,434
MT,90840,UNIÃO DO SUL,649,904,837,2575,1738,21,74
MT,90867,NOVA LACERDA,1522,1138,1353,4530,3177,40,158
MT,90883,NOVA UBIRATÃ,1828,1800,1890,5998,4108,76,137
MT,90905,BOM JESUS DO ARAGUAIA,1264,1213,1238,4070,2832,45,128
MT,90913,ITIQUIRA,2470,1897,2075,7920,5845,165,317
MT,90921,SERRA NOVA DOURADA,281,483,189,1085,896,7,46
MT,90948,NOVO SANTO ANTÔNIO,413,451,537,1562,1025,13,38
MT,90956,JACIARA,4636,6562,4408,19849,15441,439,590
MT,90964,NOVA NAZARÉ,400,576,889,2107,1218,13,123
MT,90980,SANTA CRUZ DO XINGU,285,606,499,1545,1046,12,59
MT,91006,CONQUISTA D'OESTE,631,850,716,2604,1888,26,109
MT,91022,VALE DE SÃO DOMINGOS,661,1123,431,2585,2154,41,125
MT,91049,SANTA RITA DO TRIVELATO,443,615,510,1803,1293,16,46
MT,91057,LUCIARA,342,825,303,1661,1358,16,55
MT,91081,IPIRANGA DO NORTE,854,1534,896,3611,2715,73,96
MT,91090,VILA BELA DA SANTÍSSIMA TRINDADE,3029,2709,2371,9609,7238,81,297
MT,91103,ITANHANGÁ,958,1661,1247,4197,2950,63,104
MT,91170,NOBRES,3540,3137,1535,10012,8477,143,428
MT,91197,NORTELÂNDIA,1646,1468,1051,5034,3983,96,203
MT,91219,NOSSA SENHORA DO LIVRAMENTO,5643,1938,1491,10483,8992,134,519
MT,91294,POCONÉ,11141,4109,2712,20490,17778,336,969
MT,91332,PONTE BRANCA,598,450,346,1671,1325,19,94
MT,91359,PORTO DOS GAÚCHOS,960,1568,1137,4101,2964,56,149
MT,91391,POXORÉU,4356,2704,3832,13106,9274,257,643
MT,91510,RONDONÓPOLIS,41000,40048,20025,133442,113417,4192,6987
MT,91537,ROSÁRIO OESTE,5083,2477,1822,11143,9321,195,518
MT,91553,SANTO ANTÔNIO DO LEVERGER,6485,2814,1823,13351,11528,242,523
MT,91618,TESOURO,832,479,651,2333,1682,37,138
MT,91634,TORIXORÉU,1138,1034,722,3331,2609,41,180
MT,91677,VÁRZEA GRANDE,66635,40575,34857,180166,145309,4621,6889
MT,91774,MIRASSOL D'OESTE,5595,5918,4881,19435,14554,518,811
MT,91812,PEDRA PRETA,4217,3118,2946,12260,9314,398,509
MT,91839,SÃO FÉLIX DO ARAGUAIA,1331,2173,2241,6421,4180,57,208
MT,91855,TANGARÁ DA SERRA,10542,26415,16002,62304,46302,1229,1943
MT,91898,JUSCIMEIRA,2847,2411,2042,8895,6853,182,335
MT,91910,ÁGUA BOA,2240,7020,4214,15146,10932,204,521
MT,91936,CANARANA,1998,5498,4246,13848,9602,226,593
MT,91952,NOVA XAVANTINA,3076,5019,4133,14554,10421,236,609
MT,91979,SANTA TEREZINHA,1529,1253,1504,4821,3317,52,195
MT,91995,SÃO JOSÉ DO RIO CLARO,2648,4109,3023,10957,7934,208,351
MT,98191,JUARA,3712,10486,6897,23642,16745,534,818
MT,98310,JUÍNA,8517,10914,7887,29805,21918,629,855
MT,98337,DENISE,1850,1563,1469,5858,4389,125,215
MT,98612,ALTO TAQUARI,1054,2105,1761,6212,4451,121,215
MT,98639,ARAGUAIANA,855,581,267,2009,1742,18,83
MT,98655,CAMPINÁPOLIS,2551,2383,2153,8726,6573,84,304
MT,98671,COCALINHO,1393,872,785,3658,2873,59,192
MT,98698,ITAÚBA,871,1489,1218,3929,2711,54,161
MT,98710,MARCELÂNDIA,2306,3252,2862,9034,6172,82,316
MT,98736,NOVA OLÍMPIA,3776,2876,3076,11917,8841,330,462
MT,98752,NOVA CANAÃ DO NORTE,1805,4149,2612,9626,7014,206,371
MT,98779,NOVO SÃO JOAQUIM,1054,1908,1470,5014,3544,51,180
MT,98795,NOVO HORIZONTE DO NORTE,711,1267,747,3042,2295,45,96
MT,98817,PEIXOTO DE AZEVEDO,6614,5124,4615,18604,13989,290,740
MT,98833,PARANAÍTA,2338,2938,1975,7896,5921,156,290
MT,98850,PORTO ALEGRE DO NORTE,1510,2462,2139,6829,4690,80,242
MT,98876,PORTO ESPERIDIÃO,2715,2341,2032,7917,5885,95,323
MT,98892,PRIMAVERA DO LESTE,8568,15267,9810,40434,30624,904,1443
MT,98914,RESERVA DO CABAÇAL,569,626,474,2011,1537,44,96
MT,98930,SORRISO,12785,18990,10744,48603,37859,1113,1484
MT,98957,TERRA NOVA DO NORTE,3264,2565,2322,8798,6476,108,256
MT,98973,VERA,1934,2176,1725,6400,4675,115,187
MT,98990,VILA RICA,2492,5210,4537,13461,8924,256,457
MT,99015,COMODORO,3023,5173,3747,13528,9781,147,472
MT,99031,FIGUEIRÓPOLIS D'OESTE,481,1501,750,3193,2443,58,166
MT,99058,GUARANTÃ DO NORTE,4822,7973,5876,20588,14712,325,734
MT,99074,INDIAVAÍ,725,475,194,1676,1482,15,95
PA,4006,GOIANÉSIA DO PARÁ,9486,4100,6880,22935,16055,264,735
PA,4014,ABAETETUBA,56350,14630,17141,99244,82103,943,2171
PA,4022,TAILÂNDIA,17939,9642,10931,43389,32458,618,1318
PA,4030,ACARÁ,20899,5692,7409,38634,31225,300,1194
PA,4049,BOM JESUS DO TOCANTINS,3609,1867,3054,9916,6862,97,354
PA,4057,AFUÁ,10571,5284,5375,23114,17739,107,808
PA,4065,SÃO JOÃO DE PIRABAS,8100,2122,4033,16628,12595,182,497
PA,4073,ALENQUER,13499,9413,8616,35525,26909,211,915
PA,4081,TUCUMÃ,8223,7103,6282,24594,18312,339,818
PA,4090,ALMEIRIM,10329,2185,4911,20414,15503,217,565
PA,4103,MÃE DO RIO,9419,5583,5510,23585,18075,259,722
PA,4111,ALTAMIRA,22921,16304,17160,67493,50333,1809,2535
PA,4120,ELDORADO DOS CARAJÁS,7236,3787,4640,18272,13632,304,740
PA,4138,ANAJÁS,6194,4059,4406,16713,12307,59,681
PA,4146,SANTA LUZIA DO PARÁ,6981,2901,3529,15411,11882,145,550
PA,4154,ANANINDEUA,94575,59878,23491,264577,241086,7290,10080
PA,4162,PALESTINA DO PARÁ,2330,1386,1745,5949,4204,45,197
PA,4170,AUGUSTO CORRÊA,15353,5649,8158,33344,25186,358,1159
PA,4189,IPIXUNA DO PARÁ,8312,3115,4415,18105,13690,122,698
PA,4197,AVEIRO,4840,1251,3089,10023,6934,60,274
PA,4200,JACAREACANGA,1900,1419,2820,8650,5830,75,454
PA,4219,BAGRE,6511,723,3247,11561,8314,59,367
PA,4227,BRASIL NOVO,4191,4159,2821,12420,9599,203,439
PA,4235,BAIÃO,10801,3635,4227,21980,17753,263,528
PA,4243,SANTA BÁRBARA DO PARÁ,6818,2413,2187,14002,11815,252,488
PA,4251,BARCARENA,38908,8326,9041,69338,60297,1174,1849
PA,4260,ÁGUA AZUL DO NORTE,3036,2447,2776,9466,6690,143,304
PA,4278,BELÉM,284647,243620,181245,1023078,841833,25459,37808
PA,4286,TRAIRÃO,3338,2697,2779,9503,6724,90,244
PA,4294,BENEVIDES,14878,7143,6279,36240,29961,672,1129
PA,4308,PAU D'ARCO,2426,1457,1777,6251,4474,40,194
PA,4316,BONITO,5450,1917,1808,10712,8904,157,439
PA,4324,ULIANÓPOLIS,6523,2658,4315,15691,11376,156,453
PA,4332,BRAGANÇA,33452,13435,16656,77784,61128,880,2086
PA,4340,AURORA DO PARÁ,8687,2451,3680,16492,12812,124,573
PA,4359,BREVES,24915,10100,14997,56443,41446,435,2092
PA,4367,TERRA SANTA,4830,1952,3440,11737,8297,104,268
PA,4375,BUJARU,9645,2548,3183,18366,15183,154,543
PA,4383,NOVO PROGRESSO,4311,7015,5532,17908,12376,229,430
PA,4391,CACHOEIRA DO ARARI,9742,1223,4105,16828,12723,104,445
PA,4405,VITÓRIA DO XINGU,3605,2458,2544,10090,7546,156,271
PA,4413,CAMETÁ,44565,13871,14107,81663,67556,541,1816
PA,4421,NOVO REPARTIMENTO,17103,8641,10662,40480,29818,388,1378
PA,4430,CAPANEMA,20775,9197,7619,46383,38764,1026,1468
PA,4448,BREU BRANCO,13080,4603,8698,29931,21233,390,953
PA,4456,CAPITÃO POÇO,16833,6935,3166,33120,29954,469,1353
PA,4464,SÃO DOMINGOS DO ARAGUAIA,6307,2600,4695,15805,11110,197,629
PA,4472,CASTANHAL,40925,29848,10550,112882,102332,2318,3704
PA,4480,NOVA ESPERANÇA DO PIRIÁ,6314,2733,2947,13100,10153,100,508
PA,4499,CHAVES,5207,1378,4159,12180,8021,64,504
PA,4502,ABEL FIGUEIREDO,2450,952,1638,5593,3955,40,210
PA,4510,COLARES,5122,1247,1755,9467,7712,133,321
PA,4529,CUMARU DO NORTE,2044,1547,2611,6887,4276,46,268
PA,4537,CONCEIÇÃO DO ARAGUAIA,9546,7500,9088,32370,23282,463,1165
PA,4545,TERRA ALTA,4835,1378,950,8462,7512,99,226
PA,4553,CURRALINHO,10280,1891,4048,17724,13676,78,616
PA,4561,FLORESTA DO ARAGUAIA,4818,2565,3772,12505,8733,124,453
PA,4570,CURUÇÁ,16325,3230,3594,26437,22843,296,1048
PA,4588,BANNACH,819,877,1093,3159,2066,21,90
PA,4596,FARO,3185,496,1898,6145,4247,28,130
PA,4600,NOVA IPIXUNA,3589,3150,3051,10885,7834,99,403
PA,4618,GURUPÁ,7975,3344,3499,16067,12568,43,415
PA,4626,PLACAS,4430,3175,2877,11351,8474,163,369
PA,4634,IGARAPÉ-AÇU,13323,4492,4961,27632,22671,560,938
PA,4642,MARITUBA,28265,11871,10626,65843,55217,1564,2169
PA,4650,IGARAPÉ-MIRI,24879,6414,8725,44865,36140,351,1179
PA,4669,TRACUATEUA,12177,2604,4229,21780,17551,171,682
PA,4677,INHANGAPI,3372,1974,1183,8344,7161,73,252
PA,4685,QUATIPURU,4050,1573,2863,9661,6798,100,239
PA,4693,IRITUIA,12532,3689,4747,23649,18902,221,622
PA,4707,CANAÃ DOS CARAJÁS,8905,6094,6637,26940,20303,736,925
PA,4715,ITAITUBA,26347,16142,22286,71207,48921,859,1829
PA,4723,ANAPU,5204,4175,3242,13914,10672,223,503
PA,4731,ITUPIRANGA,14657,4663,9575,31994,22419,320,1141
PA,4740,CURUÁ,4983,1389,2231,9476,7245,37,255
PA,4758,JACUNDÁ,12931,7393,9397,34147,24750,500,975
PA,4766,CACHOEIRA DO PIRIÁ,6699,1352,3352,12808,9456,88,566
PA,4774,JURUTI,12874,3412,7274,29173,21899,222,810
PA,4782,PIÇARRA,3565,1519,2625,8794,6169,95,425
PA,4790,LIMOEIRO DO AJURU,10082,2877,3149,17656,14507,98,434
PA,4804,BELTERRA,4937,3515,2985,13718,10733,135,423
PA,4812,MAGALHÃES BARATA,4019,1178,1361,7486,6125,49,169
PA,4820,SÃO JOÃO DA PONTA,2746,897,999,5416,4417,69,148
PA,4839,MARABÁ,59986,27677,33905,151463,117558,2940,5808
PA,4847,SAPUCAIA,1328,1111,1113,4005,2892,63,156
PA,4855,MARACANÃ,10877,4433,4030,22497,18467,223,598
PA,4863,MOJUÍ DOS CAMPOS,5052,5823,4277,16970,12693,163,434
PA,4871,MARAPANIM,11293,3247,4467,22567,18100,254,636
PA,4898,MELGAÇO,5195,2738,4792,14059,9267,95,498
PA,4910,MOCAJUBA,12192,2182,4116,21672,17556,148,518
PA,4936,MOJU,24276,6903,9761,45797,36036,371,1134
PA,4952,MONTE ALEGRE,16474,10720,10445,43243,32798,410,1069
PA,4979,MUANÁ,13787,2257,4230,22299,18069,127,783
PA,4995,NOVA TIMBOTEUA,5207,1746,2300,10910,8610,263,409
PA,5010,ÓBIDOS,16381,4353,8881,33417,24536,336,858
PA,5037,OEIRAS DO PARÁ,11688,1953,3424,18921,15497,70,630
PA,5053,ORIXIMINÁ,15205,6272,12178,42094,29916,434,1007
PA,5070,OURÉM,6510,2780,3150,13911,10761,131,515
PA,5096,PARAGOMINAS,24069,15432,10677,63398,52721,884,2317
PA,5118,PEIXE-BOI,3628,1310,905,6795,5890,93,242
PA,5134,PONTA DE PEDRAS,9771,2252,3725,18126,14401,117,553
PA,5150,PORTEL,12892,4334,10260,30875,20615,161,1082
PA,5177,PORTO DE MOZ,9120,2403,5072,17728,12656,80,490
PA,5193,PRAINHA,9942,4429,5315,21015,15700,102,615
PA,5215,PRIMAVERA,4094,1843,2389,9547,7158,122,326
PA,5231,SALINÓPOLIS,13000,5309,6098,28421,22323,304,586
PA,5258,SALVATERRA,8985,2226,3683,16949,13266,199,434
PA,5274,SANTA CRUZ DO ARARI,2950,724,2256,6636,4380,33,192
PA,5290,SANTA ISABEL DO PARÁ,17489,7308,6472,40547,34075,873,1266
PA,5312,SANTA MARIA DO PARÁ,7888,4189,4106,19261,15155,401,663
PA,5339,SANTANA DO ARAGUAIA,6007,5701,6466,20598,14132,278,715
PA,5355,SANTARÉM,55869,54083,45064,201993,156929,2774,5379
PA,5371,SANTARÉM NOVO,3613,626,994,5912,4918,42,169
PA,5398,SANTO ANTÔNIO DO TAUÁ,11351,3456,3752,21634,17882,286,628
PA,5410,SÃO CAETANO DE ODIVELAS,6907,2231,2917,14067,11150,222,307
PA,5436,SÃO DOMINGOS DO CAPIM,10159,4575,4637,21870,17233,177,780
PA,5452,SÃO FÉLIX DO XINGU,10408,10487,9662,33885,24223,369,1197
PA,5479,SÃO FRANCISCO DO PARÁ,5639,2870,2041,12721,10680,232,345
PA,5495,SÃO JOÃO DO ARAGUAIA,4690,1196,2766,10071,7305,83,409
PA,5517,SÃO MIGUEL DO GUAMÁ,15340,7471,7018,34724,27706,453,953
PA,5533,SÃO SEBASTIÃO DA BOA VISTA,10007,1979,3850,18126,14276,155,472
PA,5550,SENADOR JOSÉ PORFÍRIO,3797,1454,2809,8768,5959,62,268
PA,5576,SOURE,10339,1917,4609,19322,14713,236,482
PA,5592,TOMÉ-AÇU,17297,8238,10108,41720,31612,630,1202
PA,5614,TUCURUÍ,28950,11600,19505,72568,53063,1106,2008
PA,5630,VIGIA,16900,4564,7399,34195,26796,676,969
PA,5657,VISEU,22478,1848,9937,38412,28475,203,1576
PA,5673,REDENÇÃO,16061,15786,14491,55294,40803,817,1608
PA,5690,RIO MARIA,4252,3808,3165,13167,10002,209,418
PA,5711,XINGUARA,8416,9323,8018,30266,22248,494,937
PA,5738,RONDON DO PARÁ,11722,5158,9591,30292,20701,359,1250
PA,5754,URUARÁ,8272,9337,7312,27196,19884,391,1078
PA,5770,MEDICILÂNDIA,4141,6784,4231,16857,12626,270,590
PA,5797,SÃO GERALDO DO ARAGUAIA,6650,4183,6326,19884,13558,236,768
PA,5819,CONCÓRDIA DO PARÁ,8930,4664,3887,19343,15456,136,492
PA,5835,PARAUAPEBAS,45753,22812,30586,135347,104761,4579,4304
PA,5851,CURIONÓPOLIS,5058,3915,4054,15740,11686,279,527
PA,5878,GARRAFÃO DO NORTE,9595,2714,4650,19430,14780,191,813
PA,5894,RURÓPOLIS,6909,3618,4593,16636,12043,248,593
PA,5916,PACAJÁ,10557,4763,6826,24263,17437,298,898
PA,5932,BREJO GRANDE DO ARAGUAIA,2801,816,1834,6114,4280,50,242
PA,5959,OURILÂNDIA DO NORTE,7134,4641,7035,21771,14736,278,580
PA,5975,DOM ELISEU,12566,4320,8319,28890,20571,369,822
PA,5991,SANTA MARIA DAS BARREIRAS,4280,3314,4592,13498,8906,94,531
PB,19003,RIACHÃO DO POÇO,1773,720,854,4004,3150,107,200
PB,19011,ÁGUA BRANCA,3786,459,1891,7203,5312,112,456
PB,19020,SOBRADO,3062,874,1645,6756,5111,208,276
PB,19038,AGUIAR,2475,565,470,4075,3605,63,172
PB,19046,SÃO JOSÉ DOS RAMOS,2585,512,1041,4807,3766,152,279
PB,19054,ALAGOA GRANDE,8966,3087,6847,23487,16640,813,1130
PB,19062,CAPIM,1771,993,567,4257,3690,201,280
PB,19070,ALAGOA NOVA,5189,3460,3888,15545,11657,550,1032
PB,19089,CUITÉ DE MAMANGUAPE,2604,621,635,5325,4690,185,303
PB,19097,ALAGOINHA,5241,1186,2892,11070,8178,399,520
PB,19100,CURRAL DE CIMA,1915,816,1317,5006,3689,148,296
PB,19119,ALHANDRA,6274,3108,2636,16405,13769,813,697
PB,19127,RIACHÃO DO BACAMARTE,1914,580,800,4066,3266,153,251
PB,19135,SÃO JOÃO DO RIO DO PEIXE,7597,1445,3244,14500,11256,414,684
PB,19143,MATINHAS,1625,731,807,3893,3086,143,240
PB,19151,ARAÇAGI,6575,1636,4623,14850,10227,470,693
PB,19160,LOGRADOURO,1527,470,266,2878,2612,61,169
PB,19178,ARARA,3693,1344,2857,9412,6555,220,455
PB,19186,SERTÃOZINHO,1559,620,845,3928,3083,106,160
PB,19194,ARARUNA,4818,2592,4136,13937,9801,378,674
PB,19208,RIACHÃO,1415,933,620,3348,2728,46,144
PB,19216,AREIA,8770,2020,4426,19206,14780,843,943
PB,19224,SÃO DOMINGOS DO CARIRI,971,694,405,2467,2062,31,94
PB,19232,AREIAL,2357,1194,1228,5635,4407,155,251
PB,19240,CARAÚBAS,2032,274,559,3595,3036,58,195
PB,19259,AROEIRAS,7851,1661,4020,16032,12012,514,752
PB,19267,SANTO ANDRÉ,1445,263,502,2599,2097,80,133
PB,19275,DAMIÃO,2275,322,1044,4259,3215,40,177
PB,19283,SOSSÊGO,1586,317,582,3016,2434,52,133
PB,19291,BAÍA DA TRAIÇÃO,2811,711,1235,5977,4742,134,201
PB,19305,BARAÚNA,2008,486,794,3954,3160,130,157
PB,19313,BANANEIRAS,7423,2262,4921,17841,12920,509,789
PB,19321,ASSUNÇÃO,1652,411,669,3448,2779,88,154
PB,19330,BARRA DE SANTA ROSA,5418,1155,2756,11119,8363,182,442
PB,19348,ZABELÊ,1120,238,352,2022,1670,43,108
PB,19356,BARRA DE SÃO MIGUEL,2270,517,661,4582,3921,144,206
PB,19364,CACIMBAS,2563,393,1539,5365,3826,135,268
PB,19372,BAYEUX,27207,10560,11682,70574,58892,3135,3559
PB,19380,CAJAZEIRINHAS,1857,383,692,3476,2784,52,196
PB,19399,BELÉM,5544,2377,3475,13613,10138,369,587
PB,19402,SÃO BENTINHO,1505,783,741,3513,2772,53,144
PB,19410,BELÉM DO BREJO DO CRUZ,2624,1118,1119,5685,4566,116,247
PB,19429,SÃO DOMINGOS DE POMBAL,1531,347,570,2868,2298,51,135
PB,19437,BOA VENTURA,2679,538,1324,5308,3984,59,236
PB,19445,SÃO JOSÉ DE PRINCESA,1897,189,1012,3537,2525,47,166
PB,19453,BOM JESUS,1625,202,533,2732,2199,57,117
PB,19461,MARIZÓPOLIS,2961,442,830,5104,4274,102,191
PB,19470,BOM SUCESSO,2534,344,924,4296,3372,88,126
PB,19488,MATO GROSSO,1451,214,605,2561,1956,19,111
PB,19496,BONITO DE SANTA FÉ,3580,1001,2292,8055,5763,117,345
PB,19500,BERNARDINO BATISTA,1430,149,622,2627,2005,31,115
PB,19518,BOQUEIRÃO,6674,2285,1991,13167,11176,375,598
PB,19526,POÇO DE JOSÉ DE MOURA,2112,280,869,3925,3056,92,205
PB,19534,IGARACY,2605,714,539,4608,4069,56,238
PB,19542,SÃO JOSÉ DO BREJO DO CRUZ,940,213,266,1743,1477,23,75
PB,19550,BORBOREMA,1857,590,1258,4573,3315,139,240
PB,19569,SANTA INÊS,2259,139,1025,3862,2837,51,184
PB,19577,BREJO DO CRUZ,4701,1608,1959,9621,7662,197,443
PB,19585,AMPARO,1437,151,361,2212,1851,40,61
PB,19593,BREJO DOS SANTOS,2905,714,880,5426,4546,91,238
PB,19607,CASSERENGUE,2838,491,1817,5915,4098,107,242
PB,19615,CAAPORÃ,6209,1733,3091,16379,13288,1097,676
PB,19623,GADO BRAVO,3955,634,1321,7004,5683,186,396
PB,19631,CABACEIRAS,1934,758,615,4367,3752,157,184
PB,19640,POÇO DANTAS,1959,244,827,3435,2608,57,149
PB,19658,CABEDELO,13000,7276,6781,40734,33953,1924,1892
PB,19666,JOCA CLAUDINO,1201,272,591,2519,1928,47,119
PB,19674,CACHOEIRA DOS ÍNDIOS,3955,592,1489,7160,5671,206,361
PB,19682,TENÓRIO,1372,260,482,2536,2054,53,107
PB,19690,CACIMBA DE AREIA,1892,325,565,3230,2665,87,138
PB,19704,COXIXOLA,917,179,291,1705,1414,51,59
PB,19712,CACIMBA DE DENTRO,6312,1530,3576,13535,9959,204,708
PB,19720,PARARI,1099,176,269,2011,1742,16,76
PB,19739,CAIÇARA,2901,1191,557,5641,5084,114,343
PB,19747,PEDRO RÉGIS,1524,1031,1288,4520,3232,144,199
PB,19755,CAJAZEIRAS,22248,4417,9609,44464,34855,1552,1667
PB,19763,ALCANTIL,1773,1175,696,4476,3780,122,194
PB,19771,CALDAS BRANDÃO,2477,780,1029,5032,4003,163,211
PB,19780,BARRA DE SANTANA,3115,1218,1476,7478,6002,257,475
PB,19798,CAMALAÚ,3263,187,905,5043,4138,102,224
PB,19801,CATURITÉ,2363,627,656,4472,3816,137,236
PB,19810,CAMPINA GRANDE,68858,84662,18448,263601,245153,11408,19196
PB,19828,RIACHO DE SANTO ANTÔNIO,974,319,197,1873,1676,38,68
PB,19836,CARRAPATEIRA,1332,67,598,2280,1682,25,108
PB,19844,APARECIDA,3767,778,1148,6621,5473,196,240
PB,19852,CATINGUEIRA,1551,751,501,3711,3210,81,151
PB,19860,SÃO FRANCISCO,2008,440,441,3428,2987,66,130
PB,19879,CATOLÉ DO ROCHA,9976,3494,4234,21342,17108,633,821
PB,19887,VIEIRÓPOLIS,2847,407,1121,5088,3967,86,237
PB,19895,CONCEIÇÃO,7592,1421,3430,14280,10850,279,671
PB,19909,AREIA DE BARAÚNAS,955,341,368,1907,1539,38,89
PB,19917,CONDADO,2932,831,1214,5729,4515,91,254
PB,19925,ALGODÃO DE JANDAÍRA,1798,146,488,2730,2242,43,96
PB,19933,CONDE,7992,2215,2228,16822,14594,886,824
PB,19941,BOA VISTA,2273,1260,379,5191,4812,210,266
PB,19950,CONGO,2730,374,886,4640,3754,92,139
PB,19968,MARCAÇÃO,2709,641,1431,5941,4510,313,241
PB,19976,COREMAS,6075,1274,3141,12124,8983,173,484
PB,19984,MATURÉIA,2385,665,1260,5251,3991,138,224
PB,19992,CRUZ DO ESPÍRITO SANTO,6827,1942,2389,14173,11784,821,773
PB,20001,SANTA CECÍLIA,2355,834,1448,6200,4752,135,279
PB,20010,CUBATI,2893,1001,857,6041,5184,211,327
PB,20036,CUITÉ,6762,1971,4267,16520,12253,312,779
PB,20052,CUITEGI,1960,1095,1593,5705,4112,256,231
PB,20079,CURRAL VELHO,822,429,495,2086,1591,24,100
PB,20095,DESTERRO,3814,445,1781,6922,5141,100,200
PB,20117,VISTA SERRANA,1189,236,854,2898,2044,59,137
PB,20133,DIAMANTE,2756,660,1539,5660,4121,73,262
PB,20150,DONA INÊS,4490,892,2552,9205,6653,140,434
PB,20176,DUAS ESTRADAS,1403,781,745,3559,2814,112,166
PB,20192,EMAS,1536,466,343,2693,2350,59,144
PB,20214,ESPERANÇA,9401,4296,5846,24900,19054,922,1272
PB,20230,FAGUNDES,4569,1085,2173,9707,7534,248,568
PB,20257,FREI MARTINHO,1208,320,520,2766,2246,58,120
PB,20273,GUARABIRA,13893,8922,7973,39972,31999,1658,1941
PB,20290,GURINHÉM,5068,2081,2638,11443,8805,431,484
PB,20311,GURJÃO,1652,359,560,2994,2434,55,137
PB,20338,IBIARA,2659,536,1147,5214,4067,144,285
PB,20354,IMACULADA,4247,825,2476,8656,6180,149,348
PB,20370,INGÁ,6335,1829,3025,13956,10931,499,757
PB,20397,ITABAIANA,8982,2443,3977,19726,15749,699,1069
PB,20419,ITAPORANGA,7856,2636,3985,17075,13090,302,630
PB,20435,ITAPOROROCA,4274,3043,1338,10941,9603,506,660
PB,20451,ITATUBA,4460,978,1251,8039,6788,220,416
PB,20478,JACARAÚ,4798,2386,3327,12763,9436,317,518
PB,20494,JERICÓ,3305,812,1498,6419,4921,153,220
PB,20516,JOÃO PESSOA,153851,99424,38755,464765,426010,17832,23657
PB,20532,JUAREZ TÁVORA,3550,615,1494,6767,5273,241,297
PB,20559,JUAZEIRINHO,5464,2134,2348,12563,10215,465,643
PB,20575,JUNCO DO SERIDÓ,2404,1064,962,5273,4311,148,220
PB,20591,JURIPIRANGA,4260,1243,1668,9054,7386,204,455
PB,20613,JURU,4126,542,2063,7645,5582,147,366
PB,20630,LAGOA,2176,437,1138,4391,3253,136,211
PB,20656,LAGOA DE DENTRO,2994,957,1370,6081,4711,129,231
PB,20672,LAGOA SECA,6507,5126,1508,18088,16580,1288,1244
PB,20699,LASTRO,2153,205,454,3228,2774,33,120
PB,20710,LIVRAMENTO,2852,511,1295,5577,4282,117,222
PB,20737,LUCENA,4042,1230,2302,10095,7793,496,497
PB,20753,MÃE D'ÁGUA,1976,371,781,3789,3008,53,149
PB,20770,MALTA,2508,504,1101,4821,3720,89,210
PB,20796,MAMANGUAPE,10605,5059,3534,28709,25175,1314,1337
PB,20818,MANAÍRA,4209,544,2715,8725,6010,109,530
PB,20834,MARI,7499,2328,4019,16645,12626,509,725
PB,20850,MASSARANDUBA,4400,1739,926,9490,8564,514,744
PB,20877,MATARACA,2743,1078,710,6106,5396,262,309
PB,20893,MOGEIRO,5220,1267,3064,11322,8258,303,541
PB,20915,MONTADAS,1800,817,592,4000,3408,118,242
PB,20931,MONTE HOREBE,2204,288,991,3939,2948,39,142
PB,20958,MONTEIRO,11998,2744,5133,24194,19061,677,1126
PB,20974,MULUNGU,4585,1467,1389,8550,7161,209,299
PB,20990,NATUBA,2532,662,2024,6736,4712,235,433
PB,21016,NAZAREZINHO,4165,334,1071,6303,5232,100,260
PB,21032,NOVA FLORESTA,3743,925,1808,7811,6003,163,314
PB,21059,NOVA OLINDA,2161,413,618,3988,3370,124,240
PB,21075,NOVA PALMEIRA,1841,474,478,3277,2799,87,152
PB,21091,OLHO D'ÁGUA,2746,974,715,5589,4874,117,358
PB,21113,OLIVEDOS,1631,596,388,3341,2953,86,184
PB,21130,OURO VELHO,1463,314,426,2711,2285,51,123
PB,21156,PASSAGEM,1185,353,454,2259,1805,22,86
PB,21172,PATOS,24902,15037,13236,67129,53893,1881,2772
PB,21199,PAULISTA,4323,1617,2203,9617,7414,219,405
PB,21210,PEDRA BRANCA,1682,599,752,3625,2873,44,176
PB,21237,PEDRA LAVRADA,2645,1181,852,5890,5038,143,272
PB,21253,PEDRAS DE FOGO,9605,2233,2650,19686,17036,595,841
PB,21270,PIANCÓ,5468,2042,1891,11591,9700,236,603
PB,21296,PICUÍ,7271,1569,2872,14621,11749,341,668
PB,21318,PILAR,4530,778,1895,9334,7439,369,484
PB,21334,PILÕES,2963,905,1835,6813,4978,236,351
PB,21350,PILÕEZINHOS,1872,787,1496,5249,3753,289,308
PB,21377,PIRPIRITUBA,3157,1445,2085,7890,5805,293,326
PB,21393,PITIMBU,4519,859,1976,10349,8373,477,343
PB,21415,POCINHOS,5842,2094,2564,13443,10879,482,744
PB,21431,POMBAL,9443,7241,5296,25091,19795,398,862
PB,21458,PRATA,1656,642,535,3600,3065,69,188
PB,21474,PRINCESA ISABEL,6601,2404,3943,15446,11503,321,606
PB,21490,PUXINANÃ,4660,2055,1593,10649,9056,513,604
PB,21512,QUEIMADAS,13337,5237,6621,32803,26182,1415,1868
PB,21539,QUIXABA,922,295,244,1783,1539,44,86
PB,21555,REMÍGIO,6922,1534,3410,13522,10112,274,456
PB,21571,RIACHO DOS CAVALOS,4400,933,982,7108,6126,141,293
PB,21598,RIO TINTO,6687,2586,4239,18253,14014,796,839
PB,21610,SALGADINHO,1216,338,551,2798,2247,58,113
PB,21636,SALGADO DE SÃO FÉLIX,4468,1264,3305,10696,7391,205,518
PB,21652,SANTA CRUZ,3354,434,970,5385,4415,68,170
PB,21679,SANTA HELENA,3162,356,1313,5525,4212,89,264
PB,21695,SANTA LUZIA,4207,2828,2424,11659,9235,373,547
PB,21717,SANTANA DE MANGUEIRA,2479,298,1171,4696,3525,89,286
PB,21733,SANTANA DOS GARROTES,2575,911,1167,5590,4423,142,363
PB,21750,SANTA RITA,34427,13509,16353,90574,74221,4981,5123
PB,21776,SANTA TERESINHA,2131,1138,812,4725,3913,79,189
PB,21792,SÃO BENTO,8667,7057,4384,25048,20664,588,891
PB,21814,SÃO JOÃO DO CARIRI,2014,600,778,4058,3280,74,168
PB,21830,SÃO JOÃO DO TIGRE,2045,314,679,3647,2968,53,178
PB,21857,SÃO JOSÉ DA LAGOA TAPADA,3391,765,1240,6341,5101,128,290
PB,21873,SÃO JOSÉ DE CAIANA,2328,425,1652,5088,3436,55,243
PB,21890,SÃO JOSÉ DE ESPINHARAS,2187,565,615,3947,3332,75,143
PB,21911,SÃO JOSÉ DE PIRANHAS,8700,884,3395,14864,11469,259,575
PB,21938,SÃO JOSÉ DO BONFIM,1765,606,545,3382,2837,78,135
PB,21954,SÃO JOSÉ DO SABUGI,1833,818,367,3641,3274,82,171
PB,21970,SÃO JOSÉ DOS CORDEIROS,1832,273,631,3154,2523,76,111
PB,21997,SÃO MAMEDE,2707,1411,1239,6521,5282,147,233
PB,22012,SÃO MIGUEL DE TAIPU,2679,1018,956,5457,4501,140,237
PB,22039,SÃO SEBASTIÃO DE LAGOA DE ROÇA,2940,1744,2051,8787,6736,344,523
PB,22055,SÃO SEBASTIÃO DO UMBUZEIRO,1742,179,469,2857,2388,55,149
PB,22071,SAPÉ,16255,4997,10691,38424,27733,1468,1894
PB,22098,SÃO VICENTE DO SERIDÓ,3871,933,1868,8366,6498,221,306
PB,22110,SERRA BRANCA,4800,1299,2310,10071,7761,266,375
PB,22136,SERRA DA RAIZ,865,736,213,2254,2041,82,116
PB,22152,SERRA GRANDE,1602,209,554,2759,2205,33,155
PB,22179,SERRA REDONDA,2808,949,1627,6455,4828,202,341
PB,22195,SERRARIA,1651,866,1352,4706,3354,128,249
PB,22217,SOLÂNEA,8267,2832,7242,22486,15244,651,1018
PB,22233,SOLEDADE,4470,1752,1929,10955,9026,485,535
PB,22250,SOUSA,24042,4806,9679,47462,37783,1223,1586
PB,22276,SUMÉ,6257,1435,2883,12764,9881,354,551
PB,22292,TACIMA,3464,1093,2004,7556,5552,217,295
PB,22314,TAPEROÁ,4870,1732,2926,11013,8087,257,494
PB,22330,TAVARES,5658,804,3385,11198,7813,198,521
PB,22357,TEIXEIRA,5800,1241,2195,10527,8332,227,391
PB,22373,TRIUNFO,3634,432,2408,7400,4992,181,331
PB,22390,UIRAÚNA,5218,1635,2685,11419,8734,185,547
PB,22411,UMBUZEIRO,2924,811,1397,6598,5201,193,373
PB,22438,VÁRZEA,1149,357,342,2359,2017,54,102
PE,23000,QUIXABA,3334,80,1267,5585,4318,63,139
PE,23019,AFOGADOS DA INGAZEIRA,10702,1098,3935,24979,21044,748,1263
PE,23027,LAGOA DO CARRO,4170,732,2414,13098,10684,461,483
PE,23035,AFRÂNIO,8158,647,2415,15462,13047,309,850
PE,23043,SANTA CRUZ DA BAIXA VERDE,5110,235,1939,9514,7575,174,456
PE,23051,AGRESTINA,9361,662,3805,18953,15148,710,992
PE,23060,XEXÉU,3126,366,3987,11586,7599,251,350
PE,23078,ÁGUA PRETA,7112,732,7209,22703,15494,701,755
PE,23086,VERTENTE DO LÉRIO,3071,276,1737,7662,5925,224,402
PE,23094,ÁGUAS BELAS,13562,1251,7226,29446,22220,421,1725
PE,23108,SANTA CRUZ,6484,349,1848,10695,8847,152,609
PE,23116,ALAGOINHA,6212,378,2054,11064,9010,271,704
PE,23124,JUCATI,4033,218,2550,9296,6746,275,418
PE,23132,ALIANÇA,7785,846,3708,24742,21034,1166,1113
PE,23140,DORMENTES,7462,672,2747,14721,11974,272,604
PE,23159,ALTINHO,5506,821,1456,14346,12890,794,887
PE,23167,CARNAUBEIRA DA PENHA,6043,151,2341,10226,7885,144,587
PE,23175,AMARAJI,3166,512,4677,17718,13041,771,594
PE,23183,LAGOA GRANDE,8129,563,3882,17987,14105,240,752
PE,23191,ANGELIM,3838,681,2166,8343,6177,208,452
PE,23205,ARAÇOIABA,3356,340,2662,14603,11941,495,452
PE,23213,ARARIPINA,29162,2312,6199,49627,43428,957,3192
PE,23221,CASINHAS,4100,480,3426,12437,9011,379,630
PE,23230,ARCOVERDE,14404,2809,4438,41486,37048,1531,1996
PE,23248,MANARI,5983,281,3261,11427,8166,144,452
PE,23256,BARRA DE GUABIRABA,2678,565,2472,10033,7561,351,318
PE,23264,JATOBÁ,5680,212,2974,11031,8057,144,403
PE,23272,BARREIROS,7640,852,3871,27048,23177,1304,1162
PE,23280,TAMANDARÉ,3822,381,2229,14654,12425,526,441
PE,23299,BELÉM DE MARIA,3704,325,1714,8749,7035,221,489
PE,23302,JAQUEIRA,3223,247,2799,9166,6367,265,281
PE,23310,BELÉM DE SÃO FRANCISCO,8103,390,2693,14936,12243,139,746
PE,23329,SANTA FILOMENA,5947,288,2539,10591,8052,99,497
PE,23337,BELO JARDIM,24695,2917,13316,57528,44212,2517,3300
PE,23353,BETÂNIA,5169,96,2696,9832,7136,136,659
PE,23370,BEZERROS,17702,2265,10112,46414,36302,2576,2750
PE,23396,BODOCÓ,13792,620,5554,25107,19553,396,1385
PE,23418,BOM CONSELHO,15121,1480,10376,33810,23434,601,1696
PE,23434,BOM JARDIM,11162,1424,8688,31649,22961,982,1347
PE,23450,BONITO,9979,883,7507,30456,22949,775,1377
PE,23477,BREJÃO,4017,211,1829,8951,7122,180,487
PE,23493,BREJINHO,2662,205,1597,6797,5200,99,291
PE,23515,BREJO DA MADRE DE DEUS,10983,1575,6930,30379,23449,1115,1301
PE,23531,BUENOS AIRES,4100,494,2222,10984,8762,390,540
PE,23558,BUÍQUE,16790,898,11715,36844,25129,771,2645
PE,23574,CABO DE SANTO AGOSTINHO,45071,4823,25144,152624,127480,7946,5932
PE,23590,CABROBÓ,10700,510,4887,23520,18633,332,1053
PE,23612,CACHOEIRINHA,6570,873,2084,13762,11678,683,657
PE,23639,CAETÉS,9977,628,5609,18773,13164,400,974
PE,23655,CALÇADO,3436,313,1972,7893,5921,168,358
PE,23671,CALUMBI,3473,100,1432,6190,4758,74,326
PE,23698,CAMOCIM DE SÃO FÉLIX,6021,689,3222,14566,11344,517,733
PE,23710,CAMUTANGA,2408,267,683,6376,5693,209,305
PE,23736,CANHOTINHO,7715,1246,2257,14882,12625,480,963
PE,23752,CAPOEIRAS,7710,640,4899,15826,10927,418,677
PE,23779,CARNAÍBA,7100,215,1929,12951,11022,299,576
PE,23795,CARPINA,12846,2708,9567,54320,44753,2301,2097
PE,23817,CARUARU,49643,10959,21319,199869,178550,10386,11145
PE,23833,CATENDE,9921,777,4047,22667,18620,816,956
PE,23850,CEDRO,4585,257,2471,9375,6904,104,371
PE,23876,CHÃ DE ALEGRIA,2104,301,1804,10398,8594,425,476
PE,23892,CHÃ GRANDE,4865,1251,3232,16954,13722,730,800
PE,23914,CONDADO,4199,773,4650,19097,14447,881,724
PE,23930,CORRENTES,5955,382,4225,12985,8760,218,540
PE,23957,CORTÊS,3235,451,2423,10883,8460,311,429
PE,23973,CUMARU,5390,505,3763,15137,11374,538,664
PE,23990,CUPIRA,7449,779,2829,17353,14524,592,997
PE,24015,CUSTÓDIA,14046,536,4266,24396,20130,527,1602
PE,24031,ESCADA,14092,1427,3718,42280,38562,1901,1804
PE,24058,EXU,14348,545,8892,28829,19937,382,1555
PE,24074,FEIRA NOVA,5679,577,2897,16160,13263,537,825
PE,24090,FERREIROS,2681,507,902,8336,7434,490,542
PE,24112,FLORES,8284,286,4113,16221,12108,386,716
PE,24139,FLORESTA,12128,737,4525,22157,17632,260,1054
PE,24155,FREI MIGUELINHO,4590,487,2127,11698,9571,373,470
PE,24171,GAMELEIRA,4186,678,5047,16903,11856,567,653
PE,24198,GARANHUNS,39895,4343,8802,79641,70839,3149,4352
PE,24210,GLÓRIA DO GOITÁ,6799,1069,5366,22801,17435,833,1193
PE,24236,GOIANA,19409,1766,4143,51813,47670,2436,1975
PE,24252,GRANITO,3433,83,1234,5939,4705,53,237
PE,24279,GRAVATÁ,18463,5568,12477,60833,48356,3294,3159
PE,24295,IATI,7450,393,5168,15178,10010,174,713
PE,24317,IBIMIRIM,10172,555,4765,18792,14027,350,985
PE,24333,IBIRAJUBA,3056,222,1071,5804,4733,181,245
PE,24350,IGARASSU,23450,1766,5365,68389,63024,3038,2770
PE,24376,IGUARACI,4822,320,2851,9587,6736,168,427
PE,24392,INAJÁ,7459,298,2728,12101,9373,141,556
PE,24414,INGAZEIRA,1866,111,693,3755,3062,78,166
PE,24430,IPOJUCA,25512,1543,5233,57219,51986,2541,2386
PE,24457,IPUBI,9683,842,5740,21028,15288,304,1162
PE,24473,ITACURUBA,2271,92,842,4259,3417,39,187
PE,24490,ITAÍBA,8544,880,2587,15715,13128,304,983
PE,24511,ILHA DE ITAMARACÁ,5519,448,2161,15384,13223,380,463
PE,24538,ITAPETIM,4666,347,2542,11371,8829,188,566
PE,24554,ITAQUITINGA,3270,323,2772,13105,10333,332,412
PE,24570,JABOATÃO DOS GUARARAPES,98955,16613,68833,428041,359208,17530,16363
PE,24597,JATAÚBA,6135,332,2984,13416,10432,164,509
PE,24619,JOÃO ALFREDO,7680,1376,5336,22729,17393,979,1277
PE,24635,JOAQUIM NABUCO,3148,606,3420,12328,8908,447,451
PE,24651,JUPI,5011,446,2354,10998,8644,419,482
PE,24678,JUREMA,5004,369,1469,9683,8214,264,646
PE,24694,LAGOA DE ITAENGA,4937,847,3231,17239,14008,745,733
PE,24716,LAGOA DO OURO,6031,264,2330,10215,7885,151,676
PE,24732,LAGOA DOS GATOS,4635,447,3758,12248,8490,342,609
PE,24759,LAJEDO,10346,2182,5292,27360,22068,870,1132
PE,24775,LIMOEIRO,14790,2155,10990,47339,36349,1890,2170
PE,24791,MACAPARANA,5802,976,3135,17740,14605,619,904
PE,24813,MACHADOS,3972,463,2498,10109,7611,291,428
PE,24830,MARAIAL,3624,322,3502,9975,6473,180,447
PE,24856,MIRANDIBA,6139,433,2387,11332,8945,233,654
PE,24872,MORENO,16622,1333,3823,39992,36169,2310,2107
PE,24899,NAZARÉ DA MATA,5726,1035,5411,26160,20749,1197,1072
PE,24910,OLINDA,72557,11170,48803,311842,263039,11404,11826
PE,24937,OROBÓ,7300,928,6029,19848,13819,578,1010
PE,24953,OROCÓ,6015,345,2260,11150,8890,108,456
PE,24970,OURICURI,25007,1425,11432,45173,33741,637,2284
PE,24996,PALMARES,16761,1334,4301,36491,32190,1661,1765
PE,25011,PALMEIRINA,2788,183,2222,6814,4592,114,267
PE,25038,PANELAS,6788,499,6837,21129,14292,327,1066
PE,25054,PARANATAMA,4752,223,2193,9205,7012,184,581
PE,25070,PARNAMIRIM,11083,425,3292,16980,13688,146,497
PE,25097,PASSIRA,9303,1123,6337,25654,19317,993,1296
PE,25119,PAUDALHO,8825,1525,6443,38441,31998,2025,1415
PE,25135,PAULISTA,50108,6184,31266,205328,174062,7138,7476
PE,25151,PEDRA,7717,648,4776,17815,13039,411,905
PE,25178,PESQUEIRA,24893,1703,12107,48275,36168,1310,2076
PE,25194,PETROLÂNDIA,10909,742,2780,21545,18765,418,964
PE,25216,PETROLINA,74172,10659,32509,188919,156410,4219,7206
PE,25232,POÇÃO,4945,323,2017,9296,7279,226,530
PE,25259,POMBOS,6431,1030,2959,18797,15838,1114,921
PE,25275,PRIMAVERA,2472,231,2268,10251,7983,360,259
PE,25291,QUIPAPÁ,5378,632,6521,17601,11080,458,689
PE,25313,RECIFE,239769,67065,76893,1067008,990115,36479,38632
PE,25330,RIACHO DAS ALMAS,6856,753,2777,17260,14483,678,856
PE,25356,RIBEIRÃO,6579,755,8315,31540,23225,902,976
PE,25372,RIO FORMOSO,5402,477,2532,15615,13083,479,580
PE,25399,SAIRÉ,3671,486,1873,11033,9160,569,626
PE,25410,SALGADINHO,2438,314,1566,6367,4801,207,342
PE,25437,SALGUEIRO,19145,2423,3879,35529,31650,881,1619
PE,25453,SALOÁ,5760,323,4427,13116,8689,260,643
PE,25470,SANHARÓ,6334,694,1979,13700,11721,538,802
PE,25496,SANTA CRUZ DO CAPIBARIBE,18622,4705,10101,56590,46489,2177,2205
PE,25518,SANTA MARIA DA BOA VISTA,15496,1027,5774,27677,21903,447,1170
PE,25534,SANTA MARIA DO CAMBUCÁ,2823,609,2328,10345,8017,403,438
PE,25550,SANTA TEREZINHA,2723,368,2449,8253,5804,148,288
PE,25577,SÃO BENEDITO DO SUL,2286,199,2916,8171,5255,246,433
PE,25593,SÃO BENTO DO UNA,14145,2049,9250,34842,25592,1141,1625
PE,25615,SÃO CAITANO,9093,1199,3340,26127,22787,1586,1697
PE,25631,SÃO JOÃO,7457,517,4809,17159,12350,300,762
PE,25658,SÃO JOAQUIM DO MONTE,6747,1285,1636,14594,12958,603,1056
PE,25674,SÃO JOSÉ DA COROA GRANDE,3152,432,1652,12366,10714,585,614
PE,25690,SÃO JOSÉ DO BELMONTE,13238,828,7658,25837,18179,350,1356
PE,25712,SÃO JOSÉ DO EGITO,8772,930,6788,24639,17851,641,1012
PE,25739,SÃO LOURENÇO DA MATA,16980,2492,12312,75760,63448,3255,2917
PE,25755,SÃO VICENTE FÉRRER,5568,669,1499,12106,10607,370,556
PE,25771,SERRA TALHADA,28987,1551,4930,50376,45446,980,2695
PE,25798,SERRITA,7913,347,3658,14742,11084,193,680
PE,25810,SERTÂNIA,11390,1090,5132,24624,19492,568,1197
PE,25836,SIRINHAÉM,4512,526,3077,24788,21711,742,832
PE,25852,MOREILÂNDIA,5451,248,1218,8228,7010,145,362
PE,25879,SOLIDÃO,3000,142,1367,5268,3901,100,267
PE,25895,SURUBIM,15565,2028,9146,43954,34808,1456,1596
PE,25917,TABIRA,10339,745,2349,17023,14674,377,774
PE,25933,TACAIMBÓ,4725,323,1184,9017,7833,362,580
PE,25950,TACARATU,7689,464,3564,14557,10993,201,621
PE,25976,ITAMBÉ,8715,1581,2286,21030,18744,778,1143
PE,25992,TAQUARITINGA DO NORTE,4886,1876,3680,18734,15054,910,890
PE,26018,TEREZINHA,3031,150,1385,6027,4642,89,387
PE,26034,TERRA NOVA,5269,160,912,7608,6696,99,287
PE,26050,TIMBAÚBA,13156,2567,4467,38642,34175,1809,2156
PE,26077,TORITAMA,9490,1830,4964,26327,21363,1165,1057
PE,26093,TRACUNHAÉM,2328,341,1688,10416,8728,520,400
PE,26115,TRINDADE,11108,897,5143,20657,15514,347,862
PE,26131,TRIUNFO,5319,389,3089,12145,9056,247,580
PE,26158,TUPANATINGA,7007,556,5902,16564,10662,291,894
PE,26174,TUPARETAMA,4258,170,1673,7659,5986,113,332
PE,26190,VENTUROSA,6525,460,2586,12653,10067,277,604
PE,26212,VERDEJANTE,4154,227,1396,7647,6251,131,407
PE,26239,VERTENTES,4663,1291,2873,14800,11927,683,557
PE,26255,VICÊNCIA,5528,1269,2975,19762,16787,760,1014
PE,26271,VITÓRIA DE SANTO ANTÃO,25505,5902,18192,99168,80976,4787,4371
PE,26298,CAMARAGIBE,23006,3691,16879,116154,99275,4677,4441
PE,26310,ABREU E LIMA,22091,1757,12179,77400,65221,2865,2634
PE,26336,ITAPISSUMA,4537,280,1826,16096,14270,691,635
PE,30015,FERNANDO DE NORONHA,562,311,534,2175,1641,101,103
PI,10006,BRASILEIRA,3878,494,1667,7006,5339,123,323
PI,10014,AGRICOLÂNDIA,2724,350,998,4841,3843,76,300
PI,10022,ALEGRETE DO PIAUÍ,2501,267,939,4389,3450,52,209
PI,10030,ÁGUA BRANCA,6867,1545,2495,13117,10622,168,551
PI,10049,BAIXA GRANDE DO RIBEIRO,4678,620,1361,7648,6287,67,258
PI,10057,ALTO LONGÁ,6395,823,2470,11701,9231,93,515
PI,10065,BOM PRINCÍPIO DO PIAUÍ,3115,546,999,5481,4482,69,293
PI,10073,ALTOS,17542,2498,5572,30401,24829,556,1339
PI,10081,BONFIM DO PIAUÍ,2856,224,974,4502,3528,53,242
PI,10090,AMARANTE,7941,776,3556,14397,10841,168,697
PI,10103,BURITI DOS MONTES,3485,470,1265,5993,4728,65,328
PI,10111,ANGICAL DO PIAUÍ,3611,539,1410,6778,5368,108,298
PI,10120,CABECEIRAS DO PIAUÍ,5082,365,1906,8591,6685,126,465
PI,10138,ANÍSIO DE ABREU,3725,502,1411,6552,5141,63,387
PI,10146,CALDEIRÃO GRANDE DO PIAUÍ,2753,300,786,4491,3705,45,171
PI,10154,ANTÔNIO ALMEIDA,1201,275,697,2956,2259,26,109
PI,10162,CANAVIEIRA,1824,254,919,3378,2459,30,178
PI,10170,AROAZES,3286,281,1232,5439,4207,43,298
PI,10189,COIVARAS,2283,374,627,4254,3627,45,234
PI,10197,ARRAIAL,2286,174,1082,4084,3002,50,196
PI,10200,COLÔNIA DO GURGUÉIA,2879,188,1349,5017,3668,41,178
PI,10219,AVELINO LOPES,4422,570,2311,8493,6182,89,491
PI,10227,COLÔNIA DO PIAUÍ,3427,190,1852,6133,4281,64,237
PI,10235,BARRAS,16912,2920,8207,33681,25474,566,1906
PI,10243,CORONEL JOSÉ DIAS,3110,239,867,4663,3796,35,226
PI,10251,BARREIRAS DO PIAUÍ,1370,164,970,3153,2183,31,168
PI,10260,FARTURA DO PIAUÍ,2464,225,1152,4285,3133,36,215
PI,10278,BARRO DURO,2856,445,1589,6041,4452,62,205
PI,10286,JACOBINA DO PIAUÍ,2970,134,889,4561,3672,43,204
PI,10294,BATALHA,9716,2470,5893,21494,15601,293,1117
PI,10308,JARDIM DO MULATO,2346,209,675,3891,3216,51,195
PI,10316,BENEDITINOS,4958,866,1758,8770,7012,86,542
PI,10324,LAGOA ALEGRE,4470,442,1375,7193,5818,84,309
PI,10332,BERTOLÍNIA,2597,302,885,4222,3337,48,130
PI,10340,LAGOA DO BARRO DO PIAUÍ,2323,190,942,3886,2944,49,178
PI,10359,BOCAINA,2859,677,873,5232,4359,43,178
PI,10367,MARCOLÂNDIA,3458,544,1184,6420,5236,111,412
PI,10375,BOM JESUS,7318,2463,2983,15100,12117,260,693
PI,10383,PATOS DO PIAUÍ,2719,403,1397,5582,4185,98,362
PI,10391,BURITI DOS LOPES,8092,1399,3502,15371,11869,197,787
PI,10405,PASSAGEM FRANCA DO PIAUÍ,2096,163,928,3712,2784,40,183
PI,10413,CAMPINAS DO PIAUÍ,2957,153,1170,4835,3665,59,246
PI,10421,QUEIMADA NOVA,4020,307,1616,6807,5191,76,382
PI,10430,CAMPO MAIOR,17790,4088,6895,35084,28189,609,1666
PI,10448,SANTA CRUZ DOS MILAGRES,1833,237,888,3456,2568,23,152
PI,10456,CANTO DO BURITI,8239,1362,4039,15610,11571,178,711
PI,10464,SANTA ROSA DO PIAUÍ,2015,603,1191,4474,3283,39,213
PI,10472,CAPITÃO DE CAMPOS,4597,886,2287,9174,6887,175,522
PI,10480,SANTANA DO PIAUÍ,2316,203,751,3784,3033,59,212
PI,10499,CARACOL,4176,549,1894,7802,5908,116,436
PI,10502,SÃO BRAZ DO PIAUÍ,2311,139,962,3857,2895,48,155
PI,10510,CASTELO DO PIAUÍ,7401,1719,4940,16289,11349,205,813
PI,10529,SÃO JOSÉ DO DIVINO,2597,537,1089,4764,3675,76,187
PI,10537,COCAL,10269,1999,5401,20436,15035,381,1027
PI,10545,SIGEFREDO PACHECO,4724,591,1570,7953,6383,81,388
PI,10553,CONCEIÇÃO DO CANINDÉ,2535,256,949,4421,3472,65,249
PI,10561,SÃO LOURENÇO DO PIAUÍ,2619,234,1006,4358,3352,43,198
PI,10570,CORRENTE,9796,1219,4344,18223,13879,180,846
PI,10588,VÁRZEA BRANCA,2343,266,930,4037,3107,48,283
PI,10596,CRISTALÂNDIA DO PIAUÍ,3070,241,1443,5387,3944,32,271
PI,10600,BARRA D'ALCÂNTARA,1576,272,792,3207,2415,33,173
PI,10618,CRISTINO CASTRO,3760,549,2200,7411,5211,119,383
PI,10626,BELA VISTA DO PIAUÍ,2255,114,295,2941,2646,40,119
PI,10634,CURIMATÁ,4318,931,2063,8227,6164,106,349
PI,10642,BREJO DO PIAUÍ,2223,84,946,3672,2726,34,201
PI,10650,DEMERVAL LOBÃO,6062,987,1635,10362,8727,146,606
PI,10669,BOA HORA,2950,350,1446,5783,4337,82,359
PI,10677,DOM EXPEDITO LOPES,3798,465,1042,6247,5205,94,270
PI,10685,DOM INOCÊNCIO,4559,320,1712,7251,5539,47,345
PI,10693,ELESBÃO VELOSO,6621,1006,3241,12799,9558,159,796
PI,10707,CAPITÃO GERVÁSIO OLIVEIRA,2137,112,817,3337,2520,31,148
PI,10715,ELISEU MARTINS,1807,347,1065,3806,2741,68,158
PI,10723,CAMPO GRANDE DO PIAUÍ,2779,201,962,4777,3815,59,264
PI,10731,ESPERANTINA,13853,3681,7387,28876,21489,512,1264
PI,10740,CAMPO LARGO DO PIAUÍ,2624,282,989,4557,3568,61,290
PI,10758,FLORES DO PIAUÍ,2233,210,880,3965,3085,46,272
PI,10766,CURRAIS,2921,325,939,4788,3849,68,256
PI,10774,FLORIANO,21662,4623,5987,39392,33405,779,1438
PI,10782,GEMINIANO,3372,278,934,5291,4357,99,316
PI,10790,FRANCINÓPOLIS,2317,217,1269,4529,3260,57,198
PI,10804,GUARIBAS,2477,138,1163,4082,2919,19,145
PI,10812,FRANCISCO AYRES,2302,239,1322,4492,3170,59,188
PI,10820,ILHA GRANDE,4117,622,665,6627,5962,182,382
PI,10839,FRANCISCO SANTOS,3941,585,1272,6869,5597,98,330
PI,10847,JUREMA,2418,308,939,4171,3232,61,203
PI,10855,FRONTEIRAS,5360,658,2067,9348,7281,120,402
PI,10863,LAGOA DE SÃO FRANCISCO,2581,505,1338,5124,3786,73,235
PI,10871,GILBUÉS,3766,660,2172,7668,5496,84,409
PI,10880,MORRO CABEÇA NO TEMPO,1991,240,1124,3724,2600,48,197
PI,10898,GUADALUPE,3561,1141,2333,8346,6013,127,350
PI,10901,NOVO SANTO ANTÔNIO,2367,213,727,3748,3021,31,123
PI,10910,HUGO NAPOLEÃO,2340,282,750,3870,3120,44,138
PI,10928,NOSSA SENHORA DE NAZARÉ,3081,268,917,4778,3861,51,139
PI,10936,INHUMA,6514,922,3460,12594,9134,164,659
PI,10944,PAQUETÁ,2357,204,682,3679,2997,28,250
PI,10952,IPIRANGA DO PIAUÍ,4299,377,1720,7398,5678,126,403
PI,10960,NOVA SANTA RITA,2369,160,772,3650,2878,35,158
PI,10979,ISAÍAS COELHO,3422,215,1727,6181,4454,72,335
PI,10987,SÃO JOÃO DO ARRAIAL,2991,974,1537,6422,4885,83,317
PI,10995,ITAINÓPOLIS,5491,426,1979,9143,7164,180,506
PI,11010,ITAUEIRA,4789,627,2012,8669,6657,248,484
PI,11037,JAICÓS,6082,822,3965,12675,8710,151,755
PI,11053,JERUMENHA,2583,308,979,4390,3411,65,168
PI,11070,JOAQUIM PIRES,5680,1154,2788,11388,8600,150,502
PI,11088,SÃO JOÃO DA CANABRAVA,2688,323,1070,4535,3465,35,138
PI,11096,JOSÉ DE FREITAS,19192,1978,2325,27785,25460,540,1438
PI,11118,LANDRI SALES,1975,243,1335,4490,3155,40,230
PI,11134,LUIS CORREIA,12699,2271,2751,21277,18526,412,1236
PI,11150,LUZILÂNDIA,9606,1001,4652,19177,14525,257,963
PI,11177,MANOEL EMÍDIO,2289,316,1095,4442,3347,41,225
PI,11193,MARCOS PARENTE,1746,510,963,3904,2941,49,177
PI,11215,MATIAS OLÍMPIO,4198,631,2299,8442,6143,156,428
PI,11231,MIGUEL ALVES,12586,1299,6898,24301,17403,357,1308
PI,11258,MIGUEL LEÃO,676,148,232,1328,1096,4,88
PI,11274,MONSENHOR GIL,5534,691,1738,9507,7769,110,448
PI,11290,MONSENHOR HIPÓLITO,3557,391,1192,6368,5176,75,357
PI,11312,MONTE ALEGRE DO PIAUÍ,4120,629,2337,7994,5657,64,377
PI,11339,NAZARÉ DO PIAUÍ,3786,268,1784,6573,4789,73,335
PI,11355,NOSSA SENHORA DOS REMÉDIOS,3861,868,1558,7155,5597,74,306
PI,11371,NOVO ORIENTE DO PIAUÍ,3381,291,1404,5697,4293,54,311
PI,11398,OEIRAS,14873,2688,2679,24425,21746,469,1298
PI,11410,DOMINGOS MOURÃO,2102,236,1052,3771,2719,50,153
PI,11436,PADRE MARCOS,2994,352,1452,5929,4477,94,365
PI,11452,PAES LANDIM,1837,390,827,3645,2818,61,155
PI,11479,PALMEIRA DO PIAUÍ,2223,551,979,4485,3506,58,221
PI,11495,PALMEIRAIS,6808,638,2072,11128,9056,116,586
PI,11517,PARNAGUÁ,3767,347,1930,6909,4979,88,374
PI,11533,PARNAÍBA,44188,16878,9472,92326,82854,2085,4450
PI,11550,PAULISTANA,8532,577,3665,15259,11594,161,814
PI,11576,PEDRO II,12870,4423,8625,29869,21244,482,1362
PI,11592,PICOS,27514,5472,4932,46334,41402,872,2311
PI,11614,PIMENTEIRAS,5049,596,2387,9318,6931,78,546
PI,11630,PIO IX,8557,701,2912,13868,10956,137,618
PI,11657,PIRACURUCA,11743,2506,3888,21133,17245,331,957
PI,11673,PIRIPIRI,23103,5868,8573,44398,35825,1246,2238
PI,11690,PORTO,4388,458,2386,8696,6310,111,456
PI,11711,PRATA DO PIAUÍ,1785,168,949,3378,2429,27,179
PI,11738,REDENÇÃO DO GURGUÉIA,3010,627,1582,6229,4647,84,268
PI,11754,REGENERAÇÃO,7725,799,3636,14064,10428,196,748
PI,11770,RIBEIRO GONÇALVES,2708,483,981,5001,4020,38,299
PI,11797,RIO GRANDE DO PIAUÍ,3185,389,1551,5789,4238,59,303
PI,11819,SANTA CRUZ DO PIAUÍ,3294,208,866,5264,4398,38,224
PI,11835,SANTA FILOMENA,2345,355,1200,4598,3398,108,233
PI,11851,SANTA LUZ,2405,537,981,4396,3415,85,213
PI,11878,SANTO ANTÔNIO DE LISBOA,2738,344,948,5030,4082,78,279
PI,11894,SANTO INÁCIO DO PIAUÍ,1474,173,769,3264,2495,31,147
PI,11916,SÃO FÉLIX DO PIAUÍ,1897,575,605,3544,2939,25,115
PI,11932,SÃO FRANCISCO DO PIAUÍ,3091,217,1308,5645,4337,39,227
PI,11959,SÃO GONÇALO DO PIAUÍ,2164,497,909,4508,3599,75,235
PI,11975,SÃO JOÃO DA SERRA,3016,811,1614,6361,4747,131,281
PI,11991,SÃO JOÃO DO PIAUÍ,7409,1096,2990,13717,10727,151,694
PI,12009,SÃO JOÃO DA FRONTEIRA,2279,426,1303,4822,3519,66,232
PI,12017,SÃO JOSÉ DO PEIXE,1797,127,831,3187,2356,52,168
PI,12025,SÃO JOÃO DA VARJOTA,2249,218,896,3944,3048,79,229
PI,12033,SÃO JOSÉ DO PIAUÍ,3453,228,1414,5741,4327,55,263
PI,12041,SEBASTIÃO BARROS,1929,260,1107,3988,2881,35,210
PI,12050,SÃO JULIÃO,2832,452,1104,5339,4235,44,254
PI,12068,SEBASTIÃO LEAL,1838,487,479,3379,2900,70,161
PI,12076,SÃO MIGUEL DO TAPUIO,7888,928,4797,15685,10888,203,909
PI,12084,ALVORADA DO GURGUÉIA,2513,137,893,3974,3081,30,193
PI,12092,SÃO PEDRO DO PIAUÍ,5423,1107,2557,10777,8220,153,561
PI,12106,ASSUNÇÃO DO PIAUÍ,2785,593,2108,6242,4134,116,367
PI,12114,SÃO RAIMUNDO NONATO,12892,2161,4009,21846,17837,312,911
PI,12122,BETÂNIA DO PIAUÍ,3091,184,1185,5148,3963,59,319
PI,12130,SIMÕES,6095,705,2549,11310,8761,163,744
PI,12149,BOQUEIRÃO DO PIAUÍ,2797,244,1431,5099,3668,72,230
PI,12157,SIMPLÍCIO MENDES,4956,823,2225,9300,7075,134,413
PI,12165,CARIDADE DO PIAUÍ,2877,195,770,4505,3735,45,282
PI,12173,SOCORRO DO PIAUÍ,1895,346,1184,4331,3147,24,249
PI,12181,CURRAL NOVO DO PIAUÍ,2390,102,907,3924,3017,58,211
PI,12190,TERESINA,236889,79877,49086,506742,457656,10272,23327
PI,12203,JÚLIO BORGES,2734,112,1164,4462,3298,25,204
PI,12211,UNIÃO,19335,2979,6313,33695,27382,478,1699
PI,12220,LAGOA DO SÍTIO,2484,236,1157,4471,3314,45,239
PI,12238,URUÇUÍ,6223,3112,3215,15355,12140,250,727
PI,12246,MILTON BRANDÃO,3045,406,1688,5793,4105,99,258
PI,12254,VALENÇA DO PIAUÍ,7720,1517,3879,16308,12429,254,959
PI,12262,PAJEÚ DO PIAUÍ,1528,158,849,3049,2200,30,139
PI,12270,VÁRZEA GRANDE,1765,456,1163,3970,2807,45,256
PI,12289,PAVUSSU,2069,133,1143,3741,2598,44,211
PI,12297,DIRCEU ARCOVERDE,3329,289,1540,5726,4186,56,248
PI,12300,RIACHO FRIO,2384,191,1079,4143,3064,23,213
PI,12319,ALAGOINHA DO PIAUÍ,3764,414,1193,6174,4981,85,347
PI,12327,ACAUÃ,3727,228,697,5368,4671,72,236
PI,12335,BELÉM DO PIAUÍ,1784,101,495,2745,2250,33,97
PI,12343,CAJAZEIRAS DO PIAUÍ,1867,92,555,2866,2311,41,163
PI,12351,CAMPO ALEGRE DO FIDALGO,2803,134,1000,4375,3375,31,218
PI,12360,COCAL DE TELHA,2405,120,1352,4504,3152,57,235
PI,12378,FRANCISCO MACEDO,1542,106,486,2423,1937,42,84
PI,12386,JOÃO COSTA,1963,101,573,2965,2392,18,168
PI,12394,JATOBÁ DO PIAUÍ,3340,488,1071,5554,4483,88,224
PI,12408,JOCA MARQUES,2457,199,1111,4377,3266,58,143
PI,12416,JUAZEIRO DO PIAUÍ,3184,427,1181,5633,4452,93,292
PI,12424,LAGOA DO PIAUÍ,2200,347,436,3568,3132,43,165
PI,12432,LAGOINHA DO PIAUÍ,1513,158,511,2578,2067,27,102
PI,12440,MADEIRO,3197,326,1681,6096,4415,69,295
PI,12459,MORRO DO CHAPÉU DO PIAUÍ,2679,811,1703,5786,4083,64,230
PI,12467,MASSAPÊ DO PIAUÍ,3201,238,1552,5877,4325,103,394
PI,12475,MURICI DOS PORTELAS,3097,436,1481,5956,4475,88,343
PI,12483,OLHO D'ÁGUA DO PIAUÍ,1418,108,508,2310,1802,18,67
PI,12491,PEDRO LAURENTINO,1463,169,569,2591,2022,26,112
PI,12505,SÃO FRANCISCO DE ASSIS DO PIAUÍ,2491,322,782,4234,3452,52,241
PI,12513,SUSSUAPARA,3359,606,892,5563,4671,109,287
PI,12521,TANQUE DO PIAUÍ,1417,105,474,2397,1923,38,122
PI,12530,TAMBORIL DO PIAUÍ,1208,348,818,2752,1934,19,190
PI,12548,VILA NOVA DO PIAUÍ,1472,151,420,2664,2244,28,121
PI,12556,VERA MENDES,1781,88,745,3154,2409,65,226
PI,12564,WALL FERRAZ,1987,76,745,3696,2951,35,189
PI,12572,CAJUEIRO DA PRAIA,3379,509,644,5429,4785,106,317
PI,12580,CURRALINHOS,2649,211,695,4182,3487,54,198
PI,12599,PORTO ALEGRE DO PIAUÍ,726,98,461,1953,1492,7,85
PI,12602,RIBEIRA DO PIAUÍ,2124,106,926,3552,2626,29,212
PI,12610,SÃO GONÇALO DO GURGUÉIA,901,138,651,2276,1625,24,98
PI,12629,SÃO LUIS DO PIAUÍ,1509,146,491,2430,1939,21,53
PI,12637,FLORESTA DO PIAUÍ,1247,100,717,2601,1884,29,182
PI,12653,SANTO ANTÔNIO DOS MILAGRES,1077,71,318,1773,1455,23,101
PI,12661,SÃO MIGUEL DA BAIXA GRANDE,1241,331,459,2371,1912,28,116
PI,12670,CARAÚBAS DO PIAUÍ,2122,940,1231,4843,3612,43,327
PI,12688,CAXINGÓ,2561,565,912,4714,3802,55,284
PI,12696,COCAL DOS ALVES,2642,286,1388,4996,3608,104,184
PI,12700,SÃO MIGUEL DO FIDALGO,1466,146,656,2541,1885,25,104
PI,12718,PAU D'ARCO DO PIAUÍ,2583,184,728,4113,3385,42,255
PI,12726,NAZÁRIA,5753,674,709,8780,8071,144,417
PI,12734,AROEIRAS DO ITAIM,2157,174,405,3124,2719,50,163
PR,74004,GODOY MOREIRA,1077,776,650,2874,2224,54,99
PR,74012,ABATIÁ,1832,2112,1049,5847,4798,133,198
PR,74020,IBEMA,1542,1951,1011,5010,3999,91,99
PR,74039,ADRIANÓPOLIS,2232,859,1100,5038,3938,72,196
PR,74047,LINDOESTE,2159,1392,997,4986,3989,69,104
PR,74055,AGUDOS DO SUL,2369,2626,966,6823,5857,180,223
PR,74063,OURO VERDE DO OESTE,1541,1869,589,4466,3877,105,142
PR,74071,ALMIRANTE TAMANDARÉ,15493,21433,10674,68269,57595,3526,2964
PR,74080,SANTA TEREZA DO OESTE,2490,3277,1422,8250,6828,201,196
PR,74098,ALTO PARANÁ,3367,3371,1866,10181,8315,241,283
PR,74101,ANAHY,822,982,378,2514,2136,46,67
PR,74110,ALTO PIQUIRI,2940,2067,1355,7207,5852,195,233
PR,74128,ÂNGULO,730,1018,456,2572,2116,49,82
PR,74136,ALVORADA DO SUL,2326,2408,1180,6854,5674,154,157
PR,74144,BOA ESPERANÇA DO IGUAÇU,1395,479,359,2430,2071,41,25
PR,74152,AMAPORÃ,1218,1269,730,3955,3225,98,124
PR,74160,BOM SUCESSO DO SUL,1020,1187,388,2824,2436,54,43
PR,74179,AMPÉRE,6222,3733,2125,13212,11087,241,265
PR,74187,BRASILÂNDIA DO SUL,1223,964,452,2882,2430,40,71
PR,74195,ANDIRÁ,5120,5019,4388,17495,13107,479,828
PR,74209,CAFEZAL DO SUL,1315,1261,580,3616,3036,61,81
PR,74217,ANTONINA,3201,4870,3890,16259,12369,437,463
PR,74225,CANDÓI,4702,3293,2433,11581,9148,239,242
PR,74233,ANTONIO OLINTO,2066,2453,987,6357,5370,210,274
PR,74241,CRUZEIRO DO IGUAÇU,1680,866,605,3544,2939,47,88
PR,74250,APUCARANA,20164,39094,17084,94082,76998,2682,3090
PR,74268,DIAMANTE DO SUL,1246,708,636,2994,2358,34,47
PR,74276,ARAPONGAS,10834,40112,14803,80769,65966,2786,2855
PR,74284,ENTRE RIOS DO OESTE,1131,1561,369,3237,2868,33,44
PR,74292,ARAPOTI,4002,7870,3791,18685,14894,520,478
PR,74306,FAROL,1020,987,472,2833,2361,46,98
PR,74314,ARARUNA,3707,3820,2060,10707,8647,263,290
PR,74322,FAZENDA RIO GRANDE,18026,18463,11918,64856,52938,3049,2368
PR,74330,MARILÂNDIA DO SUL,1676,3117,1309,7163,5854,206,177
PR,74349,FLOR DA SERRA DO SUL,1851,1447,707,4331,3624,44,70
PR,74357,ARAUCÁRIA,24711,30657,15906,96395,80489,4030,4188
PR,74365,HONÓRIO SERPA,1961,1246,1060,4696,3636,66,95
PR,74373,ASSAÍ,2297,6157,2366,13151,10785,337,386
PR,74381,IGUATU,738,740,251,1907,1656,22,37
PR,74390,ASTORGA,4990,8621,3748,20477,16729,624,486
PR,74403,IRACEMA DO OESTE,912,804,411,2387,1976,50,67
PR,74411,ATALAIA,1142,1297,469,3424,2955,36,72
PR,74420,NOVO ITACOLOMI,804,1075,303,2522,2219,71,76
PR,74438,BALSA NOVA,2897,4124,998,9961,8963,389,400
PR,74446,ITAPERUÇU,8049,4127,2520,18208,15688,662,523
PR,74454,BANDEIRANTES,6870,9086,5353,25721,20368,617,844
PR,74462,IVATÉ,2457,1532,895,5576,4681,106,144
PR,74470,BARBOSA FERRAZ,2139,3432,2144,9025,6881,282,374
PR,74489,LIDIANÓPOLIS,1038,1253,859,3620,2761,83,136
PR,74497,BARRACÃO,2665,2476,1294,7271,5977,98,164
PR,74500,MARIPÁ,1221,2647,640,4812,4172,68,99
PR,74519,BARRA DO JACARÉ,1013,624,410,2513,2103,70,94
PR,74527,MATO RICO,1442,793,639,3133,2494,37,79
PR,74535,BELA VISTA DO PARAÍSO,2821,5915,2151,12585,10434,313,399
PR,74543,MAUÁ DA SERRA,1416,2846,1334,6766,5432,152,161
PR,74551,BITURUNA,4952,4013,2596,12639,10043,252,289
PR,74560,MERCEDES,1061,2382,562,4325,3763,69,67
PR,74578,BOA ESPERANÇA,955,1830,638,3851,3213,67,96
PR,74586,NOVA LARANJEIRAS,3122,2236,2022,8087,6065,76,189
PR,74594,BOCAIÚVA DO SUL,2661,2868,1485,8648,7163,310,355
PR,74608,NOVA SANTA BÁRBARA,1120,937,557,3226,2669,73,155
PR,74616,BOM SUCESSO,1573,1751,798,5012,4214,167,165
PR,74624,PATO BRAGADO,1005,2306,521,4144,3623,83,84
PR,74632,BORRAZÓPOLIS,2105,2467,1429,6874,5445,189,209
PR,74640,PINHAL DE SÃO BENTO,1329,399,292,2173,1881,21,38
PR,74659,CAFEARA,1064,437,265,2084,1819,58,83
PR,74667,PITANGUEIRAS,645,1236,270,2490,2220,63,38
PR,74675,CALIFÓRNIA,1415,3088,1178,6721,5543,213,205
PR,74683,QUATRO PONTES,913,1850,477,3412,2935,29,31
PR,74691,CAMBARÁ,4853,6230,3796,18698,14902,744,1139
PR,74705,RAMILÂNDIA,1336,1019,759,3483,2724,54,72
PR,74713,CAMBÉ,15443,29056,12217,74216,61999,2420,2986
PR,74721,RANCHO ALEGRE D'OESTE,711,932,520,2458,1938,59,69
PR,74730,CAMBIRA,1888,2412,1033,6256,5223,185,193
PR,74748,RIO BONITO DO IGUAÇU,5571,2035,2051,10421,8370,127,181
PR,74756,CAMPINA DA LAGOA,3679,4322,2659,12342,9683,336,344
PR,74764,SANTA LÚCIA,1204,1134,573,3234,2661,55,109
PR,74772,CAMPINA GRANDE DO SUL,7903,10043,5637,31224,25587,1160,1098
PR,74780,CAMPO BONITO,1379,1251,848,3911,3063,83,106
PR,74799,CAMPO DO TENENTE,1406,2592,781,5541,4760,146,138
PR,74802,SANTA MARIA DO OESTE,3557,2137,2593,9091,6498,123,222
PR,74810,CAMPO LARGO,19753,32565,6084,77283,71199,3554,3370
PR,74829,SANTA MÔNICA,1312,714,488,2792,2304,32,83
PR,74837,CAMPO MOURÃO,17090,24934,13687,66723,53036,1265,1571
PR,74845,SÃO MANOEL DO PARANÁ,372,923,271,1839,1568,44,40
PR,74853,CÂNDIDO DE ABREU,3846,4101,2979,12280,9301,305,410
PR,74861,SÃO PEDRO DO IGUAÇU,1710,2121,777,5265,4488,117,183
PR,74870,CAPANEMA,7034,4237,2714,14872,12158,231,228
PR,74888,TUNAS DO PARANÁ,1659,1411,958,4815,3857,82,168
PR,74896,CAPITÃO LEÔNIDAS MARQUES,4572,3682,2674,12056,9382,249,314
PR,74900,VENTANIA,2003,2809,1412,7338,5926,161,191
PR,74918,CARLÓPOLIS,2767,4424,2351,11215,8864,313,388
PR,74926,ALTO PARAÍSO,1032,818,654,2784,2130,35,53
PR,74934,CASCAVEL,52234,85729,36977,208713,171736,5086,5613
PR,74942,DOUTOR ULYSSES,2146,1100,827,4697,3870,88,134
PR,74950,CASTRO,10411,23295,9081,51580,42499,1834,1615
PR,74969,VIRMOND,1041,1581,675,3579,2904,64,55
PR,74977,CATANDUVAS,2001,2773,1677,7341,5664,170,228
PR,74985,LARANJAL,2239,992,1493,5074,3581,55,118
PR,74993,CENTENÁRIO DO SUL,3989,2017,1719,8895,7176,221,292
PR,75000,ITAIPULÂNDIA,2910,3053,1478,8263,6785,142,144
PR,75019,CERRO AZUL,5235,3234,2430,13077,10647,419,530
PR,75027,NOVA ESPERANÇA DO SUDOESTE,2319,1127,540,4261,3721,50,52
PR,75035,CHOPINZINHO,5466,5698,3035,16010,12975,339,428
PR,75043,PINHAIS,21253,28777,15799,91978,76179,3392,3346
PR,75051,CIANORTE,9723,23772,10234,53491,43257,1596,1564
PR,75060,SAUDADE DO IGUAÇU,1689,1202,825,4173,3348,86,99
PR,75078,CIDADE GAÚCHA,3395,2828,1838,9210,7372,181,217
PR,75086,ARIRANHA DO IVAÍ,965,639,487,2315,1828,24,75
PR,75094,CLEVELÂNDIA,5056,3913,3314,13598,10284,261,364
PR,75108,ARAPUÃ,1299,1085,494,3170,2676,31,86
PR,75116,MANGUEIRINHA,5504,3520,3068,13803,10735,236,321
PR,75124,BELA VISTA DA CAROBA,1495,927,550,3214,2664,32,38
PR,75132,COLOMBO,34136,46253,24924,148074,123150,7185,6257
PR,75140,BOA VENTURA DE SÃO ROQUE,2294,1147,897,4917,4020,66,143
PR,75159,COLORADO,6003,5551,3696,18690,14994,630,771
PR,75167,BOM JESUS DO SUL,1625,1004,649,3520,2871,24,50
PR,75175,CONGONHINHAS,2776,1550,1579,6713,5134,104,214
PR,75183,CAMPINA DO SIMÃO,1532,963,707,3401,2694,37,49
PR,75191,CONSELHEIRO MAIRINCK,929,900,538,3028,2490,67,108
PR,75205,CAMPO MAGRO,4470,6579,2542,18165,15623,805,754
PR,75213,CONTENDA,3199,4601,1587,11326,9739,477,357
PR,75221,CARAMBEÍ,2621,6959,2163,14557,12394,440,413
PR,75230,CORBÉLIA,3340,6900,1955,13451,11496,263,257
PR,75248,CORONEL DOMINGOS SOARES,2083,1456,1377,5244,3867,53,82
PR,75256,CORNÉLIO PROCÓPIO,7683,14199,7996,37862,29866,957,1428
PR,75264,CRUZMALTINA,792,1093,678,2910,2232,56,86
PR,75272,CORONEL VIVIDA,6198,6335,2459,16793,14334,373,342
PR,75280,CORUMBATAÍ DO SUL,1167,1003,787,3477,2690,70,116
PR,75299,CRUZEIRO DO OESTE,5080,4514,2928,15750,12822,509,506
PR,75302,ESPERANÇA NOVA,650,719,328,1872,1544,33,48
PR,75310,CRUZEIRO DO SUL,1910,1068,575,4017,3442,70,99
PR,75329,ESPIGÃO ALTO DO IGUAÇU,1474,1470,979,4315,3336,61,126
PR,75337,CRUZ MACHADO,4183,6430,2509,14066,11557,265,202
PR,75345,FERNANDES PINHEIRO,1858,2032,1008,5564,4556,115,137
PR,75353,CURITIBA,187408,544960,154981,1243703,1088722,38409,51667
PR,75361,FOZ DO JORDÃO,1879,751,1041,4166,3125,67,97
PR,75370,CURIÚVA,2908,3777,2983,11353,8370,390,328
PR,75388,GOIOXIM,2552,1338,1274,5501,4227,53,92
PR,75396,DIAMANTE DO NORTE,1354,1454,1162,4703,3541,99,128
PR,75400,DIAMANTE D'OESTE,1548,1091,711,3781,3070,56,119
PR,75418,DOIS VIZINHOS,12111,8882,4703,28649,23946,626,583
PR,75426,GUAMIRANGA,1974,2757,1009,6465,5456,190,172
PR,75434,DOUTOR CAMARGO,1403,2077,614,4788,4174,136,168
PR,75442,IMBAÚ,2500,2381,1712,8101,6389,228,291
PR,75450,ENÉAS MARQUES,2454,1689,609,5125,4516,79,91
PR,75469,MANFRINÓPOLIS,1500,660,485,2883,2398,46,55
PR,75477,ENGENHEIRO BELTRÃO,3270,4163,2123,11045,8922,279,248
PR,75485,MARQUINHO,1518,1268,1004,4093,3089,48,89
PR,75493,FAXINAL,2661,4774,2357,12058,9701,287,334
PR,75507,PEROBAL,1683,1813,839,5186,4347,122,172
PR,75515,FÊNIX,1302,1474,807,4035,3228,86,130
PR,75523,PONTAL DO PARANÁ,3819,5652,4334,17396,13062,439,514
PR,75531,FLORAÍ,1564,1829,501,4420,3919,103,104
PR,75540,PORTO BARREIRO,1270,1062,528,3049,2521,37,52
PR,75558,FLORESTA,1317,2314,460,4904,4444,88,119
PR,75566,PRADO FERREIRA,1348,857,437,3117,2680,68,95
PR,75574,FLORESTÓPOLIS,3853,2513,1908,9747,7839,170,187
PR,75582,QUARTO CENTENÁRIO,1606,1226,755,3937,3182,62,85
PR,75590,FLÓRIDA,950,650,360,2267,1907,48,64
PR,75604,RESERVA DO IGUAÇU,2366,1297,1388,5659,4271,67,127
PR,75612,FORMOSA DO OESTE,1981,2559,1115,6254,5139,161,163
PR,75620,RIO BRANCO DO IVAÍ,1099,971,936,3508,2572,51,113
PR,75639,FOZ DO IGUAÇU,48979,67741,39874,189990,150116,3660,4089
PR,75647,SERRANÓPOLIS DO IGUAÇU,1390,1983,499,4158,3659,54,69
PR,75655,FRANCISCO BELTRÃO,23297,19628,10078,60033,49955,1237,1285
PR,75663,TAMARANA,2110,3227,931,7435,6504,188,201
PR,75671,GENERAL CARNEIRO,4298,2503,2416,10068,7652,200,202
PR,75698,GOIOERÊ,6647,7857,4706,22194,17488,470,496
PR,75710,GUAÍRA,6443,8836,4785,22667,17882,521,459
PR,75736,GUAIRAÇÁ,1042,2080,849,5012,4163,113,176
PR,75744,ROSÁRIO DO IVAÍ,1462,1636,1331,5020,3689,80,186
PR,75752,GUAPIRAMA,983,1183,747,3629,2882,90,193
PR,75760,NOVA TEBAS,2240,1363,1390,5722,4332,77,172
PR,75779,GUAPOREMA,747,713,316,1924,1608,28,29
PR,75787,SULINA,1265,898,481,2882,2401,39,73
PR,75795,GUARACI,1213,1774,557,4140,3583,86,74
PR,75809,LUIZIANA,2001,1880,1158,6036,4878,131,210
PR,75817,GUARANIAÇU,2975,5108,2347,11638,9291,158,268
PR,75833,GUARAPUAVA,37496,42556,22927,122335,99408,3513,3187
PR,75850,GUARAQUEÇABA,2435,1753,1863,7026,5163,148,111
PR,75876,GUARATUBA,5707,9192,6464,25979,19515,593,690
PR,75892,IBAITI,5113,7996,5386,22644,17258,613,689
PR,75914,IBIPORÃ,6864,16958,6909,38458,31549,1353,1456
PR,75930,ICARAÍMA,2230,2601,1525,7114,5589,147,158
PR,75957,IGUARAÇU,1046,1342,488,3434,2946,79,82
PR,75973,IMBITUVA,3992,11536,3007,21366,18359,582,466
PR,75990,INÁCIO MARTINS,3656,2290,1409,8248,6839,178,244
PR,76015,INAJÁ,1024,663,473,2593,2120,41,100
PR,76031,IPIRANGA,2766,4987,1762,10774,9012,297,297
PR,76058,IPORÃ,3248,4650,2139,11621,9482,251,317
PR,76074,IRATI,10515,20052,7362,44014,36652,1218,1238
PR,76090,IRETAMA,2902,2468,1690,8123,6433,188,277
PR,76112,ITAGUAJÉ,1280,935,720,3647,2927,71,101
PR,76139,ITAMBARACÁ,1489,1956,1041,5165,4124,97,159
PR,76155,ITAMBÉ,1536,2020,693,4821,4128,92,118
PR,76171,ITAPEJARA D'OESTE,3778,2756,1196,8517,7321,216,178
PR,76198,ITAÚNA DO SUL,1128,746,854,3192,2338,73,108
PR,76210,IVAÍ,2699,4982,1157,9691,8534,198,190
PR,76236,IVAIPORÃ,6931,8961,4783,24079,19296,413,621
PR,76252,IVATUBA,763,726,340,2151,1811,35,49
PR,76279,JABOTI,992,1529,658,3850,3192,90,139
PR,76295,JACAREZINHO,9871,8134,6991,31514,24523,871,914
PR,76317,JAGUAPITÃ,2048,4183,1915,9846,7931,290,272
PR,76333,JAGUARIAÍVA,6453,9264,5094,25528,20434,487,629
PR,76350,JANDAIA DO SUL,3540,7525,2806,16469,13663,484,555
PR,76376,JANIÓPOLIS,2260,1535,1382,5804,4422,110,202
PR,76392,JAPIRA,1379,1159,872,4186,3314,88,142
PR,76414,JAPURÁ,1766,3232,971,6925,5954,196,247
PR,76430,JARDIM ALEGRE,2821,3232,2172,9512,7340,204,305
PR,76457,JARDIM OLINDA,645,255,278,1382,1104,21,26
PR,76473,JATAIZINHO,2011,4090,1721,9530,7809,232,281
PR,76490,JOAQUIM TÁVORA,2418,3142,1552,8397,6845,204,295
PR,76511,JUNDIAÍ DO SUL,1067,629,557,2616,2059,50,88
PR,76538,JUSSARA,1660,1989,1001,5588,4587,158,176
PR,76554,KALORÉ,999,1644,633,3775,3142,92,153
PR,76570,LAPA,8791,15825,5710,35986,30276,1460,1300
PR,76597,LARANJEIRAS DO SUL,7364,8744,5303,24042,18739,422,579
PR,76619,LEÓPOLIS,1296,1089,673,3509,2836,46,118
PR,76635,LOANDA,4122,5642,3408,15921,12513,427,435
PR,76651,LOBATO,1455,1104,596,3709,3113,73,119
PR,76678,LONDRINA,43739,169578,31686,331354,299668,10013,14040
PR,76694,LUPIONÓPOLIS,1448,1178,731,3981,3250,89,125
PR,76716,MALLET,3782,3841,1860,10454,8594,266,303
PR,76732,MAMBORÊ,2904,4791,2268,11243,8975,240,281
PR,76759,MANDAGUAÇU,5285,5418,2656,16016,13360,509,442
PR,76775,MANDAGUARI,6747,10118,4884,26601,21717,827,975
PR,76791,MANDIRITUBA,5802,5758,3017,17632,14615,737,555
PR,76813,MANOEL RIBAS,2594,4578,2233,10473,8240,182,257
PR,76830,MARECHAL CÂNDIDO RONDON,9579,17201,5966,36801,30835,746,892
PR,76856,MARIA HELENA,1841,1385,636,4500,3864,51,117
PR,76872,MARIALVA,6674,10709,4728,26878,22150,876,712
PR,76899,MARILUZ,2969,2544,1634,8198,6564,191,204
PR,76910,MARINGÁ,53923,105658,32823,249146,216323,5998,7414
PR,76937,MARIÓPOLIS,2004,1921,704,5095,4391,105,100
PR,76953,MARMELEIRO,4828,3174,2011,10988,8977,223,177
PR,76970,MARUMBI,1190,1565,446,3730,3284,77,140
PR,76996,MATELÂNDIA,2094,6799,2587,12781,10194,234,248
PR,77011,MEDIANEIRA,9634,13469,6289,33154,26865,716,814
PR,77038,MIRADOR,880,512,449,2112,1663,41,33
PR,77054,MIRASELVA,630,741,280,1870,1590,35,43
PR,77070,MOREIRA SALES,2834,3790,1660,9528,7868,256,346
PR,77097,MORRETES,3299,4009,3284,14785,11501,347,407
PR,77119,MUNHOZ DE MELO,1061,1163,488,3236,2748,89,101
PR,77135,NOSSA SENHORA DAS GRAÇAS,1235,847,627,3279,2652,85,129
PR,77151,NOVA ALIANÇA DO IVAÍ,461,489,265,1517,1252,36,59
PR,77178,NOVA AMÉRICA DA COLINA,1052,1056,433,2950,2517,42,77
PR,77194,NOVA CANTU,2378,1721,1871,6611,4740,69,176
PR,77216,NOVA ESPERANÇA,5509,7623,4420,21205,16785,626,579
PR,77232,NOVA FÁTIMA,1765,2047,1556,6395,4839,165,210
PR,77259,NOVA LONDRINA,3106,2696,2795,10359,7564,239,293
PR,77275,ORTIGUEIRA,6640,4313,3909,16859,12950,361,621
PR,77291,OURIZONA,1355,800,407,2944,2537,50,86
PR,77313,PAIÇANDU,9786,7437,3442,25596,22154,948,806
PR,77330,PALMAS,9272,9643,6710,28735,22025,683,615
PR,77356,PALMEIRA,5758,11738,4305,25949,21644,819,586
PR,77372,PALMITAL,4867,2785,3499,12152,8653,171,352
PR,77399,PALOTINA,5716,10465,3991,22212,18221,361,428
PR,77410,PARAÍSO DO NORTE,3594,2810,1312,8927,7615,203,251
PR,77437,PARANACITY,2492,2232,1704,7822,6118,243,329
PR,77453,PARANAGUÁ,16909,29321,17359,103220,85861,3098,3060
PR,77470,PARANAPOEMA,883,453,330,2063,1733,34,69
PR,77496,PARANAVAÍ,14322,23641,12335,62050,49715,1331,1600
PR,77518,PATO BRANCO,16304,21583,9826,55330,45504,1159,1268
PR,77534,PAULA FREITAS,1372,1868,720,4383,3663,118,89
PR,77550,PAULO FRONTIN,1869,2395,840,5531,4691,110,108
PR,77577,PEABIRU,3016,3825,2359,10618,8259,262,294
PR,77593,PÉROLA D'OESTE,2132,1905,789,5314,4525,86,115
PR,77615,PIÊN,2526,4177,935,8790,7855,258,211
PR,77631,PINHALÃO,1485,2006,1239,5686,4447,102,182
PR,77658,PINHÃO,9622,5804,5618,23618,18000,490,644
PR,77674,PIRAÍ DO SUL,4272,8222,3604,19031,15427,725,543
PR,77690,PIRAQUARA,16655,16451,10861,60697,49836,2594,2265
PR,77712,PITANGA,9437,8063,6441,26591,20150,452,691
PR,77739,PLANALTINA DO PARANÁ,1303,935,643,3357,2714,82,116
PR,77755,PLANALTO,4977,3014,2022,10816,8794,216,189
PR,77771,PONTA GROSSA,51496,95527,37602,233254,195652,7445,7398
PR,77798,PORECATU,3634,3141,2260,10921,8661,278,269
PR,77810,PORTO AMAZONAS,635,1361,615,3644,3029,150,127
PR,77836,PORTO RICO,1077,583,403,2379,1976,30,53
PR,77852,PORTO VITÓRIA,1037,1351,592,3237,2645,67,44
PR,77879,PRESIDENTE CASTELO BRANCO,1582,1071,699,3980,3281,110,140
PR,77895,PRIMEIRO DE MAIO,2430,3511,1195,8303,7108,210,267
PR,77917,PRUDENTÓPOLIS,8852,17800,6093,37204,31111,1000,1031
PR,77933,QUATIGUÁ,1554,2864,993,6260,5267,165,156
PR,77950,QUATRO BARRAS,2369,5770,2060,14380,12320,506,553
PR,77976,QUERÊNCIA DO NORTE,3412,2088,1949,8566,6617,176,279
PR,77992,QUINTA DO SOL,1507,1326,847,4451,3604,80,148
PR,78018,QUITANDINHA,3171,6034,1573,12674,11101,394,389
PR,78034,RANCHO ALEGRE,948,1216,485,3151,2666,85,132
PR,78050,REALEZA,5057,4666,2341,13282,10941,310,348
PR,78077,REBOUÇAS,4155,4420,2219,12269,10050,317,263
PR,78093,RENASCENÇA,2283,1567,763,5123,4360,121,112
PR,78115,RESERVA,5750,7049,3895,19659,15764,490,676
PR,78131,RIBEIRÃO CLARO,2693,3462,1542,8979,7437,290,298
PR,78158,RIBEIRÃO DO PINHAL,4282,2574,3139,11439,8300,214,384
PR,78174,RIO AZUL,3094,4881,1656,10845,9189,286,337
PR,78190,RIO BOM,694,1201,459,2834,2375,61,83
PR,78212,RIO BRANCO DO SUL,8929,6390,3652,24415,20763,821,852
PR,78239,RIO NEGRO,3973,11640,4122,23464,19342,774,591
PR,78255,ROLÂNDIA,7666,20466,7817,45927,38110,1676,1398
PR,78271,RONCADOR,2973,2816,1808,8552,6744,183,244
PR,78298,RONDON,1786,3443,1158,7279,6121,129,165
PR,78310,SABÁUDIA,980,2647,682,5203,4521,151,166
PR,78336,SALGADO FILHO,1406,1287,691,3749,3058,66,95
PR,78352,SALTO DO ITARARÉ,1423,1405,834,4296,3462,90,176
PR,78379,SALTO DO LONTRA,5500,2438,1833,10517,8684,204,181
PR,78395,SANTA AMÉLIA,1027,1048,559,3080,2521,81,113
PR,78417,SANTA CECÍLIA DO PAVÃO,714,1306,492,3079,2587,67,156
PR,78433,SANTA CRUZ DE MONTE CASTELO,2750,2100,1214,6700,5486,113,148
PR,78450,SANTA FÉ,2515,3186,1167,7987,6820,140,273
PR,78476,SANTA INÊS,642,526,340,1754,1414,23,47
PR,78492,SANTA ISABEL DO IVAÍ,2283,2431,1482,7102,5620,132,198
PR,78514,SANTA IZABEL DO OESTE,3572,3014,1368,8598,7230,156,174
PR,78530,SANTA MARIANA,3611,2897,2300,10244,7944,238,479
PR,78557,SANTANA DO ITARARÉ,1460,1437,951,4460,3509,114,142
PR,78573,SANTO ANTÔNIO DO SUDOESTE,6071,4259,2422,14256,11834,241,338
PR,78590,SANTO ANTÔNIO DA PLATINA,8696,10670,6026,31866,25840,1319,967
PR,78611,SANTO ANTONIO DO CAIUÁ,861,802,461,2456,1995,44,74
PR,78638,SANTO ANTÔNIO DO PARAÍSO,531,828,471,2263,1792,39,52
PR,78654,SANTO INÁCIO,1601,1403,743,4434,3691,82,184
PR,78670,SÃO CARLOS DO IVAÍ,1269,1788,880,4988,4108,166,134
PR,78697,SÃO JERÔNIMO DA SERRA,2985,2307,2326,9077,6751,188,404
PR,78719,SÃO JOÃO,3293,2910,1196,8273,7077,174,247
PR,78735,SÃO JOÃO DO CAIUÁ,1756,1289,1134,4914,3780,95,153
PR,78751,SÃO JOÃO DO IVAÍ,3238,3070,1805,9372,7567,185,297
PR,78778,SÃO JOÃO DO TRIUNFO,4847,3157,1716,10904,9188,393,215
PR,78794,SÃO JORGE DO IVAÍ,1309,1956,651,4490,3839,106,113
PR,78816,SÃO JORGE D'OESTE,2991,2912,910,7514,6604,164,140
PR,78832,SÃO JOSÉ DA BOA VISTA,929,2139,1009,4750,3741,63,136
PR,78859,SÃO JOSÉ DOS PINHAIS,39957,66120,30501,188930,158429,8024,7638
PR,78875,SÃO MATEUS DO SUL,10211,12541,5085,32023,26938,964,809
PR,78891,SÃO MIGUEL DO IGUAÇU,7821,7591,4238,21497,17259,321,516
PR,78913,SÃO PEDRO DO IVAÍ,2577,2524,1340,7314,5974,134,223
PR,78930,SÃO PEDRO DO PARANÁ,657,1023,358,2323,1965,38,56
PR,78956,SÃO SEBASTIÃO DA AMOREIRA,2343,2280,1277,6955,5678,140,237
PR,78972,SÃO TOMÉ,1133,2052,616,4534,3918,121,133
PR,78999,SAPOPEMA,1969,1548,1124,5329,4205,115,184
PR,79014,SENGÉS,3079,4974,3240,14185,10945,294,415
PR,79030,SERTANEJA,1279,2013,918,4969,4051,104,119
PR,79057,SERTANÓPOLIS,2643,5705,2736,13211,10475,465,475
PR,79073,SIQUEIRA CAMPOS,4499,5391,3122,15560,12438,415,516
PR,79090,TAMBOARA,1153,1544,566,3989,3423,110,163
PR,79111,TAPEJARA,4377,3366,2106,11578,9472,322,315
PR,79138,TEIXEIRA SOARES,2684,2821,1411,7739,6328,162,191
PR,79154,TELÊMACO BORBA,11868,14553,10134,50404,40270,1435,1463
PR,79170,TERRA BOA,2573,5846,2253,12519,10266,327,294
PR,79197,TERRA RICA,3183,4299,2409,12086,9677,324,357
PR,79219,TERRA ROXA,3627,5593,2323,12768,10445,275,306
PR,79235,TIBAGI,4711,4728,3285,14831,11546,321,372
PR,79251,TIJUCAS DO SUL,4050,3761,1933,11337,9404,406,272
PR,79278,TOLEDO,23928,40582,15177,93043,77866,2098,2362
PR,79294,TOMAZINA,1872,2598,1376,6700,5324,133,214
PR,79316,TUNEIRAS DO OESTE,2551,2075,1085,6710,5625,135,198
PR,79332,UBIRATÃ,4849,7401,2756,16763,14007,332,437
PR,79359,UMUARAMA,17295,29528,16435,77033,60598,1820,1868
PR,79375,UNIÃO DA VITÓRIA,9799,17834,8848,41823,32975,1096,1005
PR,79391,UNIFLOR,934,613,223,2053,1830,43,30
PR,79413,URAÍ,2601,3091,1365,8431,7066,192,382
PR,79430,WENCESLAU BRAZ,2754,6537,3195,14876,11681,365,482
PR,79456,VERÊ,3193,2130,804,6706,5902,112,132
PR,79472,VITORINO,1478,2055,1036,5084,4048,96,130
PR,79499,XAMBRÊ,2079,1585,876,5088,4212,75,96
PR,79510,ALTÔNIA,4434,6072,2414,14807,12393,377,357
PR,79537,ASSIS CHATEAUBRIAND,7243,10835,4482,25300,20818,621,650
PR,79553,QUEDAS DO IGUAÇU,6360,9550,5909,24059,18150,368,543
PR,79570,CÉU AZUL,1913,4144,1624,8770,7146,143,207
PR,79596,GRANDES RIOS,1480,1886,1309,5416,4107,99,201
PR,79618,INDIANÓPOLIS,833,1603,577,3519,2942,85,129
PR,79634,MATINHOS,5835,8242,7556,27886,20330,702,850
PR,79650,NOVA AURORA,2772,4090,1748,9818,8070,265,297
PR,79677,NOVA OLÍMPIA,1676,1628,743,4606,3863,104,157
PR,79693,PÉROLA,3048,2944,1246,8167,6921,222,186
PR,79715,SANTA HELENA,8047,6804,3678,20262,16584,350,465
PR,79731,TAPIRA,1874,1437,704,4611,3907,85,148
PR,79758,MARILENA,2524,1504,1303,6021,4718,120,163
PR,79774,FRANCISCO ALVES,1876,1785,852,5070,4218,132,140
PR,79790,NOVA SANTA ROSA,1433,3618,869,6436,5567,86,103
PR,79812,BOA VISTA DA APARECIDA,2522,2036,1485,6674,5189,138,193
PR,79839,BRAGANEY,1591,1678,759,4594,3835,120,123
PR,79855,CAFELÂNDIA,3178,4938,1752,11023,9271,253,285
PR,79871,TRÊS BARRAS DO PARANÁ,3043,3499,1429,8840,7411,197,260
PR,79898,VERA CRUZ DO OESTE,1985,2856,1382,7040,5658,111,169
PR,79910,PRANCHITA,1545,1962,710,4627,3917,95,77
PR,79936,TUPÃSSI,1758,3158,899,6366,5467,135,132
PR,79952,NOVA PRATA DO IGUAÇU,4092,2147,1234,8076,6842,111,139
PR,79979,JESUÍTAS,2141,3005,962,7036,6074,193,270
PR,79995,SÃO JORGE DO PATROCÍNIO,1906,1912,611,4858,4247,82,99
PR,84514,CANTAGALO,3447,2958,2522,9706,7184,151,186
PR,84530,TURVO,4978,3126,2181,11331,9150,204,335
PR,84557,ALTAMIRA DO PARANÁ,1349,1114,1324,4109,2785,18,95
PR,84573,FIGUEIRA,2131,2269,1668,6843,5175,95,139
PR,84590,LUNARDELLI,1263,1599,734,4163,3429,103,176
PR,84611,SARANDI,22353,15651,11614,62036,50422,2192,1714
PR,84638,JURANDA,1481,2871,967,6029,5062,101,153
PR,84654,DOURADINA,2256,2037,888,5888,5000,128,143
PR,84670,SANTA TEREZINHA DE ITAIPU,4003,7970,2974,16954,13980,297,305
PR,84697,MISSAL,3383,3293,1160,8529,7369,134,195
PR,84719,SÃO JOSÉ DAS PALMEIRAS,1290,1193,457,3289,2832,60,95
RJ,58009,QUISSAMÃ,5689,3139,3400,17083,13683,621,967
RJ,58017,ANGRA DOS REIS,32103,26982,26301,121904,95603,4766,6860
RJ,58025,QUATIS,2543,2823,1699,9853,8154,241,471
RJ,58033,ARARUAMA,19372,17126,20409,90831,70422,3255,5945
RJ,58041,BELFORD ROXO,120309,28566,59533,319958,260425,14183,23796
RJ,58050,BARRA DO PIRAÍ,18419,15934,13964,71384,57420,2308,3676
RJ,58068,CARDOSO MOREIRA,3294,2365,2301,10910,8609,285,617
RJ,58076,BARRA MANSA,37593,27029,22570,132288,109718,4110,7221
RJ,58084,VARRE-SAI,1867,2789,1457,7669,6212,230,515
RJ,58092,BOM JARDIM,3964,6087,4474,21214,16740,726,1996
RJ,58106,GUAPIMIRIM,10225,6409,8008,37840,29832,1201,2208
RJ,58114,BOM JESUS DO ITABAPOANA,7750,7532,6107,28517,22410,595,1472
RJ,58122,QUEIMADOS,37644,13784,18998,104941,85943,3821,5977
RJ,58130,CABO FRIO,25124,23624,30976,139911,108935,4450,7428
RJ,58149,JAPERI,26145,7197,14013,69766,55753,2480,4076
RJ,58157,CACHOEIRAS DE MACACU,12514,7088,8895,44101,35206,1643,2567
RJ,58165,COMENDADOR LEVY GASPARIAN,2828,1272,945,7138,6193,156,379
RJ,58173,CAMBUCI,3996,2388,2064,11251,9187,228,596
RJ,58181,APERIBÉ,2370,2384,1484,8701,7217,239,535
RJ,58190,CAMPOS DOS GOYTACAZES,87767,66909,68645,355029,286384,17067,25171
RJ,58203,RIO DAS OSTRAS,14653,12961,19221,80004,60783,2789,4614
RJ,58211,CANTAGALO,3554,4842,3160,16338,13178,475,1094
RJ,58220,AREAL,2407,2934,1419,9154,7735,267,488
RJ,58238,CARMO,4826,2858,2523,13863,11340,292,975
RJ,58246,PINHEIRAL,5895,2842,2609,16320,13711,318,721
RJ,58254,CASIMIRO DE ABREU,5441,5627,6228,28527,22299,832,1622
RJ,58262,IGUABA GRANDE,4544,4220,4910,21014,16104,570,1128
RJ,58270,CONCEIÇÃO DE MACABU,4355,3302,3861,16870,13009,707,1053
RJ,58289,SÃO FRANCISCO DE ITABAPOANA,7466,6722,9666,35831,26165,1485,1636
RJ,58297,CORDEIRO,3482,3931,3241,16291,13050,517,1148
RJ,58300,CARAPEBUS,2816,2025,2158,11236,9078,430,675
RJ,58319,DUAS BARRAS,2036,2788,1630,9078,7448,245,701
RJ,58327,PORTO REAL,3409,3314,2277,14989,12712,401,669
RJ,58335,DUQUE DE CAXIAS,205394,68099,111933,620663,508730,27601,50037
RJ,58343,SÃO JOSÉ DE UBÁ,2314,1530,1108,6945,5837,103,395
RJ,58351,ENGENHEIRO PAULO DE FRONTIN,2395,2426,1321,9689,8368,267,630
RJ,58360,TANGUÁ,9429,2378,4066,23074,19008,662,1131
RJ,58378,ITABORAÍ,63082,17832,30028,164990,134962,6530,9710
RJ,58386,MACUCO,2051,1400,1021,6558,5537,128,405
RJ,58394,ITAGUAÍ,25571,14055,16150,86780,70630,3379,4485
RJ,58408,ARMAÇÃO DOS BÚZIOS,4547,4493,4762,23163,18401,596,1042
RJ,58416,ITAOCARA,5003,5846,3561,18800,15239,624,1038
RJ,58424,SEROPÉDICA,14971,7095,9876,53779,43903,1901,3139
RJ,58432,ITAPERUNA,17527,16634,16538,74179,57641,2082,3469
RJ,58440,ITATIAIA,5955,5967,4375,23012,18637,656,1035
RJ,58459,LAJE DO MURIAÉ,2543,1172,1621,7043,5422,199,409
RJ,58467,MESQUITA,37891,16645,24534,133069,108535,5112,9834
RJ,58475,MACAÉ,34851,22847,34988,150794,115806,5974,8598
RJ,58491,MAGÉ,57032,21157,33020,172917,139897,7482,11605
RJ,58513,MANGARATIBA,6524,5955,6364,31171,24807,913,1652
RJ,58530,MARICÁ,30431,14784,18153,92344,74191,2372,4738
RJ,58556,MENDES,3604,3311,2800,14931,12131,390,844
RJ,58572,MIGUEL PEREIRA,4969,5939,4440,22122,17682,571,1291
RJ,58599,MIRACEMA,7303,3958,5416,22142,16726,648,1310
RJ,58610,NATIVIDADE,3169,2646,2320,12017,9697,251,897
RJ,58637,NILÓPOLIS,35406,19306,20612,129560,108948,5036,9128
RJ,58653,NITERÓI,78188,94262,44585,353045,308460,10767,23549
RJ,58670,NOVA FRIBURGO,26032,36708,32187,149021,116834,6351,13010
RJ,58696,NOVA IGUAÇU,167037,77324,108527,573905,465378,25496,43848
RJ,58718,PARACAMBI,9089,5776,5293,32950,27657,1021,1899
RJ,58734,PARAÍBA DO SUL,7100,7784,6916,33389,26473,1201,2124
RJ,58750,PARATY,5224,7235,6068,26604,20536,1016,1450
RJ,58777,PETRÓPOLIS,40122,69749,50636,244371,193735,8853,15532
RJ,58793,PIRAÍ,6142,4272,3272,20835,17563,518,1076
RJ,58815,PORCIÚNCULA,4433,2794,3674,13984,10310,329,843
RJ,58831,RESENDE,17683,27013,17769,89719,71950,2887,4172
RJ,58858,RIO BONITO,11079,9108,7986,44308,36322,1432,2654
RJ,58874,RIO CLARO,4952,3328,3187,14869,11682,410,825
RJ,58890,RIO DAS FLORES,2352,2106,1301,7650,6349,161,420
RJ,58912,SANTA MARIA MADALENA,1688,2218,1761,8343,6582,256,631
RJ,58939,SANTO ANTÔNIO DE PÁDUA,8043,7434,6928,32607,25679,794,1867
RJ,58955,SÃO FIDÉLIS,5924,7229,7655,30180,22525,683,1554
RJ,58971,SÃO GONÇALO,218448,79543,129321,678436,549115,29032,57327
RJ,58998,SÃO JOÃO DA BARRA,8496,8314,5914,34506,28592,1538,2063
RJ,59013,SÃO JOÃO DE MERITI,104001,41442,70152,364169,294017,16136,30770
RJ,59030,SÃO PEDRO DA ALDEIA,11438,9112,13151,59403,46252,1725,2965
RJ,59056,SÃO SEBASTIÃO DO ALTO,2487,1748,1824,7525,5701,179,464
RJ,59072,SAPUCAIA,4623,3852,3374,16418,13044,450,994
RJ,59099,SAQUAREMA,13310,12882,14486,61320,46834,1763,3829
RJ,59110,SILVA JARDIM,4881,3159,3799,17056,13257,427,970
RJ,59137,SUMIDOURO,3833,3963,2572,13241,10669,384,661
RJ,59153,TERESÓPOLIS,18325,39475,27309,124461,97152,4482,7442
RJ,59170,TRAJANO DE MORAIS,2781,1981,1801,8816,7015,226,633
RJ,59196,TRÊS RIOS,20042,11022,10940,60512,49572,2357,3310
RJ,59218,VALENÇA,16391,14217,12574,57862,45288,1680,3345
RJ,59234,VASSOURAS,6552,7758,6240,29077,22837,783,1586
RJ,59250,VOLTA REDONDA,56755,40039,37514,221199,183685,6174,11190
RJ,59277,ARRAIAL DO CABO,5282,4438,6444,26917,20473,752,1305
RJ,59293,ITALVA,2916,2633,2188,10900,8712,247,609
RJ,59315,PATY DO ALFERES,6872,4242,4627,21956,17329,476,968
RJ,59331,SÃO JOSÉ DO VALE DO RIO PRETO,2422,5522,3283,15510,12227,417,866
RJ,60011,RIO DE JANEIRO,958431,994712,1038141,4837323,3799182,190088,394396
RN,16004,TENENTE LAURENTINO CRUZ,2560,543,885,4757,3872,112,311
RN,16012,ACARI,4019,1975,2042,9733,7691,206,640
RN,16020,SERRA DO MEL,4592,1106,909,8366,7457,252,458
RN,16039,ASSÚ,21601,4022,3957,38847,34890,1591,2683
RN,16047,CAIÇARA DO NORTE,2453,697,1025,5232,4207,167,301
RN,16055,AFONSO BEZERRA,4420,1233,2050,9372,7322,254,611
RN,16063,SÃO MIGUEL DO GOSTOSO,3748,807,1443,7510,6067,183,493
RN,16071,ÁGUA NOVA,1556,101,277,2283,2006,61,170
RN,16080,ITAJÁ,3705,493,565,5794,5229,192,394
RN,16098,ALEXANDRIA,6306,555,1738,10113,8375,152,683
RN,16101,BODÓ,1510,347,632,2903,2271,57,197
RN,16110,ALMINO AFONSO,2753,527,516,4583,4067,141,273
RN,16128,TRIUNFO POTIGUAR,1870,536,679,3846,3167,99,241
RN,16136,ALTO DO RODRIGUES,5754,1106,1677,10815,9138,343,675
RN,16144,FERNANDO PEDROZA,1679,335,514,3098,2584,89,209
RN,16152,ANGICOS,4941,1232,1597,9505,7908,212,607
RN,16160,MAJOR SALES,1663,128,574,2846,2272,45,239
RN,16179,ANTÔNIO MARTINS,3710,290,1040,5945,4905,144,356
RN,16187,VENHA-VER,1840,210,1101,3775,2674,76,363
RN,16195,APODI,17010,2233,4993,28251,23258,742,1436
RN,16209,SERRINHA DOS PINTOS,2142,249,882,4078,3196,94,253
RN,16217,AREIA BRANCA,7567,2501,2381,18927,16546,896,1963
RN,16225,TIBAU,1908,408,310,3543,3233,138,275
RN,16233,ARÊS,4795,1426,1521,10343,8822,389,814
RN,16241,SANTA MARIA,2190,556,892,4556,3664,115,296
RN,16250,CAMPO GRANDE,4595,687,1730,8236,6506,213,443
RN,16268,RIO DO FOGO,4911,1180,2501,10539,8038,326,617
RN,16276,BAÍA FORMOSA,2889,678,1814,7216,5402,196,338
RN,16284,PORTO DO MANGUE,2206,464,348,4087,3739,149,284
RN,16292,BARCELONA,1607,1000,400,3895,3495,119,311
RN,16306,JUNDIÁ,1734,402,524,3523,2999,106,275
RN,16314,BENTO FERNANDES,2658,457,699,4643,3944,121,303
RN,16330,BOM JESUS,3200,1362,1074,7089,6015,196,494
RN,16357,BREJINHO,3435,1611,997,8226,7229,416,745
RN,16373,CAIÇARA DO RIO DO VENTO,1811,489,522,3538,3016,100,256
RN,16390,CAICÓ,19518,7360,7759,44414,36655,1635,3052
RN,16411,CAMPO REDONDO,4688,449,1483,7940,6457,242,617
RN,16438,CANGUARETAMA,11166,1989,5753,23840,18087,837,1422
RN,16454,CARAÚBAS,9648,1563,2826,17175,14349,556,1157
RN,16470,CARNAÚBA DOS DANTAS,1984,1315,939,5917,4978,267,793
RN,16497,CARNAUBAIS,4114,791,693,7571,6878,258,517
RN,16519,CEARÁ-MIRIM,26127,4893,9856,51755,41899,2220,3465
RN,16535,CERRO CORÁ,3608,1526,2051,8553,6502,179,664
RN,16551,CORONEL EZEQUIEL,2677,406,938,4879,3941,105,287
RN,16578,CORONEL JOÃO PESSOA,2022,174,913,3846,2933,104,338
RN,16594,CRUZETA,3472,1070,1306,7103,5797,177,461
RN,16616,CURRAIS NOVOS,11655,5528,8167,33079,24912,1162,3311
RN,16632,DOUTOR SEVERIANO,3050,345,1202,5418,4216,134,365
RN,16659,ENCANTO,2554,231,438,3924,3486,90,297
RN,16675,EQUADOR,2214,569,399,4199,3800,136,357
RN,16691,ESPÍRITO SANTO,3042,1064,1808,7559,5751,228,467
RN,16713,EXTREMOZ,8058,3181,2761,19797,17036,889,1517
RN,16730,FELIPE GUERRA,3974,293,832,6196,5364,181,390
RN,16756,FLORÂNIA,3933,1009,1250,7834,6584,244,552
RN,16772,FRANCISCO DANTAS,1338,256,366,2491,2125,63,220
RN,16799,GALINHOS,871,398,363,2203,1840,47,144
RN,16810,GOIANINHA,6405,2965,2669,18197,15528,1042,1490
RN,16837,GOVERNADOR DIX-SEPT ROSADO,6298,878,1278,10610,9332,468,914
RN,16853,GROSSOS,3488,680,720,7249,6529,570,651
RN,16870,GUAMARÉ,6156,1237,2068,12099,10031,342,715
RN,16896,IELMO MARINHO,5107,1059,1271,9344,8073,270,683
RN,16918,IPANGUAÇU,6618,997,1332,11339,10007,409,780
RN,16934,IPUEIRA,989,266,304,1907,1603,36,98
RN,16950,ITAÚ,2868,347,997,4984,3987,104,298
RN,16977,JAÇANÃ,2199,793,1503,6309,4806,187,437
RN,16993,JANDAÍRA,3054,737,1085,5898,4813,168,384
RN,17019,JANDUÍS,2500,545,827,4546,3719,116,265
RN,17035,BOA SAÚDE,3044,1000,1789,7782,5993,259,615
RN,17051,JAPI,2838,493,1061,5366,4305,106,344
RN,17078,JARDIM DE ANGICOS,1584,234,452,2762,2310,59,154
RN,17094,JARDIM DE PIRANHAS,6474,956,2326,11425,9099,334,621
RN,17116,JARDIM DO SERIDÓ,4787,1900,1720,10503,8783,356,920
RN,17132,JOÃO CÂMARA,12192,3049,5303,25229,19926,822,1486
RN,17159,JOÃO DIAS,1342,133,454,2504,2050,62,265
RN,17175,JOSÉ DA PENHA,3105,180,1034,5193,4159,125,406
RN,17191,JUCURUTU,7072,1968,2908,15202,12294,493,1170
RN,17213,MESSIAS TARGINO,1897,646,617,4108,3491,116,265
RN,17230,LAGOA D'ANTA,2767,442,1143,5271,4128,104,312
RN,17256,LAGOA DE PEDRAS,3586,664,1306,6572,5266,183,415
RN,17272,LAGOA DE VELHOS,1689,422,298,2980,2682,84,193
RN,17299,LAGOA NOVA,5302,1853,2777,11925,9148,402,749
RN,17310,LAGOA SALGADA,4077,896,652,7129,6477,296,675
RN,17337,LAJES,4316,1048,1684,8794,7110,204,621
RN,17353,LAJES PINTADAS,2514,354,912,4885,3973,175,381
RN,17370,LUCRÉCIA,2130,144,331,3076,2745,74,152
RN,17396,LUÍS GOMES,4428,341,2511,8306,5795,94,525
RN,17418,MACAÍBA,21643,5641,6568,46102,39534,2058,3819
RN,17434,MACAU,10159,2491,3445,21303,17858,955,1258
RN,17450,MARCELINO VIEIRA,4018,373,1165,6463,5298,125,411
RN,17477,MARTINS,3205,981,1541,6866,5325,139,468
RN,17493,MAXARANGUAPE,3876,1588,1689,9050,7361,253,600
RN,17515,FRUTUOSO GOMES,2275,241,478,3647,3169,100,192
RN,17531,MONTANHAS,4950,618,2578,9478,6900,148,546
RN,17558,MONTE ALEGRE,7270,1956,1545,13929,12384,437,1093
RN,17574,MONTE DAS GAMELEIRAS,1479,247,662,2815,2153,33,183
RN,17590,MOSSORÓ,62570,22753,17512,160013,142501,8353,19498
RN,17612,NATAL,153663,101948,74955,506699,431744,19908,48226
RN,17639,NÍSIA FLORESTA,7022,2785,2719,17940,15221,993,1398
RN,17655,NOVA CRUZ,11717,3800,8108,28704,20596,858,1572
RN,17671,OLHO D'ÁGUA DO BORGES,2411,362,984,4477,3493,119,250
RN,17698,OURO BRANCO,2193,507,614,4119,3505,97,287
RN,17710,PARANÁ,2117,141,779,3531,2752,46,278
RN,17736,PARAÚ,2154,381,667,4014,3347,137,250
RN,17752,PARAZINHO,2508,619,838,4740,3902,112,318
RN,17779,PARELHAS,6461,3664,1515,15390,13875,663,1319
RN,17795,PARNAMIRIM,31184,20059,20015,115230,95215,4752,8185
RN,17817,PASSA E FICA,3223,1188,2046,8293,6247,227,550
RN,17833,PASSAGEM,1754,633,955,4113,3158,93,275
RN,17850,PATU,4811,875,1705,9008,7303,276,527
RN,17876,PAU DOS FERROS,9986,2389,2250,18107,15857,575,1244
RN,17892,PEDRA GRANDE,1838,586,856,3955,3099,102,257
RN,17914,PEDRA PRETA,1688,328,445,2997,2552,55,212
RN,17930,PEDRO AVELINO,3170,949,1239,6402,5163,144,471
RN,17957,PEDRO VELHO,5729,971,3240,12281,9041,373,796
RN,17973,PENDÊNCIAS,5063,1302,2562,11179,8617,331,712
RN,17990,PILÕES,2085,197,600,3301,2701,54,198
RN,18015,POÇO BRANCO,5438,1151,1775,10434,8659,488,805
RN,18031,PORTALEGRE,2655,1068,1119,6208,5089,172,559
RN,18058,SERRA CAIADA,4393,580,1588,7704,6116,155,499
RN,18074,PUREZA,3643,810,1640,7450,5810,235,431
RN,18090,RAFAEL FERNANDES,2530,272,350,3827,3477,83,279
RN,18112,RIACHO DA CRUZ,1318,514,389,2720,2331,54,225
RN,18139,RIACHO DE SANTANA,2056,142,419,3120,2701,62,236
RN,18155,RIACHUELO,3593,584,886,6079,5193,100,355
RN,18171,RODOLFO FERNANDES,2681,457,749,4550,3801,86,320
RN,18198,RUY BARBOSA,1592,624,328,3390,3062,54,216
RN,18210,SÃO FRANCISCO DO OESTE,1947,335,314,3231,2917,81,234
RN,18236,SANTA CRUZ,11996,2811,5176,26076,20900,956,1725
RN,18252,SANTANA DO SERIDÓ,1206,241,195,2149,1954,52,114
RN,18279,SANTANA DO MATOS,6066,1757,2579,12145,9566,318,770
RN,18295,SANTO ANTÔNIO,9470,1529,4148,18214,14066,465,1211
RN,18317,SÃO BENTO DO NORTE,1684,528,643,3337,2694,76,185
RN,18333,SÃO BENTO DO TRAIRÍ,1942,457,717,3844,3127,101,245
RN,18350,SÃO FERNANDO,1544,631,317,3184,2867,107,283
RN,18376,SÃO GONÇALO DO AMARANTE,26357,8520,11893,65671,53778,2771,5173
RN,18392,SÃO JOÃO DO SABUGI,3239,539,957,5405,4448,86,240
RN,18414,SÃO JOSÉ DE MIPIBU,12071,3632,3852,27568,23716,1311,2654
RN,18430,SÃO JOSÉ DO CAMPESTRE,4943,1039,2451,10574,8123,406,856
RN,18457,SÃO JOSÉ DO SERIDÓ,1837,726,487,3987,3500,185,344
RN,18473,SÃO MIGUEL,8601,1455,5545,18667,13122,554,1561
RN,18490,SÃO PAULO DO POTENGI,5769,2549,2993,13804,10811,449,912
RN,18511,SÃO PEDRO,3110,779,835,5904,5069,182,456
RN,18538,SÃO RAFAEL,3723,806,1414,7373,5959,217,552
RN,18554,SÃO TOMÉ,5137,825,1155,8610,7455,124,581
RN,18570,SÃO VICENTE,2530,687,961,5095,4134,137,447
RN,18597,SENADOR ELÓI DE SOUZA,2604,543,1186,5330,4144,155,379
RN,18619,SENADOR GEORGINO AVELINO,1663,407,635,3655,3020,163,271
RN,18635,SERRA DE SÃO BENTO,2837,476,1272,5463,4191,142,378
RN,18651,SERRA NEGRA DO NORTE,2683,1163,1437,6300,4863,190,330
RN,18678,SERRINHA,3201,758,1227,6663,5436,237,482
RN,18694,SEVERIANO MELO,3895,604,1678,7225,5547,135,418
RN,18716,SÍTIO NOVO,2691,440,918,4920,4002,144,323
RN,18732,TABOLEIRO GRANDE,1323,241,338,2378,2040,35,164
RN,18759,TAIPU,5144,893,1747,10035,8288,391,668
RN,18775,TANGARÁ,4618,1824,2940,12204,9264,484,896
RN,18791,TENENTE ANANIAS,3968,1050,1748,8081,6333,140,555
RN,18813,TIBAU DO SUL,3447,1708,1876,10219,8343,495,740
RN,18830,TIMBAÚBA DOS BATISTAS,1168,385,312,2315,2003,72,134
RN,18856,TOUROS,12186,2006,4440,23402,18962,715,1495
RN,18872,UMARIZAL,4592,770,2111,9115,7004,312,629
RN,18899,UPANEMA,5210,994,1751,10475,8724,348,728
RN,18910,VÁRZEA,2466,554,1069,5091,4022,145,339
RN,18937,RAFAEL GODEIRO,1589,277,379,2951,2572,91,184
RN,18953,VERA CRUZ,3130,2060,961,8456,7495,466,707
RN,18970,VIÇOSA,808,159,353,1685,1332,55,174
RN,18996,VILA FLOR,1367,242,440,2541,2101,70,165
RN,30031,BARAÚNA,7865,2506,2404,17411,15007,906,1663
RO,19,GUAJARÁ-MIRIM,8701,7728,4591,26189,21598,379,842
RO,35,PORTO VELHO,96299,83144,52075,302773,250698,6878,11935
RO,51,JI-PARANÁ,23879,27780,20296,85624,65328,1421,2576
RO,78,ARIQUEMES,17066,24835,9483,58991,49508,1184,1903
RO,94,CACOAL,13401,22952,14992,60227,45235,1087,1881
RO,116,PIMENTA BUENO,6288,9293,6655,26161,19506,527,910
RO,132,VILHENA,12990,20977,13561,55858,42297,1203,1960
RO,159,JARU,9227,15857,10780,39621,28841,607,1100
RO,175,OURO PRETO DO OESTE,8168,10466,8114,30067,21953,486,938
RO,191,PRESIDENTE MÉDICI,5363,5105,4655,17074,12419,343,511
RO,213,COSTA MARQUES,3683,2137,2273,8792,6519,82,265
RO,230,COLORADO DO OESTE,4296,4975,2909,13720,10811,257,435
RO,256,ESPIGÃO DO OESTE,6194,8418,4856,21753,16897,400,528
RO,272,CEREJEIRAS,2924,5926,3633,13864,10231,189,403
RO,299,ROLIM DE MOURA,11503,11714,9547,37972,28425,901,1266
RO,310,ALTA FLORESTA DO OESTE,5576,6374,5347,19292,13945,333,614
RO,337,ALVORADA DO OESTE,4555,3639,3516,12863,9347,154,414
RO,353,SANTA LUZIA DO OESTE,2596,2235,1971,7626,5655,117,255
RO,370,NOVA BRASILÂNDIA DO OESTE,4232,5583,3667,14840,11173,217,417
RO,396,MACHADINHO DO OESTE,8028,7691,3993,21355,17362,265,579
RO,418,SÃO MIGUEL DO GUAPORÉ,5026,5373,3822,15537,11715,258,381
RO,434,NOVA MAMORÉ,6309,5608,2678,16064,13386,252,619
RO,450,CABIXI,1611,1649,579,4396,3817,85,153
RO,477,CANDEIAS DO JAMARI,6718,3511,3068,15637,12569,247,529
RO,493,ITAPUÃ DO OESTE,2517,1518,1212,5883,4671,82,171
RO,515,NOVO HORIZONTE DO OESTE,3108,2163,1775,7696,5921,84,204
RO,531,CASTANHEIRAS,1300,755,459,2765,2306,20,102
RO,558,VALE DO PARAÍSO,2274,2286,1591,6719,5128,57,220
RO,566,URUPÁ,3466,2939,2435,9780,7345,136,330
RO,574,MIRANTE DA SERRA,3100,3029,2336,9210,6874,103,269
RO,582,SERINGUEIRAS,3282,2866,2161,9117,6956,119,269
RO,590,THEOBROMA,2484,3077,2168,8336,6168,84,272
RO,604,MINISTRO ANDREAZZA,2528,2520,1689,7382,5693,94,230
RO,612,GOVERNADOR JORGE TEIXEIRA,2462,2571,2022,7673,5651,104,269
RO,620,CACAULÂNDIA,1335,1555,527,3824,3297,50,121
RO,639,ALTO PARAÍSO,4459,4053,2054,11521,9467,204,322
RO,647,RIO CRESPO,990,990,398,2630,2232,28,76
RO,655,CORUMBIARA,2167,1886,1434,6145,4711,80,201
RO,663,MONTE NEGRO,3302,3699,1663,9566,7903,123,335
RO,671,CAMPO NOVO DE RONDÔNIA,3068,2650,1144,7417,6273,85,223
RO,680,CUJUBIM,3247,3813,1948,9830,7882,169,295
RO,698,VALE DO ANARI,2067,2255,917,5750,4833,72,222
RO,701,PARECIS,1360,942,793,3347,2554,32,102
RO,710,SÃO FELIPE DO OESTE,1261,1933,1243,5027,3784,93,182
RO,728,PRIMAVERA DE RONDÔNIA,931,936,260,2444,2184,48,99
RO,736,ALTO ALEGRE DOS PARECIS,2973,2700,2205,8790,6585,142,257
RO,744,NOVA UNIÃO,2085,1756,1283,5590,4307,77,174
RO,752,TEIXEIRÓPOLIS,1450,1415,1014,4226,3212,62,123
RO,779,BURITIS,7055,8844,4045,21625,17580,364,620
RO,787,PIMENTEIRAS DO OESTE,561,700,706,2150,1444,13,47
RO,795,SÃO FRANCISCO DO GUAPORÉ,4274,3365,2446,10869,8423,144,321
RO,809,CHUPINGUAIA,1566,1751,1677,5544,3867,84,159
RR,3000,CAROEBE,2168,2032,771,5721,4950,46,228
RR,3018,BOA VISTA,40745,76117,21116,191072,169956,2673,5247
RR,3026,IRACEMA,2237,1326,797,5055,4258,50,186
RR,3034,CARACARAÍ,4588,3647,2117,12179,10062,122,331
RR,3042,AMAJARI,1796,1887,629,5228,4599,36,183
RR,3050,ALTO ALEGRE,3485,2985,1193,9159,7966,115,293
RR,3069,CANTÁ,3600,3420,1337,10153,8816,98,317
RR,3077,BONFIM,2651,2207,1002,7451,6449,47,239
RR,3085,RORAINÓPOLIS,6296,4347,2665,15557,12892,207,512
RR,3093,MUCAJAÍ,4147,3468,1649,10880,9231,125,350
RR,3107,UIRAMUTÃ,2313,698,713,4766,4053,26,263
RR,3115,NORMANDIA,2915,1253,636,5665,5029,21,136
RR,3123,PACARAIMA,2026,2867,1211,7480,6269,61,237
RR,3131,SÃO JOÃO DA BALIZA,1934,1317,673,4663,3990,57,171
RR,3158,SÃO LUIZ,2041,1499,767,4871,4104,66,165
RS,84735,ÁUREA,1093,1428,342,3155,2813,115,96
RS,84743,TRÊS ARROIOS,961,1078,258,2541,2283,71,87
RS,84751,NOVA ROMA DO SUL,768,1434,313,2968,2655,96,112
RS,84760,PROGRESSO,2322,1515,788,5137,4349,142,166
RS,84778,PIRAPÓ,959,596,241,2058,1817,49,79
RS,84786,JABOTICABA,1367,880,262,2813,2551,46,138
RS,84794,SÃO JORGE,725,1216,115,2324,2209,75,85
RS,84808,ALTO ALEGRE,687,593,120,1595,1475,60,57
RS,84816,NOVA HARTZ,4895,4411,1862,14075,12213,453,419
RS,84824,DOIS LAJEADOS,796,1298,240,2691,2451,106,87
RS,84832,SÃO DOMINGOS DO SUL,823,1048,262,2529,2267,129,88
RS,84840,TUNAS,1800,886,751,3698,2947,78,80
RS,84859,SÃO JOÃO DA URTIGA,1493,1538,512,4101,3589,248,156
RS,84867,GUABIJU,342,636,113,1279,1166,83,45
RS,84875,QUINZE DE NOVEMBRO,1272,1260,336,3183,2847,47,88
RS,84883,DOUTOR MAURÍCIO CARDOSO,1532,1863,698,4471,3773,74,145
RS,84891,CAPELA DE SANTANA,3400,1964,1318,8230,6912,357,309
RS,84905,JAQUIRANA,1082,957,318,2839,2521,137,123
RS,84913,VANINI,521,844,140,1726,1586,63,64
RS,84921,BOQUEIRÃO DO LEÃO,3017,1472,1026,6168,5142,179,162
RS,84930,FAGUNDES VARELA,522,1169,148,2170,2022,63,98
RS,84948,ÁGUA SANTA,968,1306,457,3155,2698,86,96
RS,84956,SILVEIRA MARTINS,683,839,204,2130,1926,90,59
RS,84964,IBIRAPUITÃ,1369,1145,294,3190,2896,79,115
RS,84972,IBARAMA,1451,1372,398,3582,3184,103,138
RS,84980,PANTANO GRANDE,3739,2106,1689,8603,6914,291,222
RS,84999,IPÊ,1138,2738,824,5377,4553,139,200
RS,85006,TRINDADE DO SUL,2001,1542,718,4725,4007,112,163
RS,85014,AGUDO,4783,4835,1993,13117,11124,433,343
RS,85022,ERNESTINA,984,953,154,2418,2264,69,64
RS,85030,AJURICABA,1914,2655,565,5681,5116,94,122
RS,85049,DEZESSEIS DE NOVEMBRO,1039,687,222,2187,1965,60,82
RS,85057,ALECRIM,2558,1795,987,6048,5061,123,187
RS,85065,BROCHIER,1943,1100,459,3981,3522,105,179
RS,85073,ALEGRETE,21614,14906,15641,61564,45923,1454,1349
RS,85081,EREBANGO,772,920,210,2236,2026,67,108
RS,85090,ALPESTRE,2730,1658,1254,6336,5082,295,207
RS,85103,ENTRE-IJUÍS,3386,2120,1245,7507,6262,163,206
RS,85111,ALVORADA,47319,30889,24818,141925,117107,8841,6492
RS,85120,NOVA ESPERANÇA DO SUL,1213,1584,596,4012,3416,229,173
RS,85138,ANTA GORDA,1313,2487,875,5316,4441,236,158
RS,85146,PAVERAMA,2985,1454,875,5902,5027,164,141
RS,85154,ANTÔNIO PRADO,2038,5630,1702,11020,9318,313,442
RS,85162,TERRA DE AREIA,2396,2335,1501,7549,6048,212,271
RS,85170,ARATIBA,2394,2127,643,5944,5301,204,202
RS,85189,HARMONIA,1324,1485,442,3844,3402,134,123
RS,85197,ARROIO DO MEIO,5597,6161,1966,16054,14088,546,555
RS,85200,CAMPOS BORGES,1137,1059,277,2846,2569,106,106
RS,85219,ARROIO DOS RATOS,4016,2581,2195,10821,8626,487,382
RS,85227,CERRO GRANDE,1002,487,164,1904,1740,34,90
RS,85235,ARROIO DO TIGRE,4538,3350,1548,10462,8914,347,263
RS,85243,IPIRANGA DO SUL,493,1015,121,1748,1627,34,58
RS,85251,ARROIO GRANDE,6377,4239,3217,15948,12731,551,460
RS,85260,LAGOÃO,2511,1118,998,5025,4027,129,163
RS,85278,ARVOREZINHA,3192,2852,1514,8729,7215,403,348
RS,85286,ESTAÇÃO,1180,2559,727,5182,4455,176,193
RS,85294,AUGUSTO PESTANA,2437,2359,862,6168,5306,133,154
RS,85308,ARROIO DO SAL,1648,2213,1508,6658,5150,170,218
RS,85316,BAGÉ,28004,25773,17936,90189,72253,3788,2873
RS,85324,SÃO JOSÉ DO HORTÊNCIO,1102,1588,405,3529,3124,124,139
RS,85332,BARÃO DE COTEGIPE,1730,2326,783,5554,4771,238,195
RS,85340,PINHAL,869,745,285,2089,1804,47,83
RS,85359,BARRACÃO,1623,1311,809,4338,3529,144,164
RS,85367,TRÊS CACHOEIRAS,2713,3406,1291,8365,7074,144,216
RS,85375,BARRA DO RIBEIRO,3901,2675,2159,10614,8455,433,324
RS,85383,SÃO VENDELINO,726,762,65,1802,1737,37,65
RS,85391,BARROS CASSAL,3600,2341,1967,8992,7025,298,310
RS,85405,PROTÁSIO ALVES,313,1084,100,1753,1653,83,76
RS,85413,BENTO GONÇALVES,19223,38377,12149,84021,71872,3141,3386
RS,85421,POUSO NOVO,598,530,149,1478,1329,65,58
RS,85430,BOA VISTA DO BURICÁ,2143,2290,773,5635,4862,98,101
RS,85448,EUGÊNIO DE CASTRO,968,733,239,2223,1984,88,76
RS,85456,BOM JESUS,2914,2803,2032,9007,6975,343,291
RS,85464,CRISTAL,2696,1454,595,5640,5045,169,124
RS,85472,BOM RETIRO DO SUL,3449,2997,1387,9745,8358,417,326
RS,85480,SÃO MIGUEL DAS MISSÕES,2803,1401,532,5306,4774,167,153
RS,85499,BOSSOROCA,2229,1405,1373,5696,4323,215,174
RS,85502,GLORINHA,1465,2327,483,5435,4952,218,257
RS,85510,BRAGA,1307,824,651,3090,2439,77,92
RS,85529,SEGREDO,2568,1931,1074,6056,4982,161,178
RS,85537,BUTIÁ,6164,3735,3370,16800,13430,661,507
RS,85545,ALEGRIA,1460,1043,629,3528,2899,97,97
RS,85553,CAÇAPAVA DO SUL,10180,7132,4606,26861,22255,1378,953
RS,85561,SALDANHA MARINHO,1026,1103,196,2569,2373,58,67
RS,85570,CACEQUI,4493,2039,2927,10645,7718,229,224
RS,85588,SÃO JOSÉ DO HERVAL,904,527,270,1901,1631,66,65
RS,85596,CACHOEIRA DO SUL,22063,21350,15682,69654,53972,2447,1699
RS,85600,VISTA ALEGRE,1276,667,331,2484,2153,59,56
RS,85618,CACHOEIRINHA,27376,25468,15494,98004,82510,4730,4189
RS,85626,IVORÁ,580,758,205,1813,1608,76,69
RS,85634,CACIQUE DOBLE,1110,1675,566,3915,3349,159,112
RS,85642,VILA MARIA,1157,1482,413,3540,3127,139,125
RS,85650,CAIBATÉ,1681,1190,633,4059,3426,166,114
RS,85669,TAQUARUÇU DO SUL,1002,879,327,2546,2219,90,74
RS,85677,CAIÇARA,1584,1588,521,4132,3611,119,119
RS,85685,IMBÉ,5907,4571,3424,16275,12851,414,451
RS,85693,CAMAQUÃ,18493,15063,8717,50181,41464,2070,1259
RS,85707,SEDE NOVA,906,808,422,2543,2121,134,85
RS,85715,CAMBARÁ DO SUL,1428,2018,1219,5493,4274,162,161
RS,85723,TUPANDI,1113,1706,345,3714,3369,181,127
RS,85731,CAMPINA DAS MISSÕES,2353,1554,379,4812,4433,80,190
RS,85740,RIOZINHO,1290,1061,293,3521,3228,170,121
RS,85758,CAMPINAS DO SUL,1040,2535,661,4742,4081,91,137
RS,85766,RELVADO,639,701,241,1876,1635,27,66
RS,85774,CAMPO BOM,14303,17417,7035,49958,42923,1805,1859
RS,85782,IMIGRANTE,911,996,266,2545,2279,119,119
RS,85790,CAMPO NOVO,1872,936,508,3923,3415,125,101
RS,85804,CIDREIRA,3073,2910,3121,11304,8183,316,357
RS,85812,CANDELÁRIA,7750,8771,4163,24078,19915,1228,710
RS,85820,MONTAURI,474,687,94,1397,1303,50,53
RS,85839,CÂNDIDO GODÓI,1844,2643,527,5655,5128,103,151
RS,85847,VISTA GAÚCHA,1142,683,221,2329,2108,44,87
RS,85855,CANELA,5968,12391,4681,29383,24702,1694,1315
RS,85863,VISTA ALEGRE DO PRATA,328,724,111,1338,1227,54,41
RS,85871,CANGUÇU,14801,17453,7460,44714,37254,1927,1023
RS,85880,CASEIROS,798,1127,386,2613,2227,100,79
RS,85898,CANOAS,84100,62396,31443,239253,207810,11298,10953
RS,85901,ITACURUBI,1161,629,323,2440,2117,64,62
RS,85910,CARAZINHO,15997,15543,8063,47099,39036,1327,1360
RS,85928,ENTRE RIOS DO SUL,1054,902,262,2469,2207,79,91
RS,85936,CARLOS BARBOSA,5786,9432,2539,21206,18667,706,842
RS,85944,CERRO GRANDE DO SUL,2922,2219,1090,7218,6128,286,246
RS,85952,CASCA,1939,3497,1070,7496,6426,292,259
RS,85960,CAMARGO,660,967,252,2208,1956,91,94
RS,85979,CATUÍPE,2859,2739,1128,7802,6674,271,239
RS,85987,PARAÍSO DO SUL,2280,2159,973,5989,5016,133,147
RS,85995,CAXIAS DO SUL,68019,134889,48963,332485,283522,14283,18108
RS,86010,CERRO LARGO,4372,3164,1628,10368,8740,229,344
RS,86029,FAXINALZINHO,776,810,195,2046,1851,59,81
RS,86037,CHAPADA,3099,3033,1014,7850,6836,224,190
RS,86045,AMARAL FERRADOR,1981,1560,872,5009,4137,196,150
RS,86053,CHIAPETTA,1337,1132,422,3277,2855,61,73
RS,86061,VILA FLORES,592,1638,149,2854,2705,108,121
RS,86070,CIRÍACO,1463,1457,618,3996,3378,139,154
RS,86088,CERRO BRANCO,1598,1270,231,3490,3259,137,117
RS,86096,COLORADO,833,1465,276,2892,2616,78,118
RS,86100,ANDRÉ DA ROCHA,265,529,89,1001,912,29,33
RS,86118,CONDOR,2127,2061,419,5187,4768,105,132
RS,86126,POÇO DAS ANTAS,809,679,147,1829,1682,61,46
RS,86134,CONSTANTINA,3102,2807,1346,8024,6678,208,251
RS,86142,TRÊS PALMEIRAS,1482,1064,611,3762,3151,102,133
RS,86150,CORONEL BICACO,2646,1517,690,5440,4750,96,180
RS,86169,NOVA ALVORADA,1020,1051,162,2519,2357,82,108
RS,86177,CRISSIUMAL,4726,3495,1879,11539,9660,312,373
RS,86185,MORRO REDONDO,1939,1753,818,5226,4408,200,147
RS,86193,CRUZ ALTA,16471,13882,10834,49099,38265,1565,1304
RS,86207,SANTA MARIA DO HERVAL,1918,2268,391,5181,4790,180,199
RS,86215,CRUZEIRO DO SUL,3901,3445,1259,9985,8726,338,415
RS,86223,BARÃO,1726,1903,525,4664,4139,153,151
RS,86231,DAVID CANABARRO,1448,1535,301,3684,3383,160,129
RS,86240,ELDORADO DO SUL,8746,5256,4252,24481,20229,1048,903
RS,86258,DOIS IRMÃOS,8014,8628,2475,22153,19678,694,676
RS,86274,DOM FELICIANO,4352,3210,1872,10758,8886,415,301
RS,86282,ALTO FELIZ,651,1192,125,2294,2169,73,96
RS,86290,DOM PEDRITO,12089,7587,6871,30423,23552,803,878
RS,86304,AMETISTA DO SUL,2127,1776,1320,5888,4568,219,175
RS,86312,DONA FRANCISCA,982,1110,278,2879,2601,107,101
RS,86320,ARAMBARÉ,1254,751,311,2775,2464,73,104
RS,86339,ENCANTADO,4620,6860,2668,16889,14221,487,630
RS,86347,BARÃO DO TRIUNFO,1835,1783,899,5112,4213,112,168
RS,86355,ENCRUZILHADA DO SUL,7634,5196,4391,20308,15917,1107,711
RS,86363,BARRA DO GUARITA,1042,701,532,2663,2131,69,95
RS,86371,ERECHIM,20195,31460,12079,75919,63840,2712,2689
RS,86380,BARRA DO RIO AZUL,625,762,145,1744,1599,58,57
RS,86398,HERVAL,2715,988,1243,5510,4267,149,147
RS,86401,BARRA FUNDA,760,1093,160,2251,2091,40,63
RS,86410,ERVAL GRANDE,1764,1350,549,4164,3615,179,140
RS,86428,BOA VISTA DAS MISSÕES,643,575,159,1641,1482,53,49
RS,86436,ERVAL SECO,2468,1800,1311,6197,4886,132,164
RS,86444,BOM PROGRESSO,766,672,152,1838,1686,43,51
RS,86452,ESMERALDA,867,931,564,2655,2091,85,56
RS,86460,CAMPESTRE DA SERRA,447,1400,450,2740,2290,109,123
RS,86479,ESPUMOSO,4427,4873,1594,12233,10639,320,346
RS,86487,CANDIOTA,3454,1701,1413,7653,6240,176,169
RS,86495,ESTÂNCIA VELHA,9805,11928,4466,32693,28227,1319,1347
RS,86509,CAPITÃO,1209,638,121,2260,2139,92,63
RS,86517,ESTEIO,25500,15734,11357,68144,56787,2327,2400
RS,86525,CARLOS GOMES,598,611,91,1399,1308,44,25
RS,86533,ESTRELA,7270,9673,3699,25056,21357,904,929
RS,86541,CENTENÁRIO,1083,1054,114,2405,2291,62,45
RS,86550,FARROUPILHA,12245,24023,6969,53155,46186,2351,2446
RS,86568,CHARRUA,783,1040,554,2629,2075,62,109
RS,86576,FAXINAL DO SOTURNO,1904,1995,841,5705,4864,223,178
RS,86584,COLINAS,810,776,150,2110,1960,60,89
RS,86592,FELIZ,3093,4388,1478,10705,9227,372,512
RS,86606,COQUEIROS DO SUL,787,1038,200,2170,1970,39,64
RS,86614,FLORES DA CUNHA,3127,12538,3440,23748,20308,813,1051
RS,86622,CORONEL BARROS,863,923,130,2140,2010,31,69
RS,86630,FONTOURA XAVIER,3802,1848,996,7732,6736,347,266
RS,86649,COXILHA,899,868,143,2174,2031,51,67
RS,86657,FORMIGUEIRO,2091,1758,397,5055,4658,192,255
RS,86665,DERRUBADAS,1036,927,241,2471,2230,36,67
RS,86673,FREDERICO WESTPHALEN,8130,8851,4233,24031,19798,690,766
RS,86681,DOIS IRMÃOS DAS MISSÕES,892,534,134,1680,1546,31,33
RS,86690,GARIBALDI,5843,12417,3565,25689,22124,901,1014
RS,86703,ENGENHO VELHO,528,374,81,1091,1010,32,34
RS,86711,GAURAMA,1511,2391,292,4836,4544,170,170
RS,86720,GARRUCHOS,1309,536,348,2402,2054,39,76
RS,86738,GENERAL CÂMARA,2774,1629,1280,6837,5557,233,214
RS,86746,GENTIL,373,805,132,1519,1387,48,45
RS,86754,SÃO VICENTE DO SUL,2741,1977,1566,7186,5620,232,220
RS,86762,GRAMADO DOS LOUREIROS,901,416,147,1678,1531,44,64
RS,86770,GETÚLIO VARGAS,2878,6395,2192,13055,10863,376,454
RS,86789,GRAMADO XAVIER,1294,938,400,2915,2515,62,90
RS,86797,GIRUÁ,5121,4595,2303,13404,11101,248,369
RS,86800,HULHA NEGRA,2224,1116,717,4654,3937,105,131
RS,86819,GRAMADO,4424,14079,4606,28621,24015,1118,1096
RS,86827,INHACORÁ,846,520,254,1888,1634,42,50
RS,86835,GRAVATAÍ,52661,49402,27965,182083,154118,10518,9264
RS,86843,ITAPUCA,729,591,190,1739,1549,101,64
RS,86851,GUAÍBA,24305,18636,11059,71893,60834,3589,2774
RS,86860,LAJEADO DO BUGRE,855,441,399,2009,1610,65,60
RS,86878,GUAPORÉ,4110,8406,2684,18542,15858,825,755
RS,86886,LAGOA DOS TRÊS CANTOS,520,714,81,1432,1351,31,32
RS,86894,GUARANI DAS MISSÕES,2576,2197,1126,6597,5471,176,194
RS,86908,LINDOLFO COLLOR,1920,1167,472,4319,3847,160,190
RS,86916,HORIZONTINA,4631,6327,2552,15166,12614,287,387
RS,86924,LINHA NOVA,438,547,71,1255,1184,45,49
RS,86932,CHARQUEADAS,8796,6264,3510,24356,20846,856,918
RS,86940,MANOEL VIANA,2586,1309,1507,5962,4455,120,168
RS,86959,HUMAITÁ,1643,1562,553,4168,3615,103,104
RS,86967,MAQUINÉ,2561,1636,1156,6034,4878,200,209
RS,86975,IBIAÇÁ,1004,1933,458,3899,3441,132,124
RS,86983,MARATÁ,989,749,85,2011,1926,32,51
RS,86991,IBIRAIARAS,1518,2619,869,5640,4771,196,149
RS,87009,MARIANA PIMENTEL,1092,1126,260,3035,2775,112,124
RS,87017,IBIRUBÁ,5468,6460,2384,16077,13693,376,422
RS,87025,MATO CASTELHANO,521,1263,144,2119,1975,30,74
RS,87033,IGREJINHA,7901,8603,3427,25495,22068,1007,819
RS,87041,MATO LEITÃO,1290,1358,188,3192,3004,111,83
RS,87050,IJUÍ,24154,18402,10318,62776,52458,1347,1463
RS,87068,MINAS DO LEÃO,1842,2380,984,6405,5421,270,272
RS,87076,ILÓPOLIS,1156,1302,657,3645,2988,165,148
RS,87084,MONTE BELO DO SUL,808,1217,241,2689,2448,102,133
RS,87092,INDEPENDÊNCIA,1977,2159,305,5015,4710,129,140
RS,87106,MORMAÇO,851,864,215,2362,2147,86,93
RS,87114,IRAÍ,2673,1862,1161,6304,5143,180,204
RS,87122,MORRINHOS DO SUL,1019,1165,172,2682,2510,67,63
RS,87130,ITAQUI,10246,6574,7135,27983,20848,568,539
RS,87149,MORRO REUTER,1349,2490,457,5011,4554,184,214
RS,87157,ITATIBA DO SUL,2028,839,485,3630,3145,67,70
RS,87165,MULITERNO,659,669,120,1598,1478,65,41
RS,87173,IVOTI,4587,6382,1609,15305,13696,472,560
RS,87181,NICOLAU VERGUEIRO,535,584,147,1692,1545,64,60
RS,87190,JACUTINGA,929,1389,198,2756,2558,83,68
RS,87203,NOVA BOA VISTA,786,750,141,1828,1687,35,40
RS,87211,JAGUARÃO,7415,6258,5353,22920,17567,699,636
RS,87220,NOVA PÁDUA,203,1432,187,2144,1957,54,75
RS,87238,JAGUARI,3478,3398,1991,10145,8154,403,310
RS,87246,NOVA SANTA RITA,6198,3557,1084,13787,12703,567,456
RS,87254,JÚLIO DE CASTILHOS,5863,4308,3234,16103,12869,387,373
RS,87262,NOVO BARREIRO,1380,1086,195,3183,2988,109,128
RS,87270,LAGOA VERMELHA,6252,8406,3799,21433,17634,818,627
RS,87289,NOVO MACHADO,1164,1436,454,3366,2912,44,62
RS,87297,LAJEADO,18767,19439,7639,55313,47674,2309,1968
RS,87300,NOVO TIRADENTES,758,478,140,1604,1464,36,58
RS,87319,LAVRAS DO SUL,2325,1615,1289,6252,4963,211,194
RS,87327,PARECI NOVO,1007,1083,172,2636,2464,73,97
RS,87335,LIBERATO SALZANO,2011,1348,759,4610,3851,186,177
RS,87343,PASSO DO SOBRADO,2166,1602,563,4953,4390,208,119
RS,87351,MACHADINHO,1658,1592,666,4476,3810,127,180
RS,87360,PICADA CAFÉ,1214,1917,539,4292,3753,93,189
RS,87378,MARAU,7099,13545,4039,28907,24868,1123,932
RS,87386,PINHAL GRANDE,1540,1148,728,3854,3126,94,66
RS,87394,MARCELINO RAMOS,1661,1562,647,4275,3628,72,98
RS,87408,PINHEIRINHO DO VALE,1729,869,419,3387,2968,83,84
RS,87416,MARIANO MORO,829,641,178,1888,1710,95,42
RS,87424,PONTÃO,1435,1071,402,3277,2875,53,64
RS,87432,MATA,1887,1140,869,4324,3455,161,110
RS,87440,PONTE PRETA,555,788,104,1601,1497,47,49
RS,87459,MAXIMILIANO DE ALMEIDA,1142,1528,696,4211,3515,163,180
RS,87467,PORTO MAUÁ,885,814,190,2106,1916,41,57
RS,87475,MIRAGUAÍ,1845,945,695,4039,3344,94,98
RS,87483,PORTO VERA CRUZ,763,458,106,1478,1372,35,42
RS,87491,MONTENEGRO,16361,13017,7151,45190,38039,2103,1687
RS,87505,PRESIDENTE LUCENA,695,1050,170,2224,2054,58,88
RS,87513,MOSTARDAS,3542,2799,1915,9427,7512,343,323
RS,87521,QUEVEDOS,980,580,189,2009,1820,98,54
RS,87530,MUÇUM,1170,1519,249,3641,3392,172,164
RS,87548,RIO DOS ÍNDIOS,1393,678,218,2571,2353,73,129
RS,87556,NÃO-ME-TOQUE,4255,5381,1737,12860,11123,374,395
RS,87564,SAGRADA FAMÍLIA,854,553,155,1919,1764,41,73
RS,87572,NONOAI,3477,2716,747,8072,7325,211,336
RS,87580,SALVADOR DAS MISSÕES,883,976,131,2197,2066,37,59
RS,87599,NOVA ARAÇÁ,674,1833,492,3585,3093,170,151
RS,87602,SANTA CLARA DO SUL,2098,1765,420,4915,4495,171,183
RS,87610,NOVA BASSANO,1288,4007,1010,7176,6166,302,266
RS,87629,SANTA TEREZA,513,766,159,1636,1477,64,74
RS,87637,NOVA BRÉSCIA,668,1363,326,2727,2401,76,131
RS,87645,SANTO ANTÔNIO DO PALMA,648,786,168,1769,1601,45,54
RS,87653,NOVA PALMA,1929,1956,710,5298,4588,139,140
RS,87661,SANTO ANTÔNIO DO PLANALTO,588,836,151,1790,1639,36,61
RS,87670,NOVA PETRÓPOLIS,3557,7993,2382,16599,14217,496,661
RS,87688,SANTO EXPEDITO DO SUL,800,824,182,2086,1904,110,76
RS,87696,NOVA PRATA,3124,8959,2949,18672,15723,675,675
RS,87700,SÃO JOÃO DO POLÊSINE,743,978,250,2309,2059,67,72
RS,87718,NOVO HAMBURGO,52504,61581,28214,179706,151492,7145,6832
RS,87726,SÃO JOSÉ DOS AUSENTES,1043,924,277,2511,2234,55,76
RS,87734,OSÓRIO,11221,9650,5499,33926,28427,1468,1475
RS,87742,SÃO JOSÉ DO INHACORÁ,885,777,82,1939,1857,50,59
RS,87750,PAIM FILHO,1541,1297,270,3443,3173,90,130
RS,87769,SÃO JOSÉ DAS MISSÕES,973,553,136,1972,1836,58,76
RS,87777,PALMEIRA DAS MISSÕES,9665,7472,4690,25381,20691,578,752
RS,87785,SÃO MARTINHO DA SERRA,870,1024,320,2698,2378,118,66
RS,87793,PALMITINHO,2975,1712,858,6027,5169,143,134
RS,87807,SÃO PEDRO DA SERRA,1036,1123,114,2598,2484,99,87
RS,87815,PANAMBI,9809,11583,4709,30392,25683,690,669
RS,87823,SÃO PEDRO DO BUTIÁ,1080,885,373,2503,2130,37,77
RS,87831,PARAÍ,1044,3222,688,5779,5091,236,220
RS,87840,SÃO VALENTIM DO SUL,639,832,173,1927,1754,90,84
RS,87858,PASSO FUNDO,43779,44980,21071,139370,118299,4464,3527
RS,87866,SÃO VALÉRIO DO SUL,1009,517,165,1884,1719,15,59
RS,87874,PEDRO OSÓRIO,2984,1420,1310,6740,5430,266,197
RS,87882,SENTINELA DO SUL,1825,1201,702,4342,3640,205,146
RS,87890,PEJUÇARA,1309,1176,489,3291,2802,74,73
RS,87904,SÉRIO,1095,455,95,1837,1742,75,42
RS,87912,PELOTAS,88257,63531,45487,253964,208477,10401,10299
RS,87920,SERTÃO SANTANA,1665,1920,373,4558,4185,166,154
RS,87939,PINHEIRO MACHADO,4452,2632,2284,11009,8725,488,328
RS,87947,SINIMBU,3676,2374,1291,8023,6732,188,233
RS,87955,PIRATINI,6728,3549,3593,16329,12736,821,471
RS,87963,TIRADENTES DO SUL,2166,1460,808,4998,4190,143,187
RS,87971,PLANALTO,2647,2824,1633,8042,6409,339,306
RS,87980,TRAVESSEIRO,964,577,225,2019,1794,44,48
RS,87998,PORTÃO,8474,6478,3360,23117,19757,963,847
RS,88005,TRÊS FORQUILHAS,1041,896,205,2342,2137,60,54
RS,88013,PORTO ALEGRE,302342,318432,208036,1097321,889285,41855,42991
RS,88021,TUPANCI DO SUL,434,556,180,1325,1145,60,56
RS,88030,PORTO LUCENA,1799,1340,655,4276,3621,132,134
RS,88048,UNIÃO DA SERRA,457,637,101,1340,1239,40,38
RS,88056,PORTO XAVIER,3092,2350,539,6704,6165,172,242
RS,88064,VALE DO SOL,3709,2782,1044,8457,7413,261,229
RS,88072,PUTINGA,833,1671,598,3735,3137,211,189
RS,88080,VALE REAL,1562,1689,236,4102,3866,175,171
RS,88099,QUARAÍ,6438,4976,4738,18757,14019,439,347
RS,88102,VILA NOVA DO SUL,1387,947,392,3194,2802,120,97
RS,88110,REDENTORA,2869,1201,584,5511,4927,100,173
RS,88129,VITÓRIA DAS MISSÕES,1443,966,307,3010,2703,48,77
RS,88137,RESTINGA SÊCA,3884,5059,2787,13656,10869,402,326
RS,88145,XANGRI-LÁ,2498,3565,1482,9532,8050,321,293
RS,88153,RIO GRANDE,65652,29717,26949,151557,124608,5945,5833
RS,88161,BOA VISTA DO SUL,906,926,206,2321,2115,89,66
RS,88170,RIO PARDO,13811,7211,5522,30698,25176,1192,926
RS,88188,DILERMANDO DE AGUIAR,1009,888,290,2557,2267,68,62
RS,88196,ROCA SALES,2644,2892,996,7927,6931,399,299
RS,88200,CAPIVARI DO SUL,1374,930,239,2972,2733,96,104
RS,88218,RODEIO BONITO,1928,1599,675,4837,4162,126,168
RS,88226,NOVA CANDELÁRIA,1081,798,212,2391,2179,102,73
RS,88234,ROLANTE,4447,6355,1911,15357,13446,587,522
RS,88242,FLORIANO PEIXOTO,706,712,169,1729,1560,45,53
RS,88250,RONDA ALTA,3234,2515,1221,7567,6346,170,134
RS,88269,CHUVISCA,1467,1575,231,3747,3516,141,105
RS,88277,RONDINHA,1904,1914,560,4696,4136,101,110
RS,88285,ESPERANÇA DO SUL,1203,783,155,2454,2299,48,72
RS,88293,ROQUE GONZALES,2564,1699,1140,5971,4831,129,211
RS,88307,DOUTOR RICARDO,672,736,159,1825,1666,92,92
RS,88315,ROSÁRIO DO SUL,11825,8277,8239,32571,24332,849,741
RS,88323,HERVEIRAS,1384,442,142,2137,1995,40,41
RS,88331,SALVADOR DO SUL,1915,2194,618,5435,4817,179,161
RS,88340,CARAÁ,2265,2112,1159,6447,5288,276,218
RS,88358,SANANDUVA,3418,6261,1515,12479,10964,441,389
RS,88366,FAZENDA VILANOVA,1160,936,177,2732,2555,121,126
RS,88374,SANTA BÁRBARA DO SUL,2671,2649,1392,7539,6147,235,155
RS,88382,ITAARA,1135,1354,314,3404,3090,87,94
RS,88390,SANTA CRUZ DO SUL,30694,35447,13459,96203,82744,3800,3411
RS,88404,ESTRELA VELHA,1208,1143,253,2853,2600,88,79
RS,88412,SANTA MARIA,57278,65635,37613,200594,162981,6504,5382
RS,88420,BENJAMIN CONSTANT DO SUL,918,387,163,1663,1500,35,27
RS,88439,SANTANA DA BOA VISTA,2610,1780,1593,7140,5547,407,243
RS,88447,MAÇAMBARÁ,1512,914,462,3304,2842,59,95
RS,88455,SANTANA DO LIVRAMENTO,28264,13616,18085,71856,53771,1819,1341
RS,88463,DOM PEDRO DE ALCÂNTARA,878,831,139,2125,1986,43,43
RS,88471,SANTA ROSA,19903,18452,8778,54217,45439,1096,1220
RS,88480,UNISTALDA,868,733,276,2230,1954,55,66
RS,88498,SANTA VITÓRIA DO PALMAR,8323,6090,5989,24701,18712,902,741
RS,88501,TURUÇU,1053,1253,228,2950,2722,98,66
RS,88510,SANTIAGO,12724,12274,8785,39599,30814,1471,1069
RS,88528,CRISTAL DO SUL,1128,600,169,2198,2029,77,95
RS,88536,SANTO ÂNGELO,23780,16387,12564,61817,49253,1560,1484
RS,88544,MUITOS CAPÕES,420,1154,241,2064,1823,74,73
RS,88552,SANTO ANTÔNIO DA PATRULHA,11818,9317,5353,31815,26462,1576,1250
RS,88560,NOVA RAMADA,852,838,287,2125,1838,25,40
RS,88579,SANTO ANTÔNIO DAS MISSÕES,3923,2160,2570,9627,7057,221,194
RS,88587,JARI,1379,815,261,2819,2558,154,71
RS,88595,SANTO AUGUSTO,5106,3161,2175,11697,9522,283,324
RS,88609,UBIRETAMA,616,897,75,1741,1666,38,41
RS,88617,SANTO CRISTO,4936,4526,1615,12494,10879,377,349
RS,88625,BARRA DO QUARAÍ,977,573,309,2292,1983,38,42
RS,88633,SÃO BORJA,19313,11146,13552,49857,36305,916,990
RS,88641,CERRITO,2404,1432,894,5565,4671,286,136
RS,88650,SÃO FRANCISCO DE ASSIS,6108,4523,3742,16366,12624,684,504
RS,88668,VALE VERDE,1019,981,253,2627,2374,114,92
RS,88676,SÃO FRANCISCO DE PAULA,5643,5083,2755,16143,13388,748,608
RS,88684,NOVO CABRAIS,1376,1317,177,3205,3028,112,89
RS,88692,SÃO GABRIEL,15264,14036,10446,46787,36341,1167,1055
RS,88706,SETE DE SETEMBRO,825,539,80,1604,1524,47,49
RS,88714,SÃO JERÔNIMO,6415,4287,2645,16313,13668,676,536
RS,88722,TABAÍ,1681,932,476,3527,3051,91,87
RS,88730,SÃO JOSÉ DO NORTE,8954,5633,3484,21444,17960,707,780
RS,88749,VILA LÂNGARO,637,954,168,1983,1815,72,66
RS,88757,SÃO JOSÉ DO OURO,1719,2504,888,5922,5034,318,181
RS,88765,SENADOR SALGADO FILHO,848,1148,171,2394,2223,44,71
RS,88773,SÃO LEOPOLDO,57368,43235,26410,162645,136235,6636,6130
RS,88781,VESPASIANO CORRÊA,468,1115,222,2099,1877,94,61
RS,88790,SÃO LOURENÇO DO SUL,14478,11029,6188,35985,29797,820,682
RS,88803,MONTE ALEGRE DOS CAMPOS,743,1273,406,2785,2379,139,63
RS,88811,SÃO LUIZ GONZAGA,10990,6290,6684,27281,20597,773,722
RS,88820,MARQUES DE SOUZA,1552,1013,327,3330,3003,139,115
RS,88838,SÃO MARCOS,2690,8852,2597,17189,14592,606,787
RS,88846,CHUÍ,1515,1050,1053,4303,3250,163,105
RS,88854,SÃO MARTINHO,1761,1980,614,4939,4325,106,130
RS,88862,ARARICÁ,1492,1336,296,3959,3663,147,165
RS,88870,SÃO NICOLAU,1982,906,1330,4768,3438,114,157
RS,88889,PASSA SETE,1965,1173,525,4030,3505,144,99
RS,88897,SÃO PAULO DAS MISSÕES,2436,1597,373,4815,4442,85,93
RS,88900,TOROPI,974,987,209,2428,2219,68,72
RS,88919,SÃO PEDRO DO SUL,4624,4667,2432,13699,11267,616,393
RS,88927,BALNEÁRIO PINHAL,2275,2076,2348,8576,6228,247,343
RS,88935,SÃO SEBASTIÃO DO CAÍ,6141,6106,2989,18824,15835,750,749
RS,88943,MAMPITUBA,1262,796,242,2574,2332,63,76
RS,88951,SÃO SEPÉ,8128,5218,4253,19920,15667,629,486
RS,88978,SÃO VALENTIM,1037,1304,446,3179,2733,110,117
RS,88986,ACEGUÁ,1372,1382,626,3904,3278,97,75
RS,88994,SAPIRANGA,20516,18704,8657,59126,50469,2244,1981
RS,89001,ALMIRANTE TAMANDARÉ DO SUL,778,658,115,1690,1575,46,44
RS,89010,SAPUCAIA DO SUL,43900,20948,15959,102962,87003,4214,3731
RS,89028,ARROIO DO PADRE,622,1363,106,2374,2268,50,53
RS,89036,SARANDI,5382,6555,3011,17242,14231,454,434
RS,89044,BOA VISTA DO CADEADO,697,904,345,2131,1786,55,50
RS,89052,SEBERI,3663,2944,1180,8688,7508,239,253
RS,89060,BOA VISTA DO INCRA,981,663,298,2155,1857,33,40
RS,89079,SELBACH,1347,2010,639,4376,3737,78,116
RS,89087,BOZANO,871,875,117,2046,1929,23,38
RS,89095,SERAFINA CORRÊA,2649,5213,1743,11688,9945,600,475
RS,89109,CANUDOS DO VALE,1095,363,135,1714,1579,29,46
RS,89117,SERTÃO,1623,2416,596,5248,4652,144,157
RS,89125,CAPÃO BONITO DO SUL,706,589,186,1647,1461,35,46
RS,89133,SEVERIANO DE ALMEIDA,1307,1361,270,3256,2986,85,122
RS,89141,CAPÃO DO CIPÓ,1162,744,306,2433,2127,64,56
RS,89150,CAPÃO DA CANOA,9344,10728,6248,32536,26288,1175,1048
RS,89168,COQUEIRO BAIXO,428,586,117,1280,1163,31,54
RS,89176,SOBRADINHO,3320,4476,2037,11337,9300,392,353
RS,89184,CORONEL PILAR,442,701,115,1408,1293,44,38
RS,89192,SOLEDADE,7866,7160,4346,23033,18687,698,711
RS,89206,CRUZALTENSE,662,960,102,1865,1763,43,41
RS,89214,TAPEJARA,2949,8182,2212,15926,13714,554,630
RS,89222,FORQUETINHA,1088,695,126,2136,2010,83,83
RS,89230,TAPERA,3185,3043,1251,8295,7044,172,218
RS,89247,SANTA CECÍLIA DO SUL,456,744,151,1600,1449,56,53
RS,89249,ITATI,989,812,247,2280,2033,53,84
RS,89257,TAPES,4902,3444,3145,13410,10265,490,410
RS,89265,JACUIZINHO,1015,544,145,1862,1717,28,49
RS,89273,TAQUARA,12954,14009,6885,40775,33890,1575,1399
RS,89281,LAGOA BONITA DO SUL,1068,705,299,2297,1998,72,66
RS,89290,TAQUARI,9192,5378,3254,20955,17701,725,475
RS,89303,MATO QUEIMADO,641,559,124,1465,1341,37,51
RS,89311,TENENTE PORTELA,4052,3204,2072,10388,8316,156,274
RS,89320,NOVO XINGU,667,525,130,1408,1278,27,27
RS,89338,TORRES,7848,8915,5310,27550,22240,1017,1155
RS,89346,PAULO BENTO,674,915,236,2025,1789,53,55
RS,89354,TRAMANDAÍ,10386,8376,7449,32138,24689,1221,1161
RS,89362,PINHAL DA SERRA,875,662,310,2127,1817,62,56
RS,89370,TRÊS COROAS,5083,6636,2322,17683,15361,877,635
RS,89389,QUATRO IRMÃOS,582,620,244,1601,1357,41,48
RS,89397,TRÊS DE MAIO,6393,7944,3674,20017,16343,499,456
RS,89400,ROLADOR,1116,461,152,2013,1861,58,62
RS,89419,TRÊS PASSOS,7559,6053,2578,18473,15895,566,583
RS,89435,TRIUNFO,6640,6284,1872,19054,17182,1080,875
RS,89443,SANTA MARGARIDA DO SUL,864,796,198,2192,1994,68,53
RS,89451,TUCUNDUVA,1503,2128,721,4863,4142,96,142
RS,89460,SÃO JOSÉ DO SUL,698,830,194,1909,1715,54,54
RS,89478,TUPANCIRETÃ,6806,4513,3501,17309,13808,559,473
RS,89486,SÃO PEDRO DAS MISSÕES,765,446,302,1728,1426,34,60
RS,89494,TUPARENDI,2440,3038,948,7193,6245,166,179
RS,89508,TIO HUGO,975,853,234,2335,2101,86,77
RS,89516,URUGUAIANA,25901,25019,24058,90680,66622,1987,1778
RS,89524,WESTFÁLIA,1339,687,297,2565,2268,64,61
RS,89532,VACARIA,9317,19391,8318,45376,37058,1993,1320
RS,89540,PINTO BANDEIRA,533,1038,223,2137,1914,63,130
RS,89559,VENÂNCIO AIRES,21600,16728,7597,53491,45894,2179,1664
RS,89567,PEDRAS ALTAS,855,549,212,1763,1551,28,41
RS,89575,VERA CRUZ,7657,6124,2249,18757,16508,668,639
RS,89591,VERANÓPOLIS,2580,9532,2979,18593,15614,859,861
RS,89613,VIADUTOS,1386,1836,226,3966,3740,154,100
RS,89630,VIAMÃO,57611,37495,29237,166977,137740,9277,7050
RS,89656,VICENTE DUTRA,1498,1460,923,4238,3315,123,97
RS,89672,PALMARES DO SUL,3926,2640,1064,9065,8001,286,305
RS,89699,VICTOR GRAEFF,869,1186,335,2646,2311,57,75
RS,89710,TAVARES,1975,1191,808,4502,3694,139,199
RS,89737,CAPÃO DO LEÃO,8406,3308,3035,18490,15455,800,589
RS,89753,SALTO DO JACUÍ,3605,2240,1976,9074,7098,249,235
RS,89770,COTIPORÃ,794,1673,263,3228,2965,146,122
RS,98213,TEUTÔNIA,8995,7569,2738,22975,20237,710,753
RS,98230,BOM PRINCÍPIO,2734,4440,972,9371,8399,349,284
RS,98256,PAROBÉ,14400,10589,5012,37398,32386,1610,1450
RS,98272,FORTALEZA DOS VALOS,1415,1581,594,3974,3380,94,83
RS,98299,JÓIA,3095,1746,1153,6703,5550,138,134
SC,80004,MONTE CARLO,2002,2424,1473,7048,5575,236,286
SC,80012,ABELARDO LUZ,4217,4219,2712,12631,9919,269,293
SC,80020,IPORÃ DO OESTE,2571,2731,787,6761,5974,173,162
SC,80039,AGROLÂNDIA,2464,3203,930,7500,6570,212,279
SC,80047,LINDÓIA DO SUL,1317,1431,456,3655,3199,110,124
SC,80055,AGRONÔMICA,1159,1877,419,3847,3428,89,131
SC,80063,APIÚNA,1837,3590,1233,7740,6507,207,281
SC,80071,ÁGUA DOCE,1391,2429,1054,5417,4363,118,148
SC,80080,DOUTOR PEDRINHO,517,1593,359,2794,2435,79,75
SC,80098,ÁGUAS DE CHAPECÓ,2053,1183,865,4663,3798,126,140
SC,80101,JOSÉ BOITEUX,1185,1457,636,3895,3259,103,151
SC,80110,ÁGUAS MORNAS,1417,2594,256,5048,4792,191,291
SC,80128,VITOR MEIRELES,1635,1538,828,4374,3546,78,105
SC,80136,ALFREDO WAGNER,2554,3493,779,7469,6690,126,218
SC,80144,UNIÃO DO OESTE,1009,868,309,2509,2200,90,91
SC,80152,ANCHIETA,2290,1390,1039,5271,4232,155,160
SC,80160,URUPEMA,646,973,341,2192,1851,45,76
SC,80179,ANGELINA,1992,1830,225,4561,4336,115,167
SC,80187,IRACEMINHA,1471,1324,448,3526,3078,90,96
SC,80195,ANITA GARIBALDI,2949,1853,1988,7688,5700,230,260
SC,80209,TIMBÓ GRANDE,2374,1445,1066,5582,4516,88,118
SC,80217,ANITÁPOLIS,1039,1052,225,2657,2432,75,98
SC,80225,ABDON BATISTA,869,898,269,2297,2028,64,83
SC,80233,ANTÔNIO CARLOS,1476,3602,315,6406,6091,181,297
SC,80241,SANTA ROSA DO SUL,2321,2142,1044,6673,5629,193,233
SC,80250,ARAQUARI,4921,4653,3221,16439,13218,643,629
SC,80268,CELSO RAMOS,1038,691,234,2227,1993,89,60
SC,80276,ARARANGUÁ,13863,16030,7311,46762,39451,1164,1387
SC,80284,SERRA ALTA,1141,967,286,2640,2354,81,57
SC,80292,ARMAZÉM,1726,2824,724,6103,5379,163,159
SC,80306,COCAL DO SUL,2699,5695,1854,12818,10964,404,614
SC,80314,ARROIO TRINTA,758,1575,407,3070,2663,58,90
SC,80322,NOVA ITABERABA,1742,1274,409,3790,3381,64,100
SC,80330,ASCURRA,1025,3186,941,6160,5219,220,264
SC,80349,SANTA TEREZINHA,2325,2705,1226,6799,5573,160,127
SC,80357,ATALANTA,801,1372,353,2846,2493,62,77
SC,80365,MIRIM DOCE,799,871,300,2229,1929,23,60
SC,80373,AURORA,1570,2126,384,4537,4153,107,144
SC,80381,CERRO NEGRO,1455,697,555,3043,2488,57,120
SC,80390,BALNEÁRIO CAMBORIÚ,11303,37346,19691,86981,67290,2149,2894
SC,80403,PASSO DE TORRES,1551,1748,856,5049,4193,186,176
SC,80411,BARRA VELHA,3952,6306,4053,18575,14522,633,674
SC,80420,BRAÇO DO TROMBUDO,661,1706,428,3084,2656,28,92
SC,80438,BENEDITO NOVO,1081,4995,1057,8060,7003,254,285
SC,80446,SUL BRASIL,1027,818,244,2277,2033,43,56
SC,80454,BIGUAÇU,9348,15173,6778,43987,37209,2100,2483
SC,80462,VARGEM,990,877,533,2734,2201,69,73
SC,80470,BLUMENAU,33749,117119,37973,238124,200151,7556,13136
SC,80489,ARABUTÃ,1430,1498,442,3687,3245,72,101
SC,80497,BOM RETIRO,2129,2772,1582,7174,5592,145,252
SC,80500,ÁGUAS FRIAS,980,839,216,2235,2019,50,62
SC,80519,BOTUVERÁ,1054,1960,332,3842,3510,153,147
SC,80527,GUATAMBÚ,2190,1387,543,4767,4224,142,126
SC,80535,BRAÇO DO NORTE,4226,12460,2858,22351,19493,633,746
SC,80543,PLANALTO ALEGRE,1291,886,308,2769,2461,46,90
SC,80551,BRUSQUE,10233,45544,11602,81489,69887,2140,3048
SC,80560,RIQUEZA,1780,1186,532,3832,3300,94,106
SC,80578,CAÇADOR,14096,18131,10109,51220,41111,2083,1749
SC,80586,LAJEADO GRANDE,640,553,265,1587,1322,21,38
SC,80594,CAIBI,1905,1731,725,4867,4142,125,179
SC,80608,RIO RUFINO,747,910,404,2290,1886,42,57
SC,80616,CAMBORIÚ,8190,12531,7777,39135,31358,1594,1543
SC,80624,PASSOS MAIA,1467,988,676,3382,2706,43,73
SC,80632,CAMPO ALEGRE,1599,4976,1491,9208,7717,241,272
SC,80640,SÃO JOÃO DO OESTE,1531,2331,547,5040,4493,157,243
SC,80659,CAMPO BELO DO SUL,2241,2143,1062,6078,5016,119,218
SC,80667,CALMON,1376,792,834,3341,2507,43,67
SC,80675,CAMPO ERÊ,3075,1903,1438,7279,5841,189,199
SC,80683,BALNEÁRIO BARRA DO SUL,2444,2305,1750,8062,6312,159,276
SC,80691,CAMPOS NOVOS,6244,10430,4879,25311,20432,856,772
SC,80705,PARAÍSO,1589,1082,624,3656,3032,83,101
SC,80713,CANELINHA,1904,3967,1489,8847,7358,289,312
SC,80721,SANTA HELENA,1011,746,303,2262,1959,43,38
SC,80730,CANOINHAS,9908,17882,7522,41114,33592,1002,995
SC,80748,BELMONTE,988,775,323,2292,1969,48,64
SC,80756,CAPINZAL,4173,7034,2511,15947,13436,596,606
SC,80764,NOVO HORIZONTE,996,805,351,2388,2037,39,37
SC,80772,CATANDUVAS,2209,3024,1153,7267,6114,183,221
SC,80780,SÃO MIGUEL DA BOA VISTA,794,514,225,1719,1494,61,62
SC,80799,CAXAMBU DO SUL,1963,1225,525,4153,3628,86,122
SC,80802,ARVOREDO,962,684,237,2126,1889,36,52
SC,80810,CHAPECÓ,44653,48616,20434,136665,116231,3768,4266
SC,80829,IPUAÇU,2512,1000,762,4750,3988,76,130
SC,80837,CONCÓRDIA,14415,22672,8767,54674,45907,1546,1707
SC,80845,OURO VERDE,674,793,270,2061,1791,50,73
SC,80853,CORONEL FREITAS,2895,3171,1182,8179,6997,252,236
SC,80861,IRATI,718,583,252,1816,1564,63,46
SC,80870,CORUPÁ,2720,5255,1629,11417,9788,318,500
SC,80888,FORMOSA DO SUL,1025,625,315,2243,1928,75,49
SC,80896,CRICIÚMA,26538,56022,23169,141977,118808,4670,5673
SC,80900,MACIEIRA,712,740,280,1888,1608,36,53
SC,80918,CUNHA PORÃ,2498,4337,1138,8642,7504,172,278
SC,80926,PONTE ALTA DO NORTE,794,994,585,2700,2115,48,75
SC,80934,CURITIBANOS,7307,12128,6236,30081,23845,1054,1279
SC,80942,SÃO CRISTÓVÃO DO SUL,773,1404,839,3496,2657,84,106
SC,80950,DESCANSO,2870,2507,736,6832,6096,182,179
SC,80969,VARGEM BONITA,1331,1459,680,3998,3318,63,77
SC,80977,DIONÍSIO CERQUEIRA,4145,3296,2438,11406,8968,171,408
SC,80985,BOMBINHAS,2498,3981,2152,11061,8909,336,501
SC,80993,DONA EMMA,1051,1194,320,2880,2560,72,74
SC,81000,SANGÃO,2144,3280,1221,7826,6605,164,274
SC,81019,ERVAL VELHO,1025,1787,462,3665,3203,92,97
SC,81027,CAPIVARI DE BAIXO,5738,4303,2417,16619,14202,503,743
SC,81035,FAXINAL DOS GUEDES,4168,2137,1255,8432,7177,157,286
SC,81043,CORDILHEIRA ALTA,1697,1129,356,3529,3173,96,79
SC,81051,FLORIANÓPOLIS,54203,118530,63273,335480,272207,10074,18118
SC,81060,FORQUILHINHA,4102,7796,1987,17630,15643,614,578
SC,81078,FRAIBURGO,5751,10733,5801,26956,21155,972,910
SC,81086,MORRO GRANDE,738,1439,331,2897,2566,76,110
SC,81094,GALVÃO,1217,876,550,2968,2418,83,101
SC,81108,CORONEL MARTINS,898,664,292,2053,1761,31,47
SC,81116,GOVERNADOR CELSO RAMOS,1768,5208,953,10941,9988,401,583
SC,81124,SÃO JOÃO DO ITAPERIÚ,665,1518,464,3101,2637,89,89
SC,81132,GAROPABA,3356,5806,2603,15417,12814,547,587
SC,81140,JARDINÓPOLIS,558,552,175,1469,1294,53,38
SC,81159,GARUVA,2533,4183,2054,10700,8646,362,389
SC,81167,ERMO,817,1095,259,2625,2366,58,89
SC,81175,GASPAR,8293,19977,5903,41667,35764,1285,1571
SC,81183,SÃO PEDRO DE ALCÂNTARA,811,1616,209,3276,3067,84,176
SC,81191,GRÃO-PARÁ,1547,2809,570,5627,5057,158,253
SC,81205,SANTIAGO DO SUL,568,532,183,1409,1226,25,37
SC,81213,GRAVATAL,1673,4509,1071,8464,7393,172,269
SC,81221,BELA VISTA DO TOLDO,1883,1819,727,4890,4163,83,86
SC,81230,GUABIRUBA,2078,8287,1492,13920,12428,446,595
SC,81248,CAPÃO ALTO,771,1228,478,2876,2398,53,98
SC,81256,GUARACIABA,3417,3246,967,8515,7548,208,248
SC,81264,PAINEL,939,894,373,2440,2067,30,80
SC,81272,GUARAMIRIM,6427,11527,4283,27040,22757,1014,1030
SC,81280,BOCAINA DO SUL,1310,999,297,2913,2616,33,108
SC,81299,GUARUJÁ DO SUL,1430,1428,639,3969,3330,87,113
SC,81302,ALTO BELA VISTA,632,796,207,1839,1632,25,57
SC,81310,HERVAL D'OESTE,3827,7147,2743,16380,13637,463,572
SC,81329,FREI ROGÉRIO,888,782,367,2265,1898,52,77
SC,81337,IBICARÉ,784,1503,365,2918,2553,66,77
SC,81345,TREVISO,790,1808,497,3732,3235,92,157
SC,81353,IBIRAMA,3559,6130,2468,14208,11740,384,642
SC,81361,IOMERÊ,767,1320,406,2800,2394,69,100
SC,81370,IÇARA,11022,13255,5170,37401,32231,1252,1463
SC,81388,BOM JESUS,967,695,365,2333,1968,57,83
SC,81396,ILHOTA,1970,4489,1748,10453,8705,343,462
SC,81400,IBIAM,612,803,209,1795,1586,41,53
SC,81418,IMARUÍ,3526,2803,1993,10057,8064,331,441
SC,81426,ENTRE RIOS,1440,437,527,2705,2178,43,53
SC,81434,IMBITUBA,8572,9932,6488,33388,26900,1068,1504
SC,81442,PAIAL,749,553,271,1780,1509,39,32
SC,81450,IMBUIA,1959,1647,478,4513,4035,144,119
SC,81469,BOM JESUS DO OESTE,858,605,229,1853,1624,50,51
SC,81477,INDAIAL,6627,20744,6438,41238,34800,1379,1946
SC,81485,SÃO BERNARDINO,1280,527,277,2287,2010,45,58
SC,81493,IPIRA,1505,1322,498,3722,3224,132,104
SC,81507,SANTA TEREZINHA DO PROGRESSO,1253,584,368,2447,2079,94,60
SC,81515,IPUMIRIM,2307,2099,652,5687,5035,152,182
SC,81523,SALTINHO,1605,744,506,3234,2728,99,88
SC,81531,IRANI,2849,2537,994,7257,6263,202,170
SC,81540,JUPIÁ,957,497,241,1892,1651,48,59
SC,81558,IRINEÓPOLIS,3085,2616,1184,7734,6550,149,183
SC,81566,PALMEIRA,793,1190,437,2787,2350,55,102
SC,81574,ITÁ,1983,2058,1123,5834,4711,134,167
SC,81582,BANDEIRANTE,1265,855,363,2687,2324,49,67
SC,81590,ITAIÓPOLIS,4690,6775,2719,15936,13217,480,550
SC,81604,FLOR DO SERTÃO,830,366,248,1606,1358,35,60
SC,81612,ITAJAÍ,23808,51085,24814,136231,111417,5013,6225
SC,81620,CUNHATAÍ,735,649,151,1642,1491,35,43
SC,81639,ITAPEMA,5399,14499,6460,33302,26842,863,1105
SC,81647,PRINCESA,1059,809,320,2442,2122,51,60
SC,81655,ITAPIRANGA,3161,5178,1624,11599,9975,326,343
SC,81663,ITAPOÁ,2689,3451,2989,11782,8793,395,460
SC,81671,ITUPORANGA,4527,8772,2119,17380,15261,440,498
SC,81680,TIGRINHOS,939,505,263,1831,1568,31,46
SC,81698,JABORÁ,1283,1479,443,3627,3184,83,91
SC,81701,CHAPADÃO DO LAGEADO,895,1023,216,2297,2081,35,71
SC,81710,JACINTO MACHADO,2169,4275,1274,8965,7691,261,327
SC,81728,BALNEÁRIO ARROIO DO SILVA,2624,2531,1720,8772,7052,202,296
SC,81736,JAGUARUNA,4584,4604,2134,13703,11569,331,455
SC,81744,BALNEÁRIO GAIVOTA,2359,2087,1371,7074,5703,167,226
SC,81752,JARAGUÁ DO SUL,21880,52226,16236,110428,94192,3323,4094
SC,81760,BARRA BONITA,784,623,286,1864,1578,43,39
SC,81779,JOAÇABA,4196,10630,3770,21483,17713,410,583
SC,81787,BRUNÓPOLIS,1024,971,409,2786,2377,61,115
SC,81795,JOINVILLE,76070,144685,60494,387585,327091,15040,22513
SC,81809,LUZERNA,1014,2582,531,4754,4223,95,173
SC,81817,LACERDÓPOLIS,521,928,256,2012,1756,55,85
SC,81825,ZORTÉA,863,1116,293,2600,2307,83,85
SC,81833,LAGES,31701,44763,21980,120605,98625,3684,4462
SC,81850,LAGUNA,10371,10263,5658,33345,27687,1022,1347
SC,81876,LAURENTINO,1517,2495,531,5208,4677,126,205
SC,81892,LAURO MÜLLER,2126,5937,1667,12049,10382,354,639
SC,81914,LEBON RÉGIS,3740,2084,2109,9132,7023,273,288
SC,81930,LEOBERTO LEAL,1327,1074,349,3002,2653,64,90
SC,81957,LONTRAS,2108,3669,1242,8046,6804,281,290
SC,81973,LUÍS ALVES,1378,5098,986,8343,7357,179,266
SC,81990,MAFRA,8153,19144,7163,42313,35150,1943,1780
SC,82015,MAJOR GERCINO,818,1302,262,2687,2425,66,76
SC,82031,MAJOR VIEIRA,1893,2446,757,5659,4902,133,167
SC,82058,MARAVILHA,6092,6738,2766,17628,14862,462,592
SC,82066,MAREMA,943,704,255,2046,1791,45,35
SC,82074,MASSARANDUBA,2477,6779,1623,12168,10545,271,406
SC,82090,MATOS COSTA,928,639,654,2446,1792,26,58
SC,82112,MELEIRO,1349,2867,745,5769,5024,149,187
SC,82139,MODELO,1345,1185,357,3205,2848,73,107
SC,82155,MONDAÍ,2964,2582,1074,7378,6304,148,242
SC,82171,MONTE CASTELO,2097,2367,1435,6895,5460,185,177
SC,82198,MORRO DA FUMAÇA,2974,5549,1454,12613,11159,353,472
SC,82210,NAVEGANTES,8407,15624,8259,41917,33658,1435,1600
SC,82236,NOVA ERECHIM,1179,1662,411,3651,3240,77,111
SC,82252,NOVA TRENTO,2197,4799,804,9454,8650,380,477
SC,82279,NOVA VENEZA,2776,5706,1369,11529,10160,308,404
SC,82295,ORLEANS,2504,10344,2535,18068,15533,568,673
SC,82317,OURO,1490,3033,850,5972,5122,157,201
SC,82333,PALHOÇA,19751,35870,14721,98848,84127,5093,5962
SC,82350,PALMA SOLA,2703,1374,1251,5995,4744,155,159
SC,82376,PALMITOS,4722,4590,2204,12790,10586,325,419
SC,82392,PAPANDUVA,5244,5242,2510,14581,12071,420,383
SC,82414,PAULO LOPES,1487,1905,331,5054,4723,150,215
SC,82430,PEDRAS GRANDES,950,1954,544,3906,3362,76,134
SC,82457,PENHA,3324,7124,4139,18773,14634,524,644
SC,82473,PERITIBA,809,1384,328,2800,2472,82,54
SC,82490,PETROLÂNDIA,1729,2280,597,5035,4438,100,158
SC,82511,BALNEÁRIO PIÇARRAS,2664,5223,3091,13616,10525,324,459
SC,82538,PINHALZINHO,4933,5105,1972,13516,11544,350,420
SC,82554,PINHEIRO PRETO,650,1311,384,2669,2285,69,94
SC,82570,PIRATUBA,1329,1910,368,4122,3754,101,144
SC,82597,POMERODE,3611,11790,3019,21947,18928,677,1170
SC,82619,PONTE ALTA,1255,1285,870,4104,3234,106,156
SC,82635,PONTE SERRADA,3307,2383,1967,8780,6813,221,235
SC,82651,PORTO BELO,2064,4539,2385,11549,9164,326,472
SC,82678,PORTO UNIÃO,6043,10209,5334,24860,19526,602,636
SC,82694,POUSO REDONDO,2853,4939,1813,10948,9135,304,341
SC,82716,PRAIA GRANDE,1763,2142,841,5789,4948,196,239
SC,82732,PRESIDENTE CASTELO BRANCO,428,790,126,1497,1371,29,51
SC,82759,PRESIDENTE GETÚLIO,3249,5382,1701,11924,10223,355,528
SC,82775,PRESIDENTE NEREU,613,933,480,2274,1794,74,75
SC,82791,QUILOMBO,3305,2761,1299,8394,7095,226,215
SC,82813,RANCHO QUEIMADO,733,1211,171,2526,2355,74,104
SC,82830,RIO DAS ANTAS,1070,2821,1039,5668,4629,171,196
SC,82856,RIO DO CAMPO,1393,2541,664,5092,4428,90,141
SC,82872,RIO DO OESTE,1968,2398,581,5488,4907,121,189
SC,82899,RIO DOS CEDROS,1501,4548,1042,8088,7046,215,352
SC,82910,RIO DO SUL,9081,23825,7809,47848,40039,1425,1944
SC,82937,RIO FORTUNA,1065,2537,326,4252,3926,92,107
SC,82953,RIO NEGRINHO,5559,14233,6241,31868,25627,795,1073
SC,82970,RODEIO,1532,4911,1302,8888,7586,291,371
SC,82996,ROMELÂNDIA,1909,1137,759,4265,3506,132,124
SC,83011,SALETE,1834,2599,1007,6046,5039,126,191
SC,83038,SALTO VELOSO,1062,1533,569,3642,3073,65,170
SC,83054,SANTA CECÍLIA,3039,4704,2814,12601,9787,513,382
SC,83070,SANTA ROSA DE LIMA,615,929,206,1959,1753,63,49
SC,83097,SANTO AMARO DA IMPERATRIZ,3700,7473,1901,16153,14252,548,897
SC,83119,SÃO BENTO DO SUL,10832,29629,9075,59643,50568,1767,1947
SC,83135,SÃO BONIFÁCIO,618,1445,178,2532,2354,85,87
SC,83151,SÃO CARLOS,2718,3418,1071,7836,6765,157,156
SC,83178,SÃO DOMINGOS,2894,2359,1170,7222,6052,197,186
SC,83194,SÃO FRANCISCO DO SUL,6926,10870,6980,33739,26759,1005,1347
SC,83216,SÃO JOÃO BATISTA,2749,9214,3053,19045,15992,683,682
SC,83232,SÃO JOÃO DO SUL,1802,2715,692,6238,5546,156,148
SC,83259,SÃO JOAQUIM,5127,8641,2942,18821,15879,576,716
SC,83275,SÃO JOSÉ,27450,54640,24395,151152,126757,6145,9022
SC,83291,SÃO JOSÉ DO CEDRO,3575,4435,1953,11019,9066,247,258
SC,83313,SÃO JOSÉ DO CERRITO,3171,2067,1033,6987,5954,171,239
SC,83330,SÃO LOURENÇO DO OESTE,6552,6344,2774,17615,14841,470,443
SC,83356,SÃO LUDGERO,2074,4102,1089,8304,7215,235,268
SC,83372,SÃO MARTINHO,816,1677,295,3090,2795,91,77
SC,83399,SÃO MIGUEL DO OESTE,9073,11042,5361,28659,23298,708,861
SC,83410,SAUDADES,2634,3126,635,7063,6428,153,196
SC,83437,SCHROEDER,2985,5231,1558,11932,10374,393,480
SC,83453,SEARA,4709,5327,2305,13947,11642,367,421
SC,83470,SIDERÓPOLIS,2111,5039,1681,10952,9271,349,398
SC,83496,SOMBRIO,6011,7159,3248,20682,17434,576,705
SC,83518,TAIÓ,3236,6392,1911,13304,11393,333,503
SC,83534,TANGARÁ,1778,3314,1134,6975,5841,185,223
SC,83550,TIJUCAS,4473,10580,4527,24940,20413,775,1180
SC,83577,TIMBÓ,3809,16972,3930,29354,25424,863,1272
SC,83593,TRÊS BARRAS,3979,4622,2885,14379,11494,407,407
SC,83615,TREZE DE MAIO,1371,3108,794,6082,5288,167,168
SC,83631,TREZE TÍLIAS,903,2751,808,5025,4217,112,164
SC,83658,TROMBUDO CENTRAL,1295,2386,746,5254,4508,140,193
SC,83674,TUBARÃO,16108,28925,12429,75453,63024,2139,3259
SC,83682,TUNÁPOLIS,1425,1569,413,3820,3407,105,157
SC,83690,TURVO,2297,5031,1235,9894,8659,248,374
SC,83712,URUBICI,2033,3403,1692,7977,6285,151,294
SC,83739,URUSSANGA,2667,7987,3076,16905,13829,405,744
SC,83755,VARGEÃO,1240,873,459,2862,2403,73,73
SC,83771,VIDAL RAMOS,2103,1800,549,4893,4344,125,143
SC,83798,VIDEIRA,7258,16145,6812,35870,29058,1322,1438
SC,83810,WITMARSUM,1081,1329,441,3154,2713,76,112
SC,83836,XANXERÊ,12490,10818,5681,33431,27750,783,1006
SC,83852,XAVANTINA,1466,1384,377,3579,3202,94,54
SC,83879,XAXIM,7137,7463,3301,20775,17474,622,742
SC,83895,BOM JARDIM DA SERRA,1375,1262,605,3535,2930,56,106
SC,83909,BALNEÁRIO RINCÃO,2997,2832,1752,9843,8091,251,312
SC,83917,MARACAJÁ,2019,2005,625,5569,4944,159,180
SC,83925,PESCARIA BRAVA,2644,2132,922,7046,6124,195,289
SC,83933,TIMBÉ DO SUL,1532,1833,557,4532,3975,115,161
SC,83950,CORREIA PINTO,3970,3719,2071,11831,9760,302,394
SC,83976,OTACÍLIO COSTA,3055,5081,2125,12470,10345,311,415
SE,31003,SANTANA DO SÃO FRANCISCO,2774,600,800,5032,4232,176,240
SE,31011,AMPARO DE SÃO FRANCISCO,1078,571,260,2341,2081,42,97
SE,31038,AQUIDABÃ,7733,1928,1965,14398,12433,368,866
SE,31054,ARACAJU,110662,81603,59455,389739,330284,14984,24472
SE,31070,ARAUÁ,3879,1448,1255,8430,7175,283,473
SE,31097,AREIA BRANCA,4913,2830,1409,11902,10493,523,718
SE,31119,BARRA DOS COQUEIROS,6299,2797,2873,17141,14268,690,984
SE,31135,BREJO GRANDE,3078,774,928,5723,4795,163,331
SE,31151,BOQUIM,8889,2361,3109,19255,16146,706,1278
SE,31194,CAMPO DO BRITO,5729,2650,2370,13224,10854,423,847
SE,31216,CANHOBA,2418,342,433,3827,3394,92,187
SE,31232,CANINDÉ DE SÃO FRANCISCO,11385,1901,4038,20805,16767,432,1120
SE,31259,CAPELA,9321,3921,3228,21700,18472,1106,1563
SE,31275,CARIRA,8383,2005,2355,15227,12872,355,1025
SE,31291,CARMÓPOLIS,4506,1803,2181,12831,10650,500,730
SE,31313,CEDRO DE SÃO JOÃO,2374,748,560,4500,3940,97,248
SE,31330,CRISTINÁPOLIS,6018,1127,2454,11704,9250,245,647
SE,31356,NOSSA SENHORA APARECIDA,3088,1575,941,6632,5691,214,361
SE,31372,CUMBE,1668,566,315,3362,3047,60,164
SE,31399,DIVINA PASTORA,1761,353,480,3397,2917,125,228
SE,31410,ESTÂNCIA,20391,4580,7300,43014,35714,1958,2462
SE,31437,FEIRA NOVA,2581,793,539,4858,4319,109,246
SE,31453,FREI PAULO,4429,3199,1518,11049,9531,339,631
SE,31470,GENERAL MAYNARD,914,363,312,2270,1958,82,156
SE,31496,GARARU,4648,886,1115,8120,7005,196,467
SE,31518,GRACCHO CARDOSO,3070,553,652,5143,4491,129,234
SE,31534,ILHA DAS FLORES,3255,994,1066,6497,5431,226,296
SE,31550,INDIAROBA,5550,978,1795,10470,8675,290,613
SE,31577,ITABAIANA,24276,16380,7247,60072,52825,1886,3577
SE,31593,ITABAIANINHA,12785,3828,3705,25886,22181,913,1672
SE,31615,ITABI,1997,732,551,4073,3522,125,241
SE,31631,ITAPORANGA D'AJUDA,10213,3275,3405,23052,19647,1125,1591
SE,31658,JAPARATUBA,6293,1954,1616,12413,10797,377,637
SE,31674,JAPOATÃ,5222,1391,1208,9593,8385,374,551
SE,31690,LAGARTO,30459,9923,9361,66270,56909,2593,4912
SE,31712,LARANJEIRAS,8096,2818,2569,19436,16867,1111,1319
SE,31739,MACAMBIRA,2690,1273,723,5520,4797,155,264
SE,31755,MALHADA DOS BOIS,1926,398,452,3349,2897,101,160
SE,31771,MALHADOR,4242,1613,1188,8924,7736,335,703
SE,31798,MARUIM,5915,1078,1607,11409,9802,507,759
SE,31810,MOITA BONITA,3292,2087,1087,8342,7255,347,672
SE,31836,MONTE ALEGRE DE SERGIPE,5127,1452,1446,9508,8062,216,541
SE,31852,MURIBECA,3002,855,794,6056,5262,266,321
SE,31879,NEÓPOLIS,6691,1454,2018,13132,11114,440,814
SE,31895,NOSSA SENHORA DA GLÓRIA,12714,3363,2945,23321,20376,634,1204
SE,31917,NOSSA SENHORA DAS DORES,8039,3584,2456,18119,15663,894,1240
SE,31933,NOSSA SENHORA DE LOURDES,3187,492,539,5048,4509,93,289
SE,31950,NOSSA SENHORA DO SOCORRO,32397,15982,11653,93641,81988,4869,5946
SE,31976,PACATUBA,5492,786,1755,10059,8304,363,518
SE,31992,PEDRA MOLE,1312,264,351,2846,2495,54,138
SE,32018,PEDRINHAS,2885,935,1281,6576,5295,151,389
SE,32034,PINHÃO,2657,538,800,4961,4161,142,270
SE,32050,PIRAMBU,3234,954,941,6594,5653,242,324
SE,32077,POÇO REDONDO,8884,2847,2835,17467,14632,419,1010
SE,32093,POÇO VERDE,8217,2763,2912,16686,13774,350,913
SE,32115,PORTO DA FOLHA,11139,2704,3211,20147,16936,604,1055
SE,32131,PROPRIÁ,8675,3682,2853,19061,16208,654,846
SE,32158,RIACHÃO DO DANTAS,7813,1720,2038,14993,12955,686,956
SE,32174,RIACHUELO,3088,864,1046,6979,5933,358,461
SE,32190,RIBEIRÓPOLIS,5169,3584,1843,13044,11201,416,889
SE,32212,ROSÁRIO DO CATETE,3666,819,1153,7703,6550,320,550
SE,32239,SALGADO,6834,1504,1617,13730,12113,611,1030
SE,32255,SANTA LUZIA DO ITANHY,5098,1038,1580,9440,7860,364,579
SE,32298,SANTA ROSA DE LIMA,1818,419,445,3469,3024,147,231
SE,32310,SANTO AMARO DAS BROTAS,4041,708,1664,7903,6239,229,496
SE,32336,SÃO CRISTÓVÃO,19648,6715,6347,50017,43670,2631,3873
SE,32352,SÃO DOMINGOS,3090,1582,1333,7382,6049,140,510
SE,32379,SÃO FRANCISCO,1725,399,477,3236,2759,64,164
SE,32395,SÃO MIGUEL DO ALEIXO,1358,734,496,3248,2752,91,253
SE,32417,SIMÃO DIAS,14753,5206,3997,30915,26918,899,2098
SE,32433,SIRIRI,2930,729,623,5659,5036,230,329
SE,32450,TELHA,1386,768,348,2870,2522,53,128
SE,32476,TOBIAS BARRETO,16851,4031,4640,34361,29721,823,2014
SE,32492,TOMAR DO GERU,4147,1405,2045,9334,7289,217,569
SE,32514,UMBAÚBA,6473,2877,2892,16008,13116,578,905
SP,61000,EUCLIDES DA CUNHA PAULISTA,2879,1369,2352,7790,5438,167,156
SP,61018,ADAMANTINA,4376,11425,6412,27575,21163,1082,652
SP,61026,BOREBI,418,754,340,1986,1646,43,38
SP,61034,ADOLFO,868,1251,738,3558,2820,137,100
SP,61042,TARUMÃ,3047,3682,1955,10716,8761,262,260
SP,61050,AGUAÍ,4716,8184,5786,24424,18638,1105,1115
SP,61069,MOTUCA,1098,913,886,3665,2779,113,90
SP,61077,ÁGUAS DA PRATA,1269,2509,1417,6422,5005,190,199
SP,61085,IARAS,1187,908,1168,3974,2806,123,124
SP,61093,ÁGUAS DE LINDÓIA,1527,5948,2946,13763,10817,380,471
SP,61107,GUATAPARÁ,1468,1530,1187,5245,4058,202,144
SP,61115,ÁGUAS DE SÃO PEDRO,324,1565,352,2877,2525,51,83
SP,61123,DIRCE REIS,469,667,290,1595,1305,59,31
SP,61131,AGUDOS,3782,8379,5676,28617,22941,1199,1520
SP,61140,ESPÍRITO SANTO DO TURVO,1189,1048,739,3443,2704,79,53
SP,61158,ALFREDO MARCONDES,1006,1316,634,3649,3015,108,127
SP,61166,ROSANA,5574,2819,5522,16636,11114,352,427
SP,61174,ALTAIR,880,973,757,3090,2333,103,93
SP,61182,EMBAÚBA,409,1161,463,2449,1986,65,86
SP,61190,ALTINÓPOLIS,2436,4445,3179,13219,10040,593,513
SP,61204,ILHA SOLTEIRA,4128,5050,5999,21549,15550,527,847
SP,61212,ALTO ALEGRE,751,1314,821,3789,2968,159,148
SP,61220,ALUMÍNIO,3053,3899,2654,14358,11704,506,581
SP,61239,ÁLVARES FLORENCE,720,1817,739,3772,3033,119,113
SP,61247,PEDRINHAS PAULISTA,660,1041,618,2761,2143,51,98
SP,61255,ÁLVARES MACHADO,4019,6142,3728,17791,14063,639,542
SP,61263,ARAÇARIGUAMA,2347,3657,3674,14683,11009,524,452
SP,61271,ÁLVARO DE CARVALHO,778,807,778,3133,2355,116,194
SP,61280,BERTIOGA,7388,10868,9660,38817,29157,1078,1231
SP,61298,ALVINLÂNDIA,695,775,548,2666,2118,88,66
SP,61301,SUZANÁPOLIS,982,943,551,2829,2278,72,78
SP,61310,AMERICANA,29533,58308,29862,172014,142152,7418,8015
SP,61328,SANTO ANTÔNIO DO ARACANGUÁ,1869,2277,965,6058,5093,87,93
SP,61336,AMÉRICO BRASILIENSE,8024,6048,5361,26830,21469,1064,1303
SP,61344,CANITAR,682,1120,777,3699,2922,152,168
SP,61352,AMÉRICO DE CAMPOS,845,2287,724,4712,3988,168,145
SP,61360,BARRA DO CHAPÉU,2161,748,1103,4597,3494,115,115
SP,61379,AMPARO,6655,23779,10354,52687,42333,2174,2292
SP,61387,EMILIANÓPOLIS,895,744,503,2593,2090,84,78
SP,61395,ANALÂNDIA,445,1556,531,3502,2971,112,147
SP,61409,NOVAIS,607,1322,724,3424,2700,137,152
SP,61417,ANDRADINA,9595,12978,9956,43973,34017,1504,1419
SP,61425,NOVA CANAÃ PAULISTA,670,633,439,2064,1625,70,51
SP,61433,ANGATUBA,4189,5624,3623,17384,13761,538,590
SP,61441,SALTINHO,494,3283,856,6119,5263,235,185
SP,61450,ANHEMBI,579,2207,1594,5596,4002,142,132
SP,61468,UBARANA,1213,1263,1045,4412,3367,165,117
SP,61476,ANHUMAS,672,1421,595,3303,2708,105,95
SP,61484,CAJATI,5203,5736,6654,23436,16782,625,517
SP,61492,APARECIDA,5030,10435,5817,29180,23363,914,801
SP,61506,CAMPINA DO MONTE ALEGRE,1039,1398,901,4570,3669,127,136
SP,61514,APARECIDA D'OESTE,1076,1490,887,3967,3080,118,91
SP,61522,ASPÁSIA,525,741,320,1801,1481,36,39
SP,61530,APIAÍ,6482,4707,5794,20664,14870,571,555
SP,61549,VARGEM,958,2907,1600,7053,5453,273,259
SP,61557,ARAÇATUBA,25150,52132,28845,141542,112697,3433,4145
SP,61565,POTIM,2495,3430,2463,11562,9099,378,266
SP,61573,ARAÇOIABA DA SERRA,3257,8930,3777,21194,17417,829,858
SP,61581,ALAMBARI,919,1434,743,4035,3292,121,86
SP,61590,ARAMINA,1257,1341,901,4432,3531,147,153
SP,61603,ITAOCA,1097,621,778,2947,2169,82,80
SP,61611,ARANDU,1259,1964,938,5333,4395,253,164
SP,61620,TUIUTI,659,2612,982,5090,4108,175,170
SP,61638,ARARAQUARA,32402,45063,33868,162058,128190,6360,9332
SP,61646,ARAPEÍ,557,639,587,2434,1847,45,76
SP,61654,ARARAS,12768,35555,16291,94443,78152,3829,3880
SP,61662,ESTIVA GERBI,1703,2813,1312,8148,6836,316,372
SP,61670,AREALVA,1060,2502,1290,6236,4946,282,253
SP,61689,ENGENHEIRO COELHO,3391,2885,2831,12476,9645,315,327
SP,61697,AREIAS,892,933,827,3352,2525,77,103
SP,61700,RIBEIRÃO GRANDE,2704,1565,1373,6713,5340,207,161
SP,61719,AREIÓPOLIS,1861,2534,1691,8580,6889,387,227
SP,61727,HORTOLÂNDIA,42889,22804,25436,138583,113147,6404,5517
SP,61735,ARIRANHA,762,3427,1424,7235,5811,277,249
SP,61743,HOLAMBRA,1668,4913,1589,10383,8794,306,293
SP,61751,ARTUR NOGUEIRA,5651,10886,5422,31654,26232,1520,1133
SP,61760,ELISIÁRIO,493,1256,480,2718,2238,101,95
SP,61778,ARUJÁ,12320,18643,11068,62375,51307,2033,2412
SP,61786,BOM SUCESSO DE ITARARÉ,1069,992,761,3149,2388,34,36
SP,61794,ASSIS,12403,22867,16353,69655,53302,2113,2141
SP,61808,PONTALINDA,931,1104,804,3391,2587,150,59
SP,61816,ATIBAIA,10342,46091,21692,102560,80868,3732,3898
SP,61824,PARISI,382,1019,409,2180,1771,57,66
SP,61832,AURIFLAMA,2847,3951,2469,11422,8953,435,373
SP,61840,TAQUARIVAÍ,850,1999,1201,4762,3561,111,102
SP,61859,AVAÍ,839,1325,770,4041,3271,127,121
SP,61867,MARAPOAMA,348,1329,449,2536,2087,71,80
SP,61875,AVANHANDAVA,1825,2197,1619,7688,6069,290,239
SP,61883,SÃO JOÃO DE IRACEMA,528,477,362,1654,1292,44,46
SP,61891,AVARÉ,7559,25162,13781,63241,49460,2576,2630
SP,61905,SÃO LOURENÇO DA SERRA,2114,3767,2306,11035,8729,433,423
SP,61913,BADY BASSITT,2397,4659,2470,11897,9427,333,471
SP,61921,ZACARIAS,603,855,553,2375,1822,72,86
SP,61930,BALBINOS,199,525,381,1494,1113,40,55
SP,61948,ITAPIRAPUÃ PAULISTA,1129,843,761,3161,2400,108,57
SP,61956,BÁLSAMO,946,3680,1013,6813,5800,241,192
SP,61964,MESÓPOLIS,403,651,380,1690,1310,66,29
SP,61972,BANANAL,1988,2620,1809,8307,6498,218,278
SP,61980,NOVA CAMPINA,2727,1581,1429,6794,5365,103,93
SP,61999,BARBOSA,1188,2103,1253,5527,4274,117,154
SP,62006,ILHA COMPRIDA,1649,2516,2394,8329,5935,174,273
SP,62014,BARÃO DE ANTONINA,663,966,533,2521,1988,63,86
SP,62022,LOURDES,547,711,457,2021,1564,43,65
SP,62030,BARIRI,2274,11290,5961,24264,18303,1005,916
SP,62049,TORRE DE PEDRA,354,1024,726,2627,1901,50,51
SP,62057,BARRA BONITA,4142,12406,6322,30325,24003,1259,1252
SP,62065,ARCO-ÍRIS,417,770,389,2020,1631,46,47
SP,62073,BARRA DO TURVO,2427,1262,2676,7242,4566,98,177
SP,62081,BREJO ALEGRE,772,624,426,2358,1932,81,92
SP,62090,BARRETOS,15417,29478,19435,84991,65556,2734,3018
SP,62103,CANAS,796,1241,676,3695,3019,86,109
SP,62111,BARRINHA,4967,5356,4465,21644,17179,1034,793
SP,62120,PRACINHA,448,469,342,1499,1157,33,41
SP,62138,BARUERI,53675,61847,40333,236313,195980,9980,9924
SP,62146,PRATÂNIA,767,1597,1028,4322,3294,178,146
SP,62154,BASTOS,2193,6101,3808,17233,13425,730,391
SP,62162,QUADRA,512,1199,693,2960,2267,75,61
SP,62170,BATATAIS,7793,16314,8669,42875,34206,1731,1483
SP,62189,SANTA CRUZ DA ESPERANÇA,277,827,474,1908,1434,31,90
SP,62197,BAURU,49147,77422,49960,258271,208311,9991,11535
SP,62200,SANTA SALETE,377,654,244,1557,1313,58,39
SP,62219,BEBEDOURO,9725,23066,13042,57978,44936,2125,1744
SP,62227,VITÓRIA BRASIL,492,580,238,1571,1333,49,58
SP,62235,BENTO DE ABREU,382,612,534,2250,1716,90,91
SP,62243,IPIGUÁ,772,1589,742,3708,2966,130,71
SP,62251,BERNARDINO DE CAMPOS,1253,3109,1892,8503,6611,281,300
SP,62260,TAQUARAL,399,980,478,2253,1775,83,69
SP,62278,BILAC,792,2762,1229,5979,4750,187,233
SP,62286,FERNÃO,308,606,353,1578,1225,47,39
SP,62294,BIRIGUI,11337,32066,14268,80575,66307,3182,3658
SP,62308,GAVIÃO PEIXOTO,1104,1009,668,3717,3049,132,115
SP,62316,BIRITIBA MIRIM,3052,8774,4252,22301,18049,843,710
SP,62324,JUMIRIM,258,1157,514,2356,1842,54,44
SP,62332,BOA ESPERANÇA DO SUL,2683,3300,2112,10189,8077,422,373
SP,62340,NANTES,844,663,488,2320,1832,47,47
SP,62359,BOCAINA,889,4007,1799,8762,6963,343,307
SP,62367,NOVA CASTILHO,255,596,249,1322,1073,44,26
SP,62375,BOFETE,1586,2511,2121,7795,5674,239,277
SP,62383,OUROESTE,2023,2279,1558,7414,5856,264,250
SP,62391,BOITUVA,5019,13559,7939,38009,30070,1607,1807
SP,62405,PAULISTÂNIA,257,697,351,1617,1266,36,44
SP,62413,BOM JESUS DOS PERDÕES,2104,6333,2989,15050,12061,528,585
SP,62421,RIBEIRÃO DOS ÍNDIOS,585,706,457,2071,1614,78,65
SP,62430,BORÁ,293,354,221,1060,839,31,25
SP,62448,TRABIJU,262,679,250,1509,1259,40,25
SP,62456,BORACÉIA,802,1473,631,3601,2970,109,116
SP,62472,BORBOREMA,1527,5475,2635,11341,8706,399,344
SP,62499,BOTUCATU,13006,34913,18831,94688,75857,3591,5041
SP,62510,BRAGANÇA PAULISTA,12193,54821,22460,117985,95525,3724,4400
SP,62553,BRAÚNA,673,1839,776,4174,3398,149,139
SP,62570,BRODOWSKI,2387,6065,3172,15528,12356,569,618
SP,62596,BROTAS,1907,7090,4366,17840,13474,706,731
SP,62618,BURI,3103,5370,3344,14779,11435,489,298
SP,62634,BURITAMA,2821,4121,3009,12397,9388,435,432
SP,62650,BURITIZAL,572,1336,605,3380,2775,101,130
SP,62677,CABRÁLIA PAULISTA,948,1045,930,3905,2975,148,104
SP,62693,CABREÚVA,5918,10837,6003,32492,26489,1594,1304
SP,62715,CAÇAPAVA,9460,23737,13344,68328,54984,2557,2714
SP,62731,CACHOEIRA PAULISTA,4724,7320,5356,24573,19217,818,807
SP,62758,CACONDE,3701,4846,3574,14442,10868,362,388
SP,62774,CAFELÂNDIA,2000,5288,3237,13378,10141,496,352
SP,62790,CAIABU,1265,1189,705,3668,2963,109,66
SP,62812,CAIEIRAS,13229,16370,10682,63608,52926,3008,3557
SP,62839,CAIUÁ,1415,902,1082,4119,3037,98,96
SP,62855,CAJAMAR,12349,13685,9437,54514,45077,2317,2037
SP,62871,CAJOBI,1645,3162,1771,8046,6275,235,257
SP,62898,CAJURU,3848,6027,4277,18574,14297,824,809
SP,62910,CAMPINAS,146501,234695,164485,809149,644664,33768,42244
SP,62936,CAMPO LIMPO PAULISTA,12279,15494,11065,59558,48493,2589,3424
SP,62952,CAMPOS DO JORDÃO,4741,15901,9751,38653,28902,1515,1358
SP,62979,CAMPOS NOVOS PAULISTA,830,1288,818,3703,2885,120,83
SP,62995,CANANÉIA,1835,3040,3067,10204,7137,212,302
SP,63010,CÂNDIDO MOTA,4110,10070,5651,24684,19033,1038,752
SP,63037,CÂNDIDO RODRIGUES,419,1110,521,2548,2027,127,104
SP,63053,CAPÃO BONITO,6891,12352,8947,36779,27832,1309,889
SP,63070,CAPELA DO ALTO,2404,5180,2449,12812,10363,520,320
SP,63096,CAPIVARI,3912,15390,6805,35447,28642,1352,1266
SP,63118,CARAGUATATUBA,12380,22992,17745,77539,59794,2865,3024
SP,63134,CARAPICUÍBA,67425,61003,50120,276929,226809,13382,12762
SP,63150,CARDOSO,2307,3185,2722,10117,7395,351,383
SP,63177,CASA BRANCA,2914,7648,5442,21031,15589,832,919
SP,63193,CÁSSIA DOS COQUEIROS,464,1068,747,2774,2027,92,119
SP,63215,CASTILHO,4389,2703,2816,13931,11115,521,385
SP,63231,CATANDUVA,11821,34751,17102,85587,68485,3037,3884
SP,63258,CATIGUÁ,930,2538,882,5781,4899,243,313
SP,63274,CEDRAL,980,3086,1152,6684,5532,273,282
SP,63290,CERQUEIRA CÉSAR,2125,5244,3451,14129,10678,627,412
SP,63312,CERQUILHO,3065,13932,5716,30777,25061,1221,1531
SP,63339,CESÁRIO LANGE,1088,5175,2487,11725,9238,562,530
SP,63355,CHARQUEADA,1619,5218,2376,12516,10140,527,413
SP,63371,CHAVANTES,1843,3376,2070,9713,7643,338,325
SP,63398,CLEMENTINA,1017,2034,1106,5263,4157,169,161
SP,63410,COLINA,3032,5369,3441,14552,11111,535,525
SP,63436,COLÔMBIA,1343,1423,1448,5725,4277,149,142
SP,63452,CONCHAL,2544,8607,3746,20179,16433,864,685
SP,63479,CONCHAS,2151,4865,3813,13776,9963,356,417
SP,63495,CORDEIRÓPOLIS,2521,5848,3313,17384,14071,775,699
SP,63517,COROADOS,807,1442,776,4116,3340,120,109
SP,63533,CORONEL MACEDO,1470,1287,888,4341,3453,108,110
SP,63550,CORUMBATAÍ,367,1421,297,2771,2474,103,117
SP,63576,COSMÓPOLIS,9835,9243,9383,44308,34925,2132,2029
SP,63592,COSMORAMA,1314,2835,1128,6082,4954,197,129
SP,63614,COTIA,29400,44671,25621,148772,123151,6576,6346
SP,63630,CRAVINHOS,2915,10249,5275,24711,19436,985,1085
SP,63657,CRISTAIS PAULISTA,1242,2973,1446,6922,5476,183,178
SP,63673,CRUZÁLIA,492,997,408,2216,1808,29,36
SP,63690,CRUZEIRO,8570,19265,12059,59117,47058,2075,2830
SP,63711,CUBATÃO,25944,16237,18596,95161,76565,2861,3454
SP,63738,CUNHA,5621,4659,5190,19391,14201,582,623
SP,63754,DESCALVADO,2357,10996,5268,25201,19933,1214,1292
SP,63770,DIADEMA,97467,60407,56444,325070,268626,14766,17142
SP,63797,DIVINOLÂNDIA,1714,4463,2180,10199,8019,473,495
SP,63819,DOBRADA,1420,1788,1031,5570,4539,211,199
SP,63835,DOIS CÓRREGOS,1843,8236,4442,18983,14541,753,567
SP,63851,DOLCINÓPOLIS,948,524,430,2241,1811,60,80
SP,63878,DOURADO,962,3094,1618,7406,5788,400,352
SP,63894,DRACENA,5791,14324,6671,33814,27143,1049,854
SP,63916,DUARTINA,1812,3911,2002,10058,8056,311,331
SP,63932,DUMONT,949,2875,1238,6508,5270,271,245
SP,63959,ECHAPORÃ,1116,1876,1299,5315,4016,127,139
SP,63975,ELDORADO,3665,2633,3810,11798,7988,191,327
SP,63991,ELIAS FAUSTO,2801,4039,2841,13283,10442,611,549
SP,64017,EMBU DAS ARTES,41008,37695,12840,149651,136811,7905,7693
SP,64033,EMBU-GUAÇU,11573,13317,10443,50960,40517,2418,2356
SP,64050,ESTRELA D'OESTE,1239,2872,1405,6944,5539,259,245
SP,64076,ESTRELA DO NORTE,586,1056,513,2557,2044,55,50
SP,64092,FARTURA,2303,5204,3002,12833,9831,362,327
SP,64114,FERNANDÓPOLIS,12893,17096,11543,50930,39387,1779,1467
SP,64130,FERNANDO PRESTES,868,2279,1009,4878,3869,230,149
SP,64157,FERRAZ DE VASCONCELOS,29341,21889,22081,120730,98649,5832,6221
SP,64173,FLORA RICA,497,488,449,1820,1371,41,30
SP,64190,FLOREAL,625,1174,510,2675,2165,67,90
SP,64211,FLÓRIDA PAULISTA,1809,3302,1570,8357,6787,327,238
SP,64238,FLORÍNEA,743,928,524,2674,2150,56,46
SP,64254,FRANCA,39088,95163,38543,229101,190558,6922,6960
SP,64270,FRANCISCO MORATO,32727,21311,22080,112572,90492,6151,5530
SP,64297,FRANCO DA ROCHA,23466,20721,18264,95780,77516,5238,6295
SP,64319,GABRIEL MONTEIRO,251,1508,442,2585,2143,64,111
SP,64335,GÁLIA,1143,1912,1425,5584,4159,160,155
SP,64351,GARÇA,4392,13018,8505,34842,26337,1421,1292
SP,64378,GASTÃO VIDIGAL,1013,914,841,3333,2492,128,78
SP,64394,GENERAL SALGADO,1527,3659,1769,8565,6796,273,181
SP,64416,GETULINA,1541,2796,2453,8461,6008,304,264
SP,64432,GLICÉRIO,1104,1361,874,4076,3202,99,109
SP,64459,GUAIÇARA,1437,3030,1822,8277,6455,306,236
SP,64475,GUAIMBÉ,1200,1388,1006,4573,3567,155,160
SP,64491,GUAÍRA,6740,11013,7767,29692,21925,732,556
SP,64513,GUAPIAÇU,2747,5500,2958,14252,11294,596,476
SP,64530,GUAPIARA,5286,3950,4726,15916,11190,369,367
SP,64556,GUARÁ,4818,4362,3443,15313,11870,482,391
SP,64572,GUARAÇAÍ,1526,2577,1667,7005,5338,229,253
SP,64599,GUARACI,2290,2686,2272,8464,6192,201,208
SP,64610,GUARANI D'OESTE,555,516,361,1700,1339,41,63
SP,64637,GUARANTÃ,1195,1423,1362,5571,4209,265,122
SP,64653,GUARARAPES,4398,9223,5944,24855,18911,768,832
SP,64670,GUARAREMA,3957,7677,3748,22336,18588,696,724
SP,64696,GUARATINGUETÁ,12758,29928,17366,89296,71930,3031,2666
SP,64718,GUAREÍ,1817,3303,1885,8958,7073,470,340
SP,64734,GUARIBA,6396,8515,5688,28354,22666,1022,843
SP,64750,GUARUJÁ,52477,46850,41416,222004,180588,8875,10557
SP,64777,GUARULHOS,166770,217844,142094,868531,726437,37624,50568
SP,64793,GUZOLÂNDIA,1159,1144,834,3835,3001,145,137
SP,64815,HERCULÂNDIA,1789,2100,1517,6874,5357,163,244
SP,64831,IACANGA,1167,3043,1312,7463,6151,285,191
SP,64858,IACRI,941,2267,1153,5311,4158,186,132
SP,64874,IBATÉ,3938,7364,4974,24503,19529,1186,936
SP,64890,IBIRÁ,1278,3899,1622,8249,6627,301,296
SP,64912,IBIRAREMA,1006,1876,1033,4932,3899,249,182
SP,64939,IBITINGA,6732,16196,9069,41952,32883,1651,1532
SP,64955,IBIÚNA,7878,24472,13297,58284,44987,2166,2137
SP,64971,ICÉM,1675,2095,1659,6705,5046,138,173
SP,64998,IEPÊ,1153,2696,1309,6112,4803,121,138
SP,65013,IGARAÇU DO TIETÊ,3462,5949,3645,18587,14942,1263,902
SP,65030,IGARAPAVA,4830,5363,6337,21865,15528,902,699
SP,65056,IGARATÁ,1256,2992,1439,7733,6294,203,282
SP,65072,IGUAPE,5308,5472,6872,22989,16117,574,731
SP,65099,ILHABELA,2797,6953,5263,22049,16786,580,590
SP,65110,INDAIATUBA,26727,48309,25653,149223,123570,7233,7382
SP,65137,INDIANA,889,1657,969,4484,3515,174,126
SP,65153,INDIAPORÃ,1128,991,671,3296,2625,87,72
SP,65170,INÚBIA PAULISTA,459,1516,537,3076,2539,113,80
SP,65196,IPAUSSU,1590,4086,2245,10657,8412,434,303
SP,65218,IPERÓ,4125,5385,3914,18225,14311,656,690
SP,65234,IPEÚNA,713,2125,570,4674,4104,112,158
SP,65250,IPORANGA,1318,635,1089,3510,2421,51,101
SP,65277,IPUÃ,3328,3477,2189,10828,8639,383,266
SP,65293,IRACEMÁPOLIS,2778,6012,2540,16111,13571,664,612
SP,65315,IRAPUÃ,1046,2380,1336,5677,4341,230,172
SP,65331,IRAPURU,1238,1839,1247,5450,4203,205,134
SP,65358,ITABERÁ,4329,4880,2828,14057,11229,428,312
SP,65374,ITAÍ,3655,5710,3770,16902,13132,680,537
SP,65390,ITAJOBI,1280,6576,2640,12365,9725,454,408
SP,65412,ITAJU,449,1273,814,3129,2315,98,89
SP,65439,ITANHAÉM,13442,18797,19856,71357,51501,2101,2717
SP,65455,ITAPECERICA DA SERRA,27520,26379,20366,110863,90497,5517,4846
SP,65471,ITAPETININGA,13315,37404,21120,104962,83842,4254,4167
SP,65498,ITAPEVA,11599,25615,15225,68136,52911,2239,1499
SP,65510,ITAPEVI,40177,26848,26005,143099,117094,7493,5989
SP,65536,ITAPIRA,5377,23708,10413,55061,44648,2963,2831
SP,65552,ITÁPOLIS,4192,12900,8156,31262,23106,1458,1254
SP,65579,ITAPORANGA,2325,4580,2642,11397,8755,369,344
SP,65595,ITAPUÍ,1216,3656,1726,8820,7094,438,264
SP,65617,ITAPURA,1357,633,1015,3726,2711,101,92
SP,65633,ITAQUAQUECETUBA,55891,41134,38240,213924,175684,11244,10490
SP,65650,ITARARÉ,5379,14940,10043,37557,27514,969,801
SP,65676,ITARIRI,2109,2484,2892,9588,6696,235,271
SP,65692,ITATIBA,7596,30855,14636,75410,60774,2765,2966
SP,65714,ITATINGA,1732,5545,2965,13897,10932,535,451
SP,65730,ITIRAPINA,1867,3351,1317,8989,7672,461,497
SP,65757,ITIRAPUÃ,1375,1745,1080,5007,3927,137,100
SP,65773,ITOBI,1574,1984,1490,6364,4874,282,196
SP,65790,ITU,14638,41081,26273,121381,95108,5129,7411
SP,65811,ITUPEVA,6809,11298,5886,35060,29174,1582,1628
SP,65838,ITUVERAVA,6199,9953,8129,30284,22155,937,872
SP,65854,JABORANDI,1494,1562,883,5006,4123,274,167
SP,65870,JABOTICABAL,6564,20133,13150,53291,40141,1719,1550
SP,65897,JACAREÍ,25643,52006,30469,159980,129511,4500,5270
SP,65919,JACI,989,2388,861,5123,4262,194,125
SP,65935,JACUPIRANGA,2504,4423,3819,13597,9778,251,349
SP,65951,JAGUARIÚNA,4675,13449,7766,35924,28158,1659,1420
SP,65978,JALES,7368,15721,8074,37690,29616,1395,1290
SP,65994,JAMBEIRO,644,1612,804,4363,3559,131,84
SP,66010,JANDIRA,17984,17285,13941,75608,61667,3925,3328
SP,66036,JARDINÓPOLIS,4319,9115,6489,27150,20661,1261,1143
SP,66052,JARINU,3258,7151,4381,19010,14629,670,658
SP,66079,JAÚ,10362,41607,18457,97378,78921,4621,4262
SP,66095,JERIQUARA,811,997,859,3240,2381,83,76
SP,66117,JOANÓPOLIS,1110,4646,1966,9267,7301,308,318
SP,66133,JOÃO RAMALHO,867,1285,894,3782,2888,90,157
SP,66150,JOSÉ BONIFÁCIO,4327,10703,5243,25358,20115,1050,698
SP,66176,JÚLIO MESQUITA,976,1193,688,3719,3031,151,125
SP,66192,JUNDIAÍ,41801,111440,39023,276399,237376,8991,14452
SP,66214,JUNQUEIRÓPOLIS,2590,5270,2566,13533,10967,526,332
SP,66230,JUQUIÁ,3126,4753,5799,17137,11338,363,458
SP,66257,JUQUITIBA,5507,6256,5134,22372,17238,714,765
SP,66273,LAGOINHA,916,2182,1111,5205,4094,155,112
SP,66290,LARANJAL PAULISTA,2165,10018,4104,20454,16350,654,581
SP,66311,LAVÍNIA,1197,1176,939,4252,3313,160,176
SP,66338,LAVRINHAS,1223,2044,1059,5818,4759,177,216
SP,66354,LEME,10900,27147,12552,70632,58080,3494,3144
SP,66370,LENÇÓIS PAULISTA,5010,18496,8227,46576,38349,2010,1773
SP,66397,LIMEIRA,30126,68094,39340,208516,169176,8754,9441
SP,66419,LINDÓIA,582,2657,997,5351,4354,126,164
SP,66435,LINS,5932,22356,12898,55571,42673,1893,1909
SP,66451,LORENA,9346,20487,13531,63836,50305,2210,1898
SP,66478,LOUVEIRA,4955,10207,2884,27679,24795,1091,1009
SP,66494,LUCÉLIA,2935,5227,3922,14935,11013,465,513
SP,66516,LUCIANÓPOLIS,509,724,416,1948,1532,58,62
SP,66532,LUÍS ANTÔNIO,2007,2275,2136,8823,6687,370,359
SP,66559,LUIZIÂNIA,796,1576,1044,4115,3071,114,115
SP,66575,LUPÉRCIO,773,1115,891,3725,2834,122,97
SP,66591,LUTÉCIA,593,827,532,2505,1973,82,77
SP,66613,MACATUBA,2037,4661,2595,13209,10614,585,422
SP,66630,MACAUBAL,774,2977,1113,6059,4946,317,182
SP,66656,MACEDÔNIA,841,1042,710,3256,2546,109,127
SP,66672,MAGDA,699,967,656,2937,2281,128,87
SP,66699,MAIRINQUE,7465,10314,7373,36320,28947,1592,1689
SP,66710,MAIRIPORÃ,8518,20390,11823,57375,45552,2478,2654
SP,66737,MANDURI,1061,3080,1590,7216,5626,266,256
SP,66753,MARABÁ PAULISTA,1079,910,1012,3545,2533,65,94
SP,66770,MARACAÍ,2710,4018,1995,10830,8835,262,243
SP,66796,MARIÁPOLIS,936,990,677,3243,2566,194,118
SP,66818,MARÍLIA,20213,58924,35166,166549,131383,6172,6168
SP,66834,MARINÓPOLIS,426,769,387,1926,1539,87,54
SP,66850,MARTINÓPOLIS,2901,7517,4533,18796,14263,581,479
SP,66877,MATÃO,11909,22031,11175,62231,51056,2616,2403
SP,66893,MAUÁ,66946,58808,50492,299521,249029,12883,19832
SP,66915,MENDONÇA,1239,1469,954,4305,3351,142,114
SP,66931,MERIDIANO,1116,1220,796,3670,2874,132,105
SP,66958,MIGUELÓPOLIS,4738,5195,4662,17059,12397,384,312
SP,66974,MINEIROS DO TIETÊ,1240,3714,1965,9309,7344,549,343
SP,66990,MIRACATU,4258,4314,5654,17034,11380,381,450
SP,67016,MIRA ESTRELA,847,753,530,2584,2054,95,108
SP,67032,MIRANDÓPOLIS,3240,6590,5230,20634,15404,833,956
SP,67059,MIRANTE DO PARANAPANEMA,4548,3362,4202,14506,10304,329,300
SP,67075,MIRASSOL,7511,16139,8393,40875,32482,1772,1579
SP,67091,MIRASSOLÂNDIA,685,1452,645,3496,2851,154,87
SP,67113,MOCOCA,7476,19796,12979,53997,41018,2549,2333
SP,67130,MOGI DAS CRUZES,47541,91536,49302,290916,241614,12125,12968
SP,67156,MOGI GUAÇU,18886,37253,19986,108945,88959,5642,5358
SP,67172,MOGI MIRIM,6983,27240,13450,67400,53950,3322,3031
SP,67199,MOMBUCA,432,1222,549,3022,2473,130,141
SP,67210,MONÇÕES,360,866,362,1978,1616,115,83
SP,67237,MONGAGUÁ,8340,9662,12041,41055,29014,1166,1535
SP,67253,MONTE ALEGRE DO SUL,753,2879,939,5725,4786,197,237
SP,67270,MONTE ALTO,4414,16744,8570,37060,28490,1572,1211
SP,67296,MONTE APRAZÍVEL,2760,6921,3108,16122,13014,632,594
SP,67318,MONTE AZUL PAULISTA,2636,6516,3597,15539,11942,656,526
SP,67334,MONTE CASTELO,1294,968,564,3331,2767,60,79
SP,67350,MONTEIRO LOBATO,670,1383,707,3543,2836,83,90
SP,67377,MONTE MOR,10003,8556,8157,38233,30076,1882,1547
SP,67393,MORRO AGUDO,4500,6763,4287,20363,16076,870,801
SP,67415,MORUNGABA,1165,4936,1587,9823,8236,410,331
SP,67431,MURUTINGA DO SUL,840,1347,762,3529,2767,100,151
SP,67458,NARANDIBA,1190,1431,791,4031,3240,95,91
SP,67474,NATIVIDADE DA SERRA,1320,1887,1941,6690,4749,168,203
SP,67490,NAZARÉ PAULISTA,1837,5477,3209,13528,10319,544,647
SP,67512,NEVES PAULISTA,1493,3163,1504,7501,5997,373,306
SP,67539,NHANDEARA,1139,3913,1612,8070,6458,328,242
SP,67555,NIPOÃ,643,1717,789,3789,3000,116,85
SP,67571,NOVA ALIANÇA,1124,2069,988,5143,4155,181,221
SP,67598,NOVA EUROPA,1904,2467,1919,7953,6034,287,259
SP,67610,NOVA GRANADA,3474,5210,3597,15294,11697,547,575
SP,67636,NOVA GUATAPORANGA,654,540,366,1898,1532,66,70
SP,67652,NOVA INDEPENDÊNCIA,759,816,534,2941,2407,91,103
SP,67679,NOVA LUZITÂNIA,891,1009,514,2817,2303,39,63
SP,67695,NOVA ODESSA,9737,11583,6996,42127,35131,1717,1660
SP,67717,NOVO HORIZONTE,4358,11967,6145,28436,22291,1021,697
SP,67733,NUPORANGA,945,2563,849,5463,4614,198,187
SP,67750,OCAUÇU,827,1290,734,3457,2723,116,125
SP,67776,ÓLEO,424,1208,587,2774,2187,103,85
SP,67792,OLÍMPIA,6829,16041,9072,39600,30528,1603,1398
SP,67814,ONDA VERDE,770,1252,696,3580,2884,109,137
SP,67830,ORIENTE,1046,2073,815,5079,4264,176,181
SP,67857,ORINDIÚVA,977,1789,1014,4638,3624,94,149
SP,67873,ORLÂNDIA,4910,12052,6368,30765,24397,1042,1224
SP,67890,OSASCO,112293,145980,104164,556804,452640,21564,27534
SP,67911,OSCAR BRESSANE,443,1170,622,2641,2019,82,58
SP,67938,OSVALDO CRUZ,3330,9733,6204,24508,18304,838,878
SP,67954,OURINHOS,12583,26322,17100,77144,60044,2930,2786
SP,67970,OURO VERDE,2054,1702,1094,5928,4834,203,137
SP,67997,PACAEMBU,1670,3581,2286,9014,6728,230,220
SP,68012,PALESTINA,1723,3620,1668,8247,6579,305,241
SP,68039,PALMARES PAULISTA,1313,2938,1294,7120,5826,309,273
SP,68055,PALMEIRA D'OESTE,2201,2898,1803,7855,6052,289,194
SP,68071,PALMITAL,2851,7594,3982,17307,13325,548,424
SP,68098,PANORAMA,2450,3898,2403,10617,8214,382,252
SP,68110,PARAGUAÇU PAULISTA,7343,9194,7663,32105,24442,1445,978
SP,68136,PARAIBUNA,3098,5178,3277,14249,10972,331,428
SP,68152,PARAÍSO,747,2327,988,5065,4077,235,245
SP,68179,PARANAPANEMA,4105,4211,3062,13624,10562,441,395
SP,68195,PARANAPUÃ,900,1197,460,3007,2547,133,111
SP,68217,PARAPUÃ,1655,3360,2087,8668,6581,307,332
SP,68233,PARDINHO,758,2090,1154,5127,3973,162,181
SP,68250,PARIQUERA-AÇU,2634,5090,3935,15044,11109,434,445
SP,68276,PATROCÍNIO PAULISTA,1628,5201,2000,10377,8377,254,173
SP,68292,PAULICÉIA,1378,1695,1229,5403,4174,193,125
SP,68314,PAULÍNIA,11870,16747,11670,64126,52456,2657,2628
SP,68330,PAULO DE FARIA,1492,2691,1614,6708,5094,138,190
SP,68357,PEDERNEIRAS,4967,10324,6409,31786,25377,1519,1087
SP,68373,PEDRA BELA,960,2233,1097,4938,3841,170,141
SP,68390,PEDRANÓPOLIS,781,727,392,2197,1805,69,54
SP,68411,PEDREGULHO,3672,4259,3718,13846,10128,468,418
SP,68438,PEDREIRA,4434,13893,6307,32584,26277,1504,1560
SP,68454,PEDRO DE TOLEDO,1803,1572,2541,8007,5466,162,223
SP,68470,PENÁPOLIS,8005,16383,10533,45736,35203,1771,1856
SP,68497,PEREIRA BARRETO,4584,6184,5297,20278,14981,621,583
SP,68519,PEREIRAS,1093,2659,1747,6761,5014,245,206
SP,68535,PERUÍBE,9174,13969,15400,53321,37921,1791,2035
SP,68551,PIACATU,844,1836,908,4476,3568,117,185
SP,68578,PIEDADE,7536,15443,8820,40384,31564,1589,1120
SP,68594,PILAR DO SUL,4252,8442,4257,21229,16972,766,546
SP,68616,PINDAMONHANGABA,16028,34996,21554,109238,87684,4406,4295
SP,68632,PINDORAMA,1938,4563,2328,11487,9159,545,521
SP,68659,ESPÍRITO SANTO DO PINHAL,3691,15584,7853,33997,26144,1358,1114
SP,68675,PINHALZINHO,1268,4703,2268,10345,8077,420,415
SP,68691,PIQUEROBI,963,870,697,3056,2359,89,109
SP,68713,PIQUETE,1386,3925,2085,10985,8900,322,401
SP,68730,PIRACAIA,2222,10090,4815,21328,16513,778,822
SP,68756,PIRACICABA,32576,102132,53358,279747,226389,12087,11888
SP,68772,PIRAJU,3490,8191,5677,23097,17420,726,973
SP,68799,PIRAJUÍ,2229,5757,3947,15896,11949,586,546
SP,68810,PIRANGI,973,3837,1813,8245,6432,380,252
SP,68837,PIRAPORA DO BOM JESUS,2696,3041,1878,10747,8869,328,331
SP,68853,PIRAPOZINHO,4305,6570,4777,20269,15492,549,535
SP,68870,PIRASSUNUNGA,5986,25418,11836,55799,43963,2077,2149
SP,68896,PIRATININGA,1523,3622,1515,8861,7346,306,279
SP,68918,PITANGUEIRAS,5474,8424,6466,26218,19752,971,970
SP,68934,PLANALTO,1082,1349,867,4011,3144,116,131
SP,68950,PLATINA,618,1065,604,2772,2168,82,63
SP,68977,POÁ,20090,19845,16676,91474,74798,3743,4245
SP,68993,POLONI,659,2032,1036,4536,3500,147,145
SP,69019,POMPÉIA,2014,7268,2835,15641,12806,412,462
SP,69035,PONGAÍ,564,1448,612,3163,2551,79,81
SP,69051,PONTAL,4384,9831,6571,27908,21337,1308,1233
SP,69078,PONTES GESTAL,450,970,488,2398,1910,66,42
SP,69094,POPULINA,1225,1237,712,3781,3069,101,125
SP,69116,PORANGABA,1276,2399,1593,6677,5084,197,241
SP,69132,PORTO FELIZ,6244,13571,7843,38696,30853,1960,1556
SP,69159,PORTO FERREIRA,4597,16086,8004,40529,32525,1638,1517
SP,69175,POTIRENDABA,1944,5558,2694,12717,10023,695,515
SP,69191,PRADÓPOLIS,3033,4328,2872,13537,10665,616,645
SP,69213,PRAIA GRANDE,35665,50205,44327,191974,147647,6081,8146
SP,69230,PRESIDENTE ALVES,647,1377,634,3412,2778,78,99
SP,69256,PRESIDENTE BERNARDES,2564,4139,3033,11341,8308,312,245
SP,69272,PRESIDENTE EPITÁCIO,6497,9822,8201,31827,23626,907,879
SP,69299,PRESIDENTE PRUDENTE,24627,64386,37785,165773,127988,4769,4906
SP,69310,PRESIDENTE VENCESLAU,5195,11258,7056,29695,22639,839,902
SP,69337,PROMISSÃO,6482,8572,6685,27755,21070,1142,862
SP,69353,QUATÁ,1414,4060,2519,10422,7903,390,286
SP,69370,QUEIROZ,738,806,832,3180,2348,73,67
SP,69396,QUELUZ,1808,2505,1962,7807,5845,200,243
SP,69418,QUINTANA,1085,2003,961,4980,4019,151,148
SP,69434,RAFARD,1095,3298,1178,7487,6309,266,268
SP,69450,RANCHARIA,4692,9097,5616,24107,18491,684,597
SP,69477,REDENÇÃO DA SERRA,703,1523,937,3887,2950,116,120
SP,69493,REGENTE FEIJÓ,2339,6831,3091,15315,12224,439,396
SP,69515,REGINÓPOLIS,667,1871,895,4509,3614,119,158
SP,69531,REGISTRO,8996,14310,11132,44336,33204,1099,1027
SP,69558,RESTINGA,1765,1802,1247,6109,4862,202,150
SP,69574,RIBEIRA,1051,687,641,2977,2336,61,78
SP,69590,RIBEIRÃO BONITO,1451,2914,1938,8885,6947,383,365
SP,69612,RIBEIRÃO BRANCO,4992,4144,3593,14623,11030,316,284
SP,69639,RIBEIRÃO CORRENTE,847,1583,844,3885,3041,90,72
SP,69655,RIBEIRÃO DO SUL,1386,1188,665,3812,3147,131,92
SP,69671,RIBEIRÃO PIRES,17369,23355,16130,88925,72795,3634,5278
SP,69698,RIBEIRÃO PRETO,61768,149921,93096,431173,338077,15313,24544
SP,69710,RIVERSUL,1609,1229,1271,4795,3524,126,116
SP,69736,RIFAINA,798,1312,1225,4184,2959,114,87
SP,69752,RINCÃO,1881,2523,1756,7939,6183,367,369
SP,69779,RINÓPOLIS,1300,3207,1835,7711,5876,237,199
SP,69795,RIO CLARO,17230,53122,26776,142064,115288,5025,7195
SP,69817,RIO DAS PEDRAS,3668,7615,4688,24348,19660,1193,813
SP,69833,RIO GRANDE DA SERRA,9002,6523,6005,33642,27637,1584,1578
SP,69850,RIOLÂNDIA,1662,2679,1860,7273,5413,225,176
SP,69876,ROSEIRA,1507,2585,1594,7814,6220,236,219
SP,69892,RUBIÁCEA,383,961,585,2472,1887,53,67
SP,69914,RUBINÉIA,684,862,636,2735,2099,105,100
SP,69930,SABINO,1102,1463,1285,4827,3542,183,254
SP,69957,SAGRES,533,759,335,2036,1701,45,53
SP,69973,SALES,705,2032,984,4604,3620,126,127
SP,69990,SALES OLIVEIRA,1532,3324,956,7589,6633,274,314
SP,70017,SALESÓPOLIS,2389,6255,3019,14699,11680,543,484
SP,70033,SALMOURÃO,693,1494,918,3907,2989,183,91
SP,70050,SALTO,16748,27140,14967,83927,68960,3505,3940
SP,70076,SALTO DE PIRAPORA,5642,8989,5679,28815,23136,1697,1296
SP,70092,SALTO GRANDE,1376,2390,1721,6857,5136,273,255
SP,70114,SANDOVALINA,1079,907,834,3456,2622,49,71
SP,70130,SANTA ADÉLIA,1554,5076,2818,11875,9057,461,526
SP,70157,SANTA ALBERTINA,1116,1875,991,4803,3812,213,131
SP,70173,SANTA BÁRBARA D'OESTE,29876,39483,23211,137106,113895,7117,6646
SP,70190,ÁGUAS DE SANTA BÁRBARA,956,1580,1351,4978,3627,151,196
SP,70211,SANTA BRANCA,1770,4628,2844,12099,9255,349,318
SP,70238,SANTA CLARA D'OESTE,500,747,466,2111,1645,80,72
SP,70254,SANTA CRUZ DA CONCEIÇÃO,563,1638,616,3520,2904,124,145
SP,70270,SANTA CRUZ DAS PALMEIRAS,3777,8722,5101,22888,17787,914,731
SP,70297,SANTA CRUZ DO RIO PARDO,4857,14364,7256,33904,26648,1374,1094
SP,70319,SANTA ERNESTINA,1076,2053,888,5062,4174,146,130
SP,70335,SANTA FÉ DO SUL,4205,9604,5761,24427,18666,850,887
SP,70351,SANTA GERTRUDES,3037,4984,1701,14808,13107,574,722
SP,70378,SANTA ISABEL,6739,15059,7195,39437,32242,1686,1796
SP,70394,SANTA LÚCIA,2290,1827,1662,8013,6351,369,367
SP,70416,SANTA MARIA DA SERRA,822,1533,502,3926,3424,187,167
SP,70432,SANTA MERCEDES,784,862,644,2631,1987,73,43
SP,70459,SANTANA DA PONTE PENSA,396,636,269,1568,1299,57,56
SP,70475,SANTANA DE PARNAÍBA,14009,24806,12309,74564,62255,3027,2743
SP,70491,SANTA RITA D'OESTE,603,906,481,2398,1917,65,74
SP,70513,SANTA RITA DO PASSA QUATRO,2348,9139,5080,21592,16512,707,830
SP,70530,SANTA ROSA DE VITERBO,3221,6537,4311,19359,15048,905,904
SP,70556,SANTO ANASTÁCIO,3273,5733,4388,17133,12745,643,629
SP,70572,SANTO ANDRÉ,111485,164283,106907,561977,455070,17923,33681
SP,70599,SANTO ANTÔNIO DA ALEGRIA,1403,2017,1265,5888,4623,143,228
SP,70610,SANTO ANTÔNIO DE POSSE,2233,7041,3410,16077,12667,841,383
SP,70637,SANTO ANTÔNIO DO JARDIM,1008,2819,1043,5482,4439,143,140
SP,70653,SANTO ANTÔNIO DO PINHAL,879,2786,1297,6012,4715,200,156
SP,70670,SANTO EXPEDITO,740,836,538,2666,2128,65,78
SP,70696,SANTÓPOLIS DO AGUAPEÍ,669,1258,708,3345,2637,162,119
SP,70718,SANTOS,49576,117786,66634,335878,269244,7847,14876
SP,70734,SÃO BENTO DO SAPUCAÍ,1209,4219,1999,8931,6932,220,228
SP,70750,SÃO BERNARDO DO CAMPO,143842,159054,103223,594770,491547,20145,32685
SP,70777,SÃO CAETANO DO SUL,14835,59790,16691,124207,107516,2472,5471
SP,70793,SÃO CARLOS,28528,61125,32442,174528,142086,6254,9273
SP,70815,SÃO FRANCISCO,673,971,587,2608,2021,87,91
SP,70831,SÃO JOÃO DA BOA VISTA,9900,29453,12839,67105,54266,2708,2751
SP,70858,SÃO JOÃO DAS DUAS PONTES,779,682,469,2407,1938,104,98
SP,70874,SÃO JOÃO DO PAU D'ALHO,623,650,314,1891,1577,67,60
SP,70890,SÃO JOAQUIM DA BARRA,7324,12954,7489,35971,28482,1489,1137
SP,70912,SÃO JOSÉ DA BELA VISTA,1550,2411,2029,7206,5177,243,172
SP,70939,SÃO JOSÉ DO BARREIRO,774,1376,747,3549,2802,59,119
SP,70955,SÃO JOSÉ DO RIO PARDO,7857,15869,8812,41576,32764,1994,1527
SP,70971,SÃO JOSÉ DO RIO PRETO,49511,126427,61656,312900,251244,9997,12757
SP,70998,SÃO JOSÉ DOS CAMPOS,78033,168808,83096,474837,391741,12697,15497
SP,71013,SÃO LUÍS DO PARAITINGA,1964,4104,1905,9758,7853,307,243
SP,71030,SÃO MANUEL,3217,11153,6202,30588,24386,1514,1592
SP,71056,SÃO MIGUEL ARCANJO,4673,9402,5484,24687,19203,643,803
SP,71072,SÃO PAULO,1623130,2722869,1673890,8787943,7114053,362973,522570
SP,71099,SÃO PEDRO,2440,10013,3644,22703,19059,854,891
SP,71110,SÃO PEDRO DO TURVO,1326,2228,1071,5474,4403,169,129
SP,71137,SÃO ROQUE,8199,21296,12079,57462,45383,2655,2302
SP,71153,SÃO SEBASTIÃO,11555,14381,12916,56916,44000,1710,1644
SP,71170,SÃO SEBASTIÃO DA GRAMA,1683,3630,2370,9571,7201,344,348
SP,71196,SÃO SIMÃO,1411,4921,2700,11789,9089,358,504
SP,71218,SÃO VICENTE,51645,55767,50221,254984,204763,8896,11525
SP,71234,SARAPUÍ,1885,2165,1551,7075,5524,248,267
SP,71250,SARUTAIÁ,846,1052,790,3267,2477,79,124
SP,71277,SEBASTIANÓPOLIS DO SUL,383,1412,532,2909,2377,104,81
SP,71293,SERRA AZUL,1692,2149,1616,6798,5182,223,254
SP,71315,SERRANA,5862,10550,6332,30568,24236,1169,1171
SP,71331,SERRA NEGRA,2479,10637,5225,21974,16749,543,632
SP,71358,SERTÃOZINHO,11744,29226,18631,87206,68575,3526,3766
SP,71374,SETE BARRAS,3013,3066,3596,11314,7718,203,334
SP,71390,SEVERÍNIA,2071,5254,2413,12421,10008,499,266
SP,71412,SILVEIRAS,991,2042,1100,5266,4166,177,133
SP,71439,SOCORRO,3325,13976,6849,29113,22264,786,1132
SP,71455,SOROCABA,70395,146371,75490,446972,371482,17504,24932
SP,71471,SUD MENNUCCI,1609,2347,1323,6266,4943,258,198
SP,71498,SUMARÉ,43902,38541,32602,171498,138896,8129,6839
SP,71510,SUZANO,42287,48272,35703,203959,168256,9295,9267
SP,71536,TABAPUÃ,1678,3488,1654,9075,7421,480,506
SP,71552,TABATINGA,2217,4383,2785,11764,8979,641,378
SP,71579,TABOÃO DA SERRA,42551,50861,37002,198585,161583,8670,9877
SP,71595,TACIBA,1717,1588,992,5064,4072,110,101
SP,71617,TAGUAÍ,1774,3480,1799,8506,6707,239,187
SP,71633,TAIAÇU,1032,1707,1110,4747,3637,206,169
SP,71650,TAIÚVA,638,2133,1093,4777,3684,160,122
SP,71676,TAMBAÚ,3139,7217,3766,17317,13551,666,595
SP,71692,TANABI,3332,8155,4571,20136,15565,553,547
SP,71714,TAPIRAÍ,1239,1606,1918,6562,4644,169,191
SP,71730,TAPIRATIBA,2615,3626,2143,10393,8250,387,318
SP,71757,TAQUARITINGA,8710,13839,9322,40283,30961,1876,1357
SP,71773,TAQUARITUBA,4643,6784,3945,18604,14659,688,468
SP,71790,TARABAI,1696,1631,1194,5513,4319,137,151
SP,71811,TATUÍ,8717,32784,17798,82011,64213,3225,3867
SP,71838,TAUBATÉ,27923,71666,45845,220125,174280,7812,9172
SP,71854,TEJUPÁ,1029,1469,1039,4093,3054,92,114
SP,71870,TEODORO SAMPAIO,4713,4578,4286,16750,12464,390,396
SP,71897,TERRA ROXA,1420,2641,1513,6941,5428,242,227
SP,71919,TIETÊ,3320,12422,5592,28240,22648,882,1155
SP,71935,TIMBURI,446,1023,559,2497,1938,53,77
SP,71951,TORRINHA,1034,3338,1587,7372,5785,327,237
SP,71978,TREMEMBÉ,3212,8480,5093,24620,19527,774,915
SP,71994,TRÊS FRONTEIRAS,1253,1679,1101,4862,3761,145,150
SP,72010,TUPÃ,7422,18642,12156,50886,38730,1422,1546
SP,72036,TUPI PAULISTA,2579,4588,2222,11014,8792,244,260
SP,72052,TURIÚBA,242,753,334,1681,1347,51,86
SP,72079,TURMALINA,529,555,534,1940,1406,59,86
SP,72095,UBATUBA,10555,21548,15375,62522,47147,1796,1879
SP,72117,UBIRAJARA,705,1523,731,3604,2873,92,78
SP,72133,UCHOA,1354,3257,1668,8004,6336,391,342
SP,72150,UNIÃO PAULISTA,279,741,537,1808,1271,42,43
SP,72176,URÂNIA,1975,2292,1211,6658,5447,334,243
SP,72192,URU,256,629,324,1461,1137,31,52
SP,72214,URUPÊS,1837,4530,2354,10514,8160,400,319
SP,72230,VALENTIM GENTIL,1881,3714,1871,9067,7196,356,274
SP,72257,VALINHOS,11569,31267,16340,84699,68359,3342,4031
SP,72273,VALPARAÍSO,3709,4801,3880,15858,11978,448,448
SP,72311,VARGEM GRANDE DO SUL,4790,14323,6209,30463,24254,1409,802
SP,72338,VÁRZEA PAULISTA,19456,19610,13564,82733,69169,3665,4306
SP,72354,VERA CRUZ,1665,3372,1942,8805,6863,235,342
SP,72370,VINHEDO,5911,21446,6576,50789,44213,2223,2068
SP,72397,VIRADOURO,2702,5235,3000,13922,10922,543,463
SP,72419,VISTA ALEGRE DO ALTO,888,2172,960,5186,4226,244,191
SP,72435,VOTORANTIM,17408,24077,15364,85120,69756,3810,4142
SP,72451,VOTUPORANGA,10783,27793,14041,68652,54611,2046,2456
SP,72737,VARGEM GRANDE PAULISTA,6733,9922,6222,34040,27818,1487,1320
TO,73008,ABREULÂNDIA,884,287,334,1929,1595,14,133
TO,73016,PIRAQUÊ,993,499,615,2591,1976,12,129
TO,73024,RIACHINHO,1647,561,806,3571,2765,25,230
TO,73032,DARCINÓPOLIS,1590,567,895,3761,2866,43,220
TO,73040,PALMEIRAS DO TOCANTINS,1550,772,1121,4317,3196,63,278
TO,73059,MAURILÂNDIA DO TOCANTINS,1510,235,695,2877,2182,19,190
TO,73067,CACHOEIRINHA,903,198,481,1941,1460,11,113
TO,73075,ANGICO,931,612,568,2586,2018,27,165
TO,73083,PALMEIRANTE,1510,550,741,3338,2597,15,207
TO,73091,CAMPOS LINDOS,2706,752,1296,5448,4152,39,305
TO,73105,SÃO FÉLIX DO TOCANTINS,621,158,267,1268,1001,5,68
TO,73113,LAGOA DO TOCANTINS,1427,262,457,2723,2266,28,218
TO,73121,BOM JESUS DO TOCANTINS,1275,585,452,2849,2397,31,172
TO,73130,SANTA MARIA DO TOCANTINS,952,553,319,2191,1872,16,135
TO,73148,NOVO ALEGRE,740,264,351,1720,1369,23,114
TO,73156,SANDOLÂNDIA,1291,705,826,3392,2566,27,210
TO,73164,TAIPAS DO TOCANTINS,684,161,529,1731,1202,15,129
TO,73172,NOVO JARDIM,724,251,553,1978,1425,28,124
TO,73180,SÃO MIGUEL DO TOCANTINS,3476,679,1456,7046,5590,70,387
TO,73199,FORTALEZA DO TABOCÃO,667,840,385,2342,1957,33,127
TO,73202,ITAPIRATINS,1373,548,695,3018,2323,31,170
TO,73210,CENTENÁRIO,836,385,508,2055,1547,15,145
TO,73229,RECURSOLÂNDIA,1275,377,696,2855,2159,19,257
TO,73237,TUPIRATINS,813,249,362,1625,1263,14,96
TO,73245,BRASILÂNDIA DO TOCANTINS,723,418,294,1750,1456,24,85
TO,73253,JUARINA,716,480,328,1770,1442,21,88
TO,73261,PAU D'ARCO,1271,809,807,3326,2519,34,173
TO,73270,MATEIROS,686,318,400,1712,1312,15,110
TO,73288,SÃO BENTO DO TOCANTINS,1985,611,762,4055,3293,29,271
TO,73296,ESPERANTINA,2640,728,1580,5889,4309,66,395
TO,73300,CARIRI DO TOCANTINS,1118,488,409,2558,2149,23,131
TO,73318,ARAGUANÃ,1810,567,1143,4107,2964,28,224
TO,73326,CARMOLÂNDIA,762,438,494,2146,1652,26,106
TO,73334,ARAGOMINAS,1964,639,1182,4395,3213,45,285
TO,73342,MURICILÂNDIA,1024,284,447,2146,1699,26,153
TO,73350,SANTA FÉ DO ARAGUAIA,1468,1085,1012,4778,3766,71,295
TO,73369,JAÚ DO TOCANTINS,1206,604,646,2833,2187,27,168
TO,73377,SUCUPIRA,531,390,279,1460,1181,9,65
TO,73385,LAGOA DA CONFUSÃO,2614,1357,1344,6529,5185,72,224
TO,73393,SÃO SALVADOR DO TOCANTINS,1120,196,705,2363,1658,11,138
TO,73407,LAJEADO,770,611,435,2538,2103,35,126
TO,73415,RIO DOS BOIS,847,384,406,2002,1596,36,117
TO,73423,CARRASCO BONITO,1637,350,994,3318,2324,38,184
TO,73431,RIO DA CONCEIÇÃO,689,192,388,1640,1252,11,84
TO,73440,PALMAS,43528,37476,18110,157405,139295,3116,7043
TO,73458,TUPIRAMA,673,314,207,1413,1206,22,66
TO,73466,OLIVEIRA DE FÁTIMA,607,418,351,1729,1378,20,79
TO,73474,CHAPADA DE AREIA,670,515,408,1927,1519,29,84
TO,73482,CHAPADA DA NATIVIDADE,1174,359,840,2901,2061,24,241
TO,73504,TALISMÃ,919,406,383,2074,1691,21,116
TO,73512,AGUIARNÓPOLIS,1548,568,955,3848,2893,45,216
TO,73520,LUZINÓPOLIS,943,412,441,2206,1765,22,139
TO,73539,SANTA TEREZINHA DO TOCANTINS,990,330,490,2156,1666,26,130
TO,73547,SANTA RITA DO TOCANTINS,676,395,323,1695,1372,16,81
TO,73555,CRIXÁS DO TOCANTINS,525,337,208,1312,1104,9,74
TO,73563,MONTE SANTO DO TOCANTINS,838,576,229,1947,1718,19,101
TO,73571,PUGMIL,737,292,261,1684,1423,20,116
TO,73580,BANDEIRANTES DO TOCANTINS,846,741,352,2345,1993,27,143
TO,73598,IPUEIRAS,679,316,244,1605,1361,13,99
TO,73601,LAVANDEIRA,606,258,301,1454,1153,11,105
TO,73610,BARRA DO OURO,1556,425,864,3411,2547,22,212
TO,92002,BERNARDO SAYÃO,1005,1092,693,3213,2520,37,160
TO,92045,BURITI DO TOCANTINS,2660,942,1642,6322,4680,70,409
TO,92070,ALMAS,2005,1120,1434,5392,3958,34,332
TO,92088,CASEARA,1605,682,820,3723,2903,35,227
TO,92134,ALVORADA,2273,1781,1336,6577,5241,83,379
TO,92142,COMBINADO,993,862,982,3760,2778,65,204
TO,92185,DIVINÓPOLIS DO TOCANTINS,2294,954,703,4770,4067,57,298
TO,92193,ANANÁS,3120,1260,1653,7180,5527,62,344
TO,92240,GOIANORTE,1822,878,688,3878,3190,31,208
TO,92304,MARIANÓPOLIS DO TOCANTINS,1258,516,398,2557,2159,52,156
TO,92371,ARAGUACEMA,2389,562,1189,4824,3635,25,224
TO,92398,ARAGUAÇU,1734,2094,1722,6634,4912,109,340
TO,92401,NOVA ROSALÂNDIA,819,466,468,2518,2050,41,119
TO,92410,ARAGUAÍNA,33768,22985,12556,96429,83873,1856,5275
TO,92436,ARAGUATINS,7356,3454,5196,20306,15110,273,1121
TO,92452,ARAPOEMA,2130,870,1188,4863,3675,51,248
TO,92479,ARRAIAS,3668,849,2602,8578,5976,112,539
TO,92487,PEQUIZEIRO,1873,739,913,4054,3141,32,208
TO,92509,PORTO ALEGRE DO TOCANTINS,831,207,576,2203,1627,17,142
TO,92525,PRAIA NORTE,2459,699,1919,6055,4136,49,359
TO,92533,AURORA DO TOCANTINS,1177,442,730,2952,2222,50,210
TO,92541,SAMPAIO,1432,511,897,3301,2404,38,177
TO,92576,AXIXÁ DO TOCANTINS,3568,1574,2019,8645,6626,117,541
TO,92584,SANTA ROSA DO TOCANTINS,1600,664,810,3714,2904,34,238
TO,92592,BABAÇULÂNDIA,3165,759,1525,6629,5104,71,403
TO,92606,SANTA TEREZA DO TOCANTINS,946,375,445,2383,1938,30,124
TO,92681,SÃO VALÉRIO DA NATIVIDADE,1488,536,1030,3583,2553,38,188
TO,92738,BREJINHO DE NAZARÉ,1424,869,758,4145,3387,62,225
TO,93114,COLINAS DO TOCANTINS,6810,6249,4807,22134,17327,295,1000
TO,93130,CONCEIÇÃO DO TOCANTINS,1379,303,1058,3458,2400,28,256
TO,93211,COUTO DE MAGALHÃES,1693,614,707,3654,2947,46,240
TO,93238,CRISTALÂNDIA,1976,1148,1294,5534,4240,96,239
TO,93416,DIANÓPOLIS,4466,2099,3149,12590,9441,200,622
TO,93459,DOIS IRMÃOS DO TOCANTINS,2048,863,1198,4927,3729,51,312
TO,93475,DUERÉ,1333,659,623,3172,2549,44,154
TO,93556,FILADÉLFIA,2929,898,1523,6463,4940,45,339
TO,93653,FORMOSO DO ARAGUAIA,4437,3102,3572,13651,10079,190,621
TO,93858,GURUPI,16708,14808,9798,53650,43852,911,2489
TO,94056,ITACAJÁ,2090,1062,1061,5415,4354,60,441
TO,94099,ITAGUATINS,2271,528,1283,4965,3682,49,359
TO,94170,ITAPORÃ DO TOCANTINS,926,384,407,2058,1651,28,125
TO,94617,MIRACEMA DO TOCANTINS,5900,2070,3499,14696,11197,221,750
TO,94633,MIRANORTE,3451,2238,2256,9977,7721,135,488
TO,94692,MONTE DO CARMO,2033,681,898,4671,3773,48,286
TO,94811,NATIVIDADE,1941,1472,1869,6770,4901,52,428
TO,94838,NAZARÉ,1708,603,977,4080,3103,48,222
TO,94994,NOVO ACORDO,1566,521,679,3437,2758,41,206
TO,95192,PARAÍSO DO TOCANTINS,8392,9077,4952,30260,25308,618,1508
TO,95214,PARANÃ,3843,594,2242,7776,5534,53,585
TO,95257,PEDRO AFONSO,3352,1684,1439,8079,6640,96,374
TO,95273,PEIXE,3097,1180,1730,7309,5579,78,427
TO,95290,COLMÉIA,2370,1788,1659,6834,5175,69,328
TO,95338,GOIATINS,3454,853,2193,8036,5843,84,612
TO,95370,PINDORAMA DO TOCANTINS,1561,853,737,3698,2961,26,213
TO,95478,PIUM,1509,1444,979,4996,4017,62,226
TO,95516,PONTE ALTA DO BOM JESUS,1456,490,799,3471,2672,24,274
TO,95532,PONTE ALTA DO TOCANTINS,1689,1241,1215,5216,4001,53,320
TO,95591,PORTO NACIONAL,13468,6048,6584,34997,28413,566,1652
TO,95699,LIZARDA,1454,164,678,2787,2109,22,246
TO,96032,SÃO SEBASTIÃO DO TOCANTINS,1587,289,886,3273,2387,28,169
TO,96130,SÍTIO NOVO DO TOCANTINS,3584,796,1950,7644,5694,87,407
TO,96156,TAGUATINGA,4351,1446,2935,10662,7727,139,669
TO,96199,TOCANTÍNIA,2263,464,991,4952,3961,40,287
TO,96210,TOCANTINÓPOLIS,6854,1533,3522,15073,11551,214,836
TO,96270,GUARAÍ,5311,4209,3616,16733,13117,217,856
TO,96296,PRESIDENTE KENNEDY,1119,512,430,2549,2119,47,165
TO,96431,XAMBIOÁ,3580,1266,1918,8333,6415,96,424
TO,96490,PALMEIRÓPOLIS,1829,1355,1009,5077,4068,51,305
TO,96598,SILVANÓPOLIS,1556,884,676,3945,3269,61,284
TO,96636,NOVA OLINDA,2943,1768,1898,7840,5942,106,456
TO,96652,WANDERLÂNDIA,3015,1015,1813,7071,5258,109,417
TO,96679,FIGUEIRÓPOLIS,1646,1064,667,3992,3325,38,195
TO,96792,RIO SONO,1796,578,542,3648,3106,37,194
TO,96830,FÁTIMA,932,831,630,2939,2309,62,106
TO,96857,AUGUSTINÓPOLIS,5147,1967,2623,11645,9022,167,635
TO,96954,ALIANÇA DO TOCANTINS,1655,882,651,3845,3194,53,224
TO,96970,APARECIDA DO RIO NEGRO,1492,806,657,3742,3085,71,206
TO,96997,BARROLÂNDIA,2125,921,772,4491,3719,55,189