STATE,CD_MUN,NM_MUN,VOTES_INCUMBENT,VOTES_CHALLENGER,QT_ABST,QT_APT,QT_ATTEND,QT_BLANK,QT_NULL
AC,1007,BUJARI,1243,623,533,3721,3188,60,353
AC,1015,CAPIXABA,1199,553,869,3682,2813,43,192
AC,1023,PORTO ACRE,2299,1060,2166,8216,6050,84,619
AC,1031,SANTA ROSA,491,77,327,1059,732,16,88
AC,1040,MARECHAL THAUMATURGO,1073,1473,1447,4782,3335,26,432
AC,1058,BRASILEIA,4548,2257,2400,12234,9834,171,795
AC,1066,PORTO WALTER,1130,1137,1203,4134,2931,36,373
AC,1074,CRUZEIRO DO SUL,8362,7667,10024,40270,30246,408,2389
AC,1082,RODRIGUES ALVES,1277,1586,1605,5731,4126,59,566
AC,1090,MANCIO LIMA,1903,2067,1551,7337,5786,114,630
AC,1104,JORDAO,860,468,838,2655,1817,41,294
AC,1112,EPITACIOLANDIA,2559,666,1404,6546,5142,88,428
AC,1120,ACRELANDIA,2032,1196,1211,6422,5211,82,486
AC,1139,FEIJO,5729,1049,3587,12932,9345,121,977
AC,1392,RIO BRANCO,64418,18209,32498,175346,142848,1496,6844
AC,1457,SENA MADUREIRA,6055,2654,4373,18961,14588,257,1403
AC,1473,TARAUACA,5894,2080,4572,16628,12056,414,1747
AC,1490,XAPURI,3023,1436,2336,9219,6883,97,700
AC,1511,PLACIDO DE CASTRO,2975,1325,2201,10127,7926,112,713
AC,1538,SENADOR GUIOMARD,4616,1419,2734,12827,10093,159,857
AC,1554,MANUEL URBANO,1019,661,999,3799,2800,54,417
AC,1570,ASSIS BRASIL,1294,587,477,3158,2681,30,271
AL,27006,PARIPUEIRA,874,897,415,5451,5036,276,532
AL,27014,AGUA BRANCA,2221,2420,3112,12076,8964,307,1211
AL,27022,PARICONHA,861,1390,1572,6119,4547,155,695
AL,27030,ANADIA,1569,1845,3562,11991,8429,420,1285
AL,27049,ESTRELA DE ALAGOAS,572,2398,2726,8564,5838,220,1100
AL,27057,ARAPIRACA,17517,29414,19055,100480,81425,2782,7942
AL,27065,JEQUIA DA PRAIA,570,1725,1728,6407,4679,198,668
AL,27073,ATALAIA,2161,6144,5706,23591,17885,755,2518
AL,27081,CAMPESTRE,639,548,1103,3665,2562,97,367
AL,27090,BARRA DE SANTO ANTONIO,1022,713,495,5418,4923,243,689
AL,27111,BARRA DE SAO MIGUEL,478,1065,234,3087,2853,81,319
AL,27138,BATALHA,1691,1119,2017,9212,7195,220,830
AL,27154,BELEM,429,822,726,3896,3170,193,444
AL,27170,BELO MONTE,684,525,923,4108,3185,170,424
AL,27197,BOCA DA MATA,2412,3356,3558,15780,12222,643,1515
AL,27219,BRANQUINHA,900,1548,1587,6080,4493,201,696
AL,27235,CACIMBINHAS,640,2321,1362,6203,4841,168,598
AL,27251,CAJUEIRO,1365,2730,2404,11021,8617,343,1383
AL,27278,CAMPO ALEGRE,1814,1618,5079,17608,12529,565,1959
AL,27294,CAMPO GRANDE,750,1188,532,4889,4357,175,511
AL,27316,CANAPI,1965,3260,2737,10691,7954,263,1052
AL,27332,CAPELA,1142,3358,2498,11062,8564,384,1221
AL,27359,CARNEIROS,981,417,618,3796,3178,55,498
AL,27375,CHA PRETA,585,1483,299,4127,3828,212,621
AL,27391,COITE DO NOIA,743,1170,1762,6927,5165,249,807
AL,27413,COLONIA LEOPOLDINA,1881,1301,3041,11425,8384,489,1104
AL,27430,COQUEIRO SECO,628,484,294,2803,2509,142,304
AL,27456,CORURIPE,3978,4514,6675,29641,22966,809,2824
AL,27472,DELMIRO GOUVEIA,9753,4604,7114,29089,21975,1003,2311
AL,27499,DOIS RIACHOS,657,1255,1598,6938,5340,92,876
AL,27510,FEIRA GRANDE,1832,2305,2794,12131,9337,532,1481
AL,27537,FELIZ DESERTO,223,710,234,2225,1991,76,241
AL,27553,FLEXEIRAS,337,2658,634,5595,4961,114,750
AL,27570,GIRAU DO PONCIANO,1855,2330,4664,18166,13502,483,2083
AL,27596,IBATEGUARA,1183,2094,2666,8273,5607,397,957
AL,27618,IGACI,1536,3504,4841,16258,11417,625,1525
AL,27634,IGREJA NOVA,2369,3104,3381,13664,10283,931,1475
AL,27650,INHAPI,2434,2423,2630,10053,7423,303,1112
AL,27677,JACARE DOS HOMENS,1111,615,715,3917,3202,82,425
AL,27693,JACUIPE,709,857,1021,4273,3252,123,481
AL,27715,JAPARATINGA,433,494,1012,4137,3125,197,320
AL,27731,JARAMATAIA,587,1062,708,3534,2826,100,465
AL,27758,JOAQUIM GOMES,1432,2200,3784,12189,8405,353,1606
AL,27774,JUNDIA,254,329,288,2532,2244,76,376
AL,27790,JUNQUEIRO,2439,4026,3824,15025,11201,459,1565
AL,27812,LAGOA DA CANOA,1427,2256,2902,10658,7756,342,1133
AL,27839,LIMOEIRO DE ANADIA,1439,1766,3377,13942,10565,561,1826
AL,27855,MACEIO,123450,54671,70874,416017,345143,7561,17204
AL,27871,MAJOR ISIDORO,1012,2315,3111,11709,8598,375,1171
AL,27898,MARAGOGI,1626,2471,2449,11280,8831,611,1162
AL,27910,MARAVILHA,514,2226,2174,7416,5242,189,779
AL,27936,MARECHAL DEODORO,3042,4236,3812,19917,16105,858,1931
AL,27952,MARIBONDO,1371,2041,2364,10053,7689,454,903
AL,27979,MAR VERMELHO,354,965,207,2391,2184,89,289
AL,27995,MATA GRANDE,2260,3450,3329,14585,11256,912,1969
AL,28010,MATRIZ DE CAMARAGIBE,1622,2340,3599,13530,9931,369,1091
AL,28037,MESSIAS,972,1392,1891,8287,6396,244,969
AL,28053,MINADOR DO NEGRAO,414,1059,869,3743,2874,112,468
AL,28070,MONTEIROPOLIS,735,651,952,4352,3400,163,442
AL,28096,MURICI,1963,3098,1343,12703,11360,347,1717
AL,28118,NOVO LINO,540,1185,582,5475,4893,194,627
AL,28134,OLHO D AGUA DAS FLORES,1911,3105,2596,11211,8615,298,1093
AL,28150,OLHO D AGUA DO CASADO,999,1403,1105,4916,3811,100,607
AL,28177,OLHO D AGUA GRANDE,286,966,830,3345,2515,79,409
AL,28193,OLIVENCA,656,2672,1556,6893,5337,100,848
AL,28215,OURO BRANCO,462,2468,1608,6332,4724,142,684
AL,28231,PALESTINA,676,385,202,2534,2332,55,363
AL,28258,PALMEIRA DOS INDIOS,6995,8460,9107,40149,31042,1144,3417
AL,28274,PAO DE ACUCAR,3381,3501,3271,14681,11410,285,1679
AL,28290,PASSO DE CAMARAGIBE,793,1311,1836,8243,6407,394,772
AL,28312,PAULO JACINTO,670,1237,288,4061,3773,173,471
AL,28339,PENEDO,7632,5171,6957,29820,22863,811,2239
AL,28355,PIACABUCU,1939,1748,2936,10501,7565,338,994
AL,28371,PILAR,2809,4245,4818,20339,15521,829,1889
AL,28398,PINDOBA,136,864,108,1569,1461,22,125
AL,28410,PIRANHAS,2445,3022,3118,11768,8650,255,1488
AL,28436,POCO DAS TRINCHEIRAS,1093,1916,1980,7935,5955,109,837
AL,28452,PORTO CALVO,2020,3525,4057,16068,12011,552,1564
AL,28479,PORTO DE PEDRAS,457,803,1228,5122,3894,226,359
AL,28495,PORTO REAL DO COLEGIO,1539,2520,2854,11618,8764,792,1103
AL,28517,QUEBRANGULO,1123,2011,641,6897,6256,385,797
AL,28533,RIO LARGO,7484,5338,7218,37469,30251,1088,2530
AL,28550,ROTEIRO,359,960,1374,4155,2781,121,525
AL,28576,SANTA LUZIA DO NORTE,844,834,939,4490,3551,143,377
AL,28592,SANTANA DO IPANEMA,3865,6587,5112,24798,19686,652,2385
AL,28614,SANTANA DO MUNDAU,623,2105,830,5715,4885,170,852
AL,28630,SAO BRAS,821,909,378,3742,3364,298,476
AL,28657,SAO JOSE DA LAJE,1481,2796,848,10108,9260,375,1411
AL,28673,SAO JOSE DA TAPERA,1579,4341,4319,15301,10982,460,1843
AL,28690,SAO LUIS DO QUITUNDE,2601,2657,4227,17702,13475,941,2106
AL,28711,SAO MIGUEL DOS CAMPOS,5926,4935,2213,24311,22098,681,2659
AL,28738,SAO MIGUEL DOS MILAGRES,529,963,368,3550,3182,241,353
AL,28754,SAO SEBASTIAO,2233,5888,5160,18664,13504,965,1939
AL,28770,SATUBA,1538,751,1294,7059,5765,291,515
AL,28797,TANQUE D ARCA,332,1093,1471,4579,3108,223,409
AL,28819,TAQUARANA,718,2092,2360,9848,7488,233,1218
AL,28835,TRAIPU,1733,5223,3765,15603,11838,300,1671
AL,28851,UNIAO DOS PALMARES,5973,5123,8904,32051,23147,1077,3127
AL,28878,VICOSA,3644,2881,3687,16605,12918,652,1903
AL,28894,CRAIBAS,1467,2849,3272,12666,9394,399,1332
AL,28916,SENADOR RUI PALMEIRA,664,476,1247,5391,4144,106,683
AL,28932,SENADOR TEOTONIO VILELA,2358,4140,6952,22108,15156,649,2114
AM,2003,APUI,1456,1140,3242,7425,4183,76,363
AM,2011,NOVO AYRAO,1369,1085,1713,5685,3972,79,342
AM,2020,GUAJARA,1105,763,3985,8156,4171,97,563
AM,2038,ANORI,963,1101,1834,6418,4584,65,472
AM,2046,CAREIRO DA VARZEA,2226,1789,2842,11072,8230,87,789
AM,2054,ATALAIA DO NORTE,553,274,1282,3468,2186,36,327
AM,2070,AUTAZES,2214,2887,4234,12994,8760,134,706
AM,2097,BARCELOS,1057,1491,1713,5626,3913,35,278
AM,2119,BARREIRINHA,3134,2508,2903,11628,8725,112,844
AM,2135,BENJAMIN CONSTANT,4106,1915,3832,13460,9628,170,1140
AM,2151,BOCA DO ACRE,2198,2358,5008,14045,9037,198,919
AM,2178,BORBA,2722,1913,4006,12972,8966,143,1064
AM,2194,CANUTAMA,728,545,1526,4397,2871,71,279
AM,2216,CARAUARI,2350,2654,4823,12753,7930,119,986
AM,2232,CAREIRO,3367,1382,4432,14114,9682,194,1050
AM,2259,COARI,9776,1693,8430,28427,19997,203,1636
AM,2275,CODAJAS,1621,829,3523,10315,6792,107,533
AM,2291,EIRUNEPE,2295,1443,5262,13353,8091,457,1170
AM,2313,ENVIRA,678,1117,3661,7826,4165,68,567
AM,2330,FONTE BOA,1600,1213,3141,9316,6175,99,669
AM,2356,HUMAITA,3712,2102,3019,15929,12910,295,834
AM,2372,SANTA ISABEL DO RIO NEGRO,516,675,1661,4433,2772,52,354
AM,2399,IPIXUNA,845,1345,3425,7268,3843,87,453
AM,2410,ITACOATIARA,19219,3816,11034,46382,35348,309,1107
AM,2437,ITAPIRANGA,1312,607,934,4261,3327,30,224
AM,2453,JAPURA,147,396,1027,2213,1186,16,136
AM,2470,JURUA,157,349,1545,3898,2353,26,363
AM,2496,JUTAI,649,1229,2468,6711,4243,83,616
AM,2518,LABREA,3978,1085,5714,15418,9704,177,1166
AM,2534,MANACAPURU,10739,4568,10955,41539,30584,292,2333
AM,2550,MANAUS,362024,70515,124884,844789,719905,8310,22784
AM,2577,MANICORE,2390,4245,5248,17236,11988,216,1420
AM,2593,MARAA,908,393,2786,5705,2919,47,353
AM,2615,MAUES,9182,2207,6506,22939,16433,223,1470
AM,2631,NHAMUNDA,1695,3241,2601,9603,7002,76,537
AM,2658,NOVA OLINDA DO NORTE,1716,2410,3583,10862,7279,120,758
AM,2674,NOVO ARIPUANA,1049,1119,2871,8369,5498,147,600
AM,2690,PARINTINS,14005,8315,10048,44346,34298,534,1888
AM,2712,PAUINI,960,1086,3222,7214,3992,125,442
AM,2739,SANTO ANTONIO DO ICA,689,2304,2510,7544,5034,133,856
AM,2755,SAO PAULO DE OLIVENCA,2137,2635,1479,8207,6728,170,519
AM,2771,SILVES,2471,280,951,4617,3666,59,211
AM,2798,TAPAUA,375,1458,2188,6933,4745,107,416
AM,2810,TEFE,6965,1896,11443,28721,17278,210,1434
AM,2836,SAO GABRIEL DA CACHOEIRA,5263,1232,6018,16670,10652,257,1143
AM,2852,URUCARA,3185,1070,2057,7716,5659,77,394
AM,2879,URUCURITUBA,3065,720,1963,7561,5598,104,416
AM,2895,ALVARAES,1791,364,1745,5758,4013,46,413
AM,2917,AMATURA,374,470,1003,3295,2292,92,326
AM,2933,ANAMA,821,1202,1587,4731,3144,37,269
AM,2950,BERURI,489,1370,1059,4553,3494,29,452
AM,2976,BOA VISTA DE RAMOS,2664,511,1852,6248,4396,80,347
AM,2992,CAAPIRANGA,854,578,1877,4888,3011,45,217
AM,98353,IRANDUBA,4662,2003,1869,13704,11835,178,959
AM,98370,ITAMARATI,235,243,1699,3654,1955,35,358
AM,98396,MANAQUIRI,1703,781,2079,7888,5809,106,523
AM,98418,PRESIDENTE FIGUEIREDO,4688,705,3344,13082,9738,165,548
AM,98434,RIO PRETO DA EVA,2281,828,2229,8212,5983,92,435
AM,98450,SAO SEBASTIAO DO UATUMA,729,928,1024,3757,2733,43,197
AM,98477,TABATINGA,3077,2980,4007,15392,11385,225,1465
AM,98493,UARINI,502,900,1788,4251,2463,53,190
AM,98515,TONANTINS,505,884,1725,4780,3055,66,519
AP,6009,PRACUUBA,304,68,92,1180,1088,8,80
AP,6017,AMAPA,1472,225,577,4189,3612,29,244
AP,6025,PORTO GRANDE,1827,428,338,4826,4488,46,322
AP,6033,CALCOENE,1213,254,741,4191,3450,37,237
AP,6041,ITAUBAL,637,148,112,1806,1694,9,108
AP,6050,MACAPA,71135,11305,24554,174593,150039,1080,6736
AP,6068,CUTIAS,688,117,449,2286,1837,10,147
AP,6076,MAZAGAO,3374,713,1151,7997,6846,49,535
AP,6084,AMAPARI,769,289,186,1854,1668,13,101
AP,6092,OIAPOQUE,2965,719,2203,8121,5918,92,423
AP,6106,SERRA DO NAVIO,786,103,177,1803,1626,10,81
AP,6114,FERREIRA GOMES,941,145,379,2652,2273,17,204
AP,6122,VITORIA DO JARI,2331,649,1013,5599,4586,53,341
AP,6130,LARANJAL DO JARI,6309,1550,3349,18051,14702,251,912
AP,6157,SANTANA,20773,3320,6101,46528,40427,285,1732
AP,6173,TARTARUGALZINHO,983,504,837,4425,3588,28,349
BA,30007,LUIS EDUARDO MAGALHAES,5045,1784,3070,14842,11772,227,1007
BA,30058,EUNAPOLIS,13442,5254,13386,47303,33917,797,4261
BA,30660,IUIU,2154,1030,2125,7008,4883,164,929
BA,30678,JABORANDI,1283,2131,1799,6990,5191,417,968
BA,30694,JUSSARI,1165,403,1972,5467,3495,71,697
BA,30716,AMERICA DOURADA,2720,1483,2964,11138,8174,353,1806
BA,30732,ARATACA,992,1125,3511,7969,4458,145,891
BA,30759,BARRO ALTO,2139,1579,2327,8675,6348,230,1133
BA,30775,BARROCAS,2750,608,2322,9940,7618,196,1171
BA,30791,BURITIRAMA,1879,1788,2750,11610,8860,117,2386
BA,30813,CAPELA DO ALTO ALEGRE,1900,1426,2634,9186,6552,332,1350
BA,30830,CAPIM GROSSO,5014,2334,5251,18974,13723,592,2322
BA,30856,CANUDOS,2475,2407,2183,9837,7654,150,1247
BA,30872,DIAS D AVILA,14654,1182,7691,31528,23837,568,2190
BA,30899,FATIMA,2719,1931,2645,11370,8725,445,1752
BA,30910,FILADELFIA,2475,1354,2589,10902,8313,324,1657
BA,30937,GAVIAO,967,421,642,3734,3092,281,553
BA,30953,GUAJERU,800,1095,1991,6329,4338,170,1259
BA,30970,HELIOPOLIS,2294,1576,2398,9146,6748,301,1625
BA,30996,JOAO DOURADO,2652,2412,1897,11302,9405,311,1383
BA,33014,ABAIRA,794,2423,1800,6732,4932,192,1013
BA,33030,ABARE,2453,1417,1942,9982,8040,255,1942
BA,33057,ACAJUTIBA,3106,541,2743,10140,7397,225,1222
BA,33065,ADUSTINA,1824,1200,2357,9442,7085,227,1614
BA,33073,AGUA FRIA,2632,643,3741,11529,7788,322,1815
BA,33090,ERICO CARDOSO,1155,1740,2631,7989,5358,282,1550
BA,33111,AIQUARA,1126,248,1798,4803,3005,156,666
BA,33138,ALAGOINHAS,33398,4949,18126,83302,65176,1751,6100
BA,33154,ALCOBACA,3772,1102,4427,12948,8521,333,1712
BA,33170,ALMADINA,1970,319,2231,5808,3577,46,500
BA,33197,AMARGOSA,7427,1774,7638,23817,16179,501,2954
BA,33219,AMELIA RODRIGUES,6022,1105,4442,17735,13293,679,1812
BA,33235,ANAGE,4235,4245,7481,22376,14895,533,3150
BA,33251,ANDARAI,2565,973,2275,8710,6435,222,1697
BA,33260,ANDORINHA,4518,689,2283,9789,7506,296,1168
BA,33278,ANGICAL,3208,2599,2452,10683,8231,205,1369
BA,33294,ANGUERA,2646,597,1383,7441,6058,480,1051
BA,33316,ANTAS,2104,1795,1537,8475,6938,393,1237
BA,33332,ANTONIO CARDOSO,3869,470,1289,8984,7695,333,1386
BA,33359,ANTONIO GONCALVES,2079,986,2206,7917,5711,145,1212
BA,33375,APORA,2100,1599,3417,10864,7447,351,1778
BA,33383,ARACAS,2503,470,1981,7242,5261,206,987
BA,33391,ARACATU,1257,2207,2936,9930,6994,267,1758
BA,33405,APUAREMA,922,1022,2075,5968,3893,131,927
BA,33413,ARACI,6817,3879,8373,30632,22259,1814,5433
BA,33430,ARAMARI,2549,471,1783,7578,5795,195,1207
BA,33456,ARATUIPE,1234,995,1793,6156,4363,145,1062
BA,33472,AURELINO LEAL,1932,862,4084,10061,5977,188,1216
BA,33499,BAIANOPOLIS,1691,2036,2216,8970,6754,568,1372
BA,33510,BAIXA GRANDE,3233,2528,4606,14747,10141,553,2083
BA,33529,BANZAE,2128,1448,2576,9587,7011,253,1637
BA,33537,BARRA,5962,3829,6858,26214,19356,571,3646
BA,33553,BARRA DA ESTIVA,2596,4337,2952,13287,10335,380,2154
BA,33570,BARRA DO CHOCA,4172,3575,5724,19003,13279,437,3043
BA,33596,BARRA DO MENDES,4014,1182,4042,12046,8004,371,1171
BA,33618,BARRA DO ROCHA,1228,361,2743,6079,3336,190,594
BA,33634,BARREIRAS,29948,4765,14565,68311,53746,1192,5234
BA,33650,GOVERNADOR LOMANTO JUNIOR,1289,549,1989,5698,3709,113,749
BA,33677,BELMONTE,2523,1194,6041,14716,8675,310,1612
BA,33693,BELO CAMPO,2302,1427,3038,11237,8199,334,1917
BA,33715,BIRITINGA,2323,1031,2762,10471,7709,461,2009
BA,33731,BOA NOVA,1762,2219,3733,10866,7133,620,1643
BA,33758,BOA VISTA DO TUPIM,2423,2364,3640,12681,9041,194,2047
BA,33774,BOM JESUS DA LAPA,9430,6244,11002,34846,23844,869,3446
BA,33782,BOM JESUS DA SERRA,978,1162,1758,6159,4401,83,1050
BA,33790,BONINAL,1755,2131,2403,8759,6356,253,1525
BA,33804,BONITO,1752,1806,2045,7750,5705,177,1283
BA,33812,BOQUIRA,3917,2683,4603,15627,11024,399,2607
BA,33839,BOTUPORA,1934,518,2179,7647,5468,202,1393
BA,33855,BREJOES,2337,1710,2697,9355,6658,241,1465
BA,33871,BREJOLANDIA,1449,1382,1866,7137,5271,235,983
BA,33898,BROTAS DE MACAUBAS,2586,546,2762,9331,6569,136,1142
BA,33910,BRUMADO,14630,7632,9448,41620,32172,1117,4785
BA,33936,BUERAREMA,3630,1521,5099,15605,10506,269,1815
BA,33952,CAATIBA,1118,953,2177,6402,4225,195,1133
BA,33960,CABACEIRAS DO PARAGUACU,1555,2107,2466,9637,7171,280,1857
BA,33979,CACHOEIRA,8201,1324,5542,21968,16426,599,2476
BA,33995,CACULE,3804,3220,3954,14327,10373,354,1963
BA,34010,CAEM,2800,809,3192,10040,6848,244,1707
BA,34029,CAETANOS,704,2421,1992,6715,4723,164,1208
BA,34037,CAETITE,7620,6796,8371,32193,23822,775,4533
BA,34053,CAFARNAUM,1630,2312,2761,10155,7394,224,1474
BA,34070,CAIRU,1580,830,1259,6660,5401,241,933
BA,34096,CALDEIRAO GRANDE,1438,1261,2137,6867,4730,222,1232
BA,34118,CAMACAN,5684,1464,8203,21920,13717,534,2300
BA,34134,CAMACARI,56220,3780,22645,115818,93173,2597,8083
BA,34150,CAMAMU,3200,2555,6972,18901,11929,494,2610
BA,34177,CAMPO ALEGRE DE LOURDES,5106,1427,5283,17833,12550,386,2383
BA,34193,CAMPO FORMOSO,10252,6629,10731,43343,32612,2132,7377
BA,34215,CANAPOLIS,1715,1232,1806,7218,5412,225,1388
BA,34231,CANARANA,3765,2900,4068,14829,10761,445,1879
BA,34258,CANAVIEIRAS,5828,1700,9146,24268,15122,481,2432
BA,34274,CANDEAL,2575,683,1664,7872,6208,290,1139
BA,34290,CANDEIAS,27970,1468,10876,51418,40542,1012,3104
BA,34312,CANDIBA,2568,1543,2410,9575,7165,563,1426
BA,34339,CANDIDO SALES,3322,1804,5785,18249,12464,656,2726
BA,34355,CANSANCAO,5210,3334,5922,21451,15529,996,3002
BA,34363,CARAIBAS,1381,1246,4262,9456,5194,135,1246
BA,34371,CARAVELAS,4149,1146,4770,13866,9096,382,1838
BA,34398,CARDEAL DA SILVA,1903,300,1616,5266,3650,109,736
BA,34410,CARINHANHA,5702,1086,4474,16285,11811,237,2082
BA,34436,CASA NOVA,11663,3271,9495,38869,29374,1341,5987
BA,34452,CASTRO ALVES,5609,2822,5814,20553,14739,630,2767
BA,34479,CATOLANDIA,626,245,364,2352,1988,138,340
BA,34495,CATU,16886,1548,6725,35737,29012,1099,3007
BA,34509,CATURAMA,1265,1205,1968,6621,4653,276,1067
BA,34517,CENTRAL,4422,1131,1759,11232,9473,322,1580
BA,34533,CHORROCHO,1968,1181,1637,7416,5779,130,1278
BA,34550,CICERO DANTAS,5964,2723,6163,23418,17255,1143,3637
BA,34576,CIPO,2657,1476,3323,11144,7821,304,1538
BA,34592,COARACI,4270,1946,6354,18035,11681,271,2033
BA,34614,COCOS,1526,2277,3308,11320,8012,866,1866
BA,34630,CONCEICAO DA FEIRA,5113,594,2468,11950,9482,559,1213
BA,34657,CONCEICAO DO ALMEIDA,4448,907,2575,12201,9626,380,1678
BA,34673,CONCEICAO DO COITE,12973,6774,8414,40358,31944,1385,5080
BA,34690,CONCEICAO DO JACUIPE,7118,1579,4283,19118,14835,518,2121
BA,34711,CONDE,3082,958,2989,11477,8488,334,1749
BA,34738,CONDEUBA,2500,3382,4515,14405,9890,358,2449
BA,34754,CONTENDAS DO SINCORA,769,859,1164,3731,2567,125,481
BA,34770,CORACAO DE MARIA,5677,1886,4388,17284,12896,776,2316
BA,34797,CORDEIROS,761,1184,2116,6223,4107,108,1009
BA,34819,CORIBE,3104,1137,2559,10213,7654,632,1439
BA,34835,CORONEL JOAO SA,1595,1434,2602,10124,7522,256,2126
BA,34851,CORRENTINA,3662,4533,5923,20519,14596,427,2994
BA,34878,COTEGIPE,2167,973,2310,8728,6418,566,1966
BA,34894,CRAVOLANDIA,860,720,659,3851,3192,324,873
BA,34916,CRISOPOLIS,2146,1103,4174,13056,8882,263,2364
BA,34932,CRISTOPOLIS,1576,1424,2383,9634,7251,238,1445
BA,34959,CRUZ DAS ALMAS,15942,2286,7428,35894,28466,894,2994
BA,34975,CURACA,6712,1868,4208,18880,14672,598,2210
BA,34991,DARIO MEIRA,1241,884,2302,7375,5073,260,1582
BA,35017,DOM BASILIO,1020,2414,2072,8180,6108,191,1305
BA,35033,DOM MACEDO COSTA,1055,220,523,3133,2610,74,500
BA,35050,ELISIO MEDRADO,1967,674,1561,6782,5221,196,1086
BA,35076,ENCRUZILHADA,2482,1999,5210,14811,9601,363,2658
BA,35092,ENTRE RIOS,7824,2498,7516,24638,17122,956,3110
BA,35114,ESPLANADA,5890,1945,5529,19756,14227,694,2518
BA,35130,EUCLIDES DA CUNHA,8806,5819,10216,38219,28003,1186,5261
BA,35149,FEIRA DA MATA,916,788,1066,3997,2931,73,518
BA,35157,FEIRA DE SANTANA,118987,20730,53464,295307,241843,6335,19736
BA,35173,FIRMINO ALVES,762,596,1335,3785,2450,130,529
BA,35190,FLORESTA AZUL,1444,1514,1495,7126,5631,207,987
BA,35211,FORMOSA DO RIO PRETO,2753,1707,3906,12878,8972,373,2081
BA,35238,GANDU,3746,2586,6391,20222,13831,472,2699
BA,35254,GENTIO DO OURO,1497,1744,1963,7699,5736,238,1069
BA,35270,GLORIA,3763,462,1536,9166,7630,263,1402
BA,35297,GONGOGI,1064,662,2829,6253,3424,107,663
BA,35319,GOVERNADOR MANGABEIRA,4363,1277,4211,14295,10084,405,1905
BA,35335,GUANAMBI,15153,9962,9812,45349,35537,1006,4279
BA,35351,GUARATINGA,4064,807,5817,15223,9406,311,1893
BA,35378,IACU,5125,2620,6374,19588,13214,564,2878
BA,35394,IBIASSUCE,1370,2121,2101,7459,5358,139,1147
BA,35416,IBICARAI,4664,3241,7918,21103,13185,462,2032
BA,35432,IBICOARA,1542,957,1578,7743,6165,192,1483
BA,35459,IBICUI,2250,1338,3827,10599,6772,429,1247
BA,35475,IBIPEBA,4856,952,3424,12536,9112,459,962
BA,35491,SANTA RITA DE CASSIA,4076,3829,4156,17014,12858,873,1951
BA,35513,IBIPITANGA,1177,2488,4261,10942,6681,231,1503
BA,35530,IBIQUERA,1081,163,1149,3581,2432,74,657
BA,35556,IBIRAPITANGA,3281,1604,6890,15791,8901,254,1559
BA,35572,IBIRAPUA,1295,788,1871,5571,3700,131,798
BA,35599,IBIRATAIA,2790,1298,5834,14992,9158,396,2250
BA,35610,IBITIARA,1350,1350,3190,10773,7583,147,1572
BA,35637,IBITITA,5720,972,3527,13387,9860,282,841
BA,35653,IBOTIRAMA,5105,2036,5389,17575,12186,314,1868
BA,35670,ICHU,2413,600,963,5402,4439,144,546
BA,35696,IGAPORA,2181,3054,2709,11085,8376,356,1846
BA,35700,IGRAPIUNA,1120,1028,2505,7212,4707,263,1044
BA,35718,IGUAI,3428,2054,5863,17240,11377,563,2544
BA,35734,ILHEUS,40678,5980,28677,109397,80720,2229,7276
BA,35750,INHAMBUPE,6567,1588,5950,22419,16469,591,3910
BA,35777,IPECAETA,2525,1633,4237,13581,9344,479,1774
BA,35793,IPIAU,8330,2523,10156,29065,18909,709,2680
BA,35815,IPIRA,13059,4148,13693,43266,29573,1094,5007
BA,35831,IPUPIARA,1891,1045,1918,7016,5098,132,795
BA,35858,IRAJUBA,1324,604,946,5009,4063,231,955
BA,35874,IRAMAIA,1847,1093,3101,8927,5826,145,1270
BA,35890,IRAQUARA,3195,2249,3584,12960,9376,388,1905
BA,35912,IRARA,5469,2292,4759,19113,14354,526,2907
BA,35939,IRECE,13380,2881,9274,36247,26973,829,3018
BA,35947,ITABELA,4080,1927,5595,16570,10975,532,1876
BA,35955,ITABERABA,13937,4557,11174,40940,29766,880,4921
BA,35971,ITABUNA,34827,10226,33489,134326,100837,1781,9044
BA,35998,ITACARE,2102,769,3794,9496,5702,207,1233
BA,36013,ITAETE,1478,2525,2904,8917,6013,237,1284
BA,36030,ITAGI,3054,464,2514,9383,6869,239,1845
BA,36056,ITAGIBA,3215,663,4596,11796,7200,225,1600
BA,36072,ITAGIMIRIM,999,657,1353,5296,3943,137,959
BA,36080,ITAGUACU DA BAHIA,2994,532,2228,8510,6282,212,1394
BA,36099,ITAJU DO COLONIA,1270,398,2341,5990,3649,143,694
BA,36110,ITAJUIPE,3733,1468,5791,17329,11538,551,1815
BA,36137,ITAMARAJU,14532,4114,15359,45371,30012,866,4236
BA,36153,ITAMARI,1538,935,1849,6142,4293,251,695
BA,36170,ITAMBE,2973,3275,5291,16347,11056,483,2289
BA,36196,ITANAGRA,1067,259,1496,4429,2933,83,644
BA,36218,ITANHEM,4965,1711,6273,16618,10345,403,2020
BA,36234,ITAPARICA,4697,493,2713,11215,8502,250,846
BA,36250,ITAPE,1874,494,1810,7247,5437,142,1114
BA,36277,ITAPEBI,1233,1010,2585,7197,4612,205,1037
BA,36293,ITAPETINGA,12115,4733,10729,41429,30700,639,4628
BA,36315,ITAPICURU,3574,2675,5994,18427,12433,732,3217
BA,36331,ITAPITANGA,1555,439,2520,6908,4388,151,729
BA,36358,ITAQUARA,999,1504,1581,5798,4217,129,1059
BA,36374,ITARANTIM,3461,835,4160,12616,8456,385,2172
BA,36382,ITATIM,1007,3071,2480,9573,7093,225,1719
BA,36390,ITIRUCU,2569,2276,2731,10030,7299,275,1374
BA,36412,ITIUBA,7119,3137,5986,23945,17959,953,3317
BA,36439,ITORORO,3505,1934,2614,12361,9747,301,1980
BA,36455,ITUACU,1372,4118,2774,12876,10102,313,2091
BA,36471,ITUBERA,3337,2148,4479,15480,11001,657,1990
BA,36498,JACARACI,2162,1823,4132,11238,7106,341,1584
BA,36510,JACOBINA,19026,4888,14974,54449,39475,1151,5878
BA,36536,JAGUAQUARA,8770,3834,7436,27251,19815,640,3169
BA,36552,JAGUARARI,7636,1935,5106,21215,16109,689,2779
BA,36579,JAGUARIPE,2474,718,2926,9731,6805,438,1591
BA,36595,JANDAIRA,1284,546,2456,6349,3893,173,850
BA,36617,JEQUIE,34061,4650,26527,94899,68372,1685,7788
BA,36633,JEREMOABO,3786,4837,6076,23341,17265,541,3641
BA,36650,JIQUIRICA,1729,1776,2461,9103,6642,251,1718
BA,36676,JITAUNA,1917,1777,4998,12035,7037,314,1613
BA,36692,JUAZEIRO,37854,5482,21991,104104,82113,1828,6975
BA,36706,JUCURUCU,2034,737,4222,9375,5153,147,1145
BA,36714,JUSSARA,3687,752,3408,10780,7372,248,1345
BA,36730,JUSSIAPE,680,1741,2151,7140,4989,176,1078
BA,36757,LAFAIETE COUTINHO,1388,353,1169,4064,2895,123,599
BA,36765,LAGOA REAL,1233,1873,1865,7569,5704,101,1369
BA,36773,LAJE,3786,1410,3782,15213,11431,434,2897
BA,36790,LAJEDAO,874,309,591,3160,2569,40,252
BA,36811,LAJEDINHO,337,113,377,2514,2137,27,364
BA,36820,LAJEDO DO TABOCAL,1095,1546,1530,5719,4189,134,936
BA,36838,LAMARAO,1029,702,2002,6202,4200,302,1065
BA,36854,LAURO DE FREITAS,34308,2706,13694,68695,55001,1650,3855
BA,36870,LENCOIS,1602,861,1360,4899,3539,79,672
BA,36897,LICINIO DE ALMEIDA,2567,1312,2578,9080,6502,172,1183
BA,36919,LIVRAMENTO DE NOSSA SENHORA,6153,5207,6946,26915,19969,528,3617
BA,36935,MACAJUBA,1068,1923,2026,7457,5431,256,1718
BA,36951,MACARANI,2038,1287,3571,11157,7586,293,2191
BA,36978,MACAUBAS,7664,4964,7155,27595,20440,479,4312
BA,36994,MACURURE,1373,915,1131,5708,4577,139,1023
BA,37010,MAIQUINIQUE,1514,479,1820,5753,3933,127,833
BA,37036,MAIRI,2244,2836,4932,14540,9608,332,2089
BA,37052,MALHADA,3415,947,2783,9608,6825,198,1131
BA,37079,MALHADA DE PEDRAS,936,610,1505,6251,4746,100,1194
BA,37095,MANOEL VITORINO,1738,2305,4115,11353,7238,360,1572
BA,37117,MARACAS,3211,3880,5179,16209,11030,575,2090
BA,37133,MARAGOGIPE,7822,3229,8289,29683,21394,1226,4550
BA,37150,MARAU,1720,1699,3719,10249,6530,345,1540
BA,37176,MARCIONILIO SOUZA,2202,645,2759,7731,4972,190,1124
BA,37192,MASCOTE,2161,869,4389,10741,6352,179,1198
BA,37214,MATA DE SAO JOAO,10518,1118,5567,23953,18386,735,2528
BA,37222,MATINA,1001,2059,1597,6986,5389,286,1497
BA,37230,MEDEIROS NETO,5397,1367,5190,17004,11814,393,2272
BA,37257,MIGUEL CALMON,5570,1235,4536,19046,14510,261,2845
BA,37273,MILAGRES,1544,344,1816,8543,6727,70,558
BA,37290,MIRANGABA,1784,2011,2520,9630,7110,396,1778
BA,37303,MIRANTE,466,1918,1467,5683,4216,73,926
BA,37311,MONTE SANTO,6889,5208,9520,33172,23652,2079,5215
BA,37338,MORPARA,1909,674,1877,6709,4832,138,1095
BA,37354,MORRO DO CHAPEU,6097,3574,5901,22884,16983,546,3430
BA,37370,MORTUGABA,1432,1959,4235,10000,5765,207,1506
BA,37397,MUCUGE,770,1547,1184,6292,5108,155,1322
BA,37419,MUCURI,5541,1701,5912,18862,12950,351,1660
BA,37427,MULUNGU DO MORRO,941,1891,2014,7239,5225,168,1217
BA,37435,MUNDO NOVO,3543,1520,3002,13361,10359,305,2193
BA,37451,MUNIZ FERREIRA,1917,443,978,6124,5146,201,1167
BA,37460,MUQUEM DO SAO FRANCISCO,1545,1231,1521,5307,3786,54,483
BA,37478,MURITIBA,5731,1692,4247,17292,13045,527,2042
BA,37494,MUTUIPE,4766,2055,3954,15059,11105,268,2039
BA,37516,NAZARE,6460,1312,5443,20846,15403,743,2455
BA,37532,NILO PECANHA,1525,1293,2130,7295,5165,321,1118
BA,37559,NOVA CANAA,2593,824,3503,10495,6992,344,1816
BA,37567,NOVA FATIMA,1548,796,818,5419,4601,241,823
BA,37575,NOVA ITARANA,548,1029,1518,4992,3474,288,882
BA,37583,NOVA REDENCAO,1923,382,1750,6089,4339,123,1033
BA,37591,NOVA SOURE,5114,1710,5679,18389,12710,722,2979
BA,37613,NOVA VICOSA,5770,1878,6504,19716,13212,418,1843
BA,37621,NOVO TRIUNFO,580,1555,1516,6272,4756,117,1107
BA,37630,OLINDINA,4106,1748,4893,17920,13027,700,2971
BA,37656,OLIVEIRA DOS BREJINHOS,4535,1941,4532,16050,11518,575,2287
BA,37672,OURICANGAS,1592,198,1591,6190,4599,141,1212
BA,37680,OUROLANDIA,2015,2202,3015,10716,7701,178,1974
BA,37699,PALMAS DE MONTE ALTO,4759,1970,3721,14602,10881,442,2538
BA,37710,PALMEIRAS,1581,962,1537,5710,4173,121,894
BA,37737,PARAMIRIM,3306,2560,4296,14504,10208,542,2157
BA,37753,PARATINGA,8086,1332,5835,20307,14472,350,2163
BA,37770,PARIPIRANGA,2744,4266,5036,19007,13971,552,3188
BA,37796,PAU BRASIL,1380,580,3927,9047,5120,173,1078
BA,37818,PAULO AFONSO,28315,3538,9345,56297,46952,1154,5605
BA,37834,PEDRAO,1712,629,1217,5325,4108,156,995
BA,37850,PEDRO ALEXANDRE,707,1061,2039,7402,5363,162,1758
BA,37877,PIATA,1039,4018,4116,14164,10048,347,2907
BA,37893,PILAO ARCADO,4579,455,6909,21900,14991,235,2701
BA,37915,PINDAI,1581,3202,3215,11246,8031,384,1704
BA,37931,PINDOBACU,3004,2993,3403,14036,10633,543,2170
BA,37940,PIRAI DO NORTE,553,1486,2330,5922,3592,161,709
BA,37958,PIRIPA,1475,645,2843,7432,4589,86,1232
BA,37974,PIRITIBA,3408,1550,3086,12443,9357,213,1970
BA,37990,PLANALTINO,734,1376,1861,6176,4315,429,1043
BA,38016,PLANALTO,2367,3708,4341,15813,11472,525,2545
BA,38032,POCOES,6685,4298,8643,29341,20698,907,4307
BA,38059,POJUCA,9176,1092,3820,20638,16818,845,2488
BA,38067,PONTO NOVO,2689,968,2338,8927,6589,298,1550
BA,38075,PORTO SEGURO,16962,4076,13353,47504,34151,865,4130
BA,38091,POTIRAGUA,1474,336,2739,7486,4747,181,1136
BA,38113,PRADO,3900,1927,5269,15618,10349,427,1678
BA,38130,PRESIDENTE DUTRA,3717,934,2685,10100,7415,211,1140
BA,38156,PRESIDENTE JANIO QUADROS,1527,756,3627,9887,6260,175,1962
BA,38164,PRESIDENTE TANCREDO NEVES,1103,3398,3262,11660,8398,385,2503
BA,38172,QUEIMADAS,5163,1957,5427,18623,13196,567,2377
BA,38199,QUIJINGUE,4500,2879,4251,18963,14712,411,3028
BA,38210,REMANSO,6493,1786,8557,26680,18123,488,4101
BA,38237,RETIROLANDIA,3927,1172,1861,9903,8042,462,1279
BA,38253,RIACHAO DAS NEVES,3367,1324,4623,16905,12282,692,3577
BA,38270,RIACHAO DO JACUIPE,8727,2977,5259,25053,19794,682,2561
BA,38296,RIACHO DE SANTANA,5153,4670,5524,20874,15350,908,3383
BA,38318,RIBEIRA DO AMPARO,2310,708,1440,7876,6436,220,1491
BA,38334,RIBEIRA DO POMBAL,8627,3570,8123,30129,22006,1244,3941
BA,38342,RIBEIRAO DO LARGO,1549,713,2171,7099,4928,145,1398
BA,38350,RIO DE CONTAS,1965,3292,1581,9535,7954,281,1503
BA,38377,RIO DO ANTONIO,1895,1651,3010,9826,6816,251,1678
BA,38393,RIO DO PIRES,890,3082,1556,7652,6096,205,1275
BA,38415,RIO REAL,5504,3145,6083,21459,15376,561,2853
BA,38431,RODELAS,2018,162,580,4109,3529,42,459
BA,38458,RUY BARBOSA,5767,2058,5915,20148,14233,445,3191
BA,38474,SALINAS DA MARGARIDA,2544,275,2086,7207,5121,147,771
BA,38490,SALVADOR,825187,51600,290155,1508170,1218015,30376,67760
BA,38512,SANTA BARBARA,5184,1028,2057,13893,11836,333,2318
BA,38539,SANTA BRIGIDA,1218,1626,1488,8376,6888,368,1934
BA,38555,SANTA CRUZ CABRALIA,3441,1135,3024,10633,7609,228,900
BA,38571,SANTA CRUZ DA VITORIA,883,292,1640,4106,2466,153,582
BA,38598,SANTA INES,2363,815,2483,8580,6097,375,1646
BA,38610,SANTALUZ,7130,4120,6593,24890,18297,548,3214
BA,38636,SANTA MARIA DA VITORIA,6178,3946,7366,25677,18311,670,3651
BA,38652,SANTANA,3900,4642,4762,17795,13033,360,2299
BA,38679,SANTANOPOLIS,2014,717,2251,8335,6084,349,1400
BA,38695,SANTA TERESINHA,1330,1182,2020,7082,5062,226,1289
BA,38717,SANTO AMARO,19210,3045,9336,41118,31782,1315,3191
BA,38733,SANTO ANTONIO DE JESUS,18338,5982,9768,50290,40522,1234,4661
BA,38750,SANTO ESTEVAO,7158,3487,7851,28125,20274,1009,4176
BA,38776,SAO DESIDERIO,3249,983,3816,14420,10604,233,1635
BA,38792,SAO FELIX,3577,898,2060,9606,7546,224,1497
BA,38806,SAO DOMINGOS,2848,1119,892,6493,5601,249,713
BA,38814,SAO FELIPE,3664,2714,5030,16889,11859,685,2401
BA,38822,SAO FELIX DO CORIBE,2451,1524,2376,8849,6473,181,1085
BA,38830,SAO FRANCISCO DO CONDE,11875,329,2654,20035,17381,424,1822
BA,38857,SAO GONCALO DOS CAMPOS,8265,1606,2932,18545,15613,960,2230
BA,38865,SAO JOSE DO JACUIPE,1543,958,2296,7677,5381,344,1129
BA,38873,SAO MIGUEL DAS MATAS,2176,396,1850,7201,5351,138,1105
BA,38890,SAO SEBASTIAO DO PASSE,14162,1771,5608,28069,22461,754,2587
BA,38911,SAPEACU,4227,1112,3324,13343,10019,480,1941
BA,38938,SATIRO DIAS,2918,716,3183,11140,7957,210,2090
BA,38946,SAUBARA,3056,341,1815,7567,5752,264,745
BA,38954,SAUDE,2626,765,1243,8134,6891,221,1685
BA,38970,SEABRA,7621,4383,6893,25447,18554,669,3638
BA,38997,SEBASTIAO LARANJEIRAS,1562,1508,1838,6351,4513,143,747
BA,39012,SENHOR DO BONFIM,14744,5535,10975,45047,34072,1109,4425
BA,39039,SENTO SE,2926,4403,6175,22634,16459,481,3036
BA,39047,SERRA DO RAMALHO,4312,2275,6448,19766,13318,347,2685
BA,39055,SERRA DOURADA,1859,2328,3250,11928,8678,352,1714
BA,39071,SERRA PRETA,3874,1300,3087,14015,10928,537,2529
BA,39098,SERRINHA,17911,3882,11013,47680,36667,1281,6374
BA,39110,SERROLANDIA,1809,1041,2427,8443,6016,203,1432
BA,39136,SIMOES FILHO,25565,1766,11285,58506,47221,1252,3439
BA,39144,SITIO DO MATO,1643,1147,1808,6879,5071,194,893
BA,39152,SOUTO SOARES,1336,2833,3917,10918,7001,324,1350
BA,39179,TABOCAS DO BREJO VELHO,1250,1755,2186,8460,6274,163,1676
BA,39195,TANHACU,1499,4185,3393,14466,11073,204,2438
BA,39217,TANQUINHO,2278,271,845,5391,4546,160,747
BA,39233,TAPEROA,2523,1652,3623,11642,8019,512,1764
BA,39250,TAPIRAMUTA,1632,2173,2161,8436,6275,128,1478
BA,39276,TEODORO SAMPAIO,2675,234,1841,6875,5034,204,909
BA,39292,TEOFILANDIA,4617,1708,4253,16269,12016,743,2607
BA,39314,TEOLANDIA,1104,2160,2908,9050,6142,377,1499
BA,39330,TERRA NOVA,4394,480,2077,9347,7270,216,1133
BA,39357,TREMEDAL,1373,2061,8525,17426,8901,229,2539
BA,39373,TUCANO,7707,4470,7846,31294,23448,1198,5660
BA,39390,UAUA,4347,4291,4831,19564,14733,608,2490
BA,39411,UBAIRA,2235,2897,4301,14087,9786,320,2055
BA,39438,UBAITABA,3054,1781,4630,13696,9066,265,1527
BA,39454,UBATA,4164,1135,7239,17913,10674,446,1847
BA,39470,UIBAI,4126,908,2798,10231,7433,186,1011
BA,39489,UMBURANAS,828,2580,1946,8264,6318,247,1552
BA,39497,UNA,3834,1260,7235,18054,10819,344,2334
BA,39519,URANDI,2709,2717,3632,12116,8484,552,1747
BA,39535,URUCUCA,4051,1169,6378,17090,10712,297,2090
BA,39551,UTINGA,2695,1156,3072,11188,8116,191,1734
BA,39578,VALENCA,11909,3859,10760,44823,34063,1760,5643
BA,39594,VALENTE,6075,2310,2684,15273,12589,566,1607
BA,39616,VARZEA DO POCO,1434,1311,1813,6565,4752,248,889
BA,39624,VARZEDO,1595,891,1737,6506,4769,198,1207
BA,39632,VERA CRUZ,8743,865,4883,20435,15552,706,1277
BA,39640,VEREDA,1350,829,2281,5990,3709,198,757
BA,39659,VITORIA DA CONQUISTA,51613,27052,38878,163941,125063,3172,13252
BA,39675,WAGNER,1420,635,1700,6224,4524,208,1061
BA,39691,WENCESLAU GUIMARAES,2197,1649,3697,11410,7713,290,1870
BA,39713,XIQUE XIQUE,10094,1785,9211,32063,22852,735,5600
BA,39730,LAPAO,6079,2342,3939,17007,13068,485,1942
BA,39748,MADRE DE DEUS,6459,242,1782,11081,9299,148,556
BA,39756,MAETINGA,871,426,2486,6006,3520,106,1005
BA,39772,MANSIDAO,1667,1809,1832,7463,5631,222,778
BA,39799,NORDESTINA,1424,419,1934,6895,4961,105,1283
BA,39810,PE DE SERRA,2069,1336,2530,10564,8034,310,1718
BA,39837,PINTADAS,2818,1025,2503,8084,5581,89,1028
BA,39845,QUIXABEIRA,2038,955,2190,7007,4817,259,891
BA,39853,RAFAEL JAMBEIRO,3184,1610,4920,15797,10877,460,3029
BA,39870,SANTA LUZIA,1334,874,3680,8742,5062,159,1108
BA,39896,SAO GABRIEL,4499,682,3180,13311,10131,205,1729
BA,39900,SITIO DO QUINTO,956,1623,2023,7547,5524,233,1176
BA,39918,TANQUE NOVO,2296,1090,2220,9574,7354,313,1764
BA,39926,SAO JOSE DA VITORIA,1095,294,2128,5633,3505,82,807
BA,39934,TEIXEIRA DE FREITAS,27116,4158,18980,67491,48511,983,5226
BA,39942,NOVO HORIZONTE,516,1916,1646,6429,4783,150,1010
BA,39950,VARZEA NOVA,2678,1099,1398,7767,6369,220,1462
BA,39969,NOVA IBIA,741,656,1762,5702,3940,291,1003
BA,39977,VARZEA DA ROCA,1238,1165,2978,9323,6345,312,1719
BA,39985,SOBRADINHO,5406,887,3996,16002,12006,259,1317
BA,39993,WANDERLEY,1872,2033,2361,9035,6674,251,1384
CE,13005,JIJOCA DE JERICOACOARA,1243,708,1998,7688,5690,124,596
CE,13013,ABAIARA,1131,592,923,5277,4354,184,650
CE,13021,MADALENA,2923,426,2301,9377,7076,150,886
CE,13030,ACARAU,5474,2392,9242,30917,21675,755,2768
CE,13048,PIRES FERREIRA,288,496,1321,6834,5513,90,437
CE,13056,ACOPIARA,7035,2507,6010,33701,27691,1729,3951
CE,13064,GRACA,549,875,3201,10568,7367,187,993
CE,13072,AIUABA,1245,729,2942,10433,7491,151,1391
CE,13080,TURURU,2213,943,1221,8753,7532,262,694
CE,13099,ALCANTARAS,335,509,1738,6936,5198,131,437
CE,13102,QUITERIANOPOLIS,2081,866,3041,13670,10629,256,1135
CE,13110,ALTANEIRA,780,389,672,4041,3369,112,431
CE,13129,BARREIRA,1685,876,2300,12507,10207,236,1061
CE,13137,ALTO SANTO,1624,553,1487,9260,7773,306,788
CE,13145,ACARAPE,1910,479,1413,8304,6891,242,688
CE,13153,ANTONINA DO NORTE,705,479,1024,4814,3790,120,448
CE,13161,CHOROZINHO,2498,806,1468,11645,10177,255,979
CE,13170,APUIARES,1932,745,1940,9186,7246,153,606
CE,13188,HORIZONTE,6251,892,3562,20621,17059,584,1520
CE,13196,AQUIRAZ,10840,2053,7200,36894,29694,897,3071
CE,13200,ERERE,355,483,1460,4877,3417,88,335
CE,13218,ARACATI,14642,2306,6652,38852,32200,968,2757
CE,13226,EUZEBIO,8139,1128,3671,22629,18958,455,1423
CE,13234,ARACOIABA,4765,1780,4231,19209,14978,496,1905
CE,13242,GUAIUBA,3348,1156,2683,13845,11162,244,1134
CE,13250,ARARIPE,1326,1344,3364,13540,10176,310,1587
CE,13269,POTIRETAMA,741,341,796,4044,3248,104,252
CE,13277,ARATUBA,2043,719,2345,9156,6811,215,946
CE,13285,PINDORETAMA,3005,752,1115,9722,8607,150,862
CE,13293,ARNEIROZ,795,444,1003,5272,4269,100,414
CE,13307,OCARA,3617,1368,2885,16058,13173,309,1272
CE,13315,ASSARE,2401,921,3912,15074,11162,389,1865
CE,13323,TEJUSSUOCA,1302,637,1152,8604,7452,160,673
CE,13331,AURORA,3151,2274,3127,17749,14622,628,1519
CE,13340,IPAPORANGA,1350,561,1749,7895,6146,110,945
CE,13358,BAIXIO,1035,395,730,4298,3568,89,373
CE,13366,TARRAFAS,615,566,1160,5480,4320,103,559
CE,13374,BARBALHA,11899,2878,6908,30965,24057,882,2474
CE,13382,BANABUIU,1862,715,2455,10766,8311,300,799
CE,13390,BARRO,3157,1787,2911,14058,11147,324,1670
CE,13404,BARROQUINHA,953,1040,2536,10984,8448,375,731
CE,13412,BATURITE,7578,1013,5516,22517,17001,608,1324
CE,13420,ARARENDA,1240,1280,2635,8522,5887,97,1038
CE,13439,BEBERIBE,6339,1707,6139,29150,23011,821,1482
CE,13447,SENADOR CATUNDA,596,602,1987,7058,5071,161,529
CE,13455,BELA CRUZ,2991,1119,4610,17571,12961,509,1616
CE,13463,CHORO,2799,635,2185,8416,6231,185,791
CE,13471,BOA VIAGEM,6875,2630,9984,36386,26402,1374,3446
CE,13480,ITAITINGA,5417,878,2689,15895,13206,358,1158
CE,13498,BREJO SANTO,12556,1275,5605,26845,21240,458,2057
CE,13501,FORTIM,2161,642,1569,8920,7351,193,899
CE,13510,CAMOCIM,5962,3283,6021,32678,26657,811,2089
CE,13536,CAMPOS SALES,1488,1686,3508,16406,12898,322,1849
CE,13552,CANINDE,8612,1973,11604,43729,32125,1134,5049
CE,13579,CAPISTRANO,3846,1111,2777,11956,9179,412,1012
CE,13595,CARIDADE,2245,775,1317,9781,8464,153,641
CE,13617,CARIRE,624,1170,4058,14578,10520,270,1100
CE,13633,CARIRIACU,1548,1857,5120,18541,13421,399,1470
CE,13650,CARIUS,2342,965,3468,13914,10446,573,1413
CE,13676,CARNAUBAL,650,1855,3458,10917,7459,229,758
CE,13692,CASCAVEL,8506,2604,7603,38457,30854,1109,3220
CE,13714,CATARINA,1101,513,1972,7068,5096,113,528
CE,13730,CAUCAIA,40045,5135,19261,119013,99752,2124,6773
CE,13757,CEDRO,3635,1717,2603,17353,14750,401,1456
CE,13773,CHAVAL,1415,816,1321,8275,6954,340,652
CE,13811,COREAU,2090,1799,3558,15093,11535,504,1597
CE,13838,CRATEUS,13097,2719,13901,50857,36956,1565,4034
CE,13854,CRATO,24224,5037,14893,69631,54738,1303,4657
CE,13870,FARIAS BRITO,2980,1209,2205,13699,11494,379,1795
CE,13897,FORTALEZA,562897,28845,180168,1262204,1082036,15188,34761
CE,13919,FRECHEIRINHA,1090,989,1314,7956,6642,281,814
CE,13935,GENERAL SAMPAIO,878,402,859,4515,3656,84,360
CE,13951,GRANJA,3820,3343,6553,28866,22313,1315,3670
CE,13978,GRANGEIRO,448,406,723,3715,2992,130,358
CE,13994,GROAIRAS,805,372,1032,6130,5098,305,561
CE,14010,GUARACIABA DO NORTE,1178,1501,7232,24244,17012,385,2534
CE,14036,GUARAMIRANGA,1283,169,1026,4283,3257,149,476
CE,14052,HIDROLANDIA,1447,1140,2414,11688,9274,242,1226
CE,14060,IBARETAMA,1839,727,1175,8446,7271,227,912
CE,14079,IBIAPINA,1233,1259,4388,15223,10835,298,1386
CE,14095,ICO,5487,4419,11968,43792,31824,1110,3604
CE,14117,IGUATU,18203,4867,13645,59529,45884,1359,4103
CE,14133,INDEPENDENCIA,3659,1362,3252,18362,15110,551,1615
CE,14150,IPAUMIRIM,2098,825,2127,8998,6871,249,979
CE,14176,IPU,2449,1906,8397,27804,19407,766,2163
CE,14192,IPUEIRAS,4965,1921,9147,27879,18732,658,2544
CE,14214,IRACEMA,1516,746,2801,10209,7408,210,753
CE,14230,IRAUCUBA,1847,693,3047,13405,10358,222,1110
CE,14257,ITAICABA,1653,212,1116,5322,4206,147,261
CE,14273,ITAPAGE,4430,1693,5709,28542,22833,741,2182
CE,14290,ITAPIPOCA,13229,3426,13703,60219,46516,1191,3576
CE,14311,ITAPIUNA,4057,881,1570,11275,9705,288,1441
CE,14338,ITATIRA,1101,700,1969,10183,8214,200,1011
CE,14354,JAGUARETAMA,2883,910,2088,12851,10763,428,1443
CE,14370,JAGUARIBARA,1429,450,1132,6642,5510,200,568
CE,14397,JAGUARIBE,3979,2055,6264,24985,18721,729,1899
CE,14419,JAGUARUANA,6812,1379,4442,21923,17481,1306,1624
CE,14435,JARDIM,4403,2010,4659,18541,13882,492,1841
CE,14451,JATI,762,460,879,5215,4336,90,421
CE,14478,JUAZEIRO DO NORTE,38055,10324,32736,132978,100242,2643,7851
CE,14494,JUCAS,2062,2269,3032,15272,12240,558,1857
CE,14516,LAVRAS DA MANGABEIRA,4301,2283,6799,23337,16538,541,2506
CE,14532,LIMOEIRO DO NORTE,12664,2212,6442,35963,29521,1253,1855
CE,14559,MARANGUAPE,19694,2713,8758,55458,46700,1193,3110
CE,14575,MARCO,2164,1103,2328,14472,12144,480,1260
CE,14591,MARTINOPOLE,1158,692,848,5794,4946,251,379
CE,14613,MASSAPE,2459,2369,4819,21258,16439,729,1738
CE,14630,MAURITI,6975,2396,6433,26787,20354,635,2443
CE,14656,MERUOCA,905,476,1269,8092,6823,181,679
CE,14672,MILAGRES,4538,2314,4469,19852,15383,409,1755
CE,14680,MIRAIMA,1070,746,2049,8763,6714,111,603
CE,14699,MISSAO VELHA,4979,3157,5635,22450,16815,584,2104
CE,14710,MOMBACA,4578,3104,5588,27858,22270,798,3965
CE,14737,MONSENHOR TABOSA,2129,860,2266,10889,8623,246,911
CE,14753,MORADA NOVA,10396,2605,10065,49123,39058,1200,3818
CE,14770,MORAUJO,539,597,824,5166,4342,184,443
CE,14796,MORRINHOS,2106,770,2940,12093,9153,179,879
CE,14818,MUCAMBO,458,902,1819,9257,7438,182,792
CE,14834,MULUNGU,1336,459,1284,6494,5210,169,635
CE,14850,NOVA OLINDA,1185,897,1293,8225,6932,175,655
CE,14877,NOVA RUSSAS,3606,1727,7590,23300,15710,475,1971
CE,14893,NOVO ORIENTE,3234,1406,3638,17441,13803,658,1454
CE,14915,OROS,3056,1416,2989,16055,13066,589,1613
CE,14931,PACAJUS,5339,1420,4926,28065,23139,728,2393
CE,14958,PACATUBA,10292,1200,4788,27201,22413,436,1778
CE,14974,PACOTI,2066,718,2093,8680,6587,285,580
CE,14990,PACUJA,447,263,800,4378,3578,99,603
CE,15016,PALHANO,803,609,746,6165,5419,134,344
CE,15032,PALMACIA,2352,467,1126,7195,6069,190,747
CE,15059,PARACURU,3084,1227,4093,18754,14661,382,1448
CE,15075,PARAMBU,2510,2328,7280,23722,16442,637,1808
CE,15091,PARAMOTI,1076,646,1326,7776,6450,124,698
CE,15113,PEDRA BRANCA,3832,1657,8699,27900,19201,819,3148
CE,15130,PENAFORTE,982,465,674,5098,4424,112,349
CE,15156,PENTECOSTE,6273,1561,3531,22271,18740,382,1630
CE,15172,PEREIRO,1180,2649,2895,11335,8440,236,870
CE,15199,PIQUET CARNEIRO,2146,998,1655,9523,7868,330,962
CE,15210,PORANGA,1278,937,1731,7961,6230,118,905
CE,15237,PORTEIRAS,3690,1126,1916,10789,8873,184,1134
CE,15253,POTENGI,776,555,997,5774,4777,196,490
CE,15270,QUIXADA,14437,2728,10083,44935,34852,828,2404
CE,15296,QUIXERAMOBIM,11081,2794,9158,41156,31998,736,3015
CE,15318,QUIXERE,3817,836,2009,11764,9755,305,932
CE,15334,REDENCAO,4979,1167,3453,18245,14792,444,1619
CE,15350,RERIUTABA,1103,883,4082,14072,9990,277,1133
CE,15377,RUSSAS,9956,1823,6627,37325,30698,1058,2688
CE,15393,SABOEIRO,1382,1126,2199,11103,8904,257,1527
CE,15415,SANTANA DO ACARAU,6294,920,4427,21184,16757,511,1775
CE,15431,SANTANA DO CARIRI,2467,925,3193,11405,8212,224,1071
CE,15440,SALITRE,319,1060,2137,8177,6040,149,811
CE,15458,SANTA QUITERIA,2383,1378,7616,29133,21517,648,2389
CE,15474,SAO BENEDITO,3553,3184,8596,30004,21408,593,2368
CE,15490,SAO GONCALO DO AMARANTE,5511,1850,5446,25904,20458,457,1708
CE,15512,SAO JOAO DO JAGUARIBE,2608,351,1081,6720,5639,212,527
CE,15539,SAO LUIS DO CURU,1786,576,1423,9205,7782,285,859
CE,15555,SENADOR POMPEU,5721,1301,3076,17450,14374,416,1938
CE,15571,SENADOR SA,357,468,652,4244,3592,90,549
CE,15598,SOBRAL,9312,5361,15760,96116,80356,2627,5527
CE,15610,SOLONOPOLE,1776,1083,2990,12644,9654,267,1702
CE,15636,TABULEIRO DO NORTE,7677,937,4646,21382,16736,572,1613
CE,15652,TAMBORIL,4541,1645,6112,20374,14262,471,1737
CE,15679,TAUA,5387,1967,6049,34311,28262,932,2685
CE,15695,TIANGUA,5902,2671,7799,35804,28005,1327,3314
CE,15717,TRAIRI,5500,2368,6489,28947,22458,607,1376
CE,15733,UBAJARA,1667,1567,4733,19329,14596,506,1477
CE,15750,UMARI,1356,551,1000,5200,4200,113,477
CE,15776,URUBURETAMA,2985,1253,1658,13096,11438,376,1085
CE,15792,URUOCA,1163,1181,1787,8458,6671,181,714
CE,15814,VARZEA ALEGRE,6492,2498,7278,26624,19346,884,2505
CE,15830,VICOSA DO CEARA,5639,2501,7428,32607,25179,540,2670
CE,15857,MARACANAU,46114,2977,15906,102015,86109,1732,4202
CE,15873,AMONTADA,3787,1552,6103,23123,17020,410,1845
CE,15881,CROATA,1257,1087,3491,11539,8048,189,937
CE,15890,CRUZ,2350,1059,3986,15394,11408,237,917
CE,15911,FORQUILHA,927,758,2856,13034,10178,402,946
CE,15920,IBICUITINGA,2252,545,1119,7993,6874,219,588
CE,15938,ICAPUI,5258,1066,2250,11505,9255,209,626
CE,15954,ITAREMA,2633,1410,5868,19186,13318,329,1476
CE,15970,MILHA,2023,465,1371,8955,7584,186,1153
CE,15989,DEP IRAPUAN PINHEIRO,1042,481,1161,6555,5394,109,912
CE,15997,PARAIPABA,1895,1323,2106,15880,13774,291,1181
CE,98531,QUIXELO,3544,3299,1682,11535,9853,382,971
CE,98558,UMIRIM,2327,886,2674,11700,9026,277,970
CE,98574,VARJOTA,921,958,2160,10288,8128,262,914
DF,97012,BRASILIA,592977,202410,234334,1518437,1284103,17517,56652
ES,56006,SAO DOMINGOS,2446,1108,1299,6597,5298,141,501
ES,56014,AFONSO CLAUDIO,5932,5879,4242,22155,17913,596,1305
ES,56022,AGUA DOCE DO NORTE,2351,1066,3687,11444,7757,289,1052
ES,56030,ALEGRE,5151,4447,4784,23441,18657,563,2057
ES,56049,IRUPI,992,1631,1465,6946,5481,174,405
ES,56057,ALFREDO CHAVES,3180,2947,1681,10485,8804,387,597
ES,56065,ALTO RIO NOVO,985,1133,1908,6245,4337,149,517
ES,56073,ANCHIETA,5158,2507,3074,15883,12809,516,803
ES,56081,VILA PAVAO,2361,954,1137,6222,5085,137,330
ES,56090,APIACA,825,656,1348,5842,4494,79,483
ES,56103,MARECHAL FLORIANO,3122,2777,1972,10961,8989,485,553
ES,56111,ARACRUZ,17903,6990,8089,47186,39097,906,2382
ES,56120,MARATAIZES,3438,1715,4416,20551,16135,469,1159
ES,56138,ATILIO VIVACQUA,2076,964,1015,7148,6133,139,469
ES,56146,BREJETUBA,1920,1387,2088,7565,5477,175,639
ES,56154,BAIXO GUANDU,6446,3569,4598,22459,17861,600,1889
ES,56162,SAO ROQUE DO CANAA,2357,2183,998,7234,6236,234,432
ES,56170,BARRA DE SAO FRANCISCO,7013,2947,6945,27864,20919,711,2340
ES,56189,SOORETAMA,4043,2150,2357,12228,9871,433,856
ES,56197,BOA ESPERANCA,3642,1663,2444,10523,8079,259,727
ES,56200,PONTO BELO,1876,988,1748,6184,4436,170,549
ES,56219,BOM JESUS DO NORTE,1289,886,1719,7608,5889,122,396
ES,56227,VILA VALERIO,4458,1235,1628,9154,7526,138,671
ES,56235,CACHOEIRO DE ITAPEMIRIM,39977,12790,16213,108449,92236,2896,3611
ES,56251,CARIACICA,68305,22334,25110,185347,160237,3599,7588
ES,56278,CASTELO,9265,4485,3599,24012,20413,881,1377
ES,56294,COLATINA,25356,15511,12263,75292,63029,1910,2882
ES,56308,GOVERNADOR LINDENBERG,3103,1536,1320,7239,5919,211,382
ES,56316,CONCEICAO DA BARRA,5047,2722,4915,17706,12791,564,1559
ES,56332,CONCEICAO DO CASTELO,1995,2172,1665,8648,6983,340,890
ES,56359,DIVINO DE SAO LOURENCO,538,766,928,3762,2834,95,303
ES,56375,DOMINGOS MARTINS,5497,6464,3149,21372,18223,792,1030
ES,56391,DORES DO RIO PRETO,847,952,1053,4761,3708,131,405
ES,56413,ECOPORANGA,5130,3282,5108,18132,13024,408,1282
ES,56430,FUNDAO,3925,1331,977,9276,8299,295,598
ES,56456,GUACUI,4483,3184,3555,18406,14851,542,1248
ES,56472,GUARAPARI,16482,10499,12667,63478,50811,1533,2642
ES,56499,IBIRACU,3886,1247,1483,9115,7632,294,535
ES,56502,IBITIRAMA,929,1085,1628,6529,4901,187,598
ES,56510,ICONHA,3508,2033,1076,8784,7708,251,441
ES,56537,ITAGUACU,3445,2578,2181,11469,9288,355,741
ES,56553,ITAPEMIRIM,4360,1856,4196,20768,16572,522,1182
ES,56570,ITARANA,2936,1708,1308,8632,7324,272,607
ES,56596,IUNA,3255,4206,4114,19676,15562,493,1360
ES,56618,JERONIMO MONTEIRO,1530,1410,1031,7094,6063,228,544
ES,56626,JOAO NEIVA,5302,1880,1800,11978,10178,329,563
ES,56634,LINHARES,23740,16281,13569,77423,63854,2407,4486
ES,56650,MANTENOPOLIS,1486,1448,3535,10783,7248,371,849
ES,56677,MIMOSO DO SUL,3648,2874,4301,19758,15457,753,1476
ES,56693,MONTANHA,4248,1592,3790,13280,9490,314,1150
ES,56715,MUCURICI,1563,949,1515,4944,3429,87,345
ES,56731,MUNIZ FREIRE,3702,2919,2747,13183,10436,305,943
ES,56758,MUQUI,3324,1509,1957,11370,9413,337,674
ES,56774,NOVA VENECIA,11670,4349,5968,29877,23909,828,1604
ES,56790,PANCAS,4303,2314,3840,15290,11450,284,998
ES,56812,PINHEIROS,5752,1828,4333,16315,11982,341,1219
ES,56839,PIUMA,2554,2004,2232,10262,8030,304,529
ES,56855,PRESIDENTE KENNEDY,998,496,1314,6480,5166,133,439
ES,56871,RIO NOVO DO SUL,2631,1818,1374,8970,7596,371,566
ES,56898,SANTA LEOPOLDINA,2262,2353,1208,8459,7251,291,625
ES,56910,SANTA TERESA,3994,5571,2895,17000,14105,527,1183
ES,56936,SAO GABRIEL DA PALHA,7273,3161,3518,19017,15499,425,1183
ES,56952,SAO JOSE DO CALCADO,1699,1007,1934,8796,6862,265,816
ES,56979,SAO MATEUS,22647,6431,12558,58208,45650,1019,2778
ES,56995,SERRA,80470,16501,31661,194762,163101,3611,7997
ES,57010,VIANA,14548,5036,7002,40962,33960,966,1549
ES,57037,VILA VELHA,84800,30472,34816,233231,198415,4153,7093
ES,57053,VITORIA,83795,37143,33631,223572,189941,3595,5495
ES,57070,MARILANDIA,3081,2124,1150,8216,7066,327,525
ES,57096,IBATIBA,2073,3651,2854,13531,10677,291,816
ES,57118,RIO BANANAL,4863,2927,2283,12842,10559,411,773
ES,57134,JAGUARE,5998,2218,2336,13355,11019,446,914
ES,57150,PEDRO CANARIO,5335,1972,6161,18582,12421,504,1588
ES,57916,LARANJA DA TERRA,2029,2930,1251,8442,7191,303,564
ES,57932,SANTA MARIA DO JETIBA,5784,4966,1914,18247,16333,531,1107
ES,57959,VARGEM ALTA,3886,2839,1878,11655,9777,357,455
ES,57975,VENDA NOVA DO IMIGRANTE,3056,3876,1525,11060,9535,352,920
ES,57991,AGUIA BRANCA,2369,1325,1345,6703,5358,189,516
GO,92010,ABADIANIA,2263,1996,1298,7974,6676,228,703
GO,92029,BONFINOPOLIS,1501,1095,734,4512,3778,72,314
GO,92037,AGUA LIMPA,582,456,247,1751,1504,31,124
GO,92053,ALEXANIA,3431,3575,3062,14932,11870,408,1218
GO,92061,CAMPOS VERDES,1123,1253,1857,5979,4122,53,617
GO,92096,ALOANDIA,481,526,208,1819,1611,28,151
GO,92100,CEZARINA,1775,1034,545,5214,4669,82,269
GO,92118,ALTO PARAISO,1231,727,1093,4053,2960,57,249
GO,92126,COLINAS DO SUL,537,771,1052,3140,2088,38,255
GO,92150,ALVORADA DO NORTE,1301,1620,1319,5563,4244,84,583
GO,92169,MORRO AGUDO DE GOIAS,483,491,290,2060,1770,47,217
GO,92177,AMORINOPOLIS,944,951,323,3340,3017,45,162
GO,92207,EDEALINA,1002,720,396,3227,2831,59,299
GO,92215,ANAPOLIS,51678,44971,29021,188467,159446,4005,6410
GO,92223,FAINA,1607,1278,1196,5794,4598,141,493
GO,92231,ANHANGUERA,232,163,118,772,654,7,73
GO,92258,ANICUNS,4630,2729,2213,14042,11829,302,985
GO,92266,GOUVELANDIA,1013,829,650,3405,2755,54,297
GO,92274,APARECIDA DE GOIANIA,64190,29659,29090,181114,152024,2993,8642
GO,92282,ITAGUARI,1215,990,484,3682,3198,62,282
GO,92290,APORE,550,612,740,2503,1763,32,164
GO,92312,ARACU,1130,1047,391,3425,3034,61,307
GO,92320,MATRINCHA,1171,758,799,3639,2840,65,278
GO,92339,ARAGARCAS,4234,1281,2603,11068,8465,201,628
GO,92347,MIMOSO DE GOIAS,403,647,358,2507,2149,39,297
GO,92355,ARAGOIANIA,1767,1168,430,4698,4268,72,364
GO,92363,MONTIVIDIU,2011,1891,1045,6604,5559,135,440
GO,92444,NOVO PLANALTO,744,620,607,2878,2271,26,247
GO,92460,PALESTINA DE GOIAS,495,722,489,2600,2111,24,250
GO,92495,ARUANA,1008,1091,974,3867,2893,37,290
GO,92517,AURILANDIA,1463,595,670,3686,3016,58,281
GO,92550,AVELINOPOLIS,565,731,286,2255,1969,79,164
GO,92568,SANTA FE DE GOIAS,1126,572,679,3346,2667,73,198
GO,92614,BALIZA,490,298,512,1640,1128,21,124
GO,92622,SAO JOAO DA PARAUNA,516,365,253,1638,1385,31,129
GO,92630,BARRO ALTO,1716,823,1507,5985,4478,79,558
GO,92649,SAO LUIZ DO NORTE,945,803,856,3570,2714,61,339
GO,92657,BELA VISTA DE GOIAS,4542,3494,2330,14255,11925,396,941
GO,92665,SAO MIGUEL DO PASSA QUATRO,893,552,383,2659,2276,70,194
GO,92673,BOM JARDIM DE GOIAS,1882,1389,1559,6357,4798,101,406
GO,92690,BOM JESUS,3301,3628,1940,11821,9881,273,1040
GO,92703,SENADOR CANEDO,11532,5712,6260,33222,26962,571,1348
GO,92711,BRAZABRANTES,667,597,280,2124,1844,43,101
GO,92720,SIMOLANDIA,1308,1348,1234,5123,3889,143,565
GO,92754,BRITANIA,1626,1009,1040,4486,3446,61,316
GO,92762,TERESINA DE GOIAS,557,336,404,1906,1502,14,238
GO,92770,BURITI ALEGRE,2145,1995,957,6663,5706,133,482
GO,92789,TROMBAS,889,679,656,3036,2380,48,288
GO,92797,CABECEIRAS,1810,1030,1069,5156,4087,119,361
GO,92800,TURVELANDIA,914,600,558,2724,2166,27,263
GO,92819,CACHOEIRA ALTA,1680,1218,1330,6217,4887,141,535
GO,92827,RIO QUENTE,770,443,351,2250,1899,38,126
GO,92835,CACHOEIRA DE GOIAS,313,408,217,1325,1108,19,108
GO,92851,CACU,2614,1788,1434,8145,6711,143,529
GO,92860,GUARINOS,526,788,430,2335,1905,36,285
GO,92878,CAIAPONIA,3264,2040,1416,9687,8271,157,841
GO,92886,COCALZINHO DE GOIAS,1978,2369,1970,9671,7701,246,930
GO,92894,CALDAS NOVAS,10846,6075,6404,34739,28335,722,1815
GO,92908,SANTO ANTONIO DE GOIAS,1235,438,403,2802,2399,60,144
GO,92916,CAMPESTRE DE GOIAS,690,671,214,2152,1938,29,116
GO,92924,CHAPADAO DO CEU,1017,614,519,2687,2168,43,135
GO,92932,CAMPINORTE,1418,1868,1658,6651,4993,169,341
GO,92940,ALTO HORIZONTE,507,696,480,2268,1788,34,167
GO,92959,CAMPO ALEGRE DE GOIAS,1039,915,656,3627,2971,53,206
GO,92967,CASTELANDIA,997,762,652,3152,2500,52,190
GO,92975,CAMPOS BELOS,3570,1570,3127,12319,9192,227,1430
GO,92983,JESUPOLIS,611,461,266,2013,1747,46,241
GO,92991,CARMO DO RIO VERDE,2034,1115,896,5867,4971,132,453
GO,93009,APARECIDA DO RIO DOCE,731,398,537,2295,1758,26,187
GO,93017,CATALAO,20683,8325,5697,46759,41062,1225,2509
GO,93025,CIDADE OCIDENTAL,9018,2574,3778,23374,19596,476,1118
GO,93033,CATURAI,1135,999,487,3392,2905,78,242
GO,93041,PROFESSOR JAMIL,1158,559,560,2816,2256,45,205
GO,93050,CAVALCANTE,1211,1099,2112,6088,3976,72,899
GO,93068,PEROLANDIA,751,260,441,2131,1690,30,188
GO,93076,CERES,4770,3385,1614,14353,12739,255,766
GO,93084,NOVA IGUACU DE GOIAS,451,660,394,1983,1589,32,182
GO,93092,DIVINOPOLIS DE GOIAS,1284,695,1025,4087,3062,75,511
GO,93106,BURITI DE GOIAS,795,264,427,2619,2192,28,221
GO,93122,CALDAZINHA,798,606,405,2484,2079,45,149
GO,93149,GUARAITA,682,332,470,2609,2139,41,230
GO,93157,CORREGO DO OURO,682,598,538,2741,2203,50,143
GO,93165,INACIOLANDIA,1248,693,725,4078,3353,66,417
GO,93173,CORUMBA DE GOIAS,1376,2232,753,6407,5654,180,656
GO,93181,MONTIVIDIU DO NORTE,548,827,429,2495,2066,58,253
GO,93190,CORUMBAIBA,1610,1015,943,5360,4417,99,490
GO,93203,SANTO ANTONIO DA BARRA,773,1146,615,3352,2737,79,254
GO,93220,TEREZOPOLIS DE GOIAS,1194,951,512,3812,3300,99,333
GO,93246,UIRAPURU,565,645,467,2339,1872,25,232
GO,93254,CRISTALINA,4592,6643,3763,21214,17451,617,1686
GO,93262,BURITINOPOLIS,408,865,619,2539,1920,33,332
GO,93270,CRISTIANOPOLIS,826,570,466,2817,2351,44,196
GO,93289,VILA BOA,786,454,315,2240,1925,24,244
GO,93297,CRIXAS,3217,1819,2348,10158,7810,120,842
GO,93300,VALPARAISO,15083,3602,5857,38666,32809,876,1569
GO,93319,CROMINIA,1010,851,350,3219,2869,56,212
GO,93327,NOVO GAMA,10034,3653,5164,29655,24491,645,2183
GO,93335,CUMARI,909,460,310,2341,2031,61,151
GO,93343,AGUAS LINDAS,8620,3167,6356,30550,24194,1013,1632
GO,93351,DAMIANOPOLIS,370,1159,712,2838,2126,36,263
GO,93360,ABADIA DE GOIAS,1178,751,487,3567,3080,59,181
GO,93378,DAMOLANDIA,751,754,255,2449,2194,70,191
GO,93386,AMARALINA,350,677,429,2155,1726,43,167
GO,93394,DAVINOPOLIS,552,388,129,1700,1571,30,140
GO,93408,BONOPOLIS,471,821,534,2177,1643,21,171
GO,93424,PORTEIRAO,710,504,612,2446,1834,23,212
GO,93432,DIORAMA,663,480,365,2198,1833,44,87
GO,93440,SANTA RITA DO NOVO DESTINO,774,367,631,3045,2414,51,258
GO,93483,SAO PATRICIO,426,443,209,1650,1441,24,136
GO,93491,EDEIA,1941,2280,1218,7129,5911,129,380
GO,93505,VILA PROPICIO,873,703,850,3620,2770,72,409
GO,93513,ESTRELA DO NORTE,815,807,589,2976,2387,51,208
GO,93530,FAZENDA NOVA,1529,1050,994,5339,4345,67,434
GO,93548,IPIRANGA DE GOIAS,621,470,256,2105,1849,47,219
GO,93564,GAMELEIRA DE GOIAS,452,623,261,1768,1507,39,114
GO,93572,FIRMINOPOLIS,2163,1819,758,6978,6220,123,431
GO,93580,CAMPO LIMPO DE GOIAS,855,1344,521,3668,3147,75,218
GO,93599,FLORES DE GOIAS,1012,1349,1116,4491,3375,84,401
GO,93602,LAGOA SANTA,163,260,141,813,672,7,66
GO,93610,FORMOSA,18205,11059,8150,50665,42515,999,2623
GO,93637,FORMOSO,1285,863,1101,4609,3508,65,398
GO,93670,GOIANAPOLIS,1710,2190,1750,8380,6630,205,518
GO,93696,GOIANDIRA,1627,708,359,3749,3390,69,278
GO,93718,GOIANESIA,11377,5964,6306,35141,28835,712,2816
GO,93734,GOIANIA,260666,144915,117143,762093,644950,10196,23657
GO,93750,GOIANIRA,4710,2118,1802,12128,10326,241,607
GO,93777,GOIAS,7803,3717,3840,20805,16965,374,1256
GO,93793,GOIATUBA,6385,6027,4447,23719,19272,607,1686
GO,93815,GUAPO,2727,2743,1375,9180,7805,213,510
GO,93831,GUARANI DE GOIAS,626,1245,734,3431,2697,37,385
GO,93874,HEITORAI,705,819,422,2644,2222,26,200
GO,93890,HIDROLANDIA,3475,2124,1614,9880,8266,245,520
GO,93912,HIDROLINA,1057,1064,529,3565,3036,74,303
GO,93939,IACIARA,1537,2161,1607,6963,5356,135,717
GO,93955,INHUMAS,11215,7878,4823,32083,27260,566,1570
GO,93971,IPAMERI,5693,3592,3181,17420,14239,435,1124
GO,93998,IPORA,6463,4574,3904,22521,18617,381,985
GO,94013,ISRAELANDIA,601,764,444,2566,2122,37,155
GO,94030,ITABERAI,5636,4902,3290,19729,16439,413,1649
GO,94072,ITAGUARU,1676,808,438,4505,4067,105,420
GO,94110,ITAJA,1158,1070,757,3958,3201,44,318
GO,94137,ITAPACI,2497,2868,1754,10215,8461,177,838
GO,94153,ITAPIRAPUA,2049,1209,1499,6711,5212,89,516
GO,94196,ITAPURANGA,7600,2992,3696,20839,17143,424,1191
GO,94218,ITARUMA,816,1183,923,3897,2974,39,253
GO,94234,ITAUCU,2547,1729,700,6429,5729,130,446
GO,94250,ITUMBIARA,18887,15821,9888,60241,50353,1183,2827
GO,94277,IVOLANDIA,626,748,369,2360,1991,29,164
GO,94293,JANDAIA,1850,1186,844,5614,4770,68,328
GO,94315,JARAGUA,6124,6114,3822,23081,19259,477,1742
GO,94331,JATAI,20132,7993,8289,52239,43950,864,2701
GO,94358,JAUPACI,647,379,358,2411,2053,35,209
GO,94374,JOVIANIA,1662,1339,935,5410,4475,129,393
GO,94390,JUSSARA,4492,3590,2986,14776,11790,217,991
GO,94439,LEOPOLDO DE BULHOES,1553,1190,1252,6336,5084,196,598
GO,94455,LUZIANIA,23935,14486,11063,75465,64402,1998,4176
GO,94471,MAIRIPOTABA,624,596,230,2001,1771,34,144
GO,94498,MAMBAI,649,1133,875,3557,2682,57,343
GO,94510,MARA ROSA,1385,2818,1559,8073,6514,137,617
GO,94536,MARZAGAO,440,437,267,1635,1368,17,148
GO,94552,PARANAIGUARA,2188,1445,1382,6654,5272,118,482
GO,94579,MAURILANDIA,2391,1361,1534,6813,5279,182,585
GO,94595,MINEIROS,9503,6202,4054,26664,22610,512,1658
GO,94650,MOIPORA,458,615,237,1773,1536,33,97
GO,94676,MONTE ALEGRE DE GOIAS,1014,1246,1351,4957,3606,55,686
GO,94714,MONTES CLAROS DE GOIAS,1418,1432,918,5486,4568,83,453
GO,94730,MORRINHOS,10446,6085,4053,27752,23699,534,1533
GO,94757,MOSSAMEDES,1731,649,891,4529,3638,87,281
GO,94773,MOZARLANDIA,2141,2366,2057,8923,6866,139,707
GO,94790,MUTUNOPOLIS,650,1132,689,3361,2672,60,263
GO,94854,NAZARIO,1584,1169,574,4856,4282,123,391
GO,94870,NEROPOLIS,4745,3253,2152,14079,11927,365,1085
GO,94897,NIQUELANDIA,7848,4799,7345,27892,20547,455,2384
GO,94919,NOVA AMERICA,462,737,213,1878,1665,41,153
GO,94935,NOVA AURORA,517,554,124,1587,1463,28,105
GO,94951,NOVA ROMA,501,1009,874,2880,2006,39,263
GO,94978,NOVA VENEZA,1804,1275,748,5228,4480,117,373
GO,95010,NOVO BRASIL,1146,767,600,3394,2794,41,318
GO,95036,ORIZONA,3680,2139,1318,9853,8535,225,787
GO,95052,OURO VERDE DE GOIAS,849,926,702,3683,2981,109,318
GO,95079,OUVIDOR,1359,829,292,3674,3382,45,252
GO,95095,PADRE BERNARDO,2359,2052,2881,11441,8560,198,1184
GO,95117,PALMEIRAS DE GOIAS,3162,4783,2081,14247,12166,209,595
GO,95133,PALMELO,634,447,307,1961,1654,28,125
GO,95150,PALMINOPOLIS,623,831,342,2717,2375,33,144
GO,95176,PANAMA,712,821,329,2341,2012,45,179
GO,95230,PARAUNA,2576,1612,1685,7916,6231,106,606
GO,95311,PETROLINA DE GOIAS,1878,2676,837,7175,6338,187,635
GO,95354,PILAR DE GOIAS,600,862,582,2686,2104,48,257
GO,95397,PIRACANJUBA,6975,3826,3012,17809,14797,321,1024
GO,95419,PIRANHAS,3135,1464,1305,8450,7145,137,742
GO,95435,PIRENOPOLIS,4075,5764,2591,16460,13869,439,1198
GO,95451,PIRES DO RIO,5870,3734,3001,19250,16249,504,1451
GO,95494,PONTALINA,3907,2751,2337,13283,10946,322,975
GO,95559,PORANGATU,8537,6195,6293,27798,21505,333,1676
GO,95575,PORTELANDIA,1008,670,525,3112,2587,99,290
GO,95613,POSSE,4473,5741,3872,18325,14453,297,1581
GO,95630,QUIRINOPOLIS,10319,5966,4389,27376,22987,575,1840
GO,95656,RIALMA,1839,1954,1306,7471,6165,133,542
GO,95672,RIANAPOLIS,1046,666,773,3849,3076,88,403
GO,95710,RIO VERDE,22770,19692,11310,75265,63955,1846,4205
GO,95737,RUBIATABA,3209,4082,2444,13499,11055,270,955
GO,95753,SANCLERLANDIA,2410,994,1178,6512,5334,109,362
GO,95770,SANTA BARBARA DE GOIAS,1195,883,506,3460,2954,49,230
GO,95796,SANTA CRUZ DE GOIAS,780,639,317,2413,2096,46,181
GO,95818,SANTA HELENA DE GOIAS,7555,7621,4565,26931,22366,625,1799
GO,95834,SANTA RITA DO ARAGUAIA,889,1038,792,3687,2895,52,313
GO,95850,SANTA ROSA DE GOIAS,1031,703,359,2883,2524,106,299
GO,95877,SANTA TEREZA DE GOIAS,884,847,973,3872,2899,65,306
GO,95893,SANTA TEREZINHA DE GOIAS,1813,2296,2068,8564,6496,131,682
GO,95915,SAO DOMINGOS,1276,1757,1888,6983,5095,110,780
GO,95931,SAO FRANCISCO DE GOIAS,1040,1415,443,3969,3526,87,330
GO,95958,PLANALTINA,13676,5150,6476,37828,31352,1210,2204
GO,95974,SAO JOAO D ALIANCA,1330,860,1371,5065,3694,96,467
GO,95990,SAO LUIS DE MONTES BELOS,5642,4100,3685,20478,16793,456,1506
GO,96016,SAO MIGUEL DO ARAGUAIA,3568,3706,3470,15036,11566,251,1000
GO,96059,SAO SIMAO,4297,2013,2699,11416,8717,138,755
GO,96075,SERRANOPOLIS,1597,584,879,4609,3730,70,330
GO,96091,SILVANIA,4401,2999,1612,11895,10283,292,688
GO,96113,SITIO D ABADIA,605,669,565,2375,1810,37,275
GO,96172,TAQUARAL DE GOIAS,680,988,435,2828,2393,54,278
GO,96237,TRES RANCHOS,810,475,231,2133,1902,47,168
GO,96253,TRINDADE,19433,11499,8507,54604,46097,909,2314
GO,96318,TURVANIA,1237,1134,488,4159,3671,55,320
GO,96334,URUACU,6168,5811,5788,23791,18003,506,1595
GO,96350,URUANA,3512,1887,1795,10657,8862,215,767
GO,96377,URUTAI,590,480,247,2176,1929,80,163
GO,96393,VARJAO,774,1055,562,3619,3057,68,299
GO,96415,VIANOPOLIS,1741,2143,1089,7277,6188,200,682
GO,96458,ACREUNA,4615,2540,2225,12446,10221,280,745
GO,96474,MINACU,6452,4059,6344,24760,18416,354,1384
GO,96512,MUNDO NOVO DE GOIAS,1042,1195,1091,4487,3396,52,530
GO,96539,NOVA CRIXAS,1392,2230,1626,6620,4994,70,617
GO,96555,NOVA GLORIA,2070,896,1389,6652,5263,142,550
GO,96571,VICENTINOPOLIS,1458,1120,667,4562,3895,81,384
GO,96610,AMERICANO DO BRASIL,1578,840,477,4110,3633,90,353
GO,96695,ARAGUAPAZ,1281,1085,1179,5394,4215,70,465
GO,96717,ARENOPOLIS,1071,596,629,3303,2674,24,274
GO,96733,CACHOEIRA DOURADA,2307,1781,982,6719,5737,117,327
GO,96750,DOVERLANDIA,1942,1419,1152,5895,4743,96,355
GO,96776,SANTO ANTONIO DO DESCOBERTO,7060,3609,5818,27178,21360,704,1884
GO,96814,INDIARA,2504,1569,1394,7640,6246,202,518
GO,96873,CAMPINACU,663,757,814,3200,2386,80,224
GO,96890,SANTA ISABEL,649,667,319,2485,2166,66,255
GO,96911,ADELANDIA,450,498,375,2208,1833,27,151
GO,96938,AGUA FRIA DE GOIAS,591,861,911,3325,2414,54,289
MA,7005,AGUA DOCE,705,657,1363,6212,4849,675,1125
MA,7013,AFONSO CUNHA,465,172,429,3373,2944,155,913
MA,7021,ALTO ALEGRE DO MARANHAO,1827,364,2802,10012,7210,298,1211
MA,7030,ALCANTARA,3425,431,1938,10962,9024,724,1402
MA,7048,ALTO ALEGRE DO PINDARE,3386,1868,3889,14624,10735,274,2465
MA,7056,ALDEIAS ALTAS,2598,833,2757,11150,8393,412,2431
MA,7064,APICUM ACU,494,1015,1373,5889,4516,239,837
MA,7072,ALTAMIRA DO MARANHAO,1178,131,1218,5104,3886,91,834
MA,7080,AMAPA DO MARANHAO,731,381,1053,3755,2702,129,643
MA,7099,ALTO PARNAIBA,696,715,1967,6239,4272,162,936
MA,7102,ARAGUANA,1322,402,1888,6100,4212,103,888
MA,7110,AMARANTE DO MARANHAO,2818,1823,3421,15494,12073,315,2156
MA,7129,BACABEIRA,1658,379,1172,6921,5749,225,1155
MA,7137,ANAJATUBA,6220,352,3780,14481,10701,458,2027
MA,7145,BACURITUBA,461,79,1083,3519,2436,80,502
MA,7153,ANAPURUS,1323,1332,927,7198,6271,573,1316
MA,7161,BELAGUA,1004,102,717,3700,2983,116,718
MA,7170,ARAIOSES,2093,3475,6790,22477,15687,1440,3725
MA,7188,BELA VISTA,1170,270,1479,5976,4497,147,943
MA,7196,ARARI,5760,1020,2724,15496,12772,539,2009
MA,7200,BERNARDO DO MEARIM,537,192,540,3492,2952,102,595
MA,7218,AXIXA,913,591,1716,6734,5018,202,719
MA,7226,CACHOEIRA GRANDE,947,78,1318,4406,3088,58,594
MA,7234,BACABAL,15602,2861,15497,56839,41342,991,5622
MA,7242,DAVINOPOLIS,1414,545,2095,7565,5470,120,892
MA,7250,BACURI,1833,947,2219,8735,6516,189,1571
MA,7269,BOM JESUS DAS SELVAS,2200,1106,2644,10173,7529,223,1676
MA,7277,BALSAS,7799,5219,8848,35006,26158,809,3626
MA,7285,BOM LUGAR,1564,583,2049,7949,5900,135,1088
MA,7293,BARAO DE GRAJAU,1560,922,1662,9869,8207,299,1859
MA,7307,BREJO DE AREIA,1035,135,1333,5461,4128,175,1101
MA,7315,BARRA DO CORDA,3845,4206,9799,41502,31703,1429,6705
MA,7323,BOA VISTA DO GURUPI,585,445,788,3170,2382,81,490
MA,7331,BARREIRINHAS,9045,1589,5760,25622,19862,924,3772
MA,7340,BURITICUPU,6627,2038,5877,24203,18326,584,3223
MA,7358,BENEDITO LEITE,468,484,790,3603,2813,127,695
MA,7366,BURITIRANA,1223,727,1582,8294,6712,149,1278
MA,7374,BEQUIMAO,4245,225,5209,15588,10379,685,1806
MA,7382,CAMPESTRE DO MARANHAO,1306,489,1649,6688,5039,139,982
MA,7390,BREJO,2123,4599,4206,17824,13618,659,2782
MA,7404,CAPINZAL DO NORTE,1460,229,976,5783,4807,143,1222
MA,7412,BURITI,2674,2503,4073,14865,10792,774,2364
MA,7420,CENTRAL DO MARANHAO,1377,63,1269,4281,3012,76,686
MA,7439,BURITI BRAVO,2723,1192,2224,11414,9190,236,2355
MA,7447,CENTRO DO GUILHERME,874,213,982,3768,2786,90,827
MA,7455,CAJAPIO,1508,171,1250,5847,4597,150,1011
MA,7463,CENTRO NOVO DO MARANHAO,1208,704,1536,6358,4822,134,1144
MA,7471,CAJARI,3143,400,3211,10698,7487,415,1336
MA,7480,CIDELANDIA,1927,503,2188,7690,5502,125,786
MA,7498,CANDIDO MENDES,1138,802,3349,10003,6654,154,1156
MA,7501,CONCEICAO DO LAGO ACU,1195,627,1812,7064,5252,146,1197
MA,7510,CANTANHEDE,1975,814,2399,8205,5806,107,1067
MA,7528,FEIRA NOVA DO MARANHAO,1118,369,629,3946,3317,176,700
MA,7536,CAROLINA,3613,2031,4477,15725,11248,308,1741
MA,7544,FERNANDO FALCAO,419,250,641,4541,3900,107,1018
MA,7552,CARUTAPERA,1869,470,2571,10913,8342,189,1298
MA,7560,FORMOSA DA SERRA NEGRA,947,1926,916,7097,6181,133,1186
MA,7579,CAXIAS,23956,6428,23676,82104,58428,1697,10109
MA,7595,CEDRAL,766,102,1416,6032,4616,252,671
MA,7609,GOVERNADOR EDSON LOBAO,1259,666,979,5763,4784,98,635
MA,7617,CHAPADINHA,7757,2009,7386,34026,26640,2244,5347
MA,7625,GOVERNADOR LUIZ ROCHA,690,664,823,5516,4693,90,1032
MA,7633,CODO,12695,4322,20219,62217,41998,1669,8585
MA,7641,GOVERNADOR NEWTON BELLO,978,239,1728,5897,4169,130,936
MA,7650,COELHO NETO,6248,1569,7313,27179,19866,864,4976
MA,7668,GOVERNADOR NUNES FREIRE,2196,772,1797,8976,7179,184,1457
MA,7676,COLINAS,2594,2289,4958,18535,13577,448,3299
MA,7684,IGARAPE DO MEIO,1263,253,1582,5558,3976,121,936
MA,7692,COROATA,5765,891,9949,35808,25859,702,3086
MA,7706,ITAIPAVA DO GRAJAU,833,619,1261,5638,4377,90,813
MA,7714,CURURUPU,3253,2316,3737,17880,14143,714,2334
MA,7722,ITINGA DO MARANHAO,2620,2364,3019,12911,9892,241,1594
MA,7730,DOM PEDRO,1939,1387,3475,14209,10734,484,1860
MA,7749,JATOBA,603,376,901,4003,3102,131,649
MA,7757,DUQUE BACELAR,1860,362,1580,5947,4367,212,1206
MA,7765,JENIPAPO DOS VIEIRAS,484,1108,1008,6720,5712,182,1400
MA,7773,ESPERANTINOPOLIS,2956,718,2099,10984,8885,307,1828
MA,7781,JUNCO DO MARANHAO,898,353,799,3479,2680,74,559
MA,7790,FORTALEZA DOS NOGUEIRAS,2291,660,1570,6991,5421,163,973
MA,7803,LAGO DOS RODRIGUES,1796,415,841,5993,5152,177,1062
MA,7811,FORTUNA,2042,679,2171,10038,7867,330,1614
MA,7820,LAGOA DO MATO,744,653,1339,5718,4379,156,1128
MA,7838,GODOFREDO VIANA,525,432,1395,4477,3082,154,659
MA,7846,LAGOA GRANDE DO MARANHAO,1380,427,1622,6792,5170,140,1292
MA,7854,GONCALVES DIAS,1506,762,2429,10143,7714,245,1857
MA,7862,LAJEADO NOVO,554,375,660,3709,3049,51,594
MA,7870,GOVERNADOR ARCHER,936,458,1380,6112,4732,205,1213
MA,7889,MARACACUME,1423,938,3244,10048,6804,196,1505
MA,7897,GOVERNADOR EUGENIO BARROS,1951,267,1272,7408,6136,247,1468
MA,7900,MARAJA DO SENA,998,473,969,5330,4361,159,1285
MA,7919,GRACA ARANHA,680,294,881,4553,3672,137,836
MA,7927,MARANHAOZINHO,1027,231,947,4488,3541,142,661
MA,7935,GRAJAU,3678,1714,5355,24762,19407,599,4041
MA,7943,MATOES DO NORTE,1110,353,1315,4503,3188,107,803
MA,7951,GUIMARAES,2156,243,1636,7765,6129,383,985
MA,7960,MILAGRES DO MARANHAO,317,758,546,3367,2821,162,654
MA,7978,HUMBERTO DE CAMPOS,3883,905,2406,12638,10232,615,1956
MA,7986,NOVA COLINAS,803,150,522,2934,2412,56,542
MA,7994,ICATU,1986,1141,1906,11863,9957,376,1787
MA,8001,NOVA OLINDA DO MARANHAO,2032,388,1508,8656,7148,216,1532
MA,8010,IGARAPE GRANDE,1378,893,1555,7218,5663,170,1088
MA,8028,OLINDA NOVA DO MARANHAO,894,562,1837,6126,4289,250,923
MA,8036,IMPERATRIZ,28069,13033,31780,134910,103130,1787,8271
MA,8044,PAULINO NEVES,1269,375,2160,6808,4648,357,1152
MA,8052,SAO LUIS GONZAGA DO MARANHAO,3694,1049,4460,15607,11147,382,2499
MA,8060,PEDRO DO ROSARIO,1763,227,2110,8598,6488,190,1699
MA,8079,ITAPECURU MIRIM,9016,1425,7570,27978,20408,556,4065
MA,8087,PERITORO,2440,667,2734,9988,7254,296,1328
MA,8095,JOAO LISBOA,2933,1931,3883,15589,11706,277,1983
MA,8109,PORTO RICO DO MARANHAO,646,591,1461,5178,3717,189,519
MA,8117,JOSELANDIA,941,498,1583,8838,7255,237,1712
MA,8125,PRESIDENTE MEDICI,819,140,583,3367,2784,77,542
MA,8133,LAGO DA PEDRA,5569,1532,7237,28280,21043,536,4722
MA,8141,PRESIDENTE SARNEY,978,235,2378,7317,4939,149,1021
MA,8150,LAGO DO JUNCO,1972,269,1243,5960,4717,228,901
MA,8168,RAPOSA,2256,360,2804,11950,9146,217,1326
MA,8176,LAGO VERDE,2011,487,2500,8932,6432,356,1514
MA,8184,RIBAMAR FIQUENE,728,468,855,4458,3603,105,616
MA,8192,LIMA CAMPOS,1744,540,1414,7976,6562,421,1421
MA,8206,SANTA FILOMENA DO MARANHAO,379,334,428,3469,3041,109,611
MA,8214,LORETO,1454,329,1665,6205,4540,164,1075
MA,8222,SANTANA DO MARANHAO,451,1176,993,4114,3121,63,806
MA,8230,LUIS DOMINGUES DO MARANHAO,443,223,898,3851,2953,38,476
MA,8249,SANTO AMARO DO MARANHAO,1437,455,1848,6642,4794,451,969
MA,8257,MAGALHAES DE ALMEIDA,1469,890,2673,9296,6623,202,1394
MA,8265,SAO DOMINGOS DO AZEITAO,908,72,788,4170,3382,88,899
MA,8273,MATA ROMA,1401,1272,831,8137,7306,554,1491
MA,8281,SAO FRANCISCO DO BREJAO,811,505,639,4326,3687,76,616
MA,8290,MATINHA,2830,674,2389,12170,9781,623,1467
MA,8303,SAO JOAO DO CARU,974,635,2259,7448,5189,211,1407
MA,8311,MATOES,2379,1481,2840,13657,10817,447,3023
MA,8320,SAO JOAO DO PARAISO,943,520,1440,6221,4781,95,878
MA,8338,MIRADOR,1796,998,2875,11561,8686,347,1965
MA,8346,SAO JOAO DO SOTER,1608,583,2524,8383,5859,170,1519
MA,8354,MIRINZAL,1729,358,2058,7821,5763,223,845
MA,8362,SAO JOSE DOS BASILIOS,748,230,877,5113,4236,67,981
MA,8370,MONCAO,2967,1262,3739,14046,10307,382,2244
MA,8389,SAO PEDRO DA AGUA BRANCA,1776,362,1972,6649,4677,93,830
MA,8397,MONTES ALTOS,1151,315,956,6129,5173,161,944
MA,8400,SAO PEDRO DOS CRENTES,379,129,417,2665,2248,40,300
MA,8419,MORROS,2471,230,2532,8854,6322,191,1475
MA,8427,SAO RAIMUNDO DA DOCA BEZERRA,518,312,693,3681,2988,81,713
MA,8435,NINA RODRIGUES,1722,223,955,5627,4672,83,976
MA,8443,SAO ROBERTO,536,157,521,3114,2593,56,659
MA,8451,NOVA IORQUE,448,599,575,3085,2510,78,599
MA,8460,SATUBINHA,1349,171,775,3902,3127,86,699
MA,8478,OLHO D AGUA DAS CUNHAS,2516,1050,3055,12342,9287,353,1957
MA,8486,SENADOR ALEXANDRE COSTA,981,266,2175,6068,3893,135,1030
MA,8494,PACO DO LUMIAR,11455,1011,6090,34590,28500,982,3022
MA,8508,SENADOR LA ROQUE,2682,1136,2283,12370,10087,305,2009
MA,8516,PALMEIRANDIA,3459,393,2295,10223,7928,491,1695
MA,8524,SERRANO DO MARANHAO,1271,576,2068,6576,4508,415,1138
MA,8532,PARAIBANO,2530,1037,3627,13071,9444,430,2367
MA,8540,SUCUPIRA DO RIACHAO,294,226,571,3150,2579,116,664
MA,8559,PARNARAMA,4801,1945,3802,17891,14089,780,3345
MA,8567,TRIZIDELA DO VALE,3246,423,3223,12415,9192,280,1704
MA,8575,PASSAGEM FRANCA,1503,812,2548,10155,7607,352,2030
MA,8583,TUFILANDIA,489,210,1061,3962,2901,90,738
MA,8591,PASTOS BONS,1715,587,1813,9763,7950,338,1881
MA,8605,TURILANDIA,1843,191,2821,9030,6209,219,1514
MA,8613,PEDREIRAS,6972,1250,6565,25900,19335,438,3180
MA,8621,VILA NOVA DOS MARTIRIOS,916,377,545,3321,2776,110,480
MA,8630,PENALVA,4938,1187,5097,18383,13286,260,2568
MA,8656,PERI MIRIM,1568,219,2532,8355,5823,287,1165
MA,8672,PINDARE MIRIM,4497,1353,2818,16339,13521,359,2629
MA,8699,PINHEIRO,7561,1899,12471,41625,29154,802,4184
MA,8710,PIO XII,3120,672,3315,14301,10986,743,2387
MA,8737,PIRAPEMAS,2335,772,2068,9035,6967,237,1626
MA,8753,POCAO DE PEDRAS,2240,1342,3721,13630,9909,474,1981
MA,8770,PORTO FRANCO,2451,1270,2257,10974,8717,140,1210
MA,8796,PRESIDENTE DUTRA,3487,1901,6141,24062,17921,551,2990
MA,8818,PRESIDENTE JUSCELINO,1328,82,1664,5579,3915,74,823
MA,8834,PRESIDENTE VARGAS,1660,437,1102,6214,5112,194,1137
MA,8850,PRIMEIRA CRUZ,1360,602,974,6612,5638,480,1186
MA,8877,RIACHAO,3470,1036,2991,11532,8541,314,1565
MA,8893,SAO JOSE DE RIBAMAR,12817,1656,8350,41818,33468,807,2844
MA,8915,ROSARIO,5782,844,6665,22947,16282,701,2911
MA,8931,SAMBAIBA,531,275,1061,4372,3311,80,575
MA,8958,SANTA HELENA,4507,526,3726,16150,12424,460,2327
MA,8974,SANTA LUZIA,10261,3088,10830,39240,28410,1086,5973
MA,8990,SANTA QUITERIA DO MARANHAO,2361,2221,2064,13030,10966,1079,2897
MA,9016,SANTA RITA,2912,1223,4996,15418,10422,493,2258
MA,9032,SANTO ANTONIO DOS LOPES,1669,800,1586,8780,7194,200,1538
MA,9059,SAO BENEDITO DO RIO PRETO,2060,590,1609,8893,7284,573,1539
MA,9075,SAO BENTO,4757,1863,5300,19980,14680,630,2632
MA,9091,SAO BERNARDO,1667,3908,3161,13539,10378,292,2270
MA,9113,SAO DOMINGOS DO MARANHAO,2406,2912,4967,20918,15951,581,3657
MA,9130,SAO FELIX DE BALSAS,465,307,486,3115,2629,108,577
MA,9156,SAO FRANCISCO DO MARANHAO,550,1222,2104,7567,5463,370,1481
MA,9172,SAO JOAO BATISTA,4653,327,4195,14639,10444,216,1842
MA,9199,SAO JOAO DOS PATOS,2024,922,4241,15028,10787,466,2135
MA,9210,SAO LUIS,227320,16620,107624,546213,438589,8398,26648
MA,9237,SAO MATEUS DO MARANHAO,3842,1987,6038,21096,15058,621,2647
MA,9253,SAO RAIMUNDO DAS MANGABEIRAS,1440,1144,2560,9636,7076,339,1361
MA,9270,SAO VICENTE FERRER,2011,432,4340,12241,7901,523,1809
MA,9296,SITIO NOVO,895,494,2473,10475,8002,146,1665
MA,9318,SUCUPIRA DO NORTE,795,708,1582,6554,4972,174,1308
MA,9334,TASSO FRAGOSO,518,398,1050,4043,2993,85,649
MA,9350,TIMBIRAS,1620,1128,4589,13667,9078,284,1520
MA,9377,TIMON,27482,4149,18875,78437,59562,1404,7603
MA,9393,TUNTUM,3458,2284,6062,22697,16635,735,3350
MA,9415,TURIACU,2984,1251,5472,17492,12020,783,2422
MA,9431,TUTOIA,2534,2869,6366,22224,15858,1328,3573
MA,9458,URBANO SANTOS,3899,575,3306,13468,10162,1165,2317
MA,9474,VARGEM GRANDE,5381,1835,7036,22636,15600,467,3518
MA,9490,VIANA,5998,1119,9490,29869,20379,519,3620
MA,9512,VITORIA DO MEARIM,4207,1776,6950,20442,13492,686,2552
MA,9539,VITORINO FREIRE,3777,1728,5299,20015,14716,946,2895
MA,9555,BOM JARDIM,4280,1911,5235,20768,15533,738,3073
MA,9571,SANTA INES,12276,4358,7175,43033,35858,879,4977
MA,9598,PAULO RAMOS,2024,1570,2098,11255,9157,576,2084
MA,9610,ACAILANDIA,11786,6247,12337,52877,40540,1201,4875
MA,9636,ESTREITO,2895,2785,3066,14218,11152,293,1558
MA,9652,SANTA LUZIA DO PARUA,2472,581,1869,11659,9790,245,1814
MA,9679,ARAME,3337,1837,3639,14247,10608,376,2459
MA,9695,MIRANDA DO NORTE,3283,264,2923,10411,7488,259,1380
MA,9717,ZE DOCA,3507,2276,8396,26552,18156,717,3810
MG,40002,ALFREDO VASCONCELOS,1582,1001,426,3899,3473,147,302
MG,40010,ABADIA DOS DOURADOS,1584,1427,1059,5542,4483,258,436
MG,40029,ARAPORA,1965,845,1060,5256,4196,96,370
MG,40037,ABAETE,4003,4760,2838,16177,13339,665,834
MG,40045,BRASILANDIA DE MINAS,2368,1681,1782,7819,6037,255,558
MG,40053,ABRE CAMPO,2883,2548,1666,9379,7713,414,961
MG,40061,CAPITAO ANDRADE,978,655,1169,3724,2555,103,418
MG,40070,ACAIACA,966,644,710,3026,2316,77,292
MG,40088,CARNEIRINHO,2438,1607,1352,6801,5449,119,463
MG,40096,ACUCENA,2670,701,2608,8801,6193,343,1049
MG,40100,CATUJI,1655,1926,1022,5660,4638,184,552
MG,40118,AGUA BOA,1598,2714,3319,10509,7190,425,1226
MG,40126,DIVISA ALEGRE,735,1059,918,3633,2715,47,606
MG,40134,AGUA COMPRIDA,805,685,618,2491,1873,47,137
MG,40142,DIVISOPOLIS,535,2178,1424,5167,3743,59,498
MG,40150,AGUANIL,1014,625,518,2969,2451,194,195
MG,40169,DURANDE,1387,997,1158,5047,3889,104,445
MG,40177,AGUAS FORMOSAS,3731,1519,3628,12472,8844,286,1496
MG,40185,ENTRE FOLHAS,1465,808,1014,4659,3645,89,513
MG,40193,AGUAS VERMELHAS,986,2254,2406,8261,5855,528,1398
MG,40207,FERVEDOURO,1847,1274,1438,6447,5009,227,616
MG,40215,AIMORES,4770,3481,4388,19096,14708,438,1133
MG,40223,FRANCISCOPOLIS,448,994,1431,3932,2501,72,565
MG,40231,AIURUOCA,1475,1323,881,4649,3768,170,423
MG,40240,ICARAI DE MINAS,1321,2141,2230,6918,4688,112,609
MG,40258,ALAGOA,433,791,376,2183,1807,63,187
MG,40266,IPABA,3502,860,1902,9829,7927,159,532
MG,40274,ALBERTINA,603,638,376,2119,1743,56,169
MG,40282,JAIBA,3773,4400,3916,15579,11663,435,1463
MG,40290,ALEM PARAIBA,10454,2054,4362,26232,21870,541,1031
MG,40304,JAMPRUCA,1142,434,932,3543,2611,113,395
MG,40312,ALFENAS,19385,10563,7065,46033,38968,1361,1719
MG,40320,JUATUBA,4800,1251,1442,10476,9034,429,776
MG,40339,ALMENARA,6519,5276,6943,24548,17605,462,2337
MG,40347,LAGOA GRANDE,1886,1060,1196,5224,4028,163,374
MG,40355,ALPERCATA,1920,847,1430,5906,4476,129,446
MG,40363,LIMEIRA DO OESTE,2076,797,969,4714,3745,89,298
MG,40371,ALPINOPOLIS,4849,2880,1844,12324,10480,505,697
MG,40380,LONTRA,1030,1864,1785,6029,4244,168,615
MG,40398,ALTEROSA,2237,3343,1405,9367,7962,357,675
MG,40401,MAMONAS,482,2528,1379,5039,3660,110,395
MG,40410,ALTO RIO DOCE,2065,3288,3205,10816,7611,450,1055
MG,40428,MATA VERDE,724,1631,1622,5062,3440,67,487
MG,40436,ALVARENGA,1583,795,1161,4410,3249,108,319
MG,40444,MATIAS CARDOSO,712,1718,1647,5400,3753,136,632
MG,40452,ALVINOPOLIS,5885,1254,2027,11787,9760,340,1184
MG,40460,MONTEZUMA,324,1837,1477,4561,3084,92,606
MG,40479,ALVORADA DE MINAS,655,362,833,2681,1848,156,342
MG,40487,NAQUE,1699,221,852,4131,3279,83,402
MG,40495,AMPARO DO SERRA,1225,921,478,3609,3131,203,450
MG,40509,NOVO ORIENTE DE MINAS,1889,1472,2847,7696,4849,201,819
MG,40517,ANDRADAS,7551,6443,2553,22923,20370,1137,1513
MG,40525,PALMOPOLIS,1084,907,2152,5559,3407,235,918
MG,40533,CACHOEIRA DE PAJEU,1520,1446,1539,6262,4723,387,963
MG,40541,PEDRAS DE MARIA DA CRUZ,1160,1345,1637,5451,3814,189,511
MG,40550,ANDRELANDIA,2994,2735,2451,10136,7685,310,735
MG,40568,PERIQUITO,1971,425,1422,5421,3999,120,553
MG,40576,ANTONIO CARLOS,3944,1273,1264,8685,7421,339,628
MG,40584,PONTO DOS VOLANTES,1618,1440,1648,6045,4397,121,716
MG,40592,ANTONIO DIAS,2681,909,1397,7315,5918,409,582
MG,40606,RIACHINHO,1598,1140,1028,4791,3763,168,334
MG,40614,ANTONIO PRADO DE MINAS,494,173,164,1503,1339,34,97
MG,40622,ROSARIO DA LIMEIRA,1291,575,930,3949,3019,121,390
MG,40630,ARACAI,813,247,324,1838,1514,43,164
MG,40649,SANTA BARBARA DO LESTE,1660,1505,1097,5841,4744,197,438
MG,40657,ARACITABA,507,436,116,1546,1430,78,243
MG,40665,SANTA RITA DE MINAS,1362,562,530,3705,3175,151,291
MG,40673,ARACUAI,6509,6162,7697,24315,16618,502,1603
MG,40681,SANTANA DO PARAISO,3705,875,1940,10628,8688,227,977
MG,40690,ARAGUARI,25548,15162,10753,73569,62816,1504,1887
MG,40703,SAO JOAO DA LAGOA,1078,387,664,3195,2531,91,461
MG,40711,ARANTINA,1237,230,489,2554,2065,52,190
MG,40720,SAO JOAO DO MANHUACU,1544,1013,1186,6217,5031,242,496
MG,40738,ARAPONGA,1567,849,1356,5428,4072,188,957
MG,40746,SAO JOAO DO MANTENINHA,866,605,811,3716,2905,132,483
MG,40754,ARAPUA,412,1043,300,2400,2100,75,228
MG,40762,SAO JOAO DO PACUI,1048,409,754,2835,2081,65,308
MG,40770,ARAUJOS,1481,1578,599,4554,3955,223,265
MG,40789,SAO JOSE DA LAPA,5663,947,1024,10615,9591,289,485
MG,40797,ARAXA,20721,13068,7368,58579,51211,1513,2649
MG,40800,SARZEDO,4052,812,889,8949,8060,331,493
MG,40819,ARCEBURGO,1743,1912,1129,6363,5234,319,488
MG,40827,SEM-PEIXE,1039,432,699,3020,2321,196,289
MG,40835,ARCOS,10348,5018,2896,24457,21561,1294,1246
MG,40843,SENADOR AMARAL,1569,743,874,4016,3142,95,183
MG,40851,AREADO,2508,3386,1434,9521,8087,256,584
MG,40860,UBAPORANGA,2434,1658,1923,8293,6370,178,594
MG,40878,ARGIRITA,1311,327,242,2483,2241,68,122
MG,40886,URUCUIA,1189,1508,1346,5026,3680,100,564
MG,40894,ARINOS,2771,1892,2970,11537,8567,235,1433
MG,40908,VARGEM ALEGRE,1458,658,1363,5353,3990,125,475
MG,40916,ASTOLFO DUTRA,3452,2294,1320,9000,7680,200,493
MG,40924,JOSENOPOLIS,646,797,1002,3012,2010,42,408
MG,40932,ATALEIA,3795,1584,3914,11760,7846,258,957
MG,40940,JUVENILIA,612,1480,1069,4293,3224,108,482
MG,40959,AUGUSTO DE LIMA,1143,754,686,3654,2968,188,271
MG,40967,LEME DO PRADO,640,858,1097,3232,2135,100,379
MG,40975,BAEPENDI,4665,2680,1782,13194,11412,412,797
MG,40983,LUISBURGO,825,1434,867,4201,3334,201,324
MG,40991,BALDIM,2457,895,1455,6471,5016,243,380
MG,41009,LUISLANDIA,1188,1078,1338,4453,3115,72,614
MG,41017,BAMBUI,4933,4072,3063,17000,13937,709,1455
MG,41025,MARIO CAMPOS,2241,498,759,5529,4770,174,324
MG,41033,BANDEIRA,753,1127,543,3213,2670,216,347
MG,41041,MARTINS SOARES,1773,491,729,4140,3411,122,317
MG,41050,BANDEIRA DO SUL,1123,1087,596,4041,3445,192,290
MG,41068,MIRAVANIA,364,1036,861,3096,2235,55,385
MG,41076,BARAO DE COCAIS,10695,1312,2293,17019,14726,385,838
MG,41084,MONTE FORMOSO,1045,365,905,3191,2286,23,357
MG,41092,BARAO DE MONTE ALTO,1382,1106,873,4858,3985,135,439
MG,41106,NATALANDIA,1093,522,889,2932,2043,37,116
MG,41114,BARBACENA,40227,12934,10049,81763,71714,2339,3952
MG,41122,NINHEIRA,569,2199,2083,6161,4078,191,876
MG,41130,BARRA LONGA,1494,1438,1548,6187,4639,361,841
MG,41149,NOVA BELEM,644,545,935,3294,2359,113,389
MG,41157,TRES MARIAS,6311,3147,3813,18181,14368,633,1245
MG,41165,NOVA PORTEIRINHA,1645,1287,1007,4938,3931,149,437
MG,41173,BARROSO,5619,3647,1923,14415,12492,625,915
MG,41181,NOVORIZONTE,696,1155,1091,3697,2606,47,465
MG,41190,BELA VISTA DE MINAS,4156,478,1319,7791,6472,184,381
MG,41203,OLHOS DAGUA,849,608,837,3198,2361,88,411
MG,41211,BELMIRO BRAGA,1159,429,438,3026,2588,69,229
MG,41220,ORATORIOS,1206,593,710,3396,2686,109,421
MG,41238,BELO HORIZONTE,780522,179060,224606,1646041,1421435,35065,50420
MG,41246,ORIZANIA,1470,715,1021,4631,3610,124,418
MG,41254,BELO ORIENTE,5693,913,2774,14486,11712,438,1099
MG,41262,PADRE CARVALHO,973,701,1121,3448,2327,62,522
MG,41270,BELO VALE,2396,1607,652,5876,5224,231,430
MG,41289,PAI PEDRO,604,1050,1157,4272,3115,120,705
MG,41297,BERILO,1132,2739,2855,8569,5714,292,1087
MG,41300,PATIS,1035,1030,1305,3897,2592,68,189
MG,41319,BERTOPOLIS,1098,534,1208,3488,2280,65,337
MG,41327,PEDRA BONITA,751,1156,690,4232,3542,115,493
MG,41335,BETIM,82928,18336,22056,178120,156064,4144,7055
MG,41343,PIEDADE DE CARATINGA,819,808,982,3812,2830,102,311
MG,41351,BIAS FORTES,1450,614,598,3707,3109,105,397
MG,41360,PINGO DAGUA,1094,381,801,3197,2396,82,256
MG,41378,BICAS,4633,1188,1372,10308,8936,225,587
MG,41386,PINTOPOLIS,971,1265,1386,4510,3124,107,367
MG,41394,BIQUINHAS,719,613,502,2330,1828,100,158
MG,41408,PONTO CHIQUE,678,685,795,2836,2041,54,305
MG,41416,BOA ESPERANCA,9037,5364,4661,25458,20797,1044,1098
MG,41424,REDUTO,1303,469,673,3672,2999,144,289
MG,41432,BOCAINA DE MINAS,899,922,826,4062,3236,145,409
MG,41440,SANTA BARBARA DO MONTE VERDE,774,439,376,2559,2183,73,209
MG,41459,BOCAIUVA,12502,3436,6614,29089,22475,677,2499
MG,41467,SANTA CRUZ DE MINAS,2279,1150,551,4921,4370,127,254
MG,41475,BOM DESPACHO,12228,6101,4345,29803,25458,1080,1636
MG,41483,SANTA CRUZ DE SALINAS,589,1197,884,3500,2616,101,589
MG,41491,BOM JARDIM DE MINAS,1814,928,1074,5422,4348,168,393
MG,41505,SANTA HELENA DE MINAS,1158,1039,1217,4215,2998,95,489
MG,41513,BOM JESUS DA PENHA,623,1087,348,2599,2251,109,191
MG,41521,SANTO ANTONIO DO RETIRO,174,1682,1010,4198,3188,136,621
MG,41530,BOM JESUS DO AMPARO,1623,649,628,3961,3333,152,390
MG,41548,SAO DOMINGOS DAS DORES,1393,793,837,3693,2856,91,286
MG,41556,BOM JESUS DO GALHO,3643,1983,2930,12518,9588,529,1251
MG,41564,SAO FELIX DE MINAS,586,446,807,2781,1974,62,319
MG,41572,BOM REPOUSO,2667,1135,1099,6734,5635,199,530
MG,41580,SAO GERALDO DO BAIXIO,668,296,731,2453,1722,46,232
MG,41599,BOM SUCESSO,3963,3567,2280,12983,10703,713,976
MG,41602,SAO JOAO DAS MISSOES,1005,883,1496,5437,3941,186,792
MG,41610,BONFIM,2089,1395,936,6111,5175,462,506
MG,41629,SAO JOAQUIM DE BICAS,4995,1233,1700,10792,9092,380,673
MG,41637,BONFINOPOLIS DE MINAS,2036,436,1185,4776,3591,60,233
MG,41645,SAO JOSE DA BARRA,2070,809,730,4478,3748,135,204
MG,41653,BORDA DA MATA,3674,2789,1510,10794,9284,425,628
MG,41661,ALTO CAPARAO,556,550,612,3422,2810,43,126
MG,41670,BOTELHOS,4125,2601,2104,11237,9133,339,708
MG,41688,ANGELANDIA,640,1585,1436,5021,3585,130,557
MG,41696,BOTUMIRIM,940,737,1359,4520,3161,91,727
MG,41700,ARICANDUVA,615,993,720,3265,2545,178,387
MG,41718,BRASILIA DE MINAS,6750,5128,6122,21923,15801,634,1400
MG,41726,BERIZAL,487,992,753,3023,2270,30,397
MG,41734,BRAS PIRES,988,805,1305,4187,2882,127,419
MG,41742,BONITO DE MINAS,1185,928,1490,5005,3515,131,516
MG,41750,BRAUNAS,1185,812,1340,4402,3062,214,495
MG,41769,BUGRE,954,473,778,3690,2912,144,370
MG,41777,BRAZOPOLIS,2946,3171,1969,11371,9402,319,852
MG,41785,CABECEIRA GRANDE,1408,1060,1477,5252,3775,169,383
MG,41793,BRUMADINHO,9250,2462,2134,18668,16534,693,993
MG,41807,CAMPO AZUL,525,891,937,3224,2287,95,363
MG,41815,BUENO BRANDAO,1731,2216,1189,7541,6352,570,486
MG,41823,CANTAGALO,520,782,768,2898,2130,154,377
MG,41831,BUENOPOLIS,1638,1727,2265,7363,5098,543,516
MG,41840,CATAS ALTAS,1531,539,476,3268,2792,85,291
MG,41858,BURITIS,4083,3018,3659,14327,10668,344,1095
MG,41866,CATUTI,719,881,957,3969,3012,74,669
MG,41874,BURITIZEIRO,5694,2437,4552,16872,12320,561,968
MG,41882,CHAPADA GAUCHA,1029,1316,1451,5383,3932,79,710
MG,41890,CABO VERDE,2652,2959,1463,8999,7536,308,485
MG,41904,CONEGO MARINHO,1011,1437,1505,4986,3481,110,606
MG,41912,CACHOEIRA DA PRATA,1652,348,509,3295,2786,83,192
MG,41920,CONFINS,2307,402,503,4125,3622,96,233
MG,41939,CACHOEIRA DE MINAS,2260,1997,1011,7807,6796,266,381
MG,41947,CORREGO FUNDO,1901,711,411,3851,3440,180,341
MG,41955,CACHOEIRA DOURADA,571,589,509,2045,1536,30,137
MG,41963,CRISOLITA,990,744,1258,4051,2793,43,708
MG,41971,CAETANOPOLIS,3007,842,814,6024,5210,227,300
MG,41980,CUPARAQUE,491,741,1204,3641,2437,72,380
MG,41998,CAETE,14072,3915,3969,28078,24109,1050,1425
MG,42005,CURRAL DE DENTRO,419,1731,1193,4684,3491,182,753
MG,42013,CAIANA,1066,564,492,3251,2759,87,291
MG,42021,DELTA,1727,438,222,3030,2808,111,194
MG,42030,CAJURI,1324,597,414,3296,2882,154,471
MG,42048,DOM BOSCO,1335,336,955,3259,2304,74,195
MG,42056,CALDAS,2473,3510,1600,10358,8758,339,584
MG,42064,FREI LAGONEGRO,479,737,790,2968,2178,178,580
MG,42072,CAMACHO,709,1010,305,2637,2332,162,303
MG,42080,FRUTA DE LEITE,667,875,1604,4576,2972,29,1132
MG,42099,CAMANDUCAIA,3574,3928,2092,13155,11063,699,1045
MG,42102,GAMELEIRAS,557,1717,1092,4096,3004,72,505
MG,42110,CAMBUI,6492,3752,2253,15875,13622,399,893
MG,42129,GLAUCILANDIA,1081,410,571,2960,2389,90,288
MG,42137,CAMBUQUIRA,3056,2096,1406,8789,7383,230,610
MG,42145,GOIABEIRA,519,536,877,2935,2058,143,302
MG,42153,CAMPANARIO,929,536,814,2940,2126,69,286
MG,42161,GOIANA,1144,383,535,2988,2453,92,217
MG,42170,CAMPANHA,3394,2593,1567,9875,8308,408,648
MG,42188,GUARACIAMA,1745,783,883,4219,3336,75,415
MG,42196,CAMPESTRE,4059,4265,2208,14401,12193,621,881
MG,42200,IBIRACATU,1089,1144,1369,4418,3049,102,541
MG,42218,CAMPINA VERDE,4760,3964,2820,14150,11330,319,577
MG,42226,IMBE DE MINAS,1538,645,1179,4597,3418,84,419
MG,42234,CAMPO BELO,10150,9257,5552,35327,29775,1604,2217
MG,42242,INDAIABIRA,575,1511,1394,4843,3449,166,715
MG,42250,CAMPO DO MEIO,2774,2548,1685,8675,6990,398,557
MG,42269,JAPONVAR,725,2041,1597,5526,3929,140,564
MG,42277,CAMPO FLORIDO,1316,1187,1155,4449,3294,160,123
MG,42285,JENIPAPO DE MINAS,464,1224,1734,4235,2501,80,533
MG,42293,CAMPOS ALTOS,1930,2442,1610,8480,6870,368,550
MG,42307,JOSE GONCALVES DE MINAS,351,1183,807,2926,2119,57,439
MG,42315,CAMPOS GERAIS,6336,4482,3031,17772,14741,716,1389
MG,42323,JOSE RAYDAN,617,695,778,2853,2075,78,494
MG,42331,CANAA,1296,743,777,3950,3173,225,510
MG,42340,SAO SEBASTIAO DA VARGEM ALEGRE,570,602,446,2413,1967,102,235
MG,42358,CANAPOLIS,3343,1501,1885,8683,6798,210,627
MG,42366,SAO SEBASTIAO DO ANTA,1259,386,791,3430,2639,74,338
MG,42374,CANA VERDE,1050,1187,802,4350,3548,171,436
MG,42382,SERRANOPOLIS DE MINAS,320,1477,879,3553,2674,105,537
MG,42390,CANDEIAS,2584,3806,1488,10567,9079,817,782
MG,42404,SETUBINHA,692,2112,1872,5990,4118,101,1018
MG,42412,CAPARAO,679,659,572,3054,2482,64,216
MG,42420,TAPARUBA,910,486,540,2932,2392,113,256
MG,42439,CAPELA NOVA,1046,1325,572,3845,3273,264,341
MG,42447,UNIAO DE MINAS,1331,693,966,3650,2684,56,202
MG,42455,CAPELINHA,4291,6367,5482,20340,14858,664,2089
MG,42463,URUANA DE MINAS,905,498,840,2886,2046,39,312
MG,42471,CAPETINGA,1209,1711,1207,5429,4222,261,388
MG,42480,VARGEM GRANDE DO RIO PARDO,338,1530,729,3156,2427,44,438
MG,42498,CAPIM BRANCO,2332,861,676,5459,4783,296,352
MG,42501,VARJAO DE MINAS,799,1496,869,3876,3007,109,210
MG,42510,CAPINOPOLIS,4282,2414,2442,11859,9417,291,573
MG,42528,VERDELANDIA,1287,924,1135,4187,3052,96,556
MG,42536,CAPITAO ENEAS,3247,1704,2341,9572,7231,261,839
MG,42544,VEREDINHA,1063,954,947,3680,2733,78,487
MG,42552,CAPITOLIO,2885,1154,1017,6112,5095,142,235
MG,42560,VERMELHO NOVO,1451,678,850,3849,2999,163,309
MG,42579,CAPUTIRA,2265,1045,1019,6142,5123,337,624
MG,42587,TOCOS DO MOJI,1034,1278,362,3123,2761,120,172
MG,42595,CARAI,3132,2341,3472,11411,7939,232,1473
MG,42617,CARANAIBA,720,1038,379,2948,2569,153,247
MG,42633,CARANDAI,6528,3069,1597,16114,14517,1001,1230
MG,42650,CARANGOLA,6301,4201,4308,22994,18686,662,1616
MG,42676,CARATINGA,18520,8569,10803,54951,44148,1631,2660
MG,42692,CARBONITA,2898,988,1992,6660,4668,277,259
MG,42714,CAREACU,1371,1296,877,4523,3646,94,238
MG,42730,CARLOS CHAGAS,5237,2921,4592,15818,11226,390,1195
MG,42757,CARMESIA,644,284,489,1818,1329,60,168
MG,42773,CARMO DA CACHOEIRA,2936,1548,1917,8428,6511,346,598
MG,42790,CARMO DA MATA,2779,2156,1145,8392,7247,401,684
MG,42811,CARMO DE MINAS,2486,1580,1209,7793,6584,300,598
MG,42838,CARMO DO CAJURU,5737,2257,1477,13034,11557,690,887
MG,42854,CARMO DO PARANAIBA,4922,5008,3019,19043,16024,1125,1532
MG,42870,CARMO DO RIO CLARO,5281,3276,2184,13378,11194,427,670
MG,42897,CARMOPOLIS DE MINAS,3479,3318,1399,10277,8878,333,801
MG,42919,CARRANCAS,1016,741,677,3248,2571,78,300
MG,42935,CARVALHOPOLIS,880,716,361,2435,2074,69,159
MG,42951,CARVALHOS,1082,1275,795,4066,3271,147,388
MG,42978,CASA GRANDE,731,489,195,1974,1779,75,129
MG,42994,CASCALHO RICO,577,606,322,2230,1908,61,108
MG,43010,CASSIA,3612,3485,2237,12296,10059,408,894
MG,43036,CONCEICAO DA BARRA DE MINAS,798,1224,438,3081,2643,118,179
MG,43052,CATAGUASES,21820,4274,6395,47329,40934,1327,2004
MG,43079,CATAS ALTAS DA NORUEGA,906,653,617,2986,2369,203,385
MG,43095,CAXAMBU,6596,2279,2525,15984,13459,382,711
MG,43117,CEDRO DO ABAETE,211,357,195,1090,895,57,123
MG,43133,CENTRAL DE MINAS,934,1025,1414,5459,4045,372,464
MG,43150,CENTRALINA,2914,1173,1613,7314,5701,174,400
MG,43176,CHACARA,800,248,273,2055,1782,69,137
MG,43192,CHALE,1220,833,855,4171,3316,91,325
MG,43214,CHAPADA DO NORTE,1472,2359,3706,9061,5355,289,1017
MG,43230,CHIADOR,518,240,430,2544,2114,61,186
MG,43257,CIPOTANEA,961,1048,1496,5200,3704,482,589
MG,43273,CLARAVAL,695,1436,437,3090,2653,51,130
MG,43290,CLARO DOS POCOES,2161,1372,985,5931,4946,185,542
MG,43311,CLAUDIO,5336,4981,1546,15314,13768,860,931
MG,43338,COIMBRA,1630,1464,682,5028,4346,191,561
MG,43354,COLUNA,1683,1264,1628,5970,4342,211,739
MG,43370,COMENDADOR GOMES,455,918,103,1791,1688,39,73
MG,43397,COMERCINHO,1834,1581,1994,6503,4509,177,661
MG,43419,CONCEICAO DA APARECIDA,2206,1780,1391,6776,5385,307,397
MG,43435,CONCEICAO DA PEDRA,673,756,238,2109,1871,95,133
MG,43451,CONCEICAO DAS ALAGOAS,4998,2951,2636,13358,10722,318,700
MG,43478,CONCEICAO DE IPANEMA,1129,973,416,3245,2829,54,282
MG,43494,CONCEICAO DO MATO DENTRO,4262,1379,3652,13151,9499,386,1958
MG,43516,CONCEICAO DO PARA,1537,853,653,4003,3350,190,273
MG,43532,CONCEICAO DO RIO VERDE,2916,2245,1737,8879,7142,321,625
MG,43559,CONCEICAO DOS OUROS,1903,1837,923,6473,5550,182,315
MG,43575,CONGONHAL,1894,2082,422,5585,5163,206,225
MG,43591,CONGONHAS,18000,2461,3088,30215,27127,991,1567
MG,43613,CONGONHAS DO NORTE,1023,495,958,3489,2531,133,656
MG,43630,CONQUISTA,1569,1732,1024,5245,4221,145,238
MG,43656,CONSELHEIRO LAFAIETE,41826,8881,7784,73367,65583,2017,2942
MG,43672,CONSELHEIRO PENA,4533,2467,5185,17263,12078,526,880
MG,43699,CONSOLACAO,424,504,212,1453,1241,57,100
MG,43710,CONTAGEM,188700,27545,45438,368705,323267,7983,13335
MG,43737,COQUEIRAL,2611,1806,1302,6684,5382,186,268
MG,43753,CORACAO DE JESUS,5677,3226,4386,18133,13747,593,1746
MG,43770,CORDISBURGO,2278,1070,1256,6221,4965,271,528
MG,43796,CORDISLANDIA,878,639,449,2728,2279,91,218
MG,43818,CORINTO,7143,2187,4307,18287,13980,516,1171
MG,43834,COROACI,1722,1656,2136,7865,5729,406,1031
MG,43850,COROMANDEL,6103,4368,3821,20252,16431,784,1284
MG,43877,CORONEL FABRICIANO,31814,4312,11418,68647,57229,1296,2005
MG,43893,CORONEL MURTA,1610,2005,1947,6834,4887,178,712
MG,43915,CORONEL PACHECO,1132,365,163,2337,2174,70,186
MG,43931,CORONEL XAVIER CHAVES,954,755,291,2403,2112,67,124
MG,43958,CORREGO DANTA,886,637,489,2841,2352,67,259
MG,43974,CORREGO DO BOM JESUS,1133,843,552,3397,2845,95,262
MG,43990,CORREGO NOVO,961,649,416,2663,2247,121,197
MG,44016,COUTO DE MAGALHAES DE MINAS,1393,398,883,3334,2451,70,338
MG,44032,CRISTAIS,2465,1495,963,6582,5619,330,614
MG,44059,CRISTALIA,705,773,853,3616,2763,21,903
MG,44075,CRISTIANO OTONI,1392,767,391,3712,3321,147,259
MG,44091,CRISTINA,2056,1973,1288,7282,5994,238,474
MG,44113,CRUCILANDIA,1039,1196,392,3451,3059,277,267
MG,44130,CRUZEIRO DA FORTALEZA,1007,846,399,2832,2433,73,108
MG,44156,CRUZILIA,3799,2768,1569,9796,8227,263,674
MG,44172,CURVELO,18851,7525,8529,46029,37500,1358,2264
MG,44199,DATAS,1479,773,801,3721,2920,96,340
MG,44210,DELFIM MOREIRA,1646,1918,981,5930,4949,248,288
MG,44237,DELFINOPOLIS,1440,1313,1379,5257,3878,157,291
MG,44253,DESCOBERTO,1507,640,387,3579,3192,113,251
MG,44270,DESTERRO DE ENTRE RIOS,1160,1791,998,5282,4284,387,435
MG,44296,DESTERRO DO MELO,695,942,303,2696,2393,84,364
MG,44318,DIAMANTINA,11785,4933,6381,29138,22757,694,2033
MG,44334,DIOGO DE VASCONCELOS,874,629,457,2920,2463,106,582
MG,44350,DIONISIO,3334,632,1890,7577,5687,213,579
MG,44377,DIVINESIA,1239,421,418,2735,2317,59,241
MG,44393,DIVINO,4009,2150,2641,12787,10146,441,1094
MG,44415,DIVINO DAS LARANJEIRAS,768,939,1089,4373,3284,143,384
MG,44431,DIVINOLANDIA DE MINAS,1447,899,946,4429,3483,117,741
MG,44458,DIVINOPOLIS,71589,16917,12286,128601,116315,3439,4058
MG,44474,DIVISA NOVA,1805,622,653,3846,3193,76,292
MG,44490,DOM CAVATI,1251,907,929,4340,3411,96,308
MG,44512,DOM JOAQUIM,1117,373,1071,3901,2830,202,754
MG,44539,DOM SILVERIO,1983,702,593,4288,3695,188,418
MG,44555,DOM VICOSO,484,975,493,2551,2058,121,216
MG,44571,DONA EUSEBIA,1220,1068,526,4248,3722,155,231
MG,44598,DORES DE CAMPOS,2511,1288,654,6475,5821,542,554
MG,44610,DORES DE GUANHAES,1593,695,1167,4498,3331,152,450
MG,44636,DORES DO INDAIA,3187,2808,2708,11721,9013,471,713
MG,44652,DORES DO TURVO,1278,948,621,3688,3067,154,427
MG,44679,DORESOPOLIS,320,519,250,1330,1080,36,115
MG,44695,DOURADOQUARA,482,398,197,1431,1234,42,94
MG,44717,ELOI MENDES,5427,4463,1953,15083,13130,477,876
MG,44733,ENGENHEIRO CALDAS,1642,1086,525,4802,4277,222,586
MG,44750,ENGENHEIRO NAVARRO,2318,875,1495,5850,4355,109,487
MG,44776,ENTRE RIOS DE MINAS,3816,2324,1693,10325,8632,471,707
MG,44792,ERVALIA,3906,3045,2884,13703,10819,697,1800
MG,44814,ESMERALDAS,10744,4803,4163,26883,22720,998,1614
MG,44830,ESPERA FELIZ,5033,2603,2723,14988,12265,469,983
MG,44857,ESPINOSA,3327,9292,6623,22709,16086,548,1598
MG,44873,ESPIRITO SANTO DO DOURADO,1232,883,403,3427,3024,179,310
MG,44890,ESTIVA,2159,1780,1033,7024,5991,318,411
MG,44911,ESTRELA DALVA,682,143,408,2109,1701,44,262
MG,44938,ESTRELA DO INDAIA,764,897,705,3156,2451,176,201
MG,44954,ESTRELA DO SUL,1629,1523,1133,5542,4409,181,336
MG,44970,EUGENOPOLIS,2599,944,1527,8055,6528,249,455
MG,44997,EWBANK DA CAMARA,1290,262,360,2893,2533,73,235
MG,45012,EXTREMA,5602,3717,1936,14117,12181,453,831
MG,45039,FAMA,775,400,296,1951,1655,84,122
MG,45055,FARIA LEMOS,992,552,508,2994,2486,48,243
MG,45071,FELICIO DOS SANTOS,776,1083,1326,4065,2739,144,453
MG,45098,SAO GONCALO DO RIO PRETO,790,465,745,2587,1842,97,329
MG,45110,FELISBURGO,1476,835,1472,4489,3017,63,412
MG,45136,FELIXLANDIA,3215,2006,1902,9372,7470,543,695
MG,45152,FERNANDES TOURINHO,617,626,513,2460,1947,38,341
MG,45179,FERROS,2354,1619,2522,9342,6820,322,1326
MG,45195,FLORESTAL,2168,499,532,4168,3636,120,217
MG,45217,FORMIGA,17819,10998,5588,46484,40896,2189,2106
MG,45233,FORMOSO,1499,899,1507,4887,3380,90,385
MG,45250,FORTALEZA DE MINAS,1079,804,689,3424,2735,197,351
MG,45276,FORTUNA DE MINAS,692,376,224,1737,1513,95,105
MG,45292,FRANCISCO BADARO,736,2885,2185,6788,4603,148,618
MG,45314,FRANCISCO DUMONT,739,390,861,3335,2474,78,337
MG,45330,FRANCISCO SA,6124,2752,4367,17084,12717,545,1712
MG,45357,FREI GASPAR,1285,691,869,3785,2916,63,561
MG,45373,FREI INOCENCIO,2387,790,1393,6021,4628,130,506
MG,45390,FRONTEIRA,2211,1316,459,5631,5172,152,376
MG,45411,FRUTAL,10921,8344,5616,33086,27470,1081,1411
MG,45438,FUNILANDIA,990,460,583,2896,2313,79,180
MG,45454,GALILEIA,1510,808,1716,5915,4199,161,526
MG,45470,GONCALVES,864,818,552,2966,2414,129,256
MG,45497,GONZAGA,569,958,1292,4304,3012,151,797
MG,45519,GOUVEA,3428,1196,1994,8327,6333,291,761
MG,45535,GOVERNADOR VALADARES,46639,23619,36357,171027,134670,3484,6255
MG,45551,GRAO MOGOL,1442,2933,2835,9194,6359,170,1262
MG,45578,GRUPIARA,387,218,185,1315,1130,43,65
MG,45594,GUANHAES,4332,3825,5097,20185,15088,950,2329
MG,45616,GUAPE,3240,2451,1516,9135,7619,396,692
MG,45632,GUARACIABA,2049,1987,940,6787,5847,237,1094
MG,45659,GUARANESIA,5201,2891,1937,12646,10709,499,897
MG,45675,GUARANI,3062,1131,1037,6780,5743,175,567
MG,45691,GUARARA,1329,287,402,3122,2720,85,223
MG,45713,GUARDA-MOR,1360,1094,985,4542,3557,117,311
MG,45730,GUAXUPE,15715,5995,4983,33258,28275,929,1854
MG,45756,GUIDOVAL,2129,1270,930,5916,4986,285,432
MG,45772,GUIMARANIA,1632,1038,837,4933,4096,139,253
MG,45799,GUIRICEMA,3029,1206,1150,7113,5963,318,633
MG,45810,GURINHATA,1819,1436,1286,5768,4482,110,255
MG,45837,HELIODORA,1372,1223,630,4126,3496,155,350
MG,45853,IAPU,2481,1504,1471,7134,5663,214,521
MG,45870,IBERTIOGA,1602,914,365,3801,3436,109,345
MG,45896,IBIA,5443,2814,2696,15173,12477,516,891
MG,45918,IBIAI,1145,1152,1273,4811,3538,198,376
MG,45934,IBIRACI,2490,2127,1277,7442,6165,164,426
MG,45950,IBIRITE,33779,4183,7619,65975,58356,1868,2870
MG,45977,IBITIURA DE MINAS,779,682,437,2747,2310,143,227
MG,45993,IBITURUNA,566,801,261,2015,1754,46,164
MG,46019,IGARAPE,7153,2289,2390,16779,14389,700,836
MG,46035,IGARATINGA,2052,986,654,4946,4292,356,246
MG,46051,IGUATAMA,2735,1222,1114,6561,5447,176,449
MG,46078,IJACI,1266,1115,429,4033,3604,262,347
MG,46094,ILICINEA,3225,1563,1327,7279,5952,248,197
MG,46116,INCONFIDENTES,1736,1654,794,5315,4521,209,253
MG,46132,INDIANOPOLIS,1458,666,362,3210,2848,92,131
MG,46159,INGAI,611,600,334,1987,1653,84,161
MG,46175,INHAPIM,6667,3150,5069,20161,15092,667,1655
MG,46191,INHAUMA,1512,698,641,3764,3123,104,293
MG,46213,INIMUTABA,1511,1021,810,4362,3552,132,367
MG,46230,IPANEMA,3364,3500,2764,13062,10298,317,949
MG,46256,IPATINGA,62442,11387,21739,146797,125058,2594,4393
MG,46272,IPIACU,1286,693,608,3439,2831,62,241
MG,46299,IPUIUNA,2162,1561,977,6957,5980,286,365
MG,46310,IRAI DE MINAS,1357,1116,582,4110,3528,102,345
MG,46337,ITABIRA,37262,7103,9336,73326,63990,2106,3861
MG,46353,ITABIRINHA,1262,1397,630,5417,4787,212,730
MG,46370,ITABIRITO,15974,3334,2723,27984,25261,882,1137
MG,46396,ITACAMBIRA,873,974,774,3447,2673,117,422
MG,46418,ITACARAMBI,3408,1185,3041,10973,7932,225,1180
MG,46434,ITAGUARA,2944,2574,1051,8402,7351,500,638
MG,46450,ITAIPE,1411,1425,1952,6550,4598,156,832
MG,46477,ITAJUBA,26351,9502,7997,59512,51515,1198,1759
MG,46493,ITAMARANDIBA,4732,5339,4779,19083,14304,1187,1345
MG,46515,ITAMARATI DE MINAS,1343,386,379,3074,2695,134,232
MG,46531,ITAMBACURI,4475,3610,5095,16928,11833,504,1922
MG,46558,ITAMBE DO MATO DENTRO,489,331,266,1786,1520,73,291
MG,46574,ITAMOGI,2831,2038,1574,8217,6643,345,679
MG,46590,ITAMONTE,2537,2360,1198,8902,7704,373,451
MG,46612,ITANHANDU,3794,1986,1305,9714,8409,282,466
MG,46639,ITANHOMI,3101,1465,2902,9645,6743,236,792
MG,46655,ITAOBIM,4449,3091,4467,15198,10731,388,1336
MG,46671,ITAPAGIPE,2544,2895,1585,8791,7206,211,385
MG,46698,ITAPECERICA,6630,4030,2987,17479,14492,722,1587
MG,46710,ITAPEVA,1256,1543,911,5299,4388,171,446
MG,46736,ITATIAIUCU,2930,984,939,6155,5216,257,421
MG,46752,ITAUNA,30266,6995,4997,54352,49355,1428,1679
MG,46779,ITAVERAVA,1634,1228,768,5019,4251,424,399
MG,46795,ITINGA,2419,2522,2876,9366,6490,181,808
MG,46817,ITUETA,1286,1132,1082,4738,3656,126,259
MG,46833,ITUIUTABA,28078,12444,13048,66915,53867,1264,1916
MG,46850,ITUMIRIM,1437,1440,720,4937,4217,229,349
MG,46876,ITURAMA,9661,3933,4019,21569,17550,451,1113
MG,46892,ITUTINGA,1186,765,543,3147,2604,130,135
MG,46914,JABOTICATUBAS,3748,1674,1956,10905,8949,415,1056
MG,46930,JACINTO,1458,2788,2951,9216,6265,245,932
MG,46957,JACUI,1186,1909,789,5303,4514,345,342
MG,46973,JACUTINGA,4286,3037,2137,13686,11549,499,713
MG,46990,JAGUARACU,1215,250,358,2382,2024,61,127
MG,47015,JANAUBA,14045,8675,9119,40960,31841,1510,3006
MG,47031,JANUARIA,12832,8276,11422,42135,30713,897,3488
MG,47058,JAPARAIBA,1013,589,293,2570,2277,105,163
MG,47074,JECEABA,2014,827,752,4688,3936,242,325
MG,47090,JEQUERI,2784,1896,2818,10310,7492,523,1407
MG,47112,JEQUITAI,2269,851,1805,6306,4501,180,606
MG,47139,JEQUITIBA,1247,1333,909,4464,3555,157,248
MG,47155,JEQUITINHONHA,5622,2144,4752,15717,10965,417,1559
MG,47171,JESUANIA,1520,730,654,3781,3127,109,320
MG,47198,JOAIMA,3330,774,2751,9387,6636,170,986
MG,47210,JOANESIA,1464,509,1688,5366,3678,223,626
MG,47236,JOAO MONLEVADE,27041,5186,7445,50686,43241,952,1380
MG,47252,JOAO PINHEIRO,8596,7357,6774,30207,23433,870,1858
MG,47279,JOAQUIM FELICIO,936,597,316,2564,2248,210,188
MG,47295,JORDANIA,1591,1692,2147,7079,4932,375,575
MG,47317,NOVA UNIAO,1689,703,786,4351,3565,233,323
MG,47333,JUIZ DE FORA,174699,24565,38667,329757,291090,6364,11272
MG,47350,JURAMENTO,1067,310,805,3467,2662,61,463
MG,47376,JURUAIA,1405,1743,1068,5742,4674,141,413
MG,47392,LADAINHA,1899,3063,3340,10320,6980,199,1234
MG,47414,LAGAMAR,1648,1635,1342,6432,5090,211,372
MG,47430,LAGOA DA PRATA,8351,6867,3573,26015,22442,1014,1475
MG,47457,LAGOA DOS PATOS,861,498,884,3432,2548,87,363
MG,47473,LAGOA DOURADA,2421,2751,887,7911,7024,512,584
MG,47490,LAGOA FORMOSA,2887,4070,2397,12875,10478,894,675
MG,47511,LAGOA SANTA,11256,3191,4025,27259,23234,938,1442
MG,47538,LAJINHA,3696,3149,3160,13592,10432,314,1159
MG,47554,LAMBARI,4949,3427,2041,13682,11641,398,845
MG,47570,LAMIM,1002,781,418,2883,2465,146,366
MG,47597,LARANJAL,1735,582,597,4972,4375,155,295
MG,47619,LASSANCE,1460,811,1114,4432,3318,101,372
MG,47635,LAVRAS,24724,9349,7164,56108,48944,1934,2797
MG,47651,LEANDRO FERREIRA,1114,498,467,2745,2278,134,173
MG,47678,LEOPOLDINA,16797,3223,5849,36210,30361,988,1370
MG,47694,LIBERDADE,1454,870,905,4629,3724,139,408
MG,47716,LIMA DUARTE,5559,1785,2151,12398,10247,466,804
MG,47732,LUMINARIAS,1102,975,603,3834,3231,257,400
MG,47759,LUZ,3967,2894,2463,12841,10378,650,802
MG,47775,MACHACALIS,1731,778,1799,5459,3660,136,557
MG,47791,MACHADO,8856,5663,3252,23992,20740,966,1271
MG,47813,MADRE DE DEUS DE MINAS,1601,1030,646,3878,3232,120,245
MG,47830,MALACACHETA,2615,3631,5036,14711,9675,325,2065
MG,47856,MANGA,3177,2878,3936,13835,9899,486,1450
MG,47872,MANHUACU,15463,7204,7712,44981,37269,1701,2273
MG,47899,MANHUMIRIM,4754,2438,2608,14435,11827,366,1089
MG,47910,MANTENA,4648,1702,5451,19773,14322,488,1256
MG,47937,MARAVILHAS,1364,1450,612,4516,3904,175,236
MG,47953,MAR DE ESPANHA,2297,1678,1254,8204,6950,225,608
MG,47970,MARIA DA FE,3040,3757,1332,10251,8919,270,435
MG,47996,MARIANA,15814,3872,4463,33474,29011,1636,2705
MG,48011,MARILAC,1079,669,1179,3612,2433,128,350
MG,48038,MARIPA DE MINAS,677,451,280,2295,2015,61,217
MG,48054,MARLIERIA,1736,260,567,3322,2755,126,200
MG,48070,MARMELOPOLIS,880,635,571,2688,2117,81,170
MG,48097,MARTINHO CAMPOS,2329,1984,1810,8874,7064,562,516
MG,48119,MATERLANDIA,764,479,1121,3486,2365,246,487
MG,48135,MATEUS LEME,6773,2114,2214,15565,13351,815,1233
MG,48151,MATIAS BARBOSA,4909,655,1111,9235,8124,196,487
MG,48178,MATIPO,2870,2322,2084,11430,9346,593,1337
MG,48194,MATO VERDE,1903,3838,2482,10595,8113,331,1094
MG,48216,MATOZINHOS,10579,2309,2738,22222,19484,884,1248
MG,48232,MATUTINA,600,794,814,3226,2412,157,398
MG,48259,MEDEIROS,548,795,375,2252,1877,83,184
MG,48275,MEDINA,4754,3125,5385,16851,11466,696,1530
MG,48291,MENDES PIMENTEL,1074,719,1525,5366,3841,173,606
MG,48313,MERCES,2657,1500,1642,7843,6201,408,717
MG,48330,MESQUITA,1400,947,905,4686,3781,176,709
MG,48356,MINAS NOVAS,2872,5177,6851,18579,11728,643,2288
MG,48372,MINDURI,1405,445,674,3156,2482,60,249
MG,48399,MIRABELA,3071,1705,2644,9068,6424,206,423
MG,48410,MIRADOURO,3199,770,1056,7467,6411,285,668
MG,48437,MIRAI,2757,1867,2040,10010,7970,394,890
MG,48453,MOEDA,1462,680,462,3554,3092,168,212
MG,48470,MOEMA,1129,1638,1064,5149,4085,127,472
MG,48496,MONJOLOS,532,515,717,2273,1556,62,181
MG,48518,MONSENHOR PAULO,2149,978,533,4953,4420,164,479
MG,48534,MONTALVANIA,1381,3703,3056,10489,7433,197,1177
MG,48550,MONTE ALEGRE DE MINAS,3686,2563,2794,13658,10864,498,798
MG,48577,MONTE AZUL,3524,7035,4721,18286,13565,365,1914
MG,48593,MONTE BELO,2357,3575,1494,9543,8049,613,563
MG,48615,MONTE CARMELO,12468,5808,4987,30908,25921,959,1826
MG,48631,MONTE SANTO DE MINAS,3597,4990,2576,14615,12039,615,1348
MG,48658,MONTES CLAROS,89991,16784,30934,191954,161020,3898,8038
MG,48674,MONTE SIAO,3241,4061,1988,12533,10545,628,887
MG,48690,MORADA NOVA DE MINAS,1233,2114,841,5374,4533,182,411
MG,48712,MORRO DA GARCA,502,596,564,2392,1828,51,201
MG,48739,MORRO DO PILAR,1095,629,671,3008,2337,90,345
MG,48755,MUNHOZ,1363,1268,859,4995,4136,231,367
MG,48771,MURIAE,19862,6964,10915,64490,53575,1833,3187
MG,48798,MUTUM,5931,3512,4595,19942,15347,654,1445
MG,48810,MUZAMBINHO,4542,4698,2195,14628,12433,643,595
MG,48836,NACIP RAYDAN,458,722,838,2519,1681,76,256
MG,48852,NANUQUE,7725,6374,8621,31064,22443,777,1896
MG,48879,NATERCIA,915,1426,553,3634,3081,238,177
MG,48895,NAZARENO,1847,1465,1004,5601,4597,172,346
MG,48917,NEPOMUCENO,5728,4773,2879,17631,14752,669,1492
MG,48933,NOVA ERA,6813,1322,2150,13268,11118,256,815
MG,48950,NOVA LIMA,26484,3688,5082,45567,40485,915,1371
MG,48976,NOVA MODICA,673,815,1059,3408,2349,35,502
MG,48992,NOVA PONTE,2242,1727,898,6590,5692,137,515
MG,49018,NOVA RESENDE,2843,3266,1211,9332,8121,565,486
MG,49034,NOVA SERRANA,6390,5629,3196,23566,20370,1428,1659
MG,49050,NOVO CRUZEIRO,3568,4681,7100,19021,11921,456,2435
MG,49077,OLARIA,716,529,204,1902,1698,52,237
MG,49093,OLIMPIO NORONHA,717,622,315,2000,1685,44,161
MG,49115,OLIVEIRA,11058,6217,3435,27127,23692,1030,1542
MG,49131,OLIVEIRA FORTES,658,332,231,1776,1545,59,230
MG,49158,ONCA DE PITANGUI,957,450,341,2318,1977,84,162
MG,49174,OURO BRANCO,12100,1973,2696,21220,18524,471,866
MG,49190,OURO FINO,5990,6711,2916,20810,17894,793,1049
MG,49212,OURO PRETO,25274,6653,6260,48940,42680,1419,2175
MG,49239,OURO VERDE DE MINAS,1280,1156,1968,5896,3928,140,555
MG,49255,PADRE PARAISO,3551,2142,4194,12956,8762,243,1168
MG,49271,PAINEIRAS,912,1228,643,3855,3212,154,236
MG,49298,PAINS,2572,1124,949,6244,5295,170,430
MG,49310,PAIVA,591,187,198,1383,1185,50,136
MG,49336,PALMA,2034,526,1184,5649,4465,120,469
MG,49352,FRONTEIRA DOS VALES,1094,743,962,3712,2750,49,551
MG,49379,PAPAGAIOS,2849,2179,1406,8768,7362,497,579
MG,49395,PARACATU,18420,6495,7406,47650,40244,1736,1474
MG,49417,PARA DE MINAS,23498,7847,5165,49101,43936,1817,2503
MG,49433,PARAGUACU,5603,3210,1753,13382,11629,369,532
MG,49450,PARAISOPOLIS,5022,2813,1952,13112,11160,418,731
MG,49476,PARAOPEBA,5963,2613,1818,13953,12135,467,674
MG,49492,PASSABEM,331,427,361,1644,1283,74,250
MG,49514,PASSA QUATRO,4738,2119,1341,10858,9517,346,594
MG,49530,PASSA TEMPO,2118,1744,1236,6588,5352,327,503
MG,49557,PASSA VINTE,350,151,225,1765,1540,49,137
MG,49573,PASSOS,33398,11266,9543,66864,57321,1498,2617
MG,49590,PATOS DE MINAS,28500,20266,13306,88568,75262,2509,3018
MG,49611,PATROCINIO,19206,8382,7372,48402,41030,1555,1829
MG,49638,PATROCINIO DO MURIAE,1143,743,430,3713,3283,114,278
MG,49654,PAULA CANDIDO,2779,949,1285,6780,5495,192,1013
MG,49670,PAULISTAS,1031,998,1381,4078,2697,117,393
MG,49697,PAVAO,1877,1861,2130,6826,4696,96,489
MG,49719,PECANHA,1991,2947,3635,12172,8537,413,1483
MG,49735,PEDRA AZUL,4479,4246,4760,17593,12833,295,2183
MG,49751,PEDRA DO ANTA,901,827,497,3013,2516,121,427
MG,49778,PEDRA DO INDAIA,673,1437,195,2838,2643,104,193
MG,49794,PEDRA DOURADA,524,217,91,1244,1153,26,184
MG,49816,PEDRALVA,2483,2826,1259,8426,7167,285,612
MG,49832,PEDRINOPOLIS,825,697,522,2874,2352,94,178
MG,49859,PEDRO LEOPOLDO,18521,4132,3704,36514,32810,1094,2005
MG,49875,PEDRO TEIXEIRA,654,196,223,1643,1420,41,125
MG,49891,PEQUERI,877,357,395,2535,2140,53,142
MG,49913,PEQUI,1199,816,515,3251,2736,84,235
MG,49930,PERDIGAO,1180,1389,592,4578,3986,266,372
MG,49956,PERDIZES,2393,2598,2117,9172,7055,230,461
MG,49972,PERDOES,3301,4592,1721,13619,11898,710,973
MG,49999,PESCADOR,923,633,1226,3470,2244,53,379
MG,50016,PIAU,956,587,354,2673,2319,97,222
MG,50032,PIEDADE DE PONTE NOVA,1132,689,779,3431,2652,145,355
MG,50059,PIEDADE DO RIO GRANDE,1042,1197,848,4008,3160,151,389
MG,50075,PIEDADE DOS GERAIS,1097,948,682,3656,2974,279,374
MG,50091,PIMENTA,1601,1649,916,5672,4756,394,446
MG,50113,PIRACEMA,1592,1572,852,5319,4467,317,544
MG,50130,PIRAJUBA,859,641,349,2285,1936,73,143
MG,50156,PIRANGA,2507,3352,3014,12122,9108,624,1649
MG,50172,PIRANGUCU,946,1368,647,3825,3178,129,304
MG,50199,PIRANGUINHO,2394,980,795,5406,4611,198,288
MG,50210,PIRAPETINGA,2028,924,1209,8192,6983,211,666
MG,50237,PIRAPORA,14508,3499,7400,33881,26481,844,1610
MG,50253,PIRAUBA,3218,1408,1306,8026,6720,319,520
MG,50270,PITANGUI,7844,2496,2412,17094,14682,630,1002
MG,50296,PIUMHI,7407,5179,3689,21337,17648,836,1247
MG,50318,PLANURA,1983,1564,1318,6433,5115,221,227
MG,50334,POCO FUNDO,4422,2780,1414,10801,9387,471,437
MG,50350,POCOS DE CALDAS,31586,20891,12741,92522,79781,1870,3277
MG,50377,POCRANE,1869,2138,2088,7982,5894,169,627
MG,50393,POMPEU,7067,2703,3202,18151,14949,905,1428
MG,50415,PONTE NOVA,18503,5341,7225,40660,33435,1107,2003
MG,50431,PORTEIRINHA,4818,7876,6463,26399,19936,1114,2712
MG,50458,PORTO FIRME,2379,1204,2274,7700,5426,291,750
MG,50474,POTE,2006,3023,2803,9933,7130,249,1040
MG,50490,POUSO ALEGRE,29814,12975,9192,72120,62928,1599,2530
MG,50512,POUSO ALTO,1337,1464,752,4978,4226,161,352
MG,50539,PRADOS,2145,1721,631,5855,5224,361,541
MG,50555,PRATA,6043,3931,3535,17586,14051,525,764
MG,50571,PRATAPOLIS,2170,2446,1466,7669,6203,240,493
MG,50598,PRATINHA,417,868,400,2316,1916,104,213
MG,50610,PRESIDENTE BERNARDES,1344,1391,658,4297,3639,135,508
MG,50636,PRESIDENTE JUSCELINO,915,436,890,3443,2553,123,352
MG,50652,PRESIDENTE KUBITSCHEK,436,300,305,2117,1812,35,305
MG,50679,PRESIDENTE OLEGARIO,3743,3001,2863,13217,10354,454,1108
MG,50695,ALTO JEQUITIBA,966,1204,1049,5844,4795,116,352
MG,50717,PRUDENTE DE MORAIS,2463,920,818,5905,5087,265,447
MG,50733,QUARTEL GERAL,649,887,592,2934,2342,209,171
MG,50750,QUELUZITO,764,541,150,1872,1722,68,170
MG,50776,RAPOSOS,6332,691,1303,10946,9643,259,381
MG,50792,RAUL SOARES,6237,3733,4559,18774,14215,970,1478
MG,50814,RECREIO,3182,1151,1680,8260,6580,207,432
MG,50830,RESENDE COSTA,2653,2411,1044,7487,6443,262,397
MG,50857,RESPLENDOR,2656,2606,3957,13909,9952,322,410
MG,50873,RESSAQUINHA,1418,1037,276,3543,3267,126,269
MG,50890,RIACHO DOS MACHADOS,1285,2034,1840,6982,5142,233,725
MG,50911,RIBEIRAO DAS NEVES,55615,11119,17900,126173,108273,4014,5612
MG,50938,RIBEIRAO VERMELHO,1615,336,329,2879,2550,82,153
MG,50954,RIO ACIMA,3155,590,789,5869,5080,158,218
MG,50970,RIO CASCA,4468,1485,3326,12532,9206,480,1133
MG,50997,RIO DOCE,793,256,363,1916,1553,42,152
MG,51012,RIO DO PRADO,1232,958,1192,3940,2748,87,305
MG,51039,RIO ESPERA,1300,1748,1226,5446,4220,328,421
MG,51055,RIO MANSO,1206,780,250,3039,2789,122,254
MG,51071,RIO NOVO,2189,1286,1076,6902,5826,289,531
MG,51098,RIO PARANAIBA,2562,1932,1355,7996,6641,449,618
MG,51110,RIO PARDO DE MINAS,2192,6390,4020,16210,12190,443,2048
MG,51136,RIO PIRACICABA,5265,1029,1929,11073,9144,347,711
MG,51152,RIO POMBA,5543,1557,2053,12643,10590,534,889
MG,51179,RIO PRETO,1615,597,385,3962,3577,96,231
MG,51195,RIO VERMELHO,1951,1848,3406,10149,6743,782,1315
MG,51217,RITAPOLIS,1302,1573,968,4638,3670,143,263
MG,51233,ROCHEDO DE MINAS,672,285,246,1665,1419,28,135
MG,51250,RODEIRO,1650,800,409,3806,3397,140,295
MG,51276,ROMARIA,1054,659,466,2803,2337,57,152
MG,51292,RUBELITA,1313,2313,1985,6949,4964,123,953
MG,51314,RUBIM,1307,2053,2360,7167,4807,129,899
MG,51330,SABARA,35642,5536,8524,70340,61816,2274,2702
MG,51357,SABINOPOLIS,3523,1725,3061,10932,7871,704,1071
MG,51373,SACRAMENTO,4079,5801,2740,15574,12834,239,408
MG,51390,SALINAS,7583,4620,6077,25771,19694,773,3002
MG,51411,SALTO DA DIVISA,1406,776,1647,4771,3124,83,600
MG,51438,SANTA BARBARA,9782,1655,2785,18310,15525,454,939
MG,51454,SANTA BARBARA DO TUGURIO,1248,1247,606,4045,3439,131,443
MG,51470,SANTA CRUZ DO ESCALVADO,1144,916,441,3329,2888,80,499
MG,51497,SANTA EFIGENIA DE MINAS,624,661,1099,3605,2506,208,542
MG,51519,SANTA FE DE MINAS,902,751,823,2911,2088,67,86
MG,51535,SANTA JULIANA,1791,1751,1057,6121,5064,268,318
MG,51551,SANTA LUZIA,54875,10957,15228,116780,101552,3422,4055
MG,51578,SANTA MARGARIDA,2306,2338,1646,9637,7991,411,1097
MG,51594,SANTA MARIA DE ITABIRA,2470,1237,1336,7123,5787,371,816
MG,51616,SANTA MARIA DO SALTO,512,845,762,3635,2873,456,510
MG,51632,SANTA MARIA DO SUACUI,2350,2063,3571,10945,7374,310,1518
MG,51659,SANTANA DA VARGEM,2506,1131,1012,5748,4736,170,336
MG,51675,SANTANA DE CATAGUASES,769,763,254,2703,2449,94,275
MG,51691,SANTANA DE PIRAPAMA,1951,1314,1802,6886,5084,316,552
MG,51713,SANTANA DO DESERTO,908,260,221,2475,2254,57,191
MG,51730,SANTANA DO GARAMBEU,371,529,339,1765,1426,70,171
MG,51756,SANTANA DO JACARE,1089,776,666,3673,3007,396,327
MG,51772,SANTANA DO MANHUACU,1765,1142,1618,6034,4416,295,414
MG,51799,SANTANA DO RIACHO,1012,709,766,3351,2585,135,345
MG,51810,SANTANA DOS MONTES,762,944,461,3246,2785,118,424
MG,51837,SANTA RITA DE CALDAS,2242,1977,877,6437,5560,182,348
MG,51853,SANTA RITA DE JACUTINGA,1252,682,816,4426,3610,144,223
MG,51870,SANTA RITA DO IBITIPOCA,900,636,343,2721,2378,99,297
MG,51896,SANTA RITA DO ITUETO,1195,1123,1117,4607,3490,68,192
MG,51918,SANTA RITA DO SAPUCAI,6634,6984,3114,22739,19625,830,1117
MG,51934,SANTA ROSA DA SERRA,625,669,514,2566,2052,108,223
MG,51950,SANTA VITORIA,4841,2730,2919,13138,10219,347,457
MG,51977,SANTO ANTONIO DO AMPARO,3145,2947,1477,10475,8998,670,1080
MG,51993,SANTO ANTONIO DO AVENTUREIRO,981,560,452,3082,2630,123,273
MG,52019,SANTO ANTONIO DO GRAMA,1145,949,735,3405,2670,81,358
MG,52035,SANTO ANTONIO DO ITAMBE,959,384,964,2997,2033,134,390
MG,52051,SANTO ANTONIO DO JACINTO,1759,2318,3365,9446,6081,358,1134
MG,52078,SANTO ANTONIO DO MONTE,4029,5596,1812,14710,12898,662,701
MG,52094,SANTO ANTONIO DO RIO ABAIXO,603,189,463,1700,1237,59,203
MG,52116,SANTO HIPOLITO,727,356,808,2707,1899,137,199
MG,52132,SANTOS DUMONT,17268,3845,4563,35422,30859,838,2038
MG,52159,SAO BENTO ABADE,805,1001,417,3021,2604,151,300
MG,52175,SAO BRAS DO SUACUI,1349,320,363,2701,2338,164,225
MG,52191,SAO DOMINGOS DO PRATA,5900,1820,2686,13799,11113,403,1135
MG,52213,SAO FRANCISCO,8126,8532,9280,31871,22591,761,2188
MG,52230,SAO FRANCISCO DE PAULA,1417,1597,731,4842,4111,172,370
MG,52256,SAO FRANCISCO DE SALES,1569,980,869,4189,3320,114,242
MG,52272,SAO FRANCISCO DO GLORIA,1466,528,781,4034,3253,163,323
MG,52299,SAO GERALDO,2271,873,954,5587,4633,216,621
MG,52310,SAO GERALDO DA PIEDADE,1184,427,1482,4163,2681,118,547
MG,52337,SAO GONCALO DO ABAETE,877,858,698,3511,2813,161,194
MG,52353,SAO GONCALO DO PARA,2418,1216,816,5977,5161,311,393
MG,52370,SAO GONCALO DO RIO ABAIXO,3041,951,961,6425,5464,272,487
MG,52396,SAO GONCALO DO SAPUCAI,5981,4222,2393,15828,13435,479,843
MG,52418,SAO GOTARDO,4517,5360,3681,19561,15880,1176,1492
MG,52434,SAO JOAO BATISTA DO GLORIA,1941,911,682,4687,4005,117,293
MG,52450,SAO JOAO DA MATA,920,471,375,2476,2101,89,187
MG,52477,SAO JOAO DA PONTE,2686,6387,5997,18425,12428,372,2184
MG,52493,SAO JOAO DEL REI,28793,12298,7779,59173,51394,1298,1775
MG,52515,SAO JOAO DO ORIENTE,2129,753,1502,6486,4984,208,695
MG,52531,SAO JOAO DO PARAISO,1830,4441,4184,14013,9829,782,1706
MG,52558,SAO JOAO EVANGELISTA,3018,2485,3686,11846,8160,225,1230
MG,52574,SAO JOAO NEPOMUCENO,9396,1734,2499,17912,15413,411,876
MG,52590,SAO JOSE DA SAFIRA,621,639,805,2997,2192,109,404
MG,52612,SAO JOSE DA VARGINHA,1035,442,356,2489,2133,117,184
MG,52639,SAO JOSE DO ALEGRE,868,737,395,2882,2487,122,238
MG,52655,SAO JOSE DO DIVINO,558,757,937,3050,2113,87,362
MG,52671,SAO JOSE DO GOIABAL,2400,430,1159,4836,3677,111,393
MG,52698,SAO JOSE DO JACURI,831,934,1461,4758,3297,299,736
MG,52710,SAO JOSE DO MANTIMENTO,638,218,370,2001,1631,59,152
MG,52736,SAO LOURENCO,8363,5930,3475,26512,23037,605,1038
MG,52752,SAO MIGUEL DO ANTA,1230,1055,250,4032,3782,197,890
MG,52779,SAO PEDRO DA UNIAO,874,1524,708,3973,3265,248,332
MG,52795,SAO PEDRO DOS FERROS,2225,1352,792,5805,5013,172,751
MG,52817,SAO PEDRO DO SUACUI,934,725,1415,4618,3203,76,760
MG,52833,SAO ROMAO,1836,929,1558,5516,3958,102,384
MG,52850,SAO ROQUE DE MINAS,932,1599,973,4699,3726,222,329
MG,52876,SAO SEBASTIAO DA BELA VISTA,939,1012,623,3561,2938,126,205
MG,52892,SAO SEBASTIAO DO MARANHAO,932,1987,2794,7898,5104,398,1017
MG,52914,SAO SEBASTIAO DO OESTE,1448,1040,521,3964,3443,193,431
MG,52930,SAO SEBASTIAO DO PARAISO,15131,9260,5698,39818,34120,1335,2317
MG,52957,SAO SEBASTIAO DO RIO PRETO,512,194,288,1424,1136,85,158
MG,52973,SAO SEBASTIAO DO RIO VERDE,597,373,203,1654,1451,58,111
MG,52990,SAO TIAGO,2303,2647,1007,7726,6719,437,406
MG,53015,SAO TOMAS DE AQUINO,1239,1658,884,4946,4062,147,455
MG,53031,SAO TOME DAS LETRAS,1627,1110,797,4449,3652,169,318
MG,53058,SAO VICENTE DE MINAS,2152,865,973,4839,3866,94,315
MG,53074,SAPUCAI MIRIM,1380,948,665,3722,3057,76,264
MG,53090,SARDOA,801,537,888,3543,2655,371,490
MG,53112,SENADOR CORTES,577,186,170,1618,1448,55,204
MG,53139,SENADOR FIRMINO,2428,1129,1320,5957,4637,146,608
MG,53155,SENADOR JOSE BENTO,450,433,269,1648,1379,51,146
MG,53171,SENADOR MODESTINO GONCALVES,1108,1073,1320,4511,3191,131,503
MG,53198,SENHORA DE OLIVEIRA,1237,1187,606,4169,3563,173,551
MG,53210,SENHORA DO PORTO,466,731,830,3248,2418,169,617
MG,53236,SENHORA DOS REMEDIOS,1592,2666,1591,7263,5672,202,668
MG,53252,SERICITA,1216,1927,1089,5699,4610,187,514
MG,53279,SERITINGA,463,394,240,1433,1193,42,135
MG,53295,SERRA AZUL DE MINAS,751,470,943,2903,1960,82,453
MG,53317,SERRA DA SAUDADE,342,165,168,869,701,13,47
MG,53333,SERRA DOS AIMORES,1926,954,1967,6246,4279,113,521
MG,53350,SERRA DO SALITRE,1799,1677,1148,6091,4943,230,206
MG,53376,SERRANIA,1818,1382,988,5204,4216,128,331
MG,53392,SERRANOS,652,428,341,1819,1478,39,153
MG,53414,SERRO,3028,3665,3574,13252,9678,499,1696
MG,53430,SETE LAGOAS,64403,15765,16109,127098,110989,3939,5119
MG,53457,SILVEIRANIA,871,275,206,1744,1538,42,139
MG,53473,SILVIANOPOLIS,1360,1341,784,4515,3731,127,317
MG,53490,SIMAO PEREIRA,924,230,231,2107,1876,39,134
MG,53511,SIMONESIA,3349,3330,2556,11659,9103,465,876
MG,53538,SOBRALIA,1138,716,1580,5136,3556,110,670
MG,53554,SOLEDADE DE MINAS,1306,892,592,4008,3416,123,235
MG,53570,TABULEIRO,1153,716,620,3475,2855,193,335
MG,53597,TAIOBEIRAS,4205,6965,5093,20827,15734,628,2394
MG,53619,TAPIRA,998,694,595,3266,2671,87,246
MG,53635,TAPIRAI,489,523,268,1736,1468,52,111
MG,53651,TAQUARACU DE MINAS,951,783,595,3323,2728,153,283
MG,53678,TARUMIRIM,3991,2598,2315,10976,8661,228,958
MG,53694,TEIXEIRAS,3489,1530,1602,9113,7511,264,1032
MG,53716,TEOFILO OTONI,32074,13026,22847,91130,68283,2040,5263
MG,53732,TIMOTEO,27120,2965,6870,50817,43947,845,1575
MG,53759,TIRADENTES,1924,1177,563,4563,4000,141,236
MG,53775,TIROS,830,1626,1742,5561,3819,274,543
MG,53791,TOCANTINS,3558,2715,1652,11262,9610,410,784
MG,53813,TOLEDO,739,1589,813,3844,3031,154,305
MG,53830,TOMBOS,2430,1220,1365,6995,5630,138,459
MG,53856,TRES CORACOES,18172,8773,6268,45575,39307,1564,2140
MG,53872,TRES PONTAS,15641,6289,5093,35394,30301,1316,1667
MG,53899,TUMIRITINGA,993,650,765,3850,3085,164,245
MG,53910,TUPACIGUARA,6020,4401,1996,16501,14505,600,806
MG,53937,TURMALINA,3347,2215,2763,10615,7852,309,1030
MG,53953,TURVOLANDIA,771,635,472,2839,2367,204,284
MG,53970,UBA,27185,7076,7388,55345,47957,1737,2511
MG,53996,UBAI,1122,1903,2458,8121,5663,248,1025
MG,54011,UBERABA,93857,27701,28033,188255,160222,3561,5896
MG,54038,UBERLANDIA,150926,48773,44767,334454,289687,7437,11130
MG,54054,UMBURATIBA,566,498,752,2429,1677,53,314
MG,54070,UNAI,18980,8859,10196,49390,39194,1269,2271
MG,54097,URUCANIA,1942,1440,1628,7424,5796,221,825
MG,54119,VARGEM BONITA,614,363,350,1994,1644,57,132
MG,54135,VARGINHA,34447,13858,9383,75464,66081,1936,2294
MG,54151,VARZEA DA PALMA,7791,3383,4578,22025,17447,683,1720
MG,54178,VARZELANDIA,2817,1988,4076,11858,7782,303,1225
MG,54194,VAZANTE,6089,1612,3206,15016,11810,591,671
MG,54216,WENCESLAU BRAZ,1009,379,267,2122,1855,54,131
MG,54232,VERISSIMO,1070,573,838,3141,2303,95,160
MG,54259,VESPASIANO,22426,4121,7184,49211,42027,1418,2456
MG,54275,VICOSA,23712,5527,6252,44525,38273,1279,2917
MG,54291,VIEIRAS,1468,382,864,3499,2635,78,233
MG,54313,MATHIAS LOBATO,833,376,793,2954,2161,71,268
MG,54330,VIRGEM DA LAPA,1912,2559,3043,9160,6117,218,967
MG,54356,VIRGINIA,1600,2156,1149,6189,5040,210,457
MG,54372,VIRGINOPOLIS,2351,1040,2173,7868,5695,308,1203
MG,54399,VIRGOLANDIA,1463,723,1531,4617,3086,155,466
MG,54410,VISCONDE DO RIO BRANCO,11844,3398,3112,24827,21715,1005,1753
MG,54437,VOLTA GRANDE,1219,395,749,3632,2883,82,280
MG,54453,ITAU DE MINAS,4127,1824,1435,10291,8856,306,617
MS,55000,NOVA ALVORADA DO SUL,2143,1449,1178,6350,5172,95,356
MS,55018,ALCINOPOLIS,516,713,673,2686,2013,47,167
MS,55026,LAGUNA CARAPA,1108,973,426,3210,2784,29,229
MS,55034,JAPORA,1612,549,1109,3950,2841,57,271
MS,55042,NOVO HORIZONTE DO SUL,1303,506,951,4028,3077,81,380
MS,90034,AGUA CLARA,1795,1911,1818,7155,5337,113,417
MS,90115,AMAMBAI,6608,3927,4172,18997,14825,221,835
MS,90131,ANASTACIO,6001,2383,2822,15663,12841,289,661
MS,90158,ANAURILANDIA,1258,2024,1066,5492,4426,85,339
MS,90174,ANTONIO JOAO,2105,1268,839,5239,4400,58,324
MS,90190,APARECIDA DO TABUADO,4015,3518,2079,12695,10616,431,676
MS,90212,AQUIDAUANA,10584,5030,6669,30612,23943,319,1400
MS,90298,BANDEIRANTES,1200,1208,1057,4952,3895,70,313
MS,90379,BATAGUACU,3293,2980,1858,10585,8727,244,579
MS,90395,BATAIPORA,2674,1923,1513,7626,6113,157,522
MS,90417,BELA VISTA,4731,2889,3170,14320,11150,147,512
MS,90433,BONITO,3700,3167,2445,12457,10012,197,556
MS,90450,BRASILANDIA,2215,1920,2451,8951,6500,236,520
MS,90492,CAMAPUA,3241,3324,2335,12175,9840,193,598
MS,90514,CAMPO GRANDE,140258,90244,68704,445346,376642,6405,12992
MS,90530,CARACOL,1143,892,527,3056,2529,43,137
MS,90557,CAARAPO,4263,3303,3086,14670,11584,355,783
MS,90573,CASSILANDIA,3163,4527,2710,15565,12855,401,962
MS,90611,CORGUINHO,843,646,594,2791,2197,31,166
MS,90638,CORUMBA,21836,9328,11301,59374,48073,669,1730
MS,90654,COXIM,4785,5513,4805,21825,17020,350,1178
MS,90735,DOURADOS,36764,27055,19518,115402,95884,1742,3016
MS,90751,FATIMA DO SUL,3200,3517,1619,13230,11611,377,943
MS,90794,GLORIA DE DOURADOS,2180,1816,1389,7550,6161,230,365
MS,90816,GUIA LOPES DA LAGUNA,2376,1778,1360,7589,6229,166,438
MS,90859,IGUATEMI,2937,2000,1664,8322,6658,119,447
MS,90875,INOCENCIA,1241,2072,1075,5457,4382,85,348
MS,90891,ITAPORA,3399,3070,2014,11469,9455,268,565
MS,90930,IVINHEMA,4064,3637,3558,16514,12956,436,911
MS,90972,JARAGUARI,820,660,421,3053,2632,38,186
MS,90999,JARDIM,5887,3597,2587,15736,13149,289,606
MS,91014,JATEI,839,872,434,2979,2545,57,161
MS,91030,LADARIO,3251,986,1711,8487,6776,129,292
MS,91073,MARACAJU,6574,4781,3310,18338,15028,252,704
MS,91111,MIRANDA,5426,3085,2633,15211,12578,246,886
MS,91138,NAVIRAI,8874,6020,4725,26811,22086,650,1418
MS,91154,NIOAQUE,3420,1568,1790,9277,7487,149,594
MS,91235,NOVA ANDRADINA,6869,6144,4967,24347,19380,495,1124
MS,91251,PARANAIBA,7668,7614,5315,27483,22168,604,1465
MS,91278,PEDRO GOMES,1487,1309,1253,6151,4898,116,522
MS,91316,PONTA PORA,13624,9263,8581,41893,33312,674,1804
MS,91375,PORTO MURTINHO,2333,1588,1536,7047,5511,56,434
MS,91413,RIBAS DO RIO PARDO,2949,2509,2673,10420,7747,127,474
MS,91430,RIO BRILHANTE,5005,2823,2113,13827,11714,265,613
MS,91456,RIO NEGRO,1286,1143,802,4202,3400,68,205
MS,91472,RIO VERDE DE MATO GROSSO,2708,2717,2329,12277,9948,222,650
MS,91499,ROCHEDO,826,869,568,3351,2783,34,222
MS,91570,SIDROLANDIA,6189,2189,2082,14832,12750,238,673
MS,91596,TERENOS,2197,1839,1161,7805,6644,135,349
MS,91650,TRES LAGOAS,19642,9342,10379,54223,43844,1026,1651
MS,91693,ANGELICA,1794,1268,1040,5426,4386,99,293
MS,91715,ARAL MOREIRA,1680,1417,759,4817,4058,65,349
MS,91731,ELDORADO,2191,1943,1495,7544,6049,203,427
MS,91758,DEODAPOLIS,1768,1999,1568,8362,6794,228,573
MS,91782,CHAPADAO DO SUL,2299,2136,1431,7779,6348,144,239
MS,91790,MUNDO NOVO,3480,2826,2323,10859,8536,160,635
MS,91804,DOIS IRMAOS DO BURITI,2587,987,1671,6658,4987,83,392
MS,91820,JUTY,1226,997,632,3639,3007,63,200
MS,91847,PARANHOS,1784,1364,1137,5097,3960,61,378
MS,91863,SANTA RITA DO PARDO,1365,911,1225,4623,3398,56,306
MS,91880,SONORA,1966,1737,1385,7095,5710,137,423
MS,91901,VICENTINA,1081,1204,583,4279,3696,153,345
MS,98019,BODOQUENA,2182,943,1197,5939,4742,63,311
MS,98035,COSTA RICA,3357,3638,2374,11872,9498,165,684
MS,98051,DOURADINA,1056,861,503,3711,3208,71,243
MS,98078,ITAQUIRAI,3360,2543,2272,10294,8022,222,613
MS,98094,SAO GABRIEL DO OESTE,3541,3090,2223,11869,9646,203,353
MS,98116,SELVIRIA,1609,834,855,4325,3470,109,243
MS,98132,SETE QUEDAS,2381,2080,1797,8118,6321,124,486
MS,98159,TACURU,1742,1237,1044,4774,3730,62,273
MS,98175,TAQUARUSSU,801,816,389,2486,2097,54,170
MS,98590,CORONEL SAPUCAIA,2760,2096,2429,9154,6725,77,585
MT,89788,COLNIZA,2661,2009,2337,9402,7065,243,553
MT,89796,COLIDER,3465,6684,4497,20312,15815,586,1077
MT,89800,CURVELANDIA,757,784,899,3535,2636,51,284
MT,89818,NOVA BRASILANDIA,513,1020,348,2933,2585,60,212
MT,89826,NOVA SANTA HELENA,685,633,574,2382,1808,29,155
MT,89834,PARANATINGA,2215,2722,2692,11001,8309,172,510
MT,89843,SANTO ANTONIO DO LESTE,370,532,482,1634,1152,14,55
MT,89850,SINOP,15864,13175,10143,51399,41256,1022,1213
MT,89877,ALTA FLORESTA,7339,7774,2928,27723,24795,533,1180
MT,89893,ARAPUTANGA,2414,2312,2592,10352,7760,243,571
MT,89915,JAURU,930,2406,2674,8786,6112,175,500
MT,89931,QUATRO MARCOS,4064,3002,3765,14543,10778,531,707
MT,89958,RIO BRANCO,1121,771,970,3936,2966,66,246
MT,89960,RONDOLANDIA,715,245,675,2181,1506,25,179
MT,89974,SALTO DO CEU,555,618,1172,3723,2551,50,285
MT,89990,PONTES E LACERDA,4318,6602,6622,25007,18385,541,1118
MT,90018,ACORIZAL,1382,1083,1270,5041,3771,53,240
MT,90026,SAO JOSE DO POVO,557,989,436,2645,2209,65,136
MT,90042,ALTO DA BOA VISTA,390,615,905,2665,1760,41,171
MT,90050,ALTO ARAGUAIA,2095,2461,2102,9049,6947,142,399
MT,90069,QUERENCIA,1561,865,1214,4734,3520,74,199
MT,90077,ALTO GARCAS,1505,1727,934,5996,5062,127,373
MT,90085,CANABRAVA DO NORTE,510,1039,986,3378,2392,75,210
MT,90093,ALTO PARAGUAI,1593,1512,1672,6628,4956,126,323
MT,90107,SANTA CARMEM,611,497,626,2580,1954,68,76
MT,90123,NOVA MARINGA,633,811,926,3056,2130,42,171
MT,90140,NOVA GUARITA,1285,599,839,3462,2623,82,190
MT,90166,NOVA MARILANDIA,348,371,488,1738,1250,18,14
MT,90182,PORTO ESTRELA,974,679,843,3406,2563,61,202
MT,90204,GLORIA D'OESTE,466,734,423,2263,1840,48,149
MT,90220,TABAPORA,1042,1779,997,4421,3424,72,140
MT,90239,ARAGUAINHA,337,191,117,950,833,21,60
MT,90247,SAO JOSE DO XINGU,587,922,1229,3429,2200,56,205
MT,90255,ARENAPOLIS,1437,2377,2109,8009,5900,143,279
MT,90263,APIACAS,885,1433,1169,4524,3355,80,235
MT,90271,ARIPUANA,2492,1457,1997,8006,6009,205,285
MT,90280,CONFRESA,2032,2910,3258,11554,8296,229,810
MT,90301,LAMBARI D'OESTE,870,1078,1096,4101,3005,128,310
MT,90310,BARAO DE MELGACO,1050,1302,865,5032,4167,97,260
MT,90328,SANTO AFONSO,556,908,828,2785,1957,47,97
MT,90336,BARRA DO BUGRES,6687,3235,4733,19976,15243,552,1106
MT,90344,PLANALTO DA SERRA,376,341,141,1542,1401,29,97
MT,90352,BARRA DO GARCAS,13703,5019,9635,38958,29323,562,1026
MT,90360,NOVA MONTE VERDE,1140,1138,1155,4905,3750,116,263
MT,90387,NOVA BANDEIRANTE,1121,827,1254,4802,3548,144,244
MT,90409,SAO PEDRO DA CIPA,726,659,563,2947,2384,56,142
MT,90425,COTRIGUACU,1570,1118,1254,5348,4094,144,319
MT,90441,RIBEIRAOZINHO,402,425,300,1530,1230,17,67
MT,90468,BRASNORTE,1560,1637,1897,6973,5076,135,297
MT,90476,CACERES,17728,9866,13171,53929,40758,656,1810
MT,90484,CAMPO NOVO DO PARECIS,4109,2574,3859,13217,9358,181,357
MT,90506,CAMPO VERDE,4126,2844,2501,12951,10450,272,446
MT,90522,CLAUDIA,1793,1607,1254,6304,5050,123,238
MT,90549,CASTANHEIRA,1457,1473,1495,5582,4087,125,256
MT,90565,JANGADA,1116,1520,1110,5214,4104,63,463
MT,90581,JURUENA,1275,621,869,3938,3069,89,260
MT,90590,CHAPADA DOS GUIMARAES,2622,2055,784,8050,7266,167,369
MT,90603,LUCAS DO RIO VERDE,5256,2664,3241,15080,11839,342,391
MT,90620,MATUPA,2135,2125,1871,8443,6572,144,390
MT,90646,NOVA MUTUM,3119,2545,1911,9697,7786,204,176
MT,90662,RIBEIRAO CASCALHEIRA,1135,1596,1558,5636,4078,71,331
MT,90670,CUIABA,130846,53592,66199,341257,275058,3754,7000
MT,90689,TAPURA,927,851,767,3539,2772,61,122
MT,90697,DIAMANTINO,3577,3618,3245,13436,10191,199,436
MT,90700,PONTAL DO ARAGUAIA,1274,641,708,3617,2909,65,127
MT,90719,DOM AQUINO,1316,1826,1506,6537,5031,102,413
MT,90727,SAPEZAL,1322,1180,1570,5506,3936,66,156
MT,90743,CAMPOS DE JULIO,559,797,545,2383,1838,22,92
MT,90760,CARLINDA,2077,2375,2048,8707,6659,155,377
MT,90778,GENERAL CARNEIRO,1444,736,990,4015,3025,71,183
MT,90786,FELIZ NATAL,797,1413,1225,4080,2855,48,108
MT,90808,NOVO MUNDO,1245,853,947,3705,2758,92,125
MT,90824,GAUCHA DO NORTE,551,650,600,2396,1796,53,91
MT,90832,GUIRATINGA,1805,2921,2344,10456,8112,170,482
MT,90840,UNIAO DO SUL,602,463,712,2266,1554,35,64
MT,90867,NOVA LACERDA,659,583,884,2760,1876,39,97
MT,90883,NOVA UBIRATA,918,540,943,3036,2093,35,84
MT,90905,BOM JESUS DO ARAGUAIA,309,619,738,2080,1342,31,113
MT,90913,ITIQUIRA,1602,1549,1960,6936,4976,112,289
MT,90921,SERRA NOVA DOURADA,132,181,256,794,538,22,62
MT,90948,NOVO SANTO ANTONIO,283,279,283,1078,795,13,28
MT,90956,JACIARA,4001,4290,2878,15806,12928,251,604
MT,90964,NOVA NAZARE,179,303,298,1043,745,6,79
MT,90980,SANTA CRUZ DO XINGU,223,361,334,1119,785,20,39
MT,91006,CONQUISTA D'OESTE,303,492,487,1909,1422,25,109
MT,91022,VALE DE SAO DOMINGOS,378,745,889,2837,1948,48,132
MT,91049,SANTA RITA DO TRIVELATO,186,300,304,1040,736,11,16
MT,91057,LUCIARA,388,214,306,1644,1338,21,119
MT,91065,BOA ESPERANCA DO NORTE,473,142,340,1319,979,34,39
MT,91081,IPIRANGA DO NORTE,536,283,271,1365,1094,31,25
MT,91090,VILA BELA STSSMA TRINDADE,1102,1692,2115,7446,5331,81,365
MT,91103,ITANHANGA,634,528,578,2236,1658,37,64
MT,91170,NOBRES,2252,2551,2507,10753,8246,131,517
MT,91197,NORTELANDIA,1577,1628,1501,6058,4557,66,241
MT,91219,NOSSA SENHORA DO LIVRAMENTO,2206,2520,2177,9434,7257,121,574
MT,91294,POCONE,5186,4213,1516,16123,14607,261,885
MT,91332,PONTE BRANCA,493,464,188,1478,1290,14,99
MT,91359,PORTO DOS GAUCHOS,748,1306,778,3598,2820,53,141
MT,91391,POXOREO,3093,4101,3654,14442,10788,266,885
MT,91510,RONDONOPOLIS,29702,22182,22475,102264,79789,1548,3026
MT,91537,ROSARIO OESTE,2750,2907,3148,12858,9710,220,792
MT,91553,SANTO ANTONIO DO LEVERGER,3343,3161,1366,11177,9811,116,520
MT,91618,TESOURO,412,773,775,2652,1877,33,180
MT,91634,TORIXOREU,903,926,317,3076,2759,85,146
MT,91677,VARZEA GRANDE,52011,20265,26972,139697,112725,1934,3785
MT,91774,MIRASSOL D'OESTE,2950,4896,4269,16403,12134,449,1139
MT,91812,PEDRA PRETA,3028,2442,2471,10970,8499,277,489
MT,91839,SAO FELIX DO ARAGUAIA,1448,1439,2543,7269,4726,89,435
MT,91855,TANGARA DA SERRA,14029,9097,9619,43890,34271,798,1316
MT,91898,JUSCIMEIRA,1893,2327,2305,9384,7079,198,487
MT,91910,AGUA BOA,2699,2278,2815,11196,8381,166,551
MT,91936,CANARANA,2524,2075,2661,10177,7516,187,545
MT,91952,NOVA XAVANTINA,3189,3364,3233,12912,9679,220,513
MT,91979,SANTA TEREZINHA,849,777,1596,4439,2843,75,308
MT,91995,SAO JOSE DO RIO CLARO,1435,2969,2606,9321,6715,230,556
MT,98191,JUARA,4800,6336,4082,19547,15465,410,956
MT,98310,JUINA,6407,5643,5097,23842,18745,422,882
MT,98337,DENISE,1183,1282,1162,5044,3882,156,207
MT,98612,ALTO TAQUARI,651,882,797,3349,2552,50,107
MT,98639,ARAGUAIANA,643,328,194,1616,1422,28,112
MT,98655,CAMPINAPOLIS,1681,2026,2386,8017,5631,147,380
MT,98671,COCALINHO,825,695,2290,4800,2510,46,187
MT,98698,ITAUBA,1025,870,942,3892,2950,46,184
MT,98710,MARCELANDIA,1663,3252,2173,9124,6951,175,388
MT,98736,NOVA OLIMPIA,3291,1943,2944,11168,8224,351,537
MT,98752,NOVA CANAA DO NORTE,1701,2206,1755,7724,5969,145,480
MT,98779,NOVO SAO JOAQUIM,1282,1562,2127,6466,4339,115,253
MT,98795,NOVO HORIZONTE DO NORTE,704,813,618,3004,2386,45,151
MT,98817,PEIXOTO DE AZEVEDO,3325,4859,5568,18811,13243,295,953
MT,98833,PARANAITA,1489,2269,1030,6409,5379,115,360
MT,98850,PORTO ALEGRE DO NORTE,1004,1791,2019,6323,4304,67,338
MT,98876,PORTO ESPEREDIAO,1142,1579,1081,5584,4503,100,420
MT,98892,PRIMAVERA DO LESTE,7083,5313,4411,23365,18954,520,796
MT,98914,RESERVA DO CABACAL,358,218,144,1307,1163,24,158
MT,98930,SORRISO,9358,4962,4560,24753,20193,557,659
MT,98957,TERRA NOVA DO NORTE,2626,2042,2154,9030,6876,160,451
MT,98973,VERA,1933,1074,1511,6154,4643,126,230
MT,98990,VILA RICA,2105,2671,2359,9707,7348,197,473
MT,99015,COMODORO,2380,2953,3542,11492,7950,197,519
MT,99031,FIGUEIROPOLES D'OESTE,337,846,334,2378,2044,68,235
MT,99058,GUARANTA DO NORTE,4007,3983,3566,16205,12639,406,876
MT,99074,INDIAVAI,440,475,261,1669,1408,27,138
PA,4006,GOIANESIA DO PARA,2926,2244,3498,12679,9181,409,1096
PA,4014,ABAETETUBA,31877,11121,8842,63349,54507,633,2059
PA,4022,TAILANDIA,5219,4888,8834,24980,16146,391,1710
PA,4030,ACARA,4987,5599,6486,22979,16493,365,1654
PA,4049,BOM JESUS DO TOCANTINS,1877,1519,2250,7616,5366,199,669
PA,4057,AFUA,3323,2003,4603,12598,7995,109,1146
PA,4065,SAO JOAO DE PIRABAS,1639,2879,2698,10545,7847,266,815
PA,4073,ALENQUER,6332,6299,8480,29107,20627,259,1522
PA,4081,TUCUMA,4324,1933,4627,16776,12149,428,1119
PA,4090,ALMERIM,5911,2948,5776,18822,13046,343,798
PA,4103,MAE DO RIO,3874,4704,3963,16718,12755,236,1008
PA,4111,ALTAMIRA,11691,8716,10016,42707,32691,792,2771
PA,4120,ELDORADO DO CARAJAS,2887,1629,3714,11941,8227,401,963
PA,4138,ANAJAS,648,2418,3103,7886,4783,37,436
PA,4146,SANTA LUZIA DO PARA,3485,2489,2277,10330,8053,146,767
PA,4154,ANANINDEUA,66246,21502,24348,172718,148370,2136,6086
PA,4162,PALESTINA DO PARA,628,1494,1045,4134,3089,76,377
PA,4170,AUGUSTO CORREA,1720,7369,5364,21465,16101,403,2140
PA,4189,IPIXUNA DO PARA,2376,3034,2681,9858,7177,129,697
PA,4197,AVEIRO,1800,1490,1652,6479,4827,99,370
PA,4200,JACAREACANGA,1194,1482,2212,5953,3741,59,247
PA,4219,BAGRE,1264,1086,2745,6680,3935,74,508
PA,4227,BRASIL NOVO,2472,2556,2000,9257,7257,200,632
PA,4235,BAIAO,4005,3179,2446,12588,10142,288,905
PA,4243,SANTA BARBARA DO PARA,2304,2176,1218,8443,7225,98,455
PA,4251,BARCARENA,14340,3772,6853,36339,29486,375,1839
PA,4260,AGUA AZUL DO NORTE,1651,1167,2421,7363,4942,201,631
PA,4278,BELEM,321197,124389,132182,848052,715870,8868,21581
PA,4286,TRAIRAO,780,2159,1566,5536,3970,104,387
PA,4294,BENEVIDES,6600,4297,3024,20329,17305,236,992
PA,4308,PAU D'ARCO,1201,741,1346,4942,3596,110,474
PA,4316,BONITO,893,3105,1468,7237,5769,76,544
PA,4324,ULIANOPOLIS,1521,1930,2390,8013,5623,178,566
PA,4332,BRAGANCA,9778,15001,14414,54024,39610,531,2295
PA,4340,AURORA DO PARA,1964,2461,2604,9888,7284,128,988
PA,4359,BREVES,9314,6280,17587,39700,22113,416,2058
PA,4367,TERRA SANTA,2139,2058,1505,7367,5862,110,439
PA,4375,BUJARU,3575,2465,3101,11673,8572,182,775
PA,4383,NOVO PROGRESSO,2363,1660,3059,9370,6311,255,499
PA,4391,CACHOEIRA DO ARARI,2326,1504,3157,10930,7773,198,747
PA,4405,VITORIA DO XINGU,1288,1784,1558,6129,4571,88,462
PA,4413,CAMETA,13255,18606,10077,52521,42444,674,2977
PA,4421,NOVO REPARTIMENTO,5725,5612,6032,23636,17604,536,2009
PA,4430,CAPANEMA,8926,7873,8841,37793,28952,686,1545
PA,4448,BREU BRANCO,4276,5708,4157,18254,14097,270,1129
PA,4456,CAPITAO POCO,4441,6590,5975,25331,19356,613,1971
PA,4464,SAO DOMINGOS DO ARAGUAIA,2830,2117,3025,11543,8518,226,1128
PA,4472,CASTANHAL,22072,17398,13129,74727,61598,1109,3362
PA,4480,NOVA ESPERANCA DO PIRIA,1121,2064,1950,6904,4954,123,571
PA,4499,CHAVES,939,1980,3047,8582,5535,124,725
PA,4502,ABEL FIGUEIREDO,1576,741,1109,4455,3346,63,434
PA,4510,COLARES,1774,1782,1208,6533,5325,114,475
PA,4529,CUMARU DO NORTE,574,794,1015,3332,2317,34,247
PA,4537,CONCEICAO DO ARAGUAIA,7631,3984,11615,30758,19143,443,1976
PA,4545,TERRA ALTA,2140,798,1255,6092,4837,109,393
PA,4553,CURRALINHO,2370,1949,2655,9004,6349,103,596
PA,4561,FLORESTA DO ARAGUAIA,1961,1754,3881,10103,6222,150,922
PA,4570,CURUCA,5127,5145,3615,18071,14456,242,1206
PA,4588,BANNACH,626,666,959,3039,2080,49,238
PA,4596,FARO,1616,427,822,4016,3194,62,282
PA,4600,NOVA IPIXUNA,2052,1634,2357,8086,5729,125,722
PA,4618,GURUPA,3506,1940,2303,8824,6521,79,583
PA,4626,PLACAS,1724,1560,1322,6519,5197,185,463
PA,4634,IGARAPE ACU,4570,3930,1932,16169,14237,373,1318
PA,4642,MARITUBA,13173,5849,6518,36681,30163,596,1862
PA,4650,IGARAPE-MIRI,9481,5689,6904,30734,23830,487,2128
PA,4669,TRACUATEUA,2099,4857,3494,14006,10512,200,1408
PA,4677,INHANGAPI,1291,2019,1601,6627,5026,123,451
PA,4685,QUATIPURU,874,2074,1772,6560,4788,149,449
PA,4693,IRITUIA,5044,3775,3772,17968,14196,379,1253
PA,4707,CANAA DOS CARAJAS,2175,706,2086,7499,5413,217,517
PA,4715,ITAITUBA,8460,12648,17180,55912,38732,603,2795
PA,4723,ANAPU,1239,2152,1789,6621,4832,164,542
PA,4731,ITUPIRANGA,6864,2500,6302,20890,14588,407,1650
PA,4740,CURUA,1268,1852,983,5138,4155,123,376
PA,4758,JACUNDA,6120,5637,7435,27410,19975,607,1995
PA,4766,CACHOEIRA DO PIRIA,1484,2148,2458,7702,5244,132,447
PA,4774,JURUTI,5044,3438,3579,15175,11596,112,1075
PA,4782,PICARRA,963,1339,2198,6124,3926,125,587
PA,4790,LIMOEIRO DO AJURU,3138,2943,2343,10836,8493,195,782
PA,4804,BELTERRA,3638,1459,1638,9143,7505,145,794
PA,4812,MAGALHAES BARATA,1525,1782,1252,5849,4597,58,299
PA,4820,SAO JOAO DA PONTA,756,1349,853,3704,2851,65,185
PA,4839,MARABA,32942,12642,19849,88890,69041,1106,4700
PA,4847,SAPUCAIA,751,739,1080,3509,2429,81,299
PA,4855,MARACANA,2762,5271,4658,18536,13878,344,1282
PA,4871,MARAPANIM,3942,3833,3159,15539,12380,224,1004
PA,4898,MELGACO,874,2227,4215,8718,4503,156,490
PA,4910,MOCAJUBA,3283,3701,2723,13080,10357,248,623
PA,4936,MOJU,8626,5819,8819,30008,21189,281,2177
PA,4952,MONTE ALEGRE,10570,5494,6125,29928,23803,333,1288
PA,4979,MUANA,4081,3252,3287,14099,10812,272,1030
PA,4995,NOVA TIMBOTEUA,2585,2127,1243,8013,6770,191,567
PA,5010,OBIDOS,10540,3783,6557,26243,19686,423,1332
PA,5037,OEIRAS DO PARA,2658,3646,2334,11204,8870,109,926
PA,5053,ORIXIMINA,10968,4675,6461,29331,22870,356,1983
PA,5070,OUREM,2714,2698,2018,9484,7466,181,903
PA,5096,PARAGOMINAS,9538,8884,13595,43714,30119,639,2803
PA,5118,PEIXE-BOI,1039,1336,897,5564,4667,87,522
PA,5134,PONTA DE PEDRAS,1987,2299,3251,12396,9145,215,909
PA,5150,PORTEL,3488,5345,7509,19359,11850,156,1345
PA,5177,PORTO DE MOZ,2757,2247,3065,9716,6651,88,593
PA,5193,PRAINHA,3763,2785,3313,13137,9824,177,1179
PA,5215,PRIMAVERA,1128,3200,1868,7859,5991,94,598
PA,5231,SALINOPOLIS,5199,4493,3509,17323,13814,255,1105
PA,5258,SALVATERRA,1900,2917,2177,9343,7166,160,608
PA,5274,SANTA CRUZ DO ARARI,1085,573,1052,4106,3054,77,286
PA,5290,SANTA IZABEL DO PARA,6510,5414,4464,26094,21630,640,1730
PA,5312,SANTA MARIA DO PARA,2950,3466,3257,14015,10758,263,1270
PA,5339,SANTANA DO ARAGUAIA,1809,2534,3657,12001,8344,229,1392
PA,5355,SANTAREM,55950,13261,33386,159503,126117,1426,7506
PA,5371,SANTAREM NOVO,1041,1777,1134,5035,3901,80,376
PA,5398,SANTO ANTONIO DO TAUA,3363,3800,2581,13946,11365,203,967
PA,5410,SAO CAETANO DE ODIVELAS,2460,3082,2405,10351,7946,226,580
PA,5436,SAO DOMINGOS DO CAPIM,2997,4498,3597,14357,10760,261,1228
PA,5452,SAO FELIX DO XINGU,3959,1995,5090,16888,11798,362,1318
PA,5479,SAO FRANCISCO DO PARA,1899,2942,1241,8112,6871,154,482
PA,5495,SAO JOAO DO ARAGUAIA,1679,851,1185,5672,4487,159,489
PA,5517,SAO MIGUEL DO GUAMA,5238,6968,5783,23383,17600,280,1074
PA,5533,SAO SEBASTIAO DA BOA VISTA,3791,2095,2939,10968,8029,146,597
PA,5550,SENADOR JOSE PORFIRIO,1502,1114,1724,5634,3910,64,374
PA,5576,SOURE,3228,1780,3186,13322,10136,209,740
PA,5592,TOME ACU,6265,5649,7068,26676,19608,575,2190
PA,5614,TUCURUI,15502,9348,9412,48361,38949,952,2732
PA,5630,VIGIA,6918,4504,5415,24653,19238,684,1499
PA,5657,VIZEU,5740,5785,8700,29587,20887,703,2422
PA,5673,REDENCAO,10298,7264,9667,41634,31967,910,2937
PA,5690,RIO MARIA,3446,1814,3959,12636,8677,281,926
PA,5711,XINGUARA,5920,3740,6283,22594,16311,565,1644
PA,5738,RONDON DO PARA,6717,3753,7542,24777,17235,497,1881
PA,5754,URUARA,4392,4567,4054,18162,14108,507,1496
PA,5770,MEDICILANDIA,2953,3331,2617,12431,9814,294,1085
PA,5797,SAO GERALDO DO ARAGUAIA,2886,4340,5709,17227,11518,398,1495
PA,5819,CONCORDIA DO PARA,3311,2999,4584,14237,9653,273,1113
PA,5835,PARAUAPEBAS,18238,5050,11607,50388,38781,1327,3012
PA,5851,CURIONOPOLIS,3196,2470,5215,15176,9961,311,1080
PA,5878,GARRAFAO DO NORTE,1529,2594,3543,12522,8979,418,1117
PA,5894,RUROPOLIS,2718,3992,2794,11874,9080,184,703
PA,5916,PACAJA,2994,4088,3662,14253,10591,419,1108
PA,5932,BREJO GRANDE DO ARAGUAIA,1132,872,1471,5075,3604,76,458
PA,5959,OURILANDIA DO NORTE,1998,1568,3091,9644,6553,174,725
PA,5975,DOM ELISEU,4369,4110,5664,20503,14839,511,1629
PA,5991,SANTA MARIA DAS BARREIRAS,931,1289,2337,6172,3835,94,497
PB,19003,RIACHAO DO POCO,884,672,385,2820,2435,86,471
PB,19011,AGUA BRANCA,777,2215,856,5165,4309,152,766
PB,19020,SOBRADO,994,1270,1184,4772,3588,185,603
PB,19038,AGUIAR,1879,566,576,4355,3779,60,782
PB,19046,SAO JOSE DOS RAMOS,1235,719,756,3435,2679,86,485
PB,19054,ALAGOA GRANDE,6116,3264,3180,18730,15550,897,2727
PB,19062,CAPIM,531,760,833,3349,2516,240,412
PB,19070,ALAGOA NOVA,3453,2698,2024,12124,10100,597,1843
PB,19089,CUITE DE MAMANGUAPE,1220,983,1308,4672,3364,124,657
PB,19097,ALAGOINHA,2921,1377,1106,8121,7015,367,1323
PB,19100,CURRAL DE CIMA,478,1472,1297,4300,3003,124,674
PB,19119,ALHANDRA,3697,2079,3009,12942,9933,586,1133
PB,19127,RIACHAO DO BACAMARTE,795,811,824,3387,2563,126,530
PB,19135,SAO JOAO DO RIO DO PEIXE,3395,2068,1885,12282,10397,738,1688
PB,19143,MATINHAS,817,616,894,3193,2299,154,431
PB,19151,ARACAGI,3423,2209,4016,12679,8663,375,1627
PB,19160,LOGRADOURO,965,385,384,2496,2112,53,403
PB,19178,ARARA,1849,1912,1321,6607,5286,225,896
PB,19186,SERTAOZINHO,1127,435,430,2656,2226,63,344
PB,19194,ARARUNA,3498,2505,1595,10488,8893,295,1711
PB,19208,RIACHAO,721,755,426,2238,1812,24,196
PB,19216,AREIA,4556,3450,1960,14955,12995,830,2142
PB,19224,SAO DOMINGOS DO CARIRI,441,722,370,1916,1546,17,185
PB,19232,AREIAL,1190,964,655,3957,3302,181,471
PB,19240,CARAUBAS,568,1039,374,2755,2381,76,342
PB,19259,AROEIRAS,1816,4373,1897,12042,10145,492,2282
PB,19267,SANTO ANDRE,295,602,223,1936,1713,80,321
PB,19275,DAMIAO,932,697,585,3001,2416,47,490
PB,19283,SOSSEGO,288,556,164,1786,1622,40,264
PB,19291,BAIA DA TRAICAO,771,959,968,4123,3155,341,570
PB,19305,BARAUNAS,471,807,313,2313,2000,66,407
PB,19313,BANANEIRAS,5204,2556,2194,13851,11657,508,1977
PB,19321,ASSUNCAO,425,928,206,2215,2009,51,248
PB,19330,BARRA DE SANTA ROSA,2689,2584,1000,8076,7076,98,1187
PB,19348,ZABELE,312,400,176,1434,1258,67,216
PB,19356,BARRA DE SAO MIGUEL,901,1324,746,4036,3290,114,493
PB,19364,CACIMBAS,311,1787,1454,4680,3226,146,730
PB,19372,BAYEUX,23054,6166,10612,61788,51176,2890,4705
PB,19380,CAJAZEIRINHAS,838,745,396,2747,2351,85,496
PB,19399,BELEM,3604,2298,2022,10830,8808,405,1395
PB,19402,SAO BENTINHO,1123,316,591,2701,2110,36,460
PB,19410,BELEM DO BREJO DO CRUZ,678,1521,681,4387,3706,182,628
PB,19429,SAO DOMINGOS DE POMBAL,470,726,651,2772,2121,95,333
PB,19437,BOA VENTURA,1117,942,694,3954,3260,80,647
PB,19445,SAO JOSE DE PRINCESA,594,698,818,2800,1982,46,421
PB,19453,BOM JESUS,543,442,238,1747,1509,66,241
PB,19461,MARIZOPOLIS,1283,1062,625,4333,3708,168,501
PB,19470,BOM SUCESSO,1150,533,640,3898,3258,128,527
PB,19488,MATO GROSSO,211,1026,201,1765,1564,19,255
PB,19496,BONITO DE SANTA FE,1696,1017,1039,5978,4939,122,875
PB,19500,BERNARDINO BATISTA,193,887,291,1823,1532,39,255
PB,19518,BOQUEIRAO,3148,2732,2940,12505,9565,361,1660
PB,19526,POCO DE JOSE DE MOURA,1182,379,384,3098,2714,79,533
PB,19534,IGARACY,1509,727,988,4520,3532,78,723
PB,19542,SAO JOSE DO BREJO CRUZ,471,211,153,1297,1144,39,162
PB,19550,BORBOREMA,1108,563,547,3159,2612,115,480
PB,19569,SANTA INES,654,1021,391,2716,2325,40,461
PB,19577,BREJO DO CRUZ,1782,2070,2263,9039,6776,283,1105
PB,19585,AMPARO,326,543,172,1405,1233,44,184
PB,19593,BREJO DOS SANTOS,920,1421,861,4785,3924,177,573
PB,19607,CASSERENGUE,1071,1112,705,4312,3607,105,797
PB,19615,CAAPORA,4184,2451,3113,13565,10452,634,1267
PB,19623,GADO BRAVO,602,2394,1700,6454,4754,294,973
PB,19631,CABACEIRAS,1129,585,433,3413,2980,100,369
PB,19640,POCO DANTAS,520,554,401,2276,1875,110,331
PB,19658,CABEDELO,9410,3536,4442,27336,22894,1236,1707
PB,19666,SANTAREM,695,462,508,2198,1690,31,289
PB,19674,CACHOEIRA DOS INDIOS,1928,981,957,5371,4414,166,651
PB,19682,TENORIO,549,414,325,1829,1504,52,317
PB,19690,CACIMBA DE AREIA,689,770,387,2582,2195,111,278
PB,19704,COXIXOLA,262,201,135,1191,1056,134,163
PB,19712,CACIMBA DE DENTRO,2801,3619,1890,10668,8778,138,1446
PB,19720,PARARI,260,438,213,1394,1181,33,214
PB,19739,CAICARA,2086,814,935,5177,4242,84,708
PB,19747,PEDRO REGIS,629,585,822,3118,2296,166,489
PB,19755,CAJAZEIRAS,15034,4289,9399,38249,28850,1294,3387
PB,19763,ALCANTIL,780,804,296,3147,2851,102,516
PB,19771,CALDAS BRANDAO,1325,622,493,3730,3237,221,484
PB,19780,BARRA DE SANTANA,805,1865,628,5266,4638,262,881
PB,19798,CAMALAU,886,738,465,3744,3279,238,649
PB,19801,CATURITE,731,873,270,2858,2588,157,325
PB,19810,CAMPINA GRANDE,89977,38795,39781,239849,200068,8197,14387
PB,19828,RIACHO DE SANTO ANTONIO,273,302,155,1282,1127,34,163
PB,19836,CARRAPATEIRA,597,276,432,1678,1246,37,210
PB,19844,APARECIDA,1623,889,762,4789,4027,249,608
PB,19852,CATINGUEIRA,873,828,644,3703,3059,101,426
PB,19860,SAO FRANCISCO,1102,744,316,2922,2606,104,405
PB,19879,CATOLE DO ROCHA,6556,4232,1964,17811,15847,347,2133
PB,19887,VIEIROPOLIS,1227,894,516,3780,3264,114,671
PB,19895,CONCEICAO,3045,3325,2130,12154,10024,389,2068
PB,19909,AREIA DE BARAUNAS,299,671,139,1441,1302,38,178
PB,19917,CONDADO,1259,1341,1063,5312,4249,131,565
PB,19925,ALGODAO DE JANDAIRA,615,389,257,1674,1417,36,238
PB,19933,CONDE,3628,1445,2719,11333,8614,833,1167
PB,19941,BOA VISTA,1096,1287,525,4026,3501,94,436
PB,19950,CONGO,896,855,361,3106,2745,134,394
PB,19968,MARCACAO,528,828,999,3607,2608,309,448
PB,19976,COREMAS,3027,2168,1571,9726,8155,298,1432
PB,19984,MATUREIA,777,1296,987,4117,3130,149,595
PB,19992,CRUZ DO ESPIRITO SANTO,3180,1571,1001,9431,8430,660,1210
PB,20001,SANTA CECILIA DE UMBUZEIRO,406,2117,1134,4602,3468,126,582
PB,20010,CUBATI,719,1793,492,4461,3969,141,714
PB,20036,CUITE,2786,4373,3575,14611,11036,384,1914
PB,20052,CUITEGI,1193,853,688,4046,3358,185,659
PB,20079,CURRAL VELHO,261,807,398,1911,1513,14,286
PB,20095,DESTERRO,726,1976,769,5017,4248,171,728
PB,20117,VISTA SERRANA,525,707,370,2160,1790,27,253
PB,20133,DIAMANTE,1223,1017,740,4544,3804,110,904
PB,20150,DONA INES,2361,1709,1060,6838,5778,129,1029
PB,20176,DUAS ESTRADAS,1138,647,479,2938,2459,78,409
PB,20192,EMAS,351,622,284,2261,1977,46,325
PB,20214,ESPERANCA,6577,4879,5266,21746,16480,794,2297
PB,20230,FAGUNDES,1787,2612,1813,8442,6629,180,1450
PB,20257,FREI MARTINHO,563,716,133,2063,1930,37,306
PB,20273,GUARABIRA,12370,5925,4210,32079,27869,1113,3436
PB,20290,GURINHEM,3018,2298,2401,10029,7628,355,1018
PB,20311,GURJAO,474,845,238,2315,2077,46,350
PB,20338,IBIARA,815,1215,697,4352,3655,211,642
PB,20354,IMACULADA,1229,2236,994,6423,5429,227,1139
PB,20370,INGA,3674,2230,3635,13268,9633,423,2010
PB,20397,ITABAIANA,5261,3898,5624,20543,14919,896,2239
PB,20419,ITAPORANGA,5198,2500,3965,15213,11248,326,1679
PB,20435,ITAPOROROCA,1340,3277,1128,8642,7514,423,1427
PB,20451,ITATUBA,1643,1873,1836,7482,5646,328,1143
PB,20478,JACARAU,2342,1824,1594,8972,7378,294,1096
PB,20494,JERICO,1631,1241,712,4982,4270,140,700
PB,20516,JOAO PESSOA,177832,40079,51902,376822,324920,10966,17943
PB,20532,JUAREZ TAVORA,1814,647,652,4953,4301,358,721
PB,20559,JUAZEIRINHO,2572,2118,1184,9493,8309,336,1415
PB,20575,JUNCO DO SERIDO,821,1530,669,4202,3533,136,565
PB,20591,JURIPIRANGA,3100,1039,2699,8706,6007,247,1061
PB,20613,JURU,1012,2479,2287,7132,4845,190,994
PB,20630,LAGOA,1153,538,495,3507,3012,205,529
PB,20656,LAGOA DE DENTRO,1511,1223,978,4832,3854,178,559
PB,20672,LAGOA SECA,4416,3751,1684,14013,12329,958,1801
PB,20699,LASTRO,1270,350,279,2648,2369,103,410
PB,20710,LIVRAMENTO,522,1872,553,4237,3684,137,712
PB,20737,LUCENA,1689,813,1744,6749,5005,441,712
PB,20753,MAE D AGUA,677,1036,450,2879,2429,84,367
PB,20770,MALTA,1148,980,851,4330,3479,166,683
PB,20796,MAMANGUAPE,5564,6116,6333,26533,20200,1077,2929
PB,20818,MANAIRA,1602,1605,2596,7719,5123,157,1105
PB,20834,MARI,3222,1849,1920,11662,9742,506,1608
PB,20850,MASSARANDUBA,2026,2004,1600,8362,6762,584,1195
PB,20877,MATARACA,1220,781,637,4156,3519,178,572
PB,20893,MOGEIRO,2348,2310,2627,9301,6674,261,973
PB,20915,MONTADAS,586,581,492,2878,2386,109,444
PB,20931,MONTE HOREBE,851,573,679,3005,2326,94,394
PB,20958,MONTEIRO,4741,5846,2473,18475,16002,693,2765
PB,20974,MULUNGU,2288,1617,888,6646,5758,210,934
PB,20990,NATUBA,650,2008,719,5122,4403,305,934
PB,21016,NAZAREZINHO,1582,879,974,5470,4496,164,872
PB,21032,NOVA FLORESTA,1177,2176,807,5758,4951,205,607
PB,21059,NOVA OLINDA,729,918,1813,5176,3363,113,780
PB,21075,NOVA PALMEIRA,914,856,333,2680,2347,95,346
PB,21091,OLHO D AGUA,1464,2235,824,5820,4996,100,756
PB,21113,OLIVEDOS,607,688,492,2772,2280,93,407
PB,21130,OURO VELHO,850,564,310,2291,1981,43,311
PB,21156,PASSAGEM,270,601,180,1568,1388,30,181
PB,21172,PATOS,18159,13389,11890,58873,46983,1574,4190
PB,21199,PAULISTA,1382,2360,1267,7800,6533,228,961
PB,21210,PEDRA BRANCA,653,1001,368,2743,2375,44,431
PB,21237,PEDRA LAVRADA,1230,1770,615,5004,4389,106,702
PB,21253,PEDRAS DE FOGO,4979,3586,5078,19468,14390,749,2444
PB,21270,PIANCO,3024,3219,1580,10406,8826,333,1402
PB,21296,PICUI,2869,3948,2654,12749,10095,432,1702
PB,21318,PILAR,2984,1277,774,7043,6269,292,937
PB,21334,PILOES,2503,477,750,5023,4273,148,778
PB,21350,PILOEZINHOS,1126,809,755,3736,2981,155,567
PB,21377,PIRPIRITUBA,1994,1311,994,6064,5070,252,772
PB,21393,PITIMBU,1734,1349,1561,7090,5529,288,688
PB,21415,POCINHOS,2599,3564,1313,10194,8881,390,1248
PB,21431,POMBAL,7681,3901,2700,20253,17553,569,2629
PB,21458,PRATA,669,781,727,3056,2329,129,351
PB,21474,PRINCESA ISABEL,2984,3615,2067,11062,8995,317,1335
PB,21490,PUXINANA,2294,2391,674,7583,6909,439,882
PB,21512,QUEIMADAS,5766,6266,3901,23771,19870,1179,3105
PB,21539,QUIXABA,286,658,167,1368,1201,13,153
PB,21555,REMIGIO,3157,2454,1579,9828,8249,394,1144
PB,21571,RIACHO DOS CAVALOS,833,2293,583,5401,4818,242,714
PB,21598,RIO TINTO,4233,3091,4590,16436,11846,821,1547
PB,21610,SALGADINHO,303,779,392,2175,1783,81,297
PB,21636,SALGADO DE SAO FELIX,2178,1769,2761,8845,6084,343,1053
PB,21652,SANTA CRUZ,2111,760,1139,5276,4137,212,608
PB,21679,SANTA HELENA,1667,461,602,4158,3556,158,560
PB,21695,SANTA LUZIA,2552,3629,1622,10603,8981,585,722
PB,21717,SANTANA DE MANGUEIRA,729,1173,692,3881,3189,196,522
PB,21733,SANTANA DOS GARROTES,1176,1378,786,5240,4454,146,958
PB,21750,SANTA RITA,24726,7271,12973,69815,56842,3417,6143
PB,21776,SANTA TERESINHA,844,1413,727,3971,3244,99,468
PB,21792,SAO BENTO,4575,6070,3336,18306,14970,425,1676
PB,21814,SAO JOAO DO CARIRI,868,718,392,3182,2790,98,502
PB,21830,SAO JOAO DO TIGRE,565,985,337,2761,2424,89,429
PB,21857,SAO JOSE DA LAGOA TAPADA,1344,1692,1460,6209,4749,251,816
PB,21873,SAO JOSE DE CAIANA,924,1195,855,4032,3177,141,690
PB,21890,SAO JOSE DE ESPINHARAS,998,1114,695,4114,3419,146,566
PB,21911,SAO JOSE DE PIRANHAS,3815,2196,2166,11706,9540,541,1413
PB,21938,SAO JOSE DO BONFIM,823,762,221,2555,2334,57,371
PB,21954,SAO JOSE DO SABUGI,490,1309,232,2935,2703,99,404
PB,21970,SAO JOSE DOS CORDEIROS,709,893,351,2815,2464,106,394
PB,21997,SAO MAMEDE,1931,1386,1186,6197,5011,167,684
PB,22012,SAO MIGUEL DE TAIPU,1309,472,471,3486,3015,144,545
PB,22039,SAO SEB. DE LAGOA DE ROCA,1969,1808,1247,6877,5630,365,781
PB,22055,SAO SEBASTIAO DO UMBUZEIRO,850,410,256,2139,1883,47,350
PB,22071,SAPE,9815,5068,9555,33722,24167,1522,3634
PB,22098,SAO VICENTE DO SERIDO,837,2171,1502,6326,4824,300,880
PB,22110,SERRA BRANCA,2422,1623,1123,7986,6863,401,1016
PB,22136,SERRA DA RAIZ,807,546,431,2399,1968,86,273
PB,22152,SERRA GRANDE,634,608,284,2008,1724,62,301
PB,22179,SERRA REDONDA,1641,983,767,5016,4249,220,833
PB,22195,SERRARIA,1538,1433,1049,5176,4127,181,716
PB,22217,SOLANEA,5285,4737,6609,21135,14526,716,2211
PB,22233,SOLEDADE,2461,2296,1423,8633,7210,304,1188
PB,22250,SOUSA,14223,5640,9573,41684,32111,1719,4367
PB,22276,SUME,2393,2942,1486,9997,8511,383,1427
PB,22292,CAMPO DE SANTANA,1849,1649,921,5938,5017,242,783
PB,22314,TAPEROA,1801,3649,1251,8670,7419,250,1119
PB,22330,TAVARES,1568,2637,1727,7927,6200,334,1259
PB,22357,TEIXEIRA,2046,2547,1058,8072,7014,229,1177
PB,22373,TRIUNFO,1231,748,1803,6691,4888,187,745
PB,22390,UIRAUNA,3183,2429,1310,9351,8041,233,1116
PB,22411,UMBUZEIRO,1038,2246,1010,5856,4846,198,962
PB,22438,VARZEA,570,581,222,1862,1640,41,174
PE,23000,QUIXABA,1190,1599,2057,6021,3964,230,676
PE,23019,AFOGADOS DA INGAZEIRA,6589,5501,6141,22377,16236,686,2081
PE,23027,LAGOA DO CARRO,3101,2346,1996,10018,8022,403,1036
PE,23035,AFRANIO,1974,3809,1797,11460,9663,458,1778
PE,23043,SANTA CRUZ DA BAIXA VERDE,2325,2145,1346,7961,6615,459,804
PE,23051,AGRESTINA,4282,4151,5020,17410,12390,854,1981
PE,23060,XEXEU,1426,1813,2725,8080,5355,246,917
PE,23078,AGUA PRETA,5478,2114,6650,20246,13596,886,1833
PE,23086,VERTENTE DO LERIO,1050,2219,2262,7174,4912,377,931
PE,23094,AGUAS BELAS,4251,5693,8457,27636,19179,1275,4903
PE,23108,SANTA CRUZ,2108,896,2161,8133,5972,339,1161
PE,23116,ALAGOINHA,2912,1871,2309,9745,7436,320,1200
PE,23124,JUCATI,1228,2325,1936,7336,5400,437,1022
PE,23132,ALIANCA,6544,4178,7666,27015,19349,1294,2913
PE,23140,DORMENTES,3460,2146,1785,10801,9016,567,1509
PE,23159,ALTINHO,3340,3660,4087,16204,12117,1514,2154
PE,23167,CARNAUBEIRA DA PENHA,2807,654,1921,7018,5097,567,807
PE,23175,AMARAJI,3930,1503,4250,15520,11270,946,1739
PE,23183,LAGOA GRANDE,4743,1318,3447,12579,9132,305,1554
PE,23191,ANGELIM,2116,1951,915,6417,5502,181,944
PE,23205,ARACOIABA,2897,1414,2531,10407,7876,464,780
PE,23213,ARARIPINA,8950,6601,12574,44561,31987,1706,6988
PE,23221,CASINHAS,1875,2650,2671,9607,6936,477,1446
PE,23230,ARCOVERDE,14037,7771,9195,39915,30720,1498,3426
PE,23248,MANARI,685,3294,2028,8074,6046,309,1562
PE,23256,BARRA DE GUABIRABA,1631,1769,2290,8278,5988,604,1028
PE,23264,JATOBA,3845,857,2213,8504,6291,190,823
PE,23272,BARREIROS,4962,3607,10125,28890,18765,1372,2222
PE,23280,TAMANDARE,3451,1108,3055,10649,7594,418,840
PE,23299,BELEM DE MARIA,1602,1915,2764,8786,6022,485,1348
PE,23302,JAQUEIRA,2414,1600,2063,7482,5419,180,805
PE,23310,BELEM DE SAO FRANCISCO,3978,2281,3843,13356,9513,393,1357
PE,23329,SANTA FILOMENA,1659,1514,1906,7882,5976,335,1221
PE,23337,BELO JARDIM,15326,12049,11470,48288,36818,1757,4757
PE,23353,BETANIA,1137,1176,1397,7723,6326,274,1532
PE,23370,BEZERROS,9159,10593,8182,38154,29972,2746,4272
PE,23396,BODOCO,5144,5201,2725,18325,15600,746,2723
PE,23418,BOM CONSELHO,4295,7724,9543,30383,20840,1622,4253
PE,23434,BOM JARDIM,5513,8022,7409,26437,19028,1137,3159
PE,23450,BONITO,5490,5408,6485,24569,18084,1661,3255
PE,23477,BREJAO,2851,1305,835,6615,5780,312,726
PE,23493,BREJINHO,821,1083,1891,6069,4178,286,791
PE,23515,BREJO DA MADRE DE DEUS,3555,7583,5410,22439,17029,1071,3230
PE,23531,BUENOS AIRES,2995,1555,2653,10020,7367,375,1302
PE,23558,BUIQUE,3406,8692,7850,29303,21453,1389,5960
PE,23574,CABO,38038,11203,19592,110669,91077,5287,6527
PE,23590,CABROBO,4174,4288,4674,18271,13597,859,2134
PE,23612,CACHOEIRINHA,2782,3973,3388,12937,9549,515,1716
PE,23639,CAETES,3916,2809,4181,13821,9640,679,1693
PE,23655,CALCADO,777,2453,1690,6444,4754,273,920
PE,23671,CALUMBI,1798,967,1912,6021,4109,329,644
PE,23698,CAMOCIM DE SAO FELIX,3168,2658,2817,12073,9256,835,1645
PE,23710,CAMUTANGA,2105,1566,1984,7244,5260,308,572
PE,23736,CANHOTINHO,2652,4425,5481,16466,10985,725,2079
PE,23752,CAPOEIRAS,3246,3279,3905,13634,9729,1058,1422
PE,23779,CARNAIBA,3099,3444,4504,14569,10065,524,1931
PE,23795,CARPINA,12914,6312,8206,41675,33469,2106,3212
PE,23817,CARUARU,39121,43502,26638,153997,127359,9974,11110
PE,23833,CATENDE,4874,3569,6464,22638,16174,1259,2380
PE,23850,CEDRO,1701,1545,1997,7256,5259,283,1110
PE,23876,CHA DE ALEGRIA,2378,2095,2278,9605,7327,578,1134
PE,23892,CHA GRANDE,2508,3249,1981,11880,9899,823,1757
PE,23914,CONDADO,4376,2051,4159,15007,10848,744,1355
PE,23930,CORRENTES,3023,2105,3675,11776,8101,588,1618
PE,23957,CORTES,2478,2117,3757,11679,7922,330,1240
PE,23973,CUMARU,2597,4046,3702,13792,10090,722,1961
PE,23990,CUPIRA,2830,4812,5666,17424,11758,804,2038
PE,24015,CUSTODIA,5145,5255,6820,22419,15599,968,3204
PE,24031,ESCADA,11929,5592,9220,40799,31579,1309,2910
PE,24058,EXU,7458,3543,7047,23308,16261,602,2988
PE,24074,FEIRA NOVA,2339,3998,3782,14937,11155,836,1991
PE,24090,FERREIROS,3291,990,2369,8540,6171,384,775
PE,24112,FLORES,4078,2572,5329,16398,11069,818,2112
PE,24139,FLORESTA,8499,1774,3908,17690,13782,455,1843
PE,24155,FREI MIGUELINHO,1337,4221,1425,9447,8022,503,1311
PE,24171,GAMELEIRA,3953,1536,4368,13912,9544,489,1284
PE,24198,GARANHUNS,29880,9312,14824,69503,54679,2512,4802
PE,24210,GLORIA DO GOITA,3553,4845,4795,18600,13805,965,2717
PE,24236,GOIANA,13667,6798,9787,47654,37867,2347,2983
PE,24252,GRANITO,1303,818,594,3877,3283,143,615
PE,24279,GRAVATA,8726,14484,12057,47009,34952,2387,5367
PE,24295,IATI,2056,2713,4133,12984,8851,357,2019
PE,24317,IBIMIRIM,2955,4297,5727,16975,11248,834,2014
PE,24333,IBIRAJUBA,845,2057,1780,6269,4489,288,996
PE,24350,IGARASSU,17839,6102,9945,51996,42051,2090,2555
PE,24376,IGUARACI,2067,1894,2782,8774,5992,345,1121
PE,24392,INAJA,1311,2457,1901,7890,5989,358,1028
PE,24414,INGAZEIRA,950,974,934,3718,2784,154,495
PE,24430,IPOJUCA,9346,5723,8997,40306,31309,2118,4191
PE,24457,IPUBI,2427,3821,4562,14877,10315,584,2296
PE,24473,ITACURUBA,1473,482,953,3549,2596,95,374
PE,24490,ITAIBA,2787,4532,4121,15686,11565,501,2640
PE,24511,ITAMARACA,3921,2115,2227,11734,9507,468,687
PE,24538,ITAPETIM,1888,3264,3496,11130,7634,726,1295
PE,24554,ITAQUITINGA,3159,757,2899,10813,7914,332,1244
PE,24570,JABOATAO,124930,44135,52139,334794,282655,13078,15742
PE,24597,JATAUBA,1987,3623,2516,10463,7947,362,1581
PE,24619,JOAO ALFREDO,3268,6043,5985,21554,15569,1271,3995
PE,24635,JOAQUIM NABUCO,3721,1449,3905,12598,8693,458,1063
PE,24651,JUPI,2302,1886,2792,9866,7074,454,1599
PE,24678,JUREMA,966,3059,1434,8118,6684,411,1563
PE,24694,LAGOA DE ITAENGA,4195,4659,3904,16784,12880,627,1814
PE,24716,LAGOA DO OURO,1764,1110,2809,9618,6809,264,1509
PE,24732,LAGOA DOS GATOS,1504,3221,3455,10842,7387,575,1653
PE,24759,LAJEDO,5906,7632,6770,26539,19769,1328,3172
PE,24775,LIMOEIRO,10888,11056,9457,42404,32947,2421,4307
PE,24791,MACAPARANA,4067,4501,6518,20377,13859,774,2510
PE,24813,MACHADOS,1792,2011,2496,8580,6084,497,944
PE,24830,MARAIAL,2070,1892,3256,9871,6615,399,1269
PE,24856,MIRANDIBA,3477,1764,2788,10251,7463,390,1258
PE,24872,MORENO,11245,4113,7574,35988,28414,1846,2393
PE,24899,NAZARE DA MATA,6047,2957,4782,22936,18154,1643,2076
PE,24910,OLINDA,111344,40073,35686,265800,230114,8071,11611
PE,24937,OROBO,2713,4387,5246,16665,11419,870,2248
PE,24953,OROCO,2244,2069,1977,8489,6512,256,1200
PE,24970,OURICURI,5774,9734,9638,35808,26170,1276,5306
PE,24996,PALMARES,11600,4957,11856,40551,28695,1495,3253
PE,25011,PALMEIRINA,1181,1943,1838,6504,4666,229,949
PE,25038,PANELAS,2449,7253,5769,18645,12876,352,2349
PE,25054,PARANATAMA,1931,2465,3405,9940,6535,373,1306
PE,25070,PARNAMIRIM,3301,3872,3110,13494,10384,644,1601
PE,25097,PASSIRA,5085,6228,5320,21894,16574,1350,2518
PE,25119,PAUDALHO,5796,6190,5382,28024,22642,1634,2803
PE,25135,PAULISTA,65246,20789,24825,159644,134819,4588,5642
PE,25151,PEDRA,3090,3829,4021,15512,11491,690,2259
PE,25178,PESQUEIRA,14331,8045,10670,41273,30603,1645,4161
PE,25194,PETROLANDIA,8821,1605,3757,17996,14239,538,1775
PE,25216,PETROLINA,55897,12875,24308,127832,103524,3734,8281
PE,25232,POCAO,1978,2367,1083,7526,6443,440,1298
PE,25259,POMBOS,3239,4749,4923,18497,13574,1263,2057
PE,25275,PRIMAVERA,2265,1230,2151,8453,6302,512,828
PE,25291,QUIPAPA,2596,2626,5693,15795,10102,676,2475
PE,25313,RECIFE,389854,167829,147622,982511,834889,27260,35633
PE,25330,RIACHO DAS ALMAS,2534,4532,3830,15238,11408,1571,1707
PE,25356,RIBEIRAO,7053,2545,8616,28836,20220,1035,2451
PE,25372,RIO FORMOSO,4052,3051,4830,16633,11803,496,1417
PE,25399,SAIRE,2441,3006,2958,11656,8698,966,1581
PE,25410,SALGADINHO,698,1797,460,4315,3855,287,779
PE,25437,SALGUEIRO,11027,6362,6935,31752,24817,1007,2712
PE,25453,SALOA,1885,2995,2947,10810,7863,549,1552
PE,25470,SANHARO,3897,2995,3787,14260,10473,726,2146
PE,25496,SANTA CRUZ DO CAPIBARIBE,9591,9244,7190,38713,31523,2419,4158
PE,25518,SANTA MARIA DA BOA VISTA,8475,2781,4517,20020,15503,534,2180
PE,25534,SANTA MARIA DO CAMBUCA,1431,3319,3034,9823,6789,425,1133
PE,25550,SANTA TEREZINHA,1168,2030,2126,7368,5242,216,997
PE,25577,SAO BENEDITO DO SUL,1323,1698,2599,7180,4581,350,897
PE,25593,SAO BENTO DO UNA,6919,7660,7638,28430,20792,1356,3048
PE,25615,SAO CAETANO,4730,6144,5665,24602,18937,1799,3797
PE,25631,SAO JOAO,3689,2379,3837,13259,9422,551,1600
PE,25658,SAO JOAQUIM DO MONTE,2742,4087,3985,14887,10902,1058,2129
PE,25674,SAO JOSE DA COROA GRANDE,1483,2011,3785,11247,7462,586,1257
PE,25690,SAO JOSE DO BELMONTE,4648,4034,7334,22416,15082,976,2615
PE,25712,SAO JOSE DO EGITO,5618,5094,6219,21367,15148,934,2433
PE,25739,SAO LOURENCO DA MATA,18287,8485,10978,59173,48195,2442,4628
PE,25755,SAO VICENTE FERRER,2421,2274,3576,12036,8460,656,1641
PE,25771,SERRA TALHADA,13116,9538,13162,48438,35276,1425,4956
PE,25798,SERRITA,2936,3915,3114,12253,9139,267,1514
PE,25810,SERTANIA,5034,4865,7018,24298,17280,952,2168
PE,25836,SIRINHAEM,5943,3522,6377,24170,17793,989,2233
PE,25852,MOREILANDIA,2413,1448,2526,8315,5789,244,1076
PE,25879,SOLIDAO,1020,1346,1482,4872,3390,188,722
PE,25895,SURUBIM,7612,9189,7622,33196,25574,2385,2963
PE,25917,TABIRA,5424,3177,4603,17432,12829,864,1955
PE,25933,TACAIMBO,1493,2739,2275,8466,6191,487,1264
PE,25950,TACARATU,2225,2727,3288,11146,7858,452,1514
PE,25976,ITAMBE,6161,3351,5926,20852,14926,854,2070
PE,25992,TAQUARITINGA DO NORTE,3381,3730,2569,13297,10728,705,1757
PE,26018,TEREZINHA,891,1593,1667,5548,3881,359,735
PE,26034,TERRA NOVA,1531,1963,730,5942,5212,264,922
PE,26050,TIMBAUBA,13201,6546,11093,40567,29474,1740,3423
PE,26077,TORITAMA,2558,3780,3193,13890,10697,942,1530
PE,26093,TRACUNHAEM,2533,1213,2293,9361,7068,587,791
PE,26115,TRINDADE,2355,3921,4313,14995,10682,598,1891
PE,26131,TRIUNFO,3566,2834,3475,12419,8944,587,1141
PE,26158,TUPANATINGA,1176,3845,4344,13989,9645,676,2615
PE,26174,TUPARETAMA,2446,975,2110,7558,5448,457,912
PE,26190,VENTUROSA,2199,3226,2691,10838,8147,387,1398
PE,26212,VERDEJANTE,1472,1895,2067,7161,5094,227,1039
PE,26239,VERTENTES,2080,3832,1466,10418,8952,852,1444
PE,26255,VICENCIA,6125,2943,6223,21224,15001,1012,2331
PE,26271,VITORIA DE SANTO ANTAO,20097,16915,16294,78504,62210,4635,6309
PE,26298,CAMARAGIBE,33962,10500,12291,86682,74391,3125,4269
PE,26310,ABREU E LIMA,23597,6497,9980,65509,55529,2232,3469
PE,26336,ITAPISSUMA,4085,2531,2787,14156,11369,767,1156
PE,30015,FERNANDO DE NORONHA,599,133,285,1175,890,23,39
PI,10006,BRASILEIRA,1236,1469,893,5143,4250,203,613
PI,10014,AGRICOLANDIA,1808,678,1125,4825,3700,79,434
PI,10022,ALEGRETE DO PIAUI,591,574,402,3102,2700,103,468
PI,10030,AGUA BRANCA,3482,1483,1568,9895,8327,222,1110
PI,10049,BAIXA GRANDE DO RIBEIRO,622,1413,1010,4567,3557,75,639
PI,10057,ALTO LONGA,2180,2101,1818,10200,8382,176,1443
PI,10065,BOM PRINCIPIO DO PIAUI,1137,445,698,4515,3817,103,593
PI,10073,ALTOS,8522,3351,2908,22331,19423,612,2761
PI,10081,BONFIM DO PIAUI,672,1445,554,3395,2841,74,494
PI,10090,AMARANTE,2924,2836,1687,11141,9454,319,1436
PI,10103,BURITI DOS MONTES,719,634,520,4590,4070,100,819
PI,10111,ANGICAL DO PIAUI,2362,827,754,5544,4790,127,496
PI,10120,CABECEIRAS DO PIAUI,1651,1072,807,5911,5104,110,878
PI,10138,ANISIO DE ABREU,1168,1520,736,4656,3920,92,681
PI,10146,CALDEIRAO GRANDE DO PIAUI,667,1523,445,3740,3295,79,490
PI,10154,ANTONIO ALMEIDA,479,723,385,2497,2112,51,306
PI,10162,CANAVIEIRA,634,700,325,2637,2312,41,430
PI,10170,AROAZES,1289,452,766,4311,3545,107,513
PI,10189,COIVARAS,1038,641,374,3345,2971,56,425
PI,10197,ARRAIAL,514,1131,510,3094,2584,39,480
PI,10200,COLONIA DO GURGUEIA,744,641,529,3542,3013,60,449
PI,10219,AVELINO LOPES,2095,1493,1314,6975,5661,119,791
PI,10227,COLONIA DO PIAUI,1469,815,960,4855,3895,167,769
PI,10235,BARRAS,8234,5588,3736,24125,20389,508,3441
PI,10243,CORONEL JOSE DIAS,1390,915,428,3623,3195,91,451
PI,10251,BARREIRAS DO PIAUI,721,434,382,2231,1849,49,314
PI,10260,FARTURA DO PIAUI,1069,946,416,3150,2734,53,447
PI,10278,BARRO DURO,1344,868,866,5013,4147,102,531
PI,10286,JACOBINA DO PIAUI,1272,917,435,3720,3285,119,458
PI,10294,BATALHA,5629,2929,2639,15669,13030,303,1983
PI,10308,JARDIM DO MULATO,702,843,356,2815,2459,75,355
PI,10316,BENEDITINOS,1680,2441,1040,7573,6533,236,1027
PI,10324,LAGOA ALEGRE,1153,1555,643,4921,4278,108,733
PI,10332,BERTOLINIA,808,592,514,3627,3113,92,423
PI,10340,LAGOA DO BARRO DO PIAUI,689,984,481,3038,2557,141,470
PI,10359,BOCAINA,2093,425,421,4534,4113,76,562
PI,10367,MARCOLANDIA,893,965,1000,4733,3733,166,749
PI,10375,BOM JESUS,2290,3387,1290,9739,8449,217,1398
PI,10383,PATOS DO PIAUI,1408,1106,595,4240,3645,114,749
PI,10391,BURITI DOS LOPES,2846,3310,3644,13364,9720,212,1348
PI,10405,PASSAGEM FRANCA DO PIAUI,879,687,543,2974,2431,61,360
PI,10413,CAMPINAS DO PIAUI,1239,1285,527,3845,3318,72,572
PI,10421,QUEIMADA NOVA,1900,711,899,5178,4279,167,748
PI,10430,CAMPO MAIOR,11481,5606,3847,29090,25243,791,2372
PI,10448,SANTA CRUZ DOS MILAGRES,1016,228,669,2642,1973,59,288
PI,10456,CANTO DO BURITI,3619,3464,1796,12323,10527,283,1715
PI,10464,SANTA ROSA DO PIAUI,804,1003,598,3630,3032,96,464
PI,10472,CAPITAO DE CAMPOS,1698,1654,1126,7182,6056,240,1111
PI,10480,SANTANA DO PIAUI,751,1191,371,3208,2837,40,510
PI,10499,CARACOL,1425,1708,852,5606,4754,164,1067
PI,10502,SAO BRAZ DO PIAUI,876,929,424,2824,2400,44,364
PI,10510,CASTELO DO PIAUI,2691,1529,2002,12410,10408,296,2045
PI,10529,SAO JOSE DO DIVINO,690,920,491,3620,3129,62,501
PI,10537,COCAL,3222,3923,3924,15892,11968,598,2152
PI,10545,SIGEFREDO PACHECO,1786,1363,611,5463,4852,174,627
PI,10553,CONCEICAO DO CANINDE,1180,764,540,3727,3187,122,446
PI,10561,SAO LOURENCO DO PIAUI,1468,755,635,3702,3067,70,459
PI,10570,CORRENTE,3866,3412,2298,14067,11769,154,1920
PI,10588,VARZEA BRANCA,665,747,518,3002,2484,63,422
PI,10596,CRISTALANDIA DO PIAUI,743,1971,705,4250,3545,39,501
PI,10600,BARRA D'ALCANTARA,468,807,693,2605,1912,53,364
PI,10618,CRISTINO CASTRO,1733,1268,903,5575,4672,123,865
PI,10626,BELA VISTA DO PIAUI,672,661,154,2244,2090,121,388
PI,10634,CURIMATA,1805,2344,729,6182,5453,110,513
PI,10642,BREJO DO PIAUI,510,782,345,2535,2190,83,410
PI,10650,DEMERVAL LOBAO,3111,1579,1031,8099,7068,178,992
PI,10669,BOA HORA,1091,882,591,4002,3411,144,657
PI,10677,DOM EXPEDITO LOPES,1942,1356,844,5235,4391,94,505
PI,10685,DOM INOCENCIO,1409,1914,738,5342,4604,176,859
PI,10693,ELESBAO VELOSO,3437,2407,2252,11627,9375,225,1721
PI,10707,CAPITAO GERVASIO OLIVEIRA,936,806,469,2906,2437,127,436
PI,10715,ELISEU MARTINS,972,726,430,3073,2643,60,422
PI,10723,CAMPO GRANDE DO PIAUI,739,866,335,3144,2809,85,454
PI,10731,ESPERANTINA,8853,2914,2987,21206,18219,707,2551
PI,10740,CAMPO LARGO DO PIAUI,679,1271,401,3271,2870,134,529
PI,10758,FLORES DO PIAUI,571,1380,405,3244,2839,53,453
PI,10766,CURRAIS,418,1442,442,3300,2858,57,692
PI,10774,FLORIANO,9490,6184,4672,31816,27144,672,2515
PI,10782,GEMINIANO,961,866,422,3435,3013,186,589
PI,10790,FRANCINOPOLIS,1859,710,636,4135,3499,106,512
PI,10804,GUARIBAS,272,1055,562,2530,1968,47,464
PI,10812,FRANCISCO AYRES,546,1348,607,3584,2977,91,468
PI,10820,ILHA GRANDE,2017,416,907,5365,4458,164,586
PI,10839,FRANCISCO SANTOS,2350,466,1046,5773,4727,118,745
PI,10847,JUREMA,569,1225,386,2990,2604,59,586
PI,10855,FRONTEIRAS,1789,1490,930,6775,5845,265,880
PI,10863,LAGOA DE SAO FRANCISCO,645,315,616,3839,3223,102,722
PI,10871,GILBUES,1540,1738,1059,6036,4977,132,749
PI,10880,MORRO CABECA NO TEMPO,660,1000,726,3103,2377,49,413
PI,10898,GUADALUPE,2306,1433,1099,6334,5235,89,677
PI,10901,NOVO SANTO ANTONIO,1094,410,541,3305,2764,85,380
PI,10910,HUGO NAPOLEAO,1165,726,518,3169,2651,68,363
PI,10928,NOSSA SENHORA DE NAZARE,1463,468,429,3441,3012,65,344
PI,10936,INHUMA,3592,1220,2222,10403,8181,210,1336
PI,10944,PAQUETA,1707,370,379,3261,2882,57,450
PI,10952,IPIRANGA DO PIAUI,1987,1134,672,5587,4915,161,891
PI,10960,NOVA SANTA RITA,972,837,355,2938,2583,86,468
PI,10979,ISAIAS COELHO,1725,925,653,4972,4319,129,777
PI,10987,SAO JOAO DO ARRAIAL,1131,1307,771,4116,3345,104,556
PI,10995,ITAINOPOLIS,2654,2168,916,7809,6893,410,1175
PI,11010,ITAUEIRA,2189,1275,942,7281,6339,233,1113
PI,11037,JAICOS,2688,2741,1274,9652,8378,376,1478
PI,11053,JERUMENHA,921,873,447,3320,2873,59,407
PI,11070,JOAQUIM PIRES,2317,2193,1120,7767,6647,180,1192
PI,11088,SAO JOAO DA CANABRAVA,890,686,456,3295,2839,88,396
PI,11096,JOSE DE FREITAS,6190,4950,3596,21767,18171,639,2568
PI,11118,LANDRI SALES,992,1325,581,3660,3079,54,396
PI,11134,LUIS CORREIA,4449,3696,3231,18125,14894,379,2099
PI,11150,LUZILANDIA,2802,4860,1687,14076,12389,443,2013
PI,11177,MANOEL EMIDIO,743,946,456,3271,2815,71,442
PI,11193,MARCOS PARENTE,559,1442,609,3621,3012,70,428
PI,11215,MATIAS OLIMPIO,1298,2522,1047,6356,5309,236,772
PI,11231,MIGUEL ALVES,5318,3692,2642,16033,13391,428,2453
PI,11258,MIGUEL LEAO,138,321,118,836,718,2,122
PI,11274,MONSENHOR GIL,2284,638,800,7099,6299,131,1039
PI,11290,MONSENHOR HIPOLITO,1862,528,887,5700,4813,101,911
PI,11312,MONTE ALEGRE DO PIAUI,1143,1697,1099,6235,5136,103,770
PI,11339,NAZARE DO PIAUI,1445,1262,1026,5423,4397,119,766
PI,11355,NOSSA SENHORA DOS REMEDIOS,1129,1819,651,4994,4343,216,770
PI,11371,NOVO ORIENTE DO PIAUI,1736,650,1032,4874,3842,141,609
PI,11398,OEIRAS,6593,4252,3240,22753,19513,657,2997
PI,11410,DOMINGOS MOURAO,600,273,610,2961,2351,77,445
PI,11436,PADRE MARCOS,1466,728,624,4751,4127,123,769
PI,11452,PAES LANDIM,1059,769,295,2775,2480,73,292
PI,11479,PALMEIRA DO PIAUI,862,1094,649,3586,2937,78,471
PI,11495,PALMEIRAIS,2605,1555,1252,8614,7362,213,1148
PI,11517,PARNAGUA,795,2082,845,5143,4298,92,702
PI,11533,PARNAIBA,25908,7690,16479,78668,62189,1242,4959
PI,11550,PAULISTANA,4200,2543,1839,12339,10500,289,1817
PI,11576,PEDRO II,5408,4597,4560,23879,19319,635,2975
PI,11592,PICOS,13261,6532,4858,36402,31544,978,3258
PI,11614,PIMENTEIRAS,2789,1204,814,7245,6431,109,1001
PI,11630,PIO IX,3689,869,1205,10361,9156,145,1331
PI,11657,PIRACURUCA,4821,4411,2331,16532,14201,275,1887
PI,11673,PIRIPIRI,7288,6683,5694,34669,28975,1563,4747
PI,11690,PORTO,1595,952,869,6063,5194,171,965
PI,11711,PRATA DO PIAUI,762,952,681,3103,2422,70,384
PI,11738,REDENCAO DO GURGUEIA,756,1680,777,4889,4112,68,725
PI,11754,REGENERACAO,3692,2456,1689,10757,9068,229,1611
PI,11770,RIBEIRO GONCALVES,1224,1092,563,3964,3401,44,658
PI,11797,RIO GRANDE DO PIAUI,913,771,1160,5202,4042,129,757
PI,11819,SANTA CRUZ DO PIAUI,1634,850,455,4356,3901,139,592
PI,11835,SANTA FILOMENA,641,1018,616,3303,2687,92,457
PI,11851,SANTA LUZ,563,1307,369,3099,2730,76,502
PI,11878,SANTO ANTONIO DE LISBOA,1694,445,420,3941,3521,60,449
PI,11894,SANTO INACIO DO PIAUI,623,1123,321,2667,2346,43,279
PI,11916,SAO FELIX DO PIAUI,1026,274,404,2792,2388,67,320
PI,11932,SAO FRANCISCO DO PIAUI,1458,1035,793,4579,3786,94,719
PI,11959,SAO GONCALO DO PIAUI,1224,716,376,3381,3005,57,358
PI,11975,SAO JOAO DA SERRA,1439,1177,885,5297,4412,214,778
PI,11991,SAO JOAO DO PIAUI,3272,3101,1413,10279,8866,171,1358
PI,12009,SAO JOAO DA FRONTEIRA,531,999,505,3268,2763,55,459
PI,12017,SAO JOSE DO PEIXE,616,810,443,2690,2247,62,367
PI,12025,SAO JOAO DA VARJOTA,834,1077,353,2913,2560,96,405
PI,12033,SAO JOSE DO PIAUI,1263,1054,782,4791,4009,174,653
PI,12041,SEBASTIAO BARROS,779,1191,503,3270,2767,56,456
PI,12050,SAO JULIAO,1213,991,538,4075,3537,58,544
PI,12068,SEBASTIAO LEAL,666,657,254,2557,2303,128,330
PI,12076,SAO MIGUEL DO TAPUIO,2249,4041,1601,12072,10471,541,1877
PI,12084,ALVORADA DO GURGUEIA,533,280,402,2558,2156,86,395
PI,12092,SAO PEDRO DO PIAUI,2232,2655,1319,8147,6828,141,1086
PI,12106,ASSUNCAO DO PIAUI,713,1273,949,4798,3849,290,758
PI,12114,SAO RAIMUNDO NONATO,5693,4975,2303,16426,14123,359,1716
PI,12122,BETANIA DO PIAUI,1053,595,620,3999,3379,73,687
PI,12130,SIMOES,2489,2549,1041,8446,7405,206,1430
PI,12149,BOQUEIRAO DO PIAUI,843,782,683,3535,2852,174,437
PI,12157,SIMPLICIO MENDES,2740,1703,905,7419,6514,142,926
PI,12165,CARIDADE DO PIAUI,851,765,431,2931,2500,60,468
PI,12173,SOCORRO DO PIAUI,929,1212,403,3413,3010,51,428
PI,12181,CURRAL NOVO DO PIAUI,706,644,566,2672,2106,77,462
PI,12190,TERESINA,203648,39324,69376,430830,361454,5130,19118
PI,12203,JULIO BORGES,1424,637,374,3150,2776,52,369
PI,12211,UNIAO,9987,4168,3282,24136,20854,533,3125
PI,12220,LAGOA DO SITIO,1132,649,442,3326,2884,50,549
PI,12238,URUCUI,2818,2965,1510,10218,8708,266,1481
PI,12246,MILTON BRANDAO,591,1838,730,4203,3473,52,646
PI,12254,VALENCA DO PIAUI,4027,2682,1995,13300,11305,251,1812
PI,12262,PAJEU DO PIAUI,382,865,625,2611,1986,57,377
PI,12270,VARZEA GRANDE,933,642,521,3435,2914,83,431
PI,12289,PAVUSSU,733,822,661,3118,2457,37,363
PI,12297,DIRCEU ARCOVERDE,1020,1418,639,4097,3458,122,587
PI,12300,RIACHO FRIO,926,762,411,2896,2485,45,324
PI,12319,ALAGOINHA,1660,1638,577,5082,4505,87,753
PI,12327,ACAUA,1155,1145,529,4118,3589,168,508
PI,12335,BELEM DO PIAUI,682,365,200,1947,1747,55,242
PI,12343,CAJAZEIRAS DO PIAUI,472,799,286,2214,1928,91,366
PI,12351,CAMPO ALEGRE DO FIDALGO,556,1321,545,3353,2808,81,518
PI,12360,COCAL DE TELHA,838,739,657,3317,2660,155,472
PI,12378,FRANCISCO MACEDO,335,280,208,1636,1428,47,277
PI,12386,JOAO COSTA,1050,463,251,2420,2169,43,405
PI,12394,JATOBA DO PIAUI,1163,1131,541,3869,3328,118,472
PI,12408,JOCA MARQUES,523,689,632,3211,2579,142,488
PI,12416,JUAZEIRO DO PIAUI,1220,766,604,4753,4149,117,640
PI,12424,LAGOA DO PIAUI,727,447,313,2531,2218,59,398
PI,12432,LAGOINHA DO PIAUI,631,663,312,1995,1683,18,207
PI,12440,MADEIRO,616,1754,805,4420,3615,73,571
PI,12459,MORRO DO CHAPEU DO PIAUI,1405,1088,834,4227,3393,120,495
PI,12467,MASSAPE DO PIAUI,852,1686,512,4371,3859,204,747
PI,12475,MURICI DOS PORTELAS,938,1519,571,4200,3629,122,608
PI,12483,OLHO DAGUA DO PIAUI,566,629,373,2049,1676,32,209
PI,12491,PEDRO LAURENTINO,634,410,222,1847,1625,26,251
PI,12505,SAO FRANCISCO DE ASSIS DO PIAUI,972,542,521,2930,2409,70,424
PI,12513,SUSSUAPARA,1759,632,521,4289,3768,150,598
PI,12521,TANQUE DO PIAUI,371,634,212,1719,1507,54,205
PI,12530,TAMBORIL DO PIAUI,221,385,487,2272,1785,20,327
PI,12548,VILA NOVA DO PIAUI,582,640,305,2137,1832,54,233
PI,12556,VERA MENDES,510,604,293,2248,1955,147,469
PI,12564,WALL FERRAZ,576,1436,400,3067,2667,76,452
PI,12572,CAJUEIRO DA PRAIA,1427,611,786,4489,3703,72,502
PI,12580,CURRALINHOS,917,471,289,2431,2142,35,408
PI,12599,PORTO ALEGRE DO PIAUI,243,169,198,1372,1174,9,146
PI,12602,RIBEIRA DO PIAUI,535,478,308,2686,2378,43,433
PI,12610,SAO GONCALO DO GURGUEIA,405,209,383,1655,1272,44,208
PI,12629,SAO LUIS DO PIAUI,485,199,222,1908,1686,31,262
PI,12637,FLORESTA DO PIAUI,360,938,394,2069,1675,23,232
PI,12653,SANTO ANTONIO DOS MILAGRES,760,184,199,1460,1261,25,152
PI,12661,SAO MIGUEL DA BAIXA GRANDE,484,80,315,1796,1481,31,237
PI,12670,CARAUBAS DO PIAUI,517,1314,499,3449,2950,100,565
PI,12688,CAXINGO,578,572,362,3046,2684,69,432
PI,12696,COCAL DOS ALVES,500,1145,710,3385,2675,110,488
PI,12700,SAO MIGUEL DO FIDALGO,701,467,332,2040,1708,77,298
PI,12718,PAU DARCO DO PIAUI,1080,377,558,3075,2517,93,378
PR,74004,GODOY MOREIRA,686,632,457,2686,2229,80,346
PR,74012,ABATIA,996,1932,451,4750,4299,196,342
PR,74020,IBEMA,2030,382,1223,4539,3316,73,375
PR,74039,ADRIANOPOLIS,1400,669,700,4237,3537,153,642
PR,74047,LINDOESTE,2014,491,615,3962,3347,93,332
PR,74055,AGUDOS DO SUL,1926,1218,545,5214,4669,208,452
PR,74063,OURO VERDE DO OESTE,1377,1200,441,3916,3475,87,318
PR,74071,ALMIRANTE TAMANDARE,18486,5680,2045,36895,34850,1042,2159
PR,74080,SANTA TEREZA DO OESTE,1897,715,219,3717,3498,87,287
PR,74098,ALTO PARANA,3085,1725,966,7991,7025,153,944
PR,74101,ANAHY,784,474,278,2112,1834,43,224
PR,74110,ALTO PIQUIRI,1788,1867,1155,7052,5897,188,736
PR,74128,ANGULO,456,745,405,2267,1862,62,281
PR,74136,ALVORADA DO SUL,1921,1837,1642,7183,5541,137,496
PR,74144,BOA ESPERANCA DO IGUACU,1120,404,240,2157,1917,37,155
PR,74152,AMAPORA,1152,462,856,3621,2765,75,405
PR,74160,BOM SUCESSO DO SUL,1072,643,200,2352,2152,88,113
PR,74179,AMPERE,5402,1375,725,9459,8734,172,643
PR,74187,BRASILANDIA DO SUL,656,759,599,2875,2276,61,359
PR,74195,ANDIRA,4828,4209,3415,16569,13154,471,1270
PR,74209,CAFEZAL DO SUL,737,1032,498,3251,2753,91,337
PR,74217,ANTONINA,4608,2029,2721,14208,11487,300,690
PR,74225,CANDOI,4053,1501,1796,9509,7713,280,910
PR,74233,ANTONIO OLINTO,1729,1276,304,4362,4058,201,425
PR,74241,CRUZEIRO DO IGUACU,1617,328,888,3414,2526,49,190
PR,74250,APUCARANA,22444,24357,12942,78084,65142,2050,3277
PR,74268,DIAMANTE DO SUL,922,295,429,2509,2080,51,330
PR,74276,ARAPONGAS,19779,16075,11321,64884,53563,1881,3374
PR,74284,ENTRE RIOS DO OESTE,1325,686,214,2616,2402,43,101
PR,74292,ARAPOTI,5180,4480,3297,17134,13837,484,865
PR,74306,FAROL,928,670,727,2882,2155,56,207
PR,74314,ARARUNA,2101,3425,1847,9785,7938,159,618
PR,74322,FAZENDA RIO GRANDE,18225,3751,5405,35512,30107,906,1483
PR,74330,MARILANDIA DO SUL,1565,2401,683,6225,5542,189,541
PR,74349,FLOR DA SERRA DO SUL,1803,475,492,3683,3191,73,260
PR,74357,ARAUCARIA,35816,8154,7789,65983,58194,1614,2678
PR,74365,HONORIO SERPA,2277,492,1271,4823,3552,83,254
PR,74373,ASSAI,2602,3881,1984,12310,10326,355,1094
PR,74381,IGUATU,557,485,253,1736,1483,31,198
PR,74390,ASTORGA,4502,6021,3301,18668,15367,604,1211
PR,74403,IRACEMA DO OESTE,786,597,392,2337,1945,64,232
PR,74411,ATALAIA,898,859,253,2653,2400,99,162
PR,74420,NOVO ITACOLOMI,580,728,184,2103,1919,68,233
PR,74438,BALSA NOVA,3688,1219,442,6965,6523,271,428
PR,74446,ITAPERUCU,5959,1892,2128,14260,12132,633,1074
PR,74454,BANDEIRANTES,7634,5573,2799,22264,19465,656,1559
PR,74462,IVATE,1392,1635,1236,5404,4168,102,524
PR,74470,BARBOSA FERRAZ,2389,2241,1657,9047,7390,331,974
PR,74489,LIDIANOPOLIS,1023,1027,485,3257,2772,94,331
PR,74497,BARRACAO,2242,1195,1783,6748,4965,105,446
PR,74500,MARIPA,1675,1215,768,4784,4016,82,184
PR,74519,BARRA DO JACARE,931,536,453,2491,2038,65,202
PR,74527,MATO RICO,932,1028,904,3456,2552,69,311
PR,74535,BELA VISTA DO PARAISO,2895,3543,2183,11700,9517,305,950
PR,74543,MAUA DA SERRA,1058,1728,608,4703,4095,108,437
PR,74551,BITURUNA,5015,1531,1604,10602,8998,252,815
PR,74560,MERCEDES,1473,833,280,3411,3131,50,167
PR,74578,BOA ESPERANCA,1085,1092,284,3244,2960,97,268
PR,74586,NOVA LARANJEIRAS,2881,957,1916,7318,5402,178,731
PR,74594,BOCAIUVA DO SUL,2444,1212,1133,6820,5687,278,545
PR,74608,NOVA SANTA BARBARA,752,678,346,2673,2327,109,365
PR,74616,BOM SUCESSO,1191,1500,558,4282,3724,136,407
PR,74624,PATO BRAGADO,1319,1027,264,3157,2893,35,179
PR,74632,BORRAZOPOLIS,2023,2222,772,6433,5661,196,513
PR,74640,PINHAL DE SAO BENTO,887,287,229,1696,1467,39,149
PR,74659,CAFEARA,786,526,220,1823,1603,56,81
PR,74667,PITANGUEIRAS,485,948,224,1960,1736,40,59
PR,74675,CALIFORNIA,1742,1597,1065,5933,4868,235,483
PR,74683,QUATRO PONTES,1173,727,403,3016,2613,58,118
PR,74691,CAMBARA,7851,2359,1706,15283,13577,320,1081
PR,74705,RAMILANDIA,772,546,366,2521,2155,49,327
PR,74713,CAMBE,22022,13125,8971,61674,52703,1744,3167
PR,74721,RANCHO ALEGRE D'OESTE,743,709,449,2367,1918,33,230
PR,74730,CAMBIRA,1676,1258,462,4835,4373,131,454
PR,74748,RIO BONITO DO IGUACU,3991,800,1339,7294,5955,128,541
PR,74756,CAMPINA DA LAGOA,2912,2386,1690,10369,8679,226,1133
PR,74764,SANTA LUCIA,1463,369,457,2974,2517,73,205
PR,74772,CAMPINA GRANDE DO SUL,8986,3716,4082,23452,19370,663,1468
PR,74780,CAMPO BONITO,1656,338,885,3560,2675,59,285
PR,74799,CAMPO DO TENENTE,1357,1013,240,3788,3548,152,348
PR,74802,SANTA MARIA DO OESTE,3062,1347,2627,8856,6229,174,737
PR,74810,CAMPO LARGO,28821,13081,8004,64785,56781,2315,2918
PR,74829,SANTA MONICA,853,615,381,2311,1930,41,197
PR,74837,CAMPO MOURAO,20971,8431,12507,56033,43526,1011,1971
PR,74845,SAO MANOEL DO PARANA,371,451,284,1633,1349,39,159
PR,74853,CANDIDO DE ABREU,3639,3290,3501,13590,10089,382,1195
PR,74861,SAO PEDRO DO IGUACU,2048,1062,695,5064,4369,119,469
PR,74870,CAPANEMA,6498,2118,3140,13899,10759,190,700
PR,74888,TUNAS DO PARANA,656,808,723,2973,2250,48,318
PR,74896,CAPITAO LEONIDAS MARQUES,5285,1177,2923,11460,8537,228,573
PR,74900,VENTANIA,1746,1278,832,5334,4502,229,554
PR,74918,CARLOPOLIS,2172,3178,1370,8929,7559,345,759
PR,74926,VILA ALTA,1066,375,683,2827,2144,49,269
PR,74934,CASCAVEL,69262,24545,36361,169405,133044,3006,6498
PR,74942,DOUTOR ULYSSES,633,1270,699,3904,3205,222,311
PR,74950,CASTRO,12601,11418,6530,42097,35567,1738,3157
PR,74969,VIRMOND,1271,511,483,3036,2553,75,241
PR,74977,CATANDUVAS,2365,1200,527,5557,5030,132,642
PR,74985,LARANJAL,1300,777,1259,4237,2978,108,438
PR,74993,CENTENARIO DO SUL,2712,1727,2757,9476,6719,223,620
PR,75000,ITAIPULANDIA,2873,503,473,4811,4338,56,251
PR,75019,CERRO AZUL,2701,2635,2601,11649,9048,750,902
PR,75027,NOVA ESPERANCA DO SUDOESTE,1534,810,496,3763,3267,86,307
PR,75035,CHOPINZINHO,6530,2430,2880,14543,11663,330,829
PR,75043,PINHAIS,33410,9783,10943,71888,60945,1560,2655
PR,75051,CIANORTE,14368,10559,7552,43460,35908,1245,2697
PR,75060,SAUDADE DO IGUACU,1375,584,469,2972,2503,55,225
PR,75078,CIDADE GAUCHA,3013,1525,834,6783,5949,156,576
PR,75086,ARIRANHA DO IVAI,690,553,953,2718,1765,39,247
PR,75094,CLEVELANDIA,5627,2052,3271,13585,10314,281,1000
PR,75108,ARAPUA,1033,809,1191,3806,2615,55,330
PR,75116,MANGUEIRINHA,5273,1829,2717,12629,9912,250,1175
PR,75124,BELA VISTA DA CAROBA,1363,631,865,3489,2624,56,228
PR,75132,COLOMBO,50418,13821,14696,105136,90440,2672,4282
PR,75140,BOA VENTURA DE SAO ROQUE,2197,878,911,4684,3773,112,334
PR,75159,COLORADO,5713,2961,3204,16503,13299,469,1309
PR,75167,BOM JESUS DO SUL,1203,923,1021,3632,2611,56,241
PR,75175,CONGONHINHAS,1207,2093,649,5046,4397,151,512
PR,75183,CAMPINA DO SIMAO,1131,544,149,2381,2232,92,263
PR,75191,CONSELHEIRO MAYRINCK,899,793,381,2796,2415,59,241
PR,75205,CAMPO MAGRO,4610,2158,541,9328,8787,273,604
PR,75213,CONTENDA,4230,1750,1155,9135,7980,287,465
PR,75221,CARAMBEI,3960,2269,1173,10314,9141,311,718
PR,75230,CORBELIA,4252,2830,800,10248,9448,191,631
PR,75248,CORONEL DOMINGOS SOARES,1586,621,976,4116,3140,128,355
PR,75256,CORNELIO PROCOPIO,13988,6045,6717,35354,28637,738,1456
PR,75264,CRUZMALTINA,775,809,1095,3410,2315,51,325
PR,75272,CORONEL VIVIDA,7065,3007,3781,17400,13619,475,966
PR,75280,CORUMBATAI DO SUL,864,730,712,3632,2920,129,440
PR,75299,CRUZEIRO DO OESTE,4323,2953,2290,13939,11649,344,1165
PR,75302,ESPERANCA NOVA,534,424,241,1724,1483,61,170
PR,75310,CRUZEIRO DO SUL,1593,870,658,3766,3108,59,209
PR,75329,ESPIGAO ALTO DO IGUACU,1676,611,1292,4440,3148,120,393
PR,75337,CRUZ MACHADO,4424,2463,1700,11754,10054,335,811
PR,75345,FERNANDES PINHEIRO,1862,800,701,4394,3693,106,385
PR,75353,CURITIBA,518212,214308,149782,1146460,996678,20675,35013
PR,75361,FOZ DO JORDAO,1511,576,493,3368,2875,80,250
PR,75370,CURIUVA,2577,2057,1977,9116,7139,381,891
PR,75388,GOIOXIM,1871,711,978,4519,3541,96,443
PR,75396,DIAMANTE DO NORTE,1144,774,809,4407,3598,104,440
PR,75400,DIAMANTE DO OESTE,1326,575,429,3155,2726,62,363
PR,75418,DOIS VIZINHOS,10479,3880,4452,23049,18597,469,1162
PR,75426,GUAMIRANGA,2151,1002,618,5246,4628,141,557
PR,75434,DOUTOR CAMARGO,1149,1571,564,4670,4106,114,369
PR,75442,IMBAU,1777,1189,1172,5795,4623,222,541
PR,75450,ENEAS MARQUES,1954,1106,547,4377,3830,87,210
PR,75469,MANFRINOPOLIS,1126,525,639,2743,2104,52,194
PR,75477,ENGENHEIRO BELTRAO,2498,2987,2649,11352,8703,205,646
PR,75485,MARQUINHO,1165,864,1041,4069,3028,100,490
PR,75493,FAXINAL,2681,2285,3029,11825,8796,275,1001
PR,75507,PEROBAL,1033,1346,797,4140,3343,85,313
PR,75515,FENIX,1005,877,483,3291,2808,89,276
PR,75523,PONTAL DO PARANA,3743,1706,1869,9726,7857,168,413
PR,75531,FLORAI,1231,1621,428,4104,3676,139,365
PR,75540,PORTO BARREIRO,1521,354,393,2783,2390,61,222
PR,75558,FLORESTA,1076,1502,395,3913,3518,87,252
PR,75566,PRADO FERREIRA,811,691,378,2479,2101,45,249
PR,75574,FLORESTOPOLIS,2932,1660,2298,9785,7487,181,869
PR,75582,QUARTO CENTENARIO,773,947,290,3151,2861,106,392
PR,75590,FLORIDA,840,323,197,1819,1622,54,133
PR,75604,RESERVA DO IGUACU,1896,485,995,4587,3592,69,457
PR,75612,FORMOSA DO OESTE,2049,1709,1069,6299,5230,189,497
PR,75620,RIO BRANCO DO IVAI,504,781,378,2310,1932,60,312
PR,75639,FOZ DO IGUACU,79886,16708,33806,169931,136125,1741,6917
PR,75647,SERRANOPOLIS DO IGUACU,1599,772,220,3352,3132,30,157
PR,75655,FRANCISCO BELTRAO,23596,8228,9764,50306,40542,863,1779
PR,75663,TAMARANA,1655,2022,878,6363,5485,199,525
PR,75671,GENERAL CARNEIRO,4063,1472,2045,9525,7480,267,576
PR,75698,GOIOERE,5059,5677,2746,19155,16409,589,1603
PR,75710,GUAIRA,9253,2798,5992,22829,16837,363,1152
PR,75736,GUAIRACA,921,1417,1145,4687,3542,108,394
PR,75744,ROSARIO DO IVAI,719,1695,792,4426,3634,115,646
PR,75752,GUAPIRAMA,946,1051,417,3024,2607,64,266
PR,75760,NOVA TEBAS,1930,1146,606,5443,4837,182,809
PR,75779,GUAPOREMA,554,510,190,1574,1384,41,161
PR,75787,SULINA,1293,541,784,3260,2476,61,231
PR,75795,GUARACI,760,1247,346,3266,2920,93,279
PR,75809,LUISIANIA,1599,1302,916,4921,4005,155,436
PR,75817,GUARANIACU,5247,1571,3341,13183,9842,311,1015
PR,75833,GUARAPUAVA,49026,13674,16654,101371,84717,1905,5106
PR,75850,GUARAQUECABA,1098,1199,1495,5733,4238,127,333
PR,75876,GUARATUBA,6687,3593,4037,19438,15401,394,1064
PR,75892,IBAITI,4881,4402,2645,17352,14707,536,1338
PR,75914,IBIPORA,8132,9151,5293,31698,26405,1248,2391
PR,75930,ICARAIMA,1597,2323,1978,7642,5664,162,689
PR,75957,IGUARACU,729,712,300,2583,2283,42,168
PR,75973,IMBITUVA,6479,3700,1827,16615,14788,497,1233
PR,75990,INACIO MARTINS,2380,1648,1467,7542,6075,253,696
PR,76015,INAJA,791,230,259,2093,1834,53,289
PR,76031,IPIRANGA,2278,3140,1315,9068,7753,307,729
PR,76058,IPORA,3128,2626,1933,11347,9414,332,1026
PR,76074,IRATI,17595,6301,5360,37334,31974,1006,2047
PR,76090,IRETAMA,2682,1520,1443,7772,6329,244,912
PR,76112,ITAGUAGE,1224,701,438,3148,2710,77,298
PR,76139,ITAMBARACA,1301,1597,619,4759,4140,152,401
PR,76155,ITAMBE,1308,1254,453,4026,3573,82,326
PR,76171,ITAPEJARA DO OESTE,3010,1222,542,6133,5591,131,467
PR,76198,ITAUNA DO SUL,854,479,584,2825,2241,113,341
PR,76210,IVAI,2349,2983,1319,8506,7187,202,610
PR,76236,IVAIPORA,7400,5154,8432,26865,18433,415,1486
PR,76252,IVATUBA,648,647,274,2028,1754,38,123
PR,76279,JABOTI,1070,1040,409,3218,2809,94,300
PR,76295,JACAREZINHO,10219,5745,6659,29870,23211,792,1341
PR,76317,JAGUAPITA,1983,2327,1575,8327,6752,281,750
PR,76333,JAGUARIAIVA,7077,3830,3521,20812,17291,493,1347
PR,76350,JANDAIA DO SUL,4884,3399,1192,13308,12116,412,902
PR,76376,JANIOPOLIS,1711,1622,1077,5616,4539,160,543
PR,76392,JAPIRA,1282,824,447,3290,2843,65,301
PR,76414,JAPURA,1426,2481,660,5900,5240,185,512
PR,76430,JARDIM ALEGRE,2144,1933,1286,7709,6423,212,829
PR,76457,JARDIM OLINDA,572,137,151,1130,979,25,92
PR,76473,JATAIZINHO,2254,2231,1948,8570,6622,253,679
PR,76490,JOAQUIM TAVORA,1933,2217,1870,7584,5714,226,476
PR,76511,JUNDIAI DO SUL,975,423,465,2446,1981,55,246
PR,76538,JUSSARA,1568,810,546,4357,3811,144,481
PR,76554,KALORE,872,1443,516,3671,3155,127,352
PR,76570,LAPA,14862,5530,4277,30657,26380,774,1330
PR,76597,LARANJEIRAS DO SUL,8965,2668,4960,21120,16160,300,1579
PR,76619,LEOPOLIS,949,671,175,2588,2413,58,248
PR,76635,LOANDA,4046,3228,3143,14247,11104,312,1111
PR,76651,LOBATO,1411,596,272,2873,2601,54,214
PR,76678,LONDRINA,83949,81756,49476,315555,266079,7802,13413
PR,76694,LUPIONOPOLIS,1029,721,421,3009,2588,73,306
PR,76716,MALLET,4288,1735,1409,9293,7884,282,605
PR,76732,MAMBORE,2777,2868,1406,10103,8697,271,936
PR,76759,MANDAGUACU,4176,2848,2176,12909,10733,358,892
PR,76775,MANDAGUARI,6622,5972,4143,23929,19786,627,1563
PR,76791,MANDIRITUBA,5730,2038,1945,12572,10627,457,771
PR,76813,MANOEL RIBAS,2660,2586,687,7597,6910,178,581
PR,76830,MARECHAL CANDIDO RONDON,12830,5802,1797,27152,25355,486,1424
PR,76856,MARIA HELENA,1233,1346,608,4123,3515,75,308
PR,76872,MARIALVA,6189,5538,3361,21287,17926,711,1150
PR,76899,MARILUZ,2547,1444,1149,7068,5919,177,778
PR,76910,MARINGA,62829,49527,32682,208199,175517,4108,7877
PR,76937,MARIOPOLIS,2198,961,987,5076,4089,146,309
PR,76953,MARMELEIRO,4223,1088,2163,9434,7271,195,386
PR,76970,MARUMBI,939,1137,386,3249,2863,105,279
PR,76996,MATELANDIA,3819,2445,1856,10795,8939,208,553
PR,77011,MEDIANEIRA,11356,5076,4853,27627,22774,379,1275
PR,77038,MIRADOR,542,269,224,1536,1312,49,136
PR,77054,MIRASELVA,421,705,195,1707,1512,26,146
PR,77070,MOREIRA SALLES,1927,2669,1391,8499,7108,257,1014
PR,77097,MORRETES,3634,2035,2196,11993,9797,226,662
PR,77119,MUNHOZ DE MELLO,587,738,291,2298,2007,65,229
PR,77135,NOSSA SENHORA DAS GRACAS,978,676,388,2836,2448,69,340
PR,77151,NOVA ALIANCA DO IVAI,282,285,115,1044,929,14,110
PR,77178,NOVA AMERICA DA COLINA,464,576,250,2333,2083,79,330
PR,77194,NOVA CANTU,2230,1112,2148,6712,4564,135,353
PR,77216,NOVA ESPERANCA,6214,4751,4378,20261,15883,563,1270
PR,77232,NOVA FATIMA,1297,1922,802,5343,4541,158,511
PR,77259,NOVA LONDRINA,2019,2654,2762,10259,7497,211,825
PR,77275,ORTIGUEIRA,3771,4031,6182,19159,12977,668,1867
PR,77291,OURIZONA,985,696,494,2842,2348,97,237
PR,77313,PAICANDU,7425,3888,3335,20812,17477,663,1427
PR,77330,PALMAS,8293,4124,3899,21864,17965,579,1676
PR,77356,PALMEIRA,8983,4602,2857,21611,18754,533,1017
PR,77372,PALMITAL,3651,2085,3389,12193,8804,265,1012
PR,77399,PALOTINA,7836,4286,3102,19097,15995,348,755
PR,77410,PARAISO DO NORTE,2912,1943,1386,7723,6337,206,526
PR,77437,PARANACITY,2434,1362,1510,6971,5461,189,515
PR,77453,PARANAGUA,37033,12122,10452,82772,72320,1365,2380
PR,77470,PARANAPOEMA,790,329,186,1677,1491,35,152
PR,77496,PARANAVAI,13618,15374,11628,56421,44793,1129,2369
PR,77518,PATO BRANCO,19905,6846,7825,43586,35761,746,1701
PR,77534,PAULA FREITAS,1484,926,621,4002,3381,130,380
PR,77550,PAULO FRONTIN,1857,1095,732,4770,4038,167,362
PR,77577,PEABIRU,3031,2258,2508,10269,7761,255,595
PR,77593,PEROLA D OESTE,2546,792,524,5010,4486,73,364
PR,77615,PIEN,2642,1438,224,5703,5479,251,389
PR,77631,PINHALAO,1189,1461,640,4437,3797,117,419
PR,77658,PINHAO,7825,2524,3810,18851,15041,482,1538
PR,77674,PIRAI DO SUL,5331,4200,2807,16497,13690,625,1148
PR,77690,PIRAQUARA,18784,4657,6413,39682,33269,929,1704
PR,77712,PITANGA,8264,6005,5517,24954,19437,593,1792
PR,77739,PLANALTINA DO PARANA,1164,254,334,2703,2369,67,242
PR,77755,PLANALTO,5331,1206,1091,9117,8026,150,579
PR,77771,PONTA GROSSA,64166,43054,26443,189269,162826,4412,7345
PR,77798,PORECATU,2884,2047,3661,13420,9759,248,915
PR,77810,PORTO AMAZONAS,1138,570,310,2885,2575,109,184
PR,77836,PORTO RICO,530,519,326,1974,1648,46,182
PR,77852,PORTO VITORIA,1184,487,270,2669,2399,73,161
PR,77879,PRESIDENTE CASTELO BRANCO,1252,763,461,3376,2915,78,276
PR,77895,PRIMEIRO DE MAIO,1769,2959,498,6830,6332,196,530
PR,77917,PRUDENTOPOLIS,11534,7614,6468,34988,28520,991,2863
PR,77933,QUATIGUA,1396,2211,1192,5891,4699,169,342
PR,77950,QUATRO BARRAS,4519,2220,1908,12370,10462,328,655
PR,77976,QUERENCIA DO NORTE,2889,1423,1923,7918,5995,152,769
PR,77992,QUINTA DO SOL,890,663,512,3728,3216,132,381
PR,78018,QUITANDINHA,3404,2448,523,9067,8544,513,819
PR,78034,RANCHO ALEGRE,794,962,340,3103,2763,102,221
PR,78050,REALEZA,4746,1862,854,9437,8583,208,633
PR,78077,REBOUCAS,4461,1476,1670,10336,8666,266,570
PR,78093,RENASCENCA,2265,1081,1224,5519,4295,108,269
PR,78115,RESERVA,6616,2617,3789,17598,13809,547,1495
PR,78131,RIBEIRAO CLARO,2384,3232,2161,9393,7232,303,551
PR,78158,RIBEIRAO DO PINHAL,3014,2777,3198,11160,7962,308,588
PR,78174,RIO AZUL,3959,1682,1138,9061,7923,259,622
PR,78190,RIO BOM,710,846,311,2579,2268,91,270
PR,78212,RIO BRANCO DO SUL,7680,2946,1761,18729,16968,840,1537
PR,78239,RIO NEGRO,8813,4024,2895,20399,17504,489,958
PR,78255,ROLANDIA,9519,11136,6446,37344,30898,1128,1252
PR,78271,RONCADOR,3000,2308,1217,8551,7334,168,933
PR,78298,RONDON,2376,1654,707,6014,5307,137,539
PR,78310,SABAUDIA,1471,1153,527,4366,3839,163,289
PR,78336,SALGADO FILHO,1487,700,454,3429,2975,81,285
PR,78352,SALTO DO ITARARE,985,1624,1074,4521,3447,126,265
PR,78379,SALTO DO LONTRA,3727,1919,1349,8763,7414,278,625
PR,78395,SANTA AMELIA,1129,826,435,3138,2703,169,292
PR,78417,SANTA CECILIA DO PAVAO,698,598,421,2817,2396,82,406
PR,78433,SANTA CRUZ DO MONTE CASTELO,1407,1310,724,5372,4648,161,683
PR,78450,SANTA FE,1784,2289,1395,7210,5815,277,431
PR,78476,SANTA INES,511,487,170,1529,1359,33,153
PR,78492,SANTA IZABEL DO IVAI,1606,1863,990,6258,5268,158,648
PR,78514,SANTA IZABEL DO OESTE,3214,1655,571,6749,6178,230,487
PR,78530,SANTA MARIANA,3305,1884,1264,8960,7696,263,845
PR,78557,SANTA ANA DO ITARARE,1218,1291,570,3812,3242,134,311
PR,78573,SANTO ANTONIO DO SUDOESTE,4146,2588,779,9795,9016,265,670
PR,78590,SANTO ANTONIO DA PLATINA,8280,6535,7015,30189,23174,1112,1831
PR,78611,SANTO ANTONIO DO CAIUA,772,349,257,2088,1831,47,318
PR,78638,SANTO ANTONIO DO PARAISO,551,468,243,1809,1566,63,127
PR,78654,SANTO INACIO,1418,764,475,3553,3078,44,328
PR,78670,SAO CARLOS DO IVAI,937,1516,745,4218,3473,172,350
PR,78697,SAO JERONIMO DA SERRA,1874,2020,1107,7478,6371,147,1088
PR,78719,SAO JOAO,3703,1288,927,7566,6639,164,624
PR,78735,SAO JOAO DO CAIUA,1235,794,1136,4818,3682,102,702
PR,78751,SAO JOAO DO IVAI,2477,2294,1518,9218,7700,192,945
PR,78778,SAO JOAO DO TRIUNFO,4444,1208,1121,8743,7622,333,673
PR,78794,SAO JORGE DO IVAI,1446,1553,822,4661,3839,109,272
PR,78816,SAO JORGE D OESTE,3574,977,918,6728,5810,162,535
PR,78832,SAO JOSE DA BOA VISTA,978,1947,555,4265,3710,69,255
PR,78859,SAO JOSE DOS PINHAIS,60354,21741,16335,127769,111434,3356,4753
PR,78875,SAO MATEUS DO SUL,11577,5690,3229,25827,22598,628,1675
PR,78891,SAO MIGUEL DO IGUACU,8536,3157,3473,19006,15533,318,922
PR,78913,SAO PEDRO DO IVAI,1850,1803,762,6074,5312,177,578
PR,78930,SAO PEDRO DO PARANA,493,604,251,1878,1627,49,185
PR,78956,SAO SEBASTIAO DA AMOREIRA,2007,1289,740,5710,4970,137,643
PR,78972,SAO TOME,899,1336,430,3548,3118,88,366
PR,78999,SAPOPEMA,1768,847,394,4083,3689,143,403
PR,79014,SENGES,3876,2118,2226,11893,9667,400,844
PR,79030,SERTANEJA,1258,1369,565,4472,3907,119,319
PR,79057,SERTANOPOLIS,2925,3590,1813,11422,9609,374,790
PR,79073,SIQUEIRA CAMPOS,4205,3453,2581,12291,9710,415,612
PR,79090,TAMBOARA,767,886,346,3007,2661,127,319
PR,79111,TAPEJARA,2593,2218,1120,8438,7318,261,689
PR,79138,TEIXEIRA SOARES,2114,1233,997,6072,5075,161,412
PR,79154,TELEMACO BORBA,17091,5081,7661,42185,34524,854,1559
PR,79170,TERRA BOA,2272,4277,1105,10074,8969,284,779
PR,79197,TERRA RICA,2587,2729,1304,9475,8171,191,797
PR,79219,TERRA ROXA,3423,3368,1476,11219,9743,271,1046
PR,79235,TIBAGI,3876,2578,2343,11865,9522,356,885
PR,79251,TIJUCAS DO SUL,2932,2348,1580,8626,7046,283,507
PR,79278,TOLEDO,29897,14103,11002,69750,58748,1269,2824
PR,79294,TOMAZINA,1221,2811,751,5908,5157,159,513
PR,79316,TUNEIRAS DO OESTE,1670,1136,847,5773,4926,175,486
PR,79332,UBIRATA,4242,3766,2072,14384,12312,423,1042
PR,79359,UMUARAMA,24283,14426,15970,69548,53578,1189,2997
PR,79375,UNIAO DA VITORIA,14874,6292,6428,35991,29563,651,1601
PR,79391,UNIFLOR,951,338,472,2206,1734,49,155
PR,79413,URAI,2370,2582,1129,8254,7125,255,697
PR,79430,WENCESLAU BRAZ,3242,3371,1199,11596,10397,381,1114
PR,79456,VERE,3286,1312,533,6173,5640,129,360
PR,79472,VITORINO,1838,876,782,4291,3509,88,281
PR,79499,XAMBRE,1605,1314,756,4842,4086,131,242
PR,79510,ALTONIA,3549,4019,2213,13292,11079,436,1239
PR,79537,ASSIS CHATEAUBRIAND,7988,6407,3134,22852,19718,738,1422
PR,79553,QUEDAS DO IGUACU,7600,2404,4801,18554,13753,443,1217
PR,79570,CEU AZUL,3471,1319,836,7253,6417,140,417
PR,79596,GRANDES RIOS,1076,1505,796,4823,4027,94,618
PR,79618,INDIANOPOLIS,832,924,286,2864,2578,117,372
PR,79634,MATINHOS,5925,2811,4126,17987,13861,331,797
PR,79650,NOVA AURORA,3301,1963,628,8016,7388,286,671
PR,79677,NOVA OLIMPIA,1351,999,679,3971,3292,71,399
PR,79693,PEROLA,2254,1654,1913,7835,5922,209,681
PR,79715,SANTA HELENA,7721,2627,1889,15528,13639,223,802
PR,79731,TAPIRA,1423,909,644,4155,3511,133,407
PR,79758,MARILENA,1243,1209,1305,5168,3863,125,690
PR,79774,FRANCISCO ALVES,1454,1168,927,5209,4282,198,462
PR,79790,NOVA SANTA ROSA,1346,1050,466,5101,4635,66,241
PR,79812,BOA VISTA DA APARECIDA,1624,1323,522,4821,4299,233,404
PR,79839,BRAGANEY,1631,879,503,4055,3552,122,423
PR,79855,CAFELANDIA,3144,1928,1146,7777,6631,178,496
PR,79871,TRES BARRAS DO PARANA,2912,1971,1051,7547,6496,170,725
PR,79898,VERA CRUZ DO OESTE,1773,1541,890,6296,5406,144,506
PR,79910,PRANCHITA,1947,930,436,4110,3674,74,268
PR,79936,TUPASSI,1936,1810,669,5865,5196,235,344
PR,79952,NOVA PRATA DO IGUACU,3508,1210,1333,7273,5940,108,470
PR,79979,JESUITAS,2253,1815,1109,6889,5780,225,601
PR,79995,SAO JORGE DO PATROCINIO,1365,1327,734,4621,3887,140,527
PR,84514,CANTAGALO,3599,1012,2388,9382,6994,190,736
PR,84530,TURVO,4145,1377,871,8554,7683,260,801
PR,84557,ALTAMIRA DO PARANA,744,1215,1630,4527,2897,104,450
PR,84573,FIGUEIRA,2056,1166,837,5743,4906,177,551
PR,84590,LUNARDELLI,951,1088,522,3761,3239,125,469
PR,84611,SARANDI,13420,8469,8173,46693,38520,1607,3074
PR,84638,JURANDA,1837,1217,1536,6271,4735,170,451
PR,84654,DOURADINA,1718,1231,601,4363,3762,110,311
PR,84670,SANTA TEREZINHA DE ITAIPU,5946,1972,2045,13125,11080,189,710
PR,84697,MISSAL,3857,1459,635,7211,6576,96,357
PR,84719,SAO JOSE DAS PALMEIRAS,1064,469,322,2680,2358,58,328
RJ,58009,QUISSAMA,2523,601,1729,10856,9127,220,433
RJ,58017,ANGRA DOS REIS,20415,4820,12021,82486,70465,1394,2825
RJ,58025,QUATIS,2616,567,917,7404,6487,163,492
RJ,58033,ARARUAMA,11387,4135,10315,60088,49773,997,2462
RJ,58041,BELFORD ROXO,58067,7072,34517,248385,213868,3452,9075
RJ,58050,BARRA DO PIRAI,23447,3857,7671,63947,56276,869,2175
RJ,58068,CARDOSO MOREIRA,1283,1049,2286,10817,8531,173,571
RJ,58076,BARRA MANSA,45154,7575,14086,116488,102402,1754,4561
RJ,58084,VARRE E SAI,661,1038,1077,6572,5495,155,317
RJ,58092,BOM JARDIM,5480,2811,2740,17710,14970,601,1479
RJ,58106,GUAPIMIRIM,6183,1190,4227,26378,22151,369,1244
RJ,58114,BOM JESUS DO ITABAPOANA,2771,3590,5168,28137,22969,452,1679
RJ,58122,QUEIMADOS,11901,1372,11534,75220,63686,799,2720
RJ,58130,CABO FRIO,18435,5156,12835,79547,66712,1118,2309
RJ,58149,JAPERI,6969,1023,7513,50628,43115,685,2357
RJ,58157,CACHOEIRAS DE MACACU,8390,2107,5083,32995,27912,740,1625
RJ,58165,COMENDADOR LEVY GASPARIAN,2154,268,815,6559,5744,106,271
RJ,58173,CAMBUCI,1178,630,1478,10908,9430,208,825
RJ,58181,APERIBE,996,571,1072,7150,6078,155,398
RJ,58190,CAMPOS,81003,18231,46832,283864,237032,6030,10723
RJ,58203,RIO DAS OSTRAS,5438,1784,3438,21472,18034,379,790
RJ,58211,CANTAGALO,3842,1981,1520,15209,13689,407,904
RJ,58220,AREAL,2190,1255,1063,8577,7514,169,475
RJ,58238,CARMO,3924,1266,1918,12591,10673,226,719
RJ,58246,PINHEIRAL,4422,739,1409,12190,10781,160,425
RJ,58254,CASIMIRO DE ABREU,4239,1279,3072,18331,15259,249,655
RJ,58262,IGUABA GRANDE,2669,934,2532,13598,11066,140,439
RJ,58270,CONCEICAO DE MACABU,3307,937,2521,14727,12206,294,757
RJ,58289,SAO FRANCISCO DE ITABAPOANA,2750,2238,7538,31252,23714,763,1968
RJ,58297,CORDEIRO,3996,1209,1847,13152,11305,270,652
RJ,58300,CARAPEBUS,2141,904,1330,7680,6350,213,314
RJ,58319,DUAS BARRAS,1863,1319,1448,8204,6756,192,643
RJ,58327,PORTO REAL,2863,569,841,7730,6889,155,389
RJ,58335,DUQUE DE CAXIAS,151662,19415,70652,506886,436234,7429,17927
RJ,58343,SAO JOSE DE UBA,426,717,803,5540,4737,84,427
RJ,58351,ENGENHEIRO PAULO DE FRONTIN,2915,521,1726,11664,9938,170,494
RJ,58360,TANGUA,2882,685,2306,17550,15244,242,854
RJ,58378,ITABORAI,22194,4752,14426,110843,96417,1879,4427
RJ,58386,MACUCO,2023,972,948,6080,5132,80,288
RJ,58394,ITAGUAI,13185,3393,8628,62095,53467,907,2135
RJ,58408,ARMACAO DE BUZIOS,2721,1033,2205,14394,12189,147,430
RJ,58416,ITAOCARA,2106,1617,3347,18487,15140,402,1073
RJ,58424,SEROPEDICA,8677,1683,5081,37308,32227,473,1423
RJ,58432,ITAPERUNA,12743,6131,10796,65522,54726,1267,3046
RJ,58440,ITATIAIA,7480,1746,2514,18025,15511,349,752
RJ,58459,LAJE DO MURIAE,1246,594,1064,6291,5227,196,506
RJ,58467,MESQUITA,29516,3460,13907,109577,95670,1407,3565
RJ,58475,MACAE,31972,8933,13171,85808,72637,2066,3232
RJ,58491,MAGE,32801,4727,17439,128534,111095,1809,4925
RJ,58513,MANGARATIBA,5961,1441,2031,19139,17108,265,752
RJ,58530,MARICA,11770,2567,8298,51345,43047,680,1968
RJ,58556,MENDES,4745,863,2080,14486,12406,206,661
RJ,58572,MIGUEL PEREIRA,3860,1246,1326,16395,15069,263,670
RJ,58599,MIRACEMA,4245,1976,4193,20341,16148,516,1295
RJ,58610,NATIVIDADE,1538,1014,2178,11696,9518,191,780
RJ,58637,NILOPOLIS,44486,5755,18890,144079,125189,2025,4601
RJ,58653,NITEROI,153401,30278,51661,382994,331333,4943,11831
RJ,58670,NOVA FRIBURGO,47342,13178,16346,124572,108226,3236,5625
RJ,58696,NOVA IGUACU,98012,16540,63802,453494,389692,6291,15275
RJ,58718,PARACAMBI,6375,1298,3628,29523,25895,429,1145
RJ,58734,PARAIBA DO SUL,8181,1511,4154,29006,24852,427,1221
RJ,58750,PARATI,4469,2442,3066,18426,15360,441,932
RJ,58777,PETROPOLIS,74644,24344,23595,207877,184282,3688,6161
RJ,58793,PIRAI,4875,824,2798,19219,16421,192,646
RJ,58815,PORCIUNCULA,2245,931,2635,12167,9532,210,864
RJ,58831,RESENDE,25337,6886,11974,71264,59290,1514,2866
RJ,58858,RIO BONITO,7067,3342,5074,37524,32450,544,1786
RJ,58874,RIO CLARO,2792,645,1748,12383,10635,264,729
RJ,58890,RIO DAS FLORES,1136,190,360,5093,4733,87,326
RJ,58912,SANTA MARIA MADALENA,1169,376,1999,9040,7041,133,533
RJ,58939,SANTO ANTONIO DE PADUA,5262,1851,4685,27889,23204,448,1288
RJ,58955,SAO FIDELIS,3426,2659,5644,29340,23696,515,1519
RJ,58971,SAO GONCALO,160165,22579,77563,561405,483842,8840,20940
RJ,58998,SAO JOAO DA BARRA,4936,3055,5091,24996,19905,660,1315
RJ,59013,SAO JOAO DE MERITI,91348,11118,42664,320350,277686,4676,10663
RJ,59030,SAO PEDRO DA ALDEIA,7690,1967,6772,42922,36150,547,1370
RJ,59056,SAO SEBASTIAO DO ALTO,1067,1485,753,6386,5633,175,525
RJ,59072,SAPUCAIA,3441,1230,1306,13177,11871,274,901
RJ,59099,SAQUAREMA,7882,2627,7091,40230,33139,663,1997
RJ,59110,SILVA JARDIM,1743,685,2429,13757,11328,203,814
RJ,59137,SUMIDOURO,1510,1857,1719,11302,9583,298,748
RJ,59153,TERESOPOLIS,30020,16266,13813,103286,89473,2503,4588
RJ,59170,TRAJANO DE MORAIS,1202,487,1710,8777,7067,167,717
RJ,59196,TRES RIOS,16221,2874,6588,52119,45531,809,2041
RJ,59218,VALENCA,20933,3495,6780,51666,44886,1094,2558
RJ,59234,VASSOURAS,5505,2227,3667,24604,20937,364,1114
RJ,59250,VOLTA REDONDA,91904,10077,22025,187626,165601,2077,4823
RJ,59277,ARRAIAL DO CABO,5866,1074,3258,19921,16663,294,420
RJ,59293,ITALVA,1395,842,2410,10937,8527,198,398
RJ,59315,PATI DO ALFERES,2559,730,2764,18019,15255,199,845
RJ,59331,SAO JOSE DO VALE DO RIO PRETO,1994,1801,1360,11809,10449,198,376
RJ,60011,RIO DE JANEIRO,1625333,367992,664401,4327481,3663080,66134,153131
RN,16004,TENENTE LAURENTINO CRUZ,713,832,524,3370,2846,119,504
RN,16012,ACARI,2833,1472,1429,8450,7021,236,856
RN,16020,SERRA DO MEL,1226,896,600,5243,4643,280,711
RN,16039,ASSU,10659,3424,6108,32987,26879,1291,3318
RN,16047,CAICARA DO NORTE,873,913,765,4327,3562,125,446
RN,16055,AFONSO BEZERRA,2035,1792,1390,8231,6841,309,1194
RN,16063,SAO MIGUEL DE TOUROS,1111,1028,727,4361,3634,155,658
RN,16071,AGUA NOVA,318,618,372,2031,1659,66,312
RN,16080,ITAJA,1200,879,535,4760,4225,133,642
RN,16098,ALEXANDRIA,3528,2108,2686,11041,8355,174,1296
RN,16101,BODO,471,448,297,2068,1771,54,372
RN,16110,ALMINO AFONSO,1096,1424,420,4209,3789,124,561
RN,16128,TRIUNFO POTIGUAR,450,890,346,2697,2351,61,404
RN,16136,ALTO DO RODRIGUES,2371,519,340,6158,5818,261,849
RN,16144,FERNANDO PEDROSA,506,591,299,2327,2028,86,287
RN,16152,ANGICOS,1809,1900,1573,9323,7750,212,1114
RN,16160,MAJOR SALES,391,422,509,2361,1852,20,292
RN,16179,ANTONIO MARTINS,975,1571,1219,5787,4568,174,777
RN,16187,VENHA VER,340,698,521,2631,2110,80,548
RN,16195,APODI,7344,3684,3833,23201,19368,863,2533
RN,16209,SERRINHA DOS PINTOS,438,391,754,3596,2842,56,585
RN,16217,AREIA BRANCA,6452,1999,3427,18487,15060,581,1787
RN,16225,TIBAU,807,233,275,2177,1902,84,274
RN,16233,ARES,2307,2124,1565,9033,7468,510,1019
RN,16241,SANTA MARIA,732,466,572,3235,2663,135,415
RN,16250,CAMPO GRANDE,2045,1772,1226,7269,6043,307,864
RN,16268,RIO DO FOGO,1335,1779,1868,7952,6084,307,926
RN,16276,BAIA FORMOSA,1345,619,1519,6070,4551,251,649
RN,16284,PORTO DO MANGUE,668,782,436,2862,2426,75,418
RN,16292,BARCELONA,598,946,283,3133,2850,82,440
RN,16306,JUNDIA,608,547,769,2858,2089,101,370
RN,16314,BENTO FERNANDES,1163,368,556,3906,3350,90,626
RN,16330,BOM JESUS,1268,1278,1454,6833,5379,257,875
RN,16357,BREJINHO,1269,1986,1683,7471,5788,275,1091
RN,16373,CAICARA DO RIO DO VENTO,659,297,200,2621,2421,51,456
RN,16390,CAICO,16847,4807,6247,39473,33226,1021,2504
RN,16411,CAMPO REDONDO,973,1124,830,6466,5636,203,1022
RN,16438,CANGUARETAMA,6890,1501,4360,18440,14080,853,2193
RN,16454,CARAUBAS,4285,1726,2907,15435,12528,1025,1886
RN,16470,CARNAUBA DOS DANTAS,1013,1666,662,4942,4280,134,461
RN,16497,CARNAUBAIS,2116,928,1089,6867,5778,293,802
RN,16519,CEARA MIRIM,10172,9238,8636,40184,31548,1507,4218
RN,16535,CERRO-CORA,983,2258,1527,7290,5763,194,1116
RN,16551,CORONEL EZEQUIEL,492,895,566,3642,3076,91,644
RN,16578,CORONEL JOAO PESSOA,533,508,982,3743,2761,94,602
RN,16594,CRUZETA,1793,1297,1287,6656,5369,273,777
RN,16616,CURRAIS NOVOS,8101,4905,5772,29903,24131,1024,2646
RN,16632,DOUTOR SEVERIANO,533,995,995,4911,3916,114,801
RN,16659,ENCANTO,910,249,852,3747,2895,102,542
RN,16675,EQUADOR,921,1019,813,3996,3183,125,541
RN,16691,ESPIRITO SANTO,1314,971,1034,5858,4824,178,830
RN,16713,EXTREMOZ,3819,3668,3869,16400,12531,513,1373
RN,16730,FELIPE GUERRA,1743,608,440,4980,4540,248,666
RN,16756,FLORANIA,1677,1918,1377,7663,6286,191,958
RN,16772,FRANCISCO DANTAS,469,625,238,2345,2107,44,297
RN,16799,GALINHOS,430,132,143,1497,1354,29,222
RN,16810,GOIANINHA,3521,3257,1962,13674,11712,587,1809
RN,16837,GOVERNADOR DIX-SEPT ROSADO,3023,1071,1414,8825,7411,524,1073
RN,16853,GROSSOS,1697,376,656,5848,5192,243,533
RN,16870,GUAMARE,1988,934,1890,8979,7089,172,1187
RN,16896,IELMO MARINHO,1259,1296,1304,6771,5467,284,981
RN,16918,IPANGUACU,2826,1620,1870,9481,7611,320,1136
RN,16934,IPUEIRA,566,228,151,1559,1408,24,121
RN,16950,ITAU,986,746,756,4307,3551,56,545
RN,16977,JACANA,745,1825,763,4741,3978,128,641
RN,16993,JANDAIRA,757,1107,805,4792,3987,265,613
RN,17019,JANDUIS,1581,653,890,4618,3728,171,494
RN,17035,BOA SAUDE,683,1418,1116,5649,4533,179,871
RN,17051,JAPI,657,1107,1149,5148,3999,95,747
RN,17078,JARDIM DE ANGICOS,724,425,181,2122,1941,21,344
RN,17094,JARDIM DE PIRANHAS,3367,1583,1780,9050,7270,279,924
RN,17116,JARDIM DO SERIDO,2102,2649,1507,9338,7831,310,970
RN,17132,JOAO CAMARA,6549,2252,4035,21037,17002,894,2795
RN,17159,JOAO DIAS,414,1028,251,2178,1927,35,210
RN,17175,JOSE DA PENHA,1318,919,1030,4780,3750,111,585
RN,17191,JUCURUTU,3097,2955,2310,13312,11002,348,1802
RN,17213,MESSIAS TARGINO,1413,282,260,3108,2848,99,466
RN,17230,LAGOA D ANTA,824,1227,947,4355,3408,71,693
RN,17256,LAGOA DE PEDRAS,708,1533,906,4721,3815,175,737
RN,17272,LAGOA DE VELHOS,528,631,226,2167,1941,81,279
RN,17299,LAGOA NOVA,1115,2902,1973,9595,7622,243,1271
RN,17310,LAGOA SALGADA,1054,962,709,5874,5165,329,1070
RN,17337,LAJES,2047,1955,1256,7860,6604,142,1100
RN,17353,LAJES PINTADAS,705,559,488,3555,3067,132,618
RN,17370,LUCRECIA,1015,243,307,2507,2200,43,302
RN,17396,LUIS GOMES,1493,2207,1577,7206,5629,142,1020
RN,17418,MACAIBA,8505,6897,6121,34515,28394,1467,4086
RN,17434,MACAU,7744,2328,4392,20095,15703,597,1247
RN,17450,MARCELINO VIEIRA,1687,561,1263,6368,5105,152,824
RN,17477,MARTINS,1471,642,1360,6049,4689,113,688
RN,17493,MAXARANGUAPE,1279,1812,2014,7735,5721,192,938
RN,17515,FRUTUOSO GOMES,1030,686,943,3919,2976,91,431
RN,17531,MONTANHAS,2550,702,2063,7808,5745,180,1063
RN,17558,MONTE ALEGRE,3101,2172,2485,11715,9230,397,1606
RN,17574,MONTE DAS GAMELEIRAS,571,410,371,1985,1614,35,416
RN,17590,MOSSORO,53708,10750,21512,135516,114004,3838,10271
RN,17612,NATAL,178283,46375,69111,446841,377730,9099,20922
RN,17639,NISIA FLORESTA,3163,1860,1765,11028,9263,676,1127
RN,17655,NOVA CRUZ,4656,4398,6219,24406,18187,697,3097
RN,17671,OLHO D'AGUA DO BORGES,713,802,786,3980,3194,202,615
RN,17698,OURO BRANCO,946,1111,380,3639,3259,88,387
RN,17710,PARANA,819,874,479,2978,2499,86,413
RN,17736,PARAU,574,538,520,3444,2924,130,462
RN,17752,PARAZINHO,698,407,336,2918,2582,113,440
RN,17779,PARELHAS,3575,3212,2612,14486,11874,465,1497
RN,17795,PARNAMIRIM,22790,8517,9560,63429,53869,1807,3616
RN,17817,PASSA E FICA,767,1948,1452,5954,4502,178,886
RN,17833,PASSAGEM,563,542,252,2222,1970,67,380
RN,17850,PATU,2058,2018,995,8371,7376,338,1132
RN,17876,PAU DOS FERROS,4499,2751,2965,15920,12955,448,1627
RN,17892,PEDRA GRANDE,824,699,596,3095,2499,115,345
RN,17914,PEDRA PRETA,434,881,266,2385,2119,61,341
RN,17930,PEDRO AVELINO,1435,1369,807,6013,5206,182,992
RN,17957,PEDRO VELHO,3207,959,2798,10632,7834,397,1120
RN,17973,PENDENCIAS,3095,667,1743,9148,7405,270,1085
RN,17990,PILOES,620,478,450,2625,2175,50,320
RN,18015,POCO BRANCO,2506,1574,1699,8814,7115,414,1188
RN,18031,PORTALEGRE,688,1681,919,5471,4552,111,889
RN,18058,SERRA CAIADA,906,1933,1213,5709,4496,133,869
RN,18074,PUREZA,1320,1388,682,4889,4207,144,666
RN,18090,RAFAEL FERNANDES,643,486,690,3572,2882,134,582
RN,18112,RIACHO DA CRUZ,285,415,266,2270,2004,27,361
RN,18139,RIACHO DE SANTANA,649,355,665,3169,2504,53,476
RN,18155,RIACHUELO,1073,1215,718,4490,3772,66,559
RN,18171,RODOLFO FERNANDES,503,443,258,3737,3479,46,672
RN,18198,RUY BARBOSA,405,1195,459,2906,2447,57,343
RN,18210,SAO FRANCISCO DO OESTE,526,548,560,2924,2364,150,379
RN,18236,SANTA CRUZ,5619,3446,3945,21321,17376,770,2677
RN,18252,SANTANA DO SERIDO,596,360,118,1642,1524,57,188
RN,18279,SANTANA DO MATOS,1914,1835,1899,10304,8405,436,1382
RN,18295,SANTO ANTONIO,4545,1215,3652,15118,11466,658,2096
RN,18317,SAO BENTO DO NORTE,837,461,369,2685,2316,74,402
RN,18333,SAO BENTO DO TRAIRI,391,1238,284,2783,2499,65,414
RN,18350,SAO FERNANDO,936,471,353,2826,2473,134,290
RN,18376,SAO GONCALO DO AMARANTE,13396,8080,9483,48914,39431,1886,3792
RN,18392,SAO JOAO DO SABUGI,1679,1133,509,4445,3936,80,365
RN,18414,SAO JOSE DE MIPIBU,7247,3153,4455,23045,18590,809,2756
RN,18430,SAO JOSE DE CAMPESTRE,2129,1420,1927,9020,7093,415,1307
RN,18457,SAO JOSE DO SERIDO,1178,392,275,2934,2659,164,287
RN,18473,SAO MIGUEL,2353,2409,3802,15640,11838,757,2589
RN,18490,SAO PAULO DO POTENGI,2138,2840,2029,10275,8246,509,1241
RN,18511,SAO PEDRO,1163,1043,514,4895,4381,149,751
RN,18538,SAO RAFAEL,1798,1233,1248,6749,5501,233,950
RN,18554,SAO TOME,1855,1251,1545,8137,6592,370,1256
RN,18570,SAO VICENTE,685,1485,487,4022,3535,150,572
RN,18597,SENADOR ELOI DE SOUZA,729,755,950,3887,2937,183,559
RN,18619,SENADOR GEORGINO AVELINO,732,951,331,2845,2514,73,324
RN,18635,SERRA DE SAO BENTO,974,757,720,4071,3351,96,652
RN,18651,SERRA NEGRA DO NORTE,2317,894,1403,6147,4744,99,512
RN,18678,SERRINHA,1607,473,692,5091,4399,199,789
RN,18694,SEVERIANO MELO,1383,695,1611,6268,4657,177,840
RN,18716,SITIO NOVO,618,658,741,3556,2815,136,503
RN,18732,TABOLEIRO GRANDE,267,388,137,1781,1644,21,239
RN,18759,TAIPU,2706,1371,2112,9312,7200,415,1262
RN,18775,TANGARA,1691,1478,1890,9169,7279,382,1276
RN,18791,TENENTE ANANIAS,1083,1270,1719,6924,5205,118,726
RN,18813,TIBAU DO SUL,1441,522,651,5616,4965,257,759
RN,18830,TIMBAUBA DOS BATISTAS,617,256,203,1807,1604,55,216
RN,18856,TOUROS,3721,3061,3246,16427,13181,915,2046
RN,18872,UMARIZAL,1891,1654,1798,8938,7140,321,1097
RN,18899,UPANEMA,1789,1219,942,7911,6969,271,988
RN,18910,VARZEA,760,392,1002,4274,3272,96,573
RN,18937,RAFAEL GODEIRO,574,781,295,2377,2082,71,242
RN,18953,VERA CRUZ,1177,1532,1411,7337,5926,419,1086
RN,18970,VICOSA,382,144,295,1476,1181,29,201
RN,18996,VILA FLOR,500,251,394,1959,1565,111,270
RN,30031,BARAUNA,2538,2606,3158,13623,10465,552,1795
RO,19,GUAJARA MIRIM,7050,1940,5022,22458,17436,272,1378
RO,35,PORTO VELHO,80181,22351,36811,210986,174175,2223,7574
RO,51,JI PARANA,22829,12327,16180,71869,55689,748,3075
RO,78,ARIQUEMES,13062,11482,11442,49708,38266,975,2735
RO,94,CACOAL,15299,6744,10307,47389,37082,694,2628
RO,116,PIMENTA BUENO,6622,4333,5072,22522,17450,353,1060
RO,132,VILHENA,12840,5670,8105,36758,28653,560,1639
RO,159,JARU,10714,5370,8678,37506,28828,803,2582
RO,175,OURO PRETO DO OESTE,8654,3898,6916,28093,21177,393,1799
RO,191,PRESIDENTE MEDICI,5400,2262,4822,18742,13920,431,1215
RO,213,COSTA MARQUES,1663,824,1524,6057,4533,117,455
RO,230,COLORADO DO OESTE,4703,2091,4010,15854,11844,347,917
RO,256,ESPIGAO D'OESTE,6292,2822,3404,17543,14139,406,959
RO,272,CEREJEIRAS,3379,2040,3425,13537,10112,246,756
RO,299,ROLIM DE MOURA,9514,4751,6705,30753,24048,617,1678
RO,310,ALTA FLORESTA DO OESTE,6089,3631,3754,17671,13917,341,1093
RO,337,ALVORADA DO OESTE,3025,1935,3520,13572,10052,257,827
RO,353,SANTA LUZIA DO OESTE,2626,1461,2155,8470,6315,150,526
RO,370,NOVA BRASILANDIA,3347,2440,2340,12456,10116,249,891
RO,396,MACHADINHO DO OESTE,4284,2516,2849,13873,11024,303,1508
RO,418,SAO MIGUEL DO GUAPORE,2661,1837,2035,9900,7865,236,655
RO,434,NOVA MAMORE,1744,962,1716,7483,5767,196,624
RO,450,CABIXI,1574,632,1162,5016,3854,174,343
RO,477,CANDEIAS DO JAMARI,1764,584,819,5212,4393,124,403
RO,493,ITAPUA DO OESTE,870,448,315,2797,2482,57,255
RO,515,NOVO HORIZONTE DO OESTE,2679,1074,1863,8248,6385,133,648
RO,531,CASTANHEIRAS,961,389,232,2287,2055,29,193
RO,558,VALE DO PARAISO,2091,744,1512,6323,4811,93,602
RO,566,URUPA,2737,857,2153,8897,6744,224,662
RO,574,MIRANTE DA SERRA,2254,975,2169,8823,6654,133,608
RO,582,SERINGUEIRAS,2097,710,1306,6156,4850,94,501
RO,590,THEOBROMA,2109,714,1731,6920,5189,159,614
RO,604,MINISTRO ANDREAZZA,2453,443,1532,6792,5260,64,525
RO,612,GOVERNADOR JORGE TEIXEIRA,2161,876,2016,7842,5826,178,803
RO,620,CACAULANDIA,1214,849,639,3815,3176,89,332
RO,639,ALTO PARAISO,1749,1821,1926,8301,6375,246,569
RO,647,RIO CRESPO,666,500,620,2504,1884,66,220
RO,655,CORUMBIARA,1954,666,1124,5501,4377,105,349
RO,663,MONTE NEGRO,2188,1465,1999,8011,6012,186,696
RO,671,CAMPO NOVO DE RONDONIA,1298,862,1411,5463,4052,156,510
RO,680,CUJUBIM,1173,799,910,4211,3301,124,338
RO,698,VALE DO ANARI,1214,576,997,4164,3167,55,460
RO,701,PARECIS,786,594,718,2957,2239,43,279
RO,710,SAO FELIPE D OESTE,1383,1034,1094,4833,3739,58,383
RO,728,PRIMAVERA DE RONDONIA,1077,626,697,3322,2625,55,202
RO,736,ALTO ALEGRE DOS PARECIS,2300,821,1258,6075,4817,165,345
RO,744,NOVA UNIAO,1854,349,1133,5148,4015,144,432
RO,752,TEIXEIROPOLIS,1364,679,1147,4320,3173,50,416
RO,779,BURITIS,4229,2117,3153,14064,10911,384,1086
RO,787,PIMENTEIRAS DO OESTE,458,208,338,1515,1177,15,96
RO,795,SAO FRANCISCO DO GUAPORE,1601,1316,1441,6542,5101,115,373
RO,809,CHUPINGUAIA,1043,585,882,3286,2404,38,195
RR,3000,CAROEBE,1252,606,644,4067,3423,48,417
RR,3018,BOA VISTA,48209,11543,20050,131665,111615,1144,6466
RR,3026,IRACEMA,1412,358,624,3805,3181,43,364
RR,3034,CARACARAI,2959,1040,1796,9394,7598,76,771
RR,3042,AMAJARI,1183,320,818,4165,3347,58,290
RR,3050,ALTO ALEGRE,2471,582,1201,7878,6677,90,675
RR,3069,CANTA,2589,545,1340,7525,6185,61,669
RR,3077,BONFIM,1138,590,799,4825,4026,39,439
RR,3085,RORAINOPOLIS,2740,1075,1480,8586,7106,100,818
RR,3093,MUCAJAI,2580,709,1292,7983,6691,86,582
RR,3107,UIRAMUTA,370,154,509,2290,1781,36,284
RR,3115,NORMANDIA,1027,323,615,3954,3339,39,337
RR,3123,PACARAIMA,1099,384,947,4385,3438,38,361
RR,3131,SAO JOAO DA BALIZA,1413,505,551,3759,3208,40,386
RR,3158,SAO LUIZ DO ANAUA,1510,461,647,4243,3596,46,391
RS,84735,AUREA,1350,739,451,3123,2672,100,144
RS,84743,TRES ARROIOS,1265,586,256,2618,2362,89,89
RS,84751,NOVA ROMA DO SUL,781,1207,217,2633,2416,63,176
RS,84760,PROGRESSO,1504,1567,896,4921,4025,212,270
RS,84778,PIRAPO,778,705,748,2802,2054,101,182
RS,84786,JABOTICABA,1159,691,580,3345,2765,64,283
RS,84794,SAO JORGE,678,1016,439,2461,2022,64,113
RS,84808,ALTO ALEGRE,634,435,260,1814,1554,54,80
RS,84816,NOVA HARTZ,5111,1869,1029,10504,9475,234,413
RS,84824,DOIS LAJEADOS,956,954,269,2659,2390,152,144
RS,84832,SAO DOMINGOS DO SUL,769,821,347,2552,2205,104,126
RS,84840,TUNAS,1053,1187,726,3587,2861,139,265
RS,84859,SAO JOAO DA URTIGA,1546,1139,697,4314,3617,223,293
RS,84867,GUABIJU,380,530,317,1572,1255,106,92
RS,84875,QUINZE DE NOVEMBRO,1095,1074,229,2877,2648,88,58
RS,84883,DOUTOR MAURICIO CARDOSO,2171,1467,750,5074,4324,45,206
RS,84891,CAPELA DE SANTANA,2492,1526,654,6494,5840,214,307
RS,84905,JAQUIRANA,820,1065,747,3614,2867,139,257
RS,84913,VANINI,447,538,202,1530,1328,100,101
RS,84921,BOQUEIRAO DO LEAO,1896,1574,773,5823,5050,321,413
RS,84930,FAGUNDES VARELA,644,820,212,2111,1899,114,94
RS,84948,AGUA SANTA,863,1153,278,2795,2517,71,170
RS,84956,SILVEIRA MARTINS,767,682,326,2332,2006,96,126
RS,84964,IBIRAPUITA,826,1279,532,3388,2856,151,292
RS,84972,IBARAMA,1436,751,421,3469,3048,151,228
RS,84980,PANTANO GRANDE,2766,2007,1278,8251,6973,287,652
RS,84999,IPE,1225,1716,596,4720,4124,197,345
RS,85006,TRINDADE DO SUL,1442,961,1206,4795,3589,126,339
RS,85014,AGUDO,4057,2970,1461,12328,10867,599,627
RS,85022,ERNESTINA,1113,847,336,2904,2568,59,142
RS,85030,AJURICABA,2539,1312,707,5899,5192,77,215
RS,85049,DEZESSEIS DE NOVEMBRO,725,836,757,2851,2094,71,213
RS,85057,ALECRIM,2386,1958,1215,6635,5420,131,343
RS,85065,BROCHIER,1052,1422,376,3703,3327,140,200
RS,85073,ALEGRETE,18868,14462,10497,58571,48074,1284,2149
RS,85081,EREBANGO,863,541,360,2277,1917,45,156
RS,85090,ALPESTRE,2866,1703,2025,7820,5795,213,421
RS,85103,ENTRE IJUIS,3091,1287,1254,7777,6523,245,430
RS,85111,ALVORADA,38561,27816,11486,111207,99721,3014,3700
RS,85120,NOVA ESPERANCA DO SUL,834,1136,401,3272,2871,224,263
RS,85138,ANTA GORDA,1346,1794,691,4990,4299,331,253
RS,85146,PAVERAMA,1480,1873,675,5410,4735,237,383
RS,85154,ANTONIO PRADO,3211,3328,957,9446,8489,423,616
RS,85162,TERRA DE AREIA,1250,2055,1111,6091,4980,233,310
RS,85170,ARATIBA,2460,1373,671,5607,4936,178,226
RS,85189,HARMONIA,1052,1118,221,3029,2808,110,117
RS,85197,ARROIO DO MEIO,5182,3635,1291,12921,11630,490,495
RS,85200,CAMPOS BORGES,1222,706,551,3097,2546,123,202
RS,85219,ARROIO DOS RATOS,2623,2714,1453,9542,8089,404,475
RS,85227,CERRO GRANDE,857,240,688,2543,1855,37,217
RS,85235,ARROIO DO TIGRE,3570,2674,1082,9419,8337,421,552
RS,85243,IPIRANGA DO SUL,439,856,259,1813,1554,42,97
RS,85251,ARROIO GRANDE,4386,3600,2080,14440,12360,446,787
RS,85260,LAGOAO,679,1797,930,4541,3611,233,466
RS,85278,ARVOREZINHA,2289,1986,1307,7645,6338,590,518
RS,85286,ESTACAO,1756,1570,582,4939,4357,135,267
RS,85294,AUGUSTO PESTANA,2301,1552,824,6188,5364,124,229
RS,85308,ARROIO DO SAL,1362,1057,1041,4653,3612,96,187
RS,85316,BAGE,31533,17834,10699,79785,69086,2008,2615
RS,85324,SAO JOSE DO HORTENCIO,829,963,203,2558,2355,98,96
RS,85332,BARAO DE COTEGIPE,2038,1363,566,4909,4343,128,276
RS,85340,PINHAL,643,489,339,1939,1600,40,166
RS,85359,BARRACAO,1428,1132,986,4477,3491,201,297
RS,85367,TRES CACHOEIRAS,2057,1996,975,6936,5961,202,282
RS,85375,BARRA DO RIBEIRO,2545,2652,1216,8862,7646,291,341
RS,85383,SAO VENDELINO,386,706,122,1482,1360,38,62
RS,85391,BARROS CASSAL,2437,2024,1610,8146,6536,357,659
RS,85405,PROTASIO ALVES,401,774,271,1987,1716,91,134
RS,85413,BENTO GONCALVES,26330,16996,5896,62302,56406,1764,2133
RS,85421,POUSO NOVO,605,464,503,1961,1458,64,110
RS,85430,BOA VISTA DO BURICA,2225,1235,616,4986,4370,101,138
RS,85448,EUGENIO DE CASTRO,942,662,583,2912,2329,74,197
RS,85456,BOM JESUS,2158,3333,2044,9569,7525,311,649
RS,85464,CRISTAL,1315,1493,865,5393,4528,287,314
RS,85472,BOM RETIRO DO SUL,2736,1665,936,8093,7157,393,418
RS,85480,SAO MIGUEL DAS MISSOES,2035,1178,903,5715,4812,213,406
RS,85499,BOSSOROCA,2156,1214,1136,5876,4740,294,343
RS,85502,GLORINHA,986,1690,373,4246,3873,153,231
RS,85510,BRAGA,1018,720,701,3257,2556,110,294
RS,85529,SEGREDO,1830,1595,728,5328,4600,212,389
RS,85537,BUTIA,5124,3552,2268,15165,12897,526,784
RS,85545,ALEGRIA,1416,1118,752,4264,3512,128,279
RS,85553,CACAPAVA DO SUL,8122,7969,4398,27679,23281,1365,1811
RS,85561,SALDANHA MARINHO,885,985,372,2717,2345,59,97
RS,85570,CACEQUI,4095,2228,2354,11043,8689,261,533
RS,85588,SAO JOSE DO HERVAL,545,505,464,2084,1620,76,199
RS,85596,CACHOEIRA DO SUL,24155,13957,9932,63626,53694,1785,2095
RS,85600,VISTA ALEGRE,1101,583,392,2527,2135,59,156
RS,85618,CACHOEIRINHA,29129,19008,7843,78967,71124,1924,2385
RS,85626,IVORA,737,645,290,2045,1755,68,97
RS,85634,CACIQUE DOBLE,1072,1108,709,3809,3100,152,264
RS,85642,VILA MARIA,1281,1075,439,3397,2958,129,210
RS,85650,CAIBATE,1772,835,817,4219,3402,143,168
RS,85669,TAQUARUCU DO SUL,852,799,409,2467,2058,47,126
RS,85677,CAICARA,1442,1148,674,4206,3532,87,225
RS,85685,IMBE,2974,3010,1831,10153,8322,202,301
RS,85693,CAMAQUA,12595,11406,5597,43776,38179,1486,1879
RS,85707,SEDE NOVA,906,753,491,2626,2135,44,164
RS,85715,CAMBARA DO SUL,1246,1632,1024,5143,4119,228,272
RS,85723,TUPANDI,608,1206,237,2576,2339,91,132
RS,85731,CAMPINA DAS MISSOES,2489,1106,1031,5866,4835,167,210
RS,85740,RIOZINHO,1118,1056,341,3217,2876,187,173
RS,85758,CAMPINAS DO SUL,1500,1651,584,4423,3839,79,176
RS,85766,RELVADO,335,887,523,2190,1667,80,149
RS,85774,CAMPO BOM,18508,10097,3595,40415,36820,1032,1258
RS,85782,IMIGRANTE,855,821,303,2519,2216,143,142
RS,85790,CAMPO NOVO,1730,974,1279,5251,3972,96,372
RS,85804,CIDREIRA,2031,1704,1782,7281,5499,124,217
RS,85812,CANDELARIA,6484,4500,2724,22062,19338,1211,1110
RS,85820,MONTAURI,639,334,200,1483,1283,102,69
RS,85839,CANDIDO GODOI,1793,1657,766,5935,5169,111,272
RS,85847,VISTA GAUCHA,713,787,359,2227,1868,31,150
RS,85855,CANELA,6693,7864,2257,22641,20384,937,942
RS,85863,VISTA ALEGRE DO PRATA,458,504,211,1499,1288,75,58
RS,85871,CANGUCU,7582,14946,5109,41256,36147,2363,2327
RS,85880,CASEIROS,609,862,413,2490,2077,122,163
RS,85898,CANOAS,89805,49171,20888,210646,189758,4793,6166
RS,85901,ITACURUBI,839,621,500,2740,2240,74,186
RS,85910,CARAZINHO,15282,10798,5427,40682,35255,709,1415
RS,85928,ENTRE RIOS DO SUL,1177,620,621,2861,2240,69,160
RS,85936,CARLOS BARBOSA,6553,5170,1260,15782,14522,522,583
RS,85944,CERRO GRANDE DO SUL,1715,1735,922,6532,5610,364,513
RS,85952,CASCA,2127,2067,819,6290,5471,429,297
RS,85960,CAMARGO,720,726,289,2134,1845,94,149
RS,85979,CATUIPE,2922,1887,1545,8696,7151,280,369
RS,85987,PARAISO DO SUL,1686,1463,537,5301,4764,153,231
RS,85995,CAXIAS DO SUL,94155,84254,21129,248366,227237,5727,9121
RS,86010,CERRO LARGO,4416,1654,1855,9853,7998,182,363
RS,86029,FAXINALZINHO,695,544,456,2283,1827,52,162
RS,86037,CHAPADA,2427,2567,925,7891,6966,166,323
RS,86045,AMARAL FERRADOR,1049,1142,756,4492,3736,202,355
RS,86053,CHIAPETA,1179,844,452,3291,2839,93,157
RS,86061,VILA FLORES,891,931,234,2659,2425,128,140
RS,86070,CIRIACO,1358,1060,748,4253,3505,329,226
RS,86088,CERRO BRANCO,1390,591,381,3589,3208,203,226
RS,86096,COLORADO,1065,1194,440,3371,2931,129,163
RS,86100,ANDRE DA ROCHA,281,469,199,1148,949,27,46
RS,86118,CONDOR,1815,1266,666,5149,4483,127,295
RS,86126,POCO DAS ANTAS,527,685,182,1761,1579,84,66
RS,86134,CONSTANTINA,2612,2184,1712,7871,6159,214,441
RS,86142,TRES PALMEIRAS,1415,629,849,3943,3094,120,274
RS,86150,CORONEL BICACO,2356,1308,1610,6677,5067,210,495
RS,86169,NOVA ALVORADA,652,946,237,2303,2066,126,187
RS,86177,CRISSIUMAL,4920,2050,2294,12430,10136,583,472
RS,86185,MORRO REDONDO,1055,1628,708,5145,4437,262,231
RS,86193,CRUZ ALTA,17888,11163,8031,47811,39780,1117,1707
RS,86207,SANTA MARIA DO HERVAL,1587,1695,224,4409,4185,181,207
RS,86215,CRUZEIRO DO SUL,3419,1972,914,8353,7439,305,365
RS,86223,BARAO,1045,1667,391,3911,3520,149,245
RS,86231,DAVID CANABARRO,1189,1236,514,3730,3216,231,205
RS,86240,ELDORADO DO SUL,6096,4712,2314,18629,16315,453,737
RS,86258,DOIS IRMAOS,6955,4714,1014,15289,14275,341,491
RS,86274,DOM FELICIANO,2667,2375,1499,9669,8170,629,761
RS,86282,ALTO FELIZ,539,997,212,2201,1989,107,139
RS,86290,DOM PEDRITO,9336,7176,4965,28865,23900,923,1335
RS,86304,AMETISTA DO SUL,1441,1611,917,5101,4184,146,440
RS,86312,DONA FRANCISCA,987,944,480,3164,2684,118,207
RS,86320,ARAMBARE,1129,791,574,3270,2696,76,161
RS,86339,ENCANTADO,5050,3828,1782,14388,12606,473,793
RS,86347,BARAO DO TRIUNFO,588,1591,559,4187,3628,201,364
RS,86355,ENCRUZILHADA DO SUL,4393,5247,2988,18318,15330,913,1301
RS,86363,BARRA DO GUARITA,689,743,482,2330,1848,55,163
RS,86371,ERECHIM,29845,11511,7886,62101,54215,1467,1892
RS,86380,BARRA DO RIO AZUL,891,466,264,1922,1658,56,101
RS,86398,HERVAL,1463,1376,1088,5671,4583,214,348
RS,86401,BARRA FUNDA,907,355,273,2053,1780,41,103
RS,86410,ERVAL GRANDE,1736,899,737,4451,3714,113,320
RS,86428,BOA VISTA DAS MISSOES,657,347,305,1867,1562,24,110
RS,86436,ERVAL SECO,2239,1358,1221,6520,5299,147,469
RS,86444,BOM PROGRESSO,804,494,489,2289,1800,51,127
RS,86452,ESMERALDA,400,1255,524,2798,2274,146,149
RS,86460,CAMPESTRE DA SERRA,603,925,427,2548,2121,146,133
RS,86479,ESPUMOSO,3634,3330,1588,11503,9915,364,668
RS,86487,CANDIOTA,2522,1164,787,5712,4925,140,211
RS,86495,ESTANCIA VELHA,10052,6894,2138,24152,22014,594,953
RS,86509,CAPITAO,839,566,256,2292,2036,118,128
RS,86517,ESTEIO,26833,12881,5954,58961,53007,1136,1253
RS,86525,CARLOS GOMES,786,357,298,1741,1443,44,60
RS,86533,ESTRELA,7256,5714,2310,20601,18291,571,702
RS,86541,CENTENARIO,1128,635,327,2518,2191,52,109
RS,86550,FARROUPILHA,14147,14883,3881,40350,36469,1307,1632
RS,86568,CHARRUA,784,922,335,2496,2161,44,187
RS,86576,FAXINAL DO SOTURNO,2246,1458,745,5453,4708,154,225
RS,86584,COLINAS,645,692,256,2140,1884,85,92
RS,86592,FELIZ,2418,3596,847,8712,7865,372,435
RS,86606,COQUEIROS DO SUL,878,794,270,2429,2159,78,100
RS,86614,FLORES DA CUNHA,5021,6826,1565,17283,15718,732,863
RS,86622,CORONEL BARROS,744,646,233,2202,1969,36,91
RS,86630,FONTOURA XAVIER,2199,1983,1933,8253,6320,438,697
RS,86649,COXILHA,952,796,383,2685,2302,64,152
RS,86657,FORMIGUEIRO,1652,1995,1046,6277,5231,250,512
RS,86665,DERRUBADAS,750,1084,552,2852,2300,56,204
RS,86673,FREDERICO WESTPHALEN,7393,5540,3443,20272,16829,339,1005
RS,86681,DOIS IRMAOS DAS MISSOES,666,361,445,1991,1546,44,143
RS,86690,GARIBALDI,6900,6910,1851,19581,17730,772,701
RS,86703,ENGENHO VELHO,689,379,454,1750,1296,29,91
RS,86711,GAURAMA,2239,1089,689,5325,4636,166,239
RS,86720,GARRUCHOS,743,474,636,2715,2079,96,155
RS,86738,GENERAL CAMARA,2298,1848,1210,7077,5867,231,427
RS,86746,GENTIL,477,526,241,1634,1393,106,104
RS,86754,SAO VICENTE DO SUL,1851,2014,1146,6603,5457,218,442
RS,86762,GRAMADO DOS LOUREIROS,691,525,572,2235,1663,52,164
RS,86770,GETULIO VARGAS,3356,4454,1657,12142,10485,314,605
RS,86789,GRAMADO XAVIER,878,559,426,2872,2446,91,219
RS,86797,GIRUA,4083,3112,2732,14189,11457,282,589
RS,86800,HULHA NEGRA,1735,777,617,4166,3549,94,177
RS,86819,GRAMADO,5620,8687,2230,21730,19500,746,1027
RS,86827,INHACORA,495,412,528,2110,1582,42,131
RS,86835,GRAVATAI,51624,36495,13243,140805,127562,3783,4422
RS,86843,ITAPUCA,497,478,352,1827,1475,122,135
RS,86851,GUAIBA,19707,16260,6104,61245,55141,1572,1815
RS,86860,LAJEADO DO BUGRE,714,168,439,1979,1540,50,157
RS,86878,GUAPORE,5704,4090,1663,14701,13038,670,677
RS,86886,LAGOA DOS TRES CANTOS,389,544,144,1378,1234,44,38
RS,86894,GUARANI DAS MISSOES,3364,1084,1296,7139,5843,152,265
RS,86908,LINDOLFO COLLOR,1592,665,300,3251,2951,86,137
RS,86916,HORIZONTINA,6377,3229,1973,13998,12025,205,423
RS,86924,LINHA NOVA,301,456,152,1269,1117,60,85
RS,86932,CHARQUEADAS,7837,4378,1686,19033,17347,416,659
RS,86940,MANOEL VIANA,1514,1578,989,5407,4418,174,273
RS,86959,HUMAITA,1938,1015,774,4502,3728,99,192
RS,86967,MAQUINE,1707,1830,887,5629,4742,243,315
RS,86975,IBIACA,1107,1439,534,4040,3506,174,213
RS,86983,MARATA,566,871,240,2209,1969,67,113
RS,86991,IBIRAIARAS,1722,2118,686,5480,4794,170,270
RS,87009,MARIANA PIMENTEL,620,1190,475,3120,2645,87,193
RS,87017,IBIRUBA,5363,4359,1782,14300,12518,330,399
RS,87025,MATO CASTELHANO,675,820,275,2325,2050,101,177
RS,87033,IGREJINHA,7550,4763,1856,19038,17182,597,864
RS,87041,MATO LEITAO,1286,629,275,2962,2687,117,145
RS,87050,IJUI,23916,9875,7969,54632,46663,705,1483
RS,87068,MINAS DO LEAO,1906,1443,988,6176,5188,234,368
RS,87076,ILOPOLIS,737,1066,406,3036,2630,135,194
RS,87084,MONTE BELO DO SUL,902,1176,283,2803,2520,131,139
RS,87092,INDEPENDENCIA,1965,1314,858,5557,4699,139,314
RS,87106,MORMACO,497,729,302,2148,1846,111,117
RS,87114,IRAI,2473,1676,1395,6969,5574,171,335
RS,87122,MORRINHOS DO SUL,833,934,432,2979,2547,97,140
RS,87130,ITAQUI,9082,4827,4525,25908,21383,359,829
RS,87149,MORRO REUTER,1232,1608,308,4025,3717,185,193
RS,87157,ITATIBA DO SUL,1815,1014,668,4094,3426,82,197
RS,87165,MULITERNO,455,450,225,1427,1202,76,101
RS,87173,IVOTI,4438,3330,925,11340,10415,293,383
RS,87181,NICOLAU VERGUEIRO,393,793,269,1739,1470,73,102
RS,87190,JACUTINGA,1073,882,300,2776,2476,102,154
RS,87203,NOVA BOA VISTA,731,490,146,1808,1662,43,45
RS,87211,JAGUARAO,7945,4724,3111,20994,17883,497,957
RS,87220,NOVA PADUA,500,1063,205,2157,1952,67,115
RS,87238,JAGUARI,3107,2806,1717,10149,8432,467,598
RS,87246,NOVA SANTA RITA,3893,2468,1138,10297,9159,258,400
RS,87254,JULIO DE CASTILHOS,4410,4639,2531,14842,12311,438,824
RS,87262,NOVO BARREIRO,1349,605,371,3102,2731,31,191
RS,87270,LAGOA VERMELHA,5523,6017,3104,19386,16282,776,1092
RS,87289,NOVO MACHADO,1131,1192,684,4075,3391,75,190
RS,87297,LAJEADO,17878,11850,4741,44840,40099,1394,1622
RS,87300,NOVO TIRADENTES,683,353,445,1874,1429,51,104
RS,87319,LAVRAS DO SUL,1805,2094,1239,6819,5580,236,489
RS,87327,PARECI NOVO,667,1111,216,2374,2158,61,80
RS,87335,LIBERATO SALZANO,1938,1189,1379,5310,3931,143,326
RS,87343,PASSO DO SOBRADO,1880,615,406,4387,3981,180,230
RS,87351,MACHADINHO,1430,1469,856,4618,3762,81,371
RS,87360,PICADA CAFE,1161,1313,281,3496,3215,95,144
RS,87378,MARAU,7773,6395,2288,20591,18303,781,1030
RS,87386,PINHAL GRANDE,1330,938,531,3491,2960,127,194
RS,87394,MARCELINO RAMOS,1892,1015,789,4682,3893,81,200
RS,87408,PINHEIRINHO DO VALE,928,850,553,3168,2615,96,190
RS,87416,MARIANO MORO,900,451,164,1904,1740,95,115
RS,87424,PONTAO,1426,811,374,3199,2825,48,108
RS,87432,MATA,1037,1603,809,4498,3689,267,338
RS,87440,PONTE PRETA,683,549,215,1785,1570,47,105
RS,87459,MAXIMILIANO DE ALMEIDA,1504,1042,791,4442,3651,146,314
RS,87467,PORTO MAUA,880,564,363,2298,1935,47,111
RS,87475,MIRAGUAI,1385,959,1143,4375,3232,85,283
RS,87483,PORTO VERA CRUZ,755,561,393,2076,1683,41,120
RS,87491,MONTENEGRO,13545,10475,4147,37350,33203,1152,1761
RS,87505,PRESIDENTE LUCENA,610,631,160,1799,1639,35,77
RS,87513,MOSTARDAS,1662,2823,1072,7823,6751,307,421
RS,87521,QUEVEDOS,400,914,334,2061,1727,100,155
RS,87530,MUCUM,1238,1571,581,4217,3636,196,236
RS,87548,RIO DOS INDIOS,1252,758,957,3781,2824,125,269
RS,87556,NAO ME TOQUE,4316,3472,1302,10957,9655,266,368
RS,87564,SAGRADA FAMILIA,873,169,619,2414,1795,50,123
RS,87572,NONOAI,2694,1746,2180,9338,7158,234,789
RS,87580,SALVADOR DAS MISSOES,1023,525,332,2296,1964,33,51
RS,87599,NOVA ARACA,832,1035,278,2694,2416,131,175
RS,87602,SANTA CLARA DO SUL,1399,1465,389,4207,3818,211,205
RS,87610,NOVA BASSANO,2246,1860,741,6098,5357,283,243
RS,87629,SANTA TEREZA,685,442,207,1811,1604,94,117
RS,87637,NOVA BRESCIA,600,1122,436,2710,2274,62,180
RS,87645,SANTO ANTONIO DO PALMA,779,526,247,1890,1643,74,108
RS,87653,NOVA PALMA,2143,1455,568,4934,4366,81,241
RS,87661,SANTO ANTONIO DO PLANALTO,727,628,249,1992,1743,32,81
RS,87670,NOVA PETROPOLIS,3299,5351,1363,13409,12046,473,574
RS,87688,SANTO EXPEDITO DO SUL,692,814,390,2303,1913,82,126
RS,87696,NOVA PRATA,4603,4250,1715,13735,12020,482,482
RS,87700,SAO JOAO DO POLESINE,919,688,365,2401,2036,49,109
RS,87718,NOVO HAMBURGO,61892,40967,14971,154641,139670,3194,4020
RS,87726,SAO JOSE DOS AUSENTES,470,939,566,2505,1939,69,160
RS,87734,OSORIO,9201,8306,3267,27606,24339,915,1201
RS,87742,SAO JOSE DO INHACORA,871,604,200,1950,1750,52,74
RS,87750,PAIM FILHO,1496,1002,609,3617,3008,60,220
RS,87769,SAO JOSE DAS MISSOES,1031,439,696,2994,2298,61,236
RS,87777,PALMEIRA DAS MISSOES,7362,4590,4248,23104,18856,404,1389
RS,87785,SAO MARTINHO DA SERRA,667,1007,485,2983,2498,128,150
RS,87793,PALMITINHO,2025,1515,893,5418,4525,99,358
RS,87807,SAO PEDRO DA SERRA,680,967,168,2305,2137,73,120
RS,87815,PANAMBI,9113,4656,3100,23634,20534,512,745
RS,87823,SAO PEDRO DO BUTIA,1085,519,366,2503,2137,55,81
RS,87831,PARAI,1274,1700,435,4463,4028,351,195
RS,87840,SAO VALENTIM DO SUL,828,611,259,2060,1801,90,92
RS,87858,PASSO FUNDO,50877,26646,13452,114255,100803,2118,3539
RS,87866,SAO VALERIO DO SUL,700,393,381,1792,1411,40,120
RS,87874,PEDRO OSORIO,2548,1073,1158,6652,5494,257,330
RS,87882,SENTINELA DO SUL,927,1364,653,4095,3442,170,319
RS,87890,PEJUCARA,1356,903,520,3474,2954,67,136
RS,87904,SERIO,627,737,251,2262,2011,155,147
RS,87912,PELOTAS,67945,51510,28943,226295,197352,6253,8288
RS,87920,SERTAO SANTANA,736,1412,517,3854,3337,123,185
RS,87939,PINHEIRO MACHADO,3425,2628,1593,10399,8806,449,615
RS,87947,SINIMBU,2990,750,1019,7828,6809,257,417
RS,87955,PIRATINI,3303,4377,2545,15162,12617,1008,1057
RS,87963,TIRADENTES DO SUL,2338,1308,1150,5971,4821,155,326
RS,87971,PLANALTO,2800,2137,1805,8436,6631,276,463
RS,87980,TRAVESSEIRO,811,725,296,2133,1837,41,100
RS,87998,PORTAO,6555,4671,1874,17443,15569,588,705
RS,88005,TRES FORQUILHAS,661,889,508,2932,2424,120,136
RS,88013,PORTO ALEGRE,381836,261628,117806,992387,874581,19869,24572
RS,88021,TUPANCI DO SUL,427,524,404,1671,1267,50,108
RS,88030,PORTO LUCENA,1793,1264,824,4914,4090,112,221
RS,88048,UNIAO DA SERRA,621,455,268,1715,1447,103,80
RS,88056,PORTO XAVIER,2323,2468,1852,8657,6805,239,531
RS,88064,VALE DO SOL,3112,738,713,7739,7026,339,452
RS,88072,PUTINGA,987,1238,1037,4275,3238,165,352
RS,88080,VALE REAL,929,1475,275,3262,2987,162,133
RS,88099,QUARAI,6676,2947,2714,17451,14737,436,681
RS,88102,VILA NOVA DO SUL,1104,939,720,3848,3128,160,264
RS,88110,REDENTORA,1633,1481,1346,5595,4249,120,447
RS,88129,VITORIA DAS MISSOES,1464,429,738,3608,2870,92,218
RS,88137,RESTINGA SECA,4042,3577,1870,12433,10563,369,619
RS,88145,XANGRI-LA,2015,2348,1254,7259,6005,149,225
RS,88153,RIO GRANDE,53509,28232,16505,128453,111948,3174,4248
RS,88161,BOA VISTA DO SUL,744,901,263,2400,2137,153,108
RS,88170,RIO PARDO,11609,6237,3771,28191,24420,858,1537
RS,88188,DILERMANDO DE AGUIAR,712,867,507,2723,2216,76,179
RS,88196,ROCA SALES,2707,1907,1003,7405,6402,384,362
RS,88200,CAPIVARI DO SUL,623,854,269,2311,2042,46,90
RS,88218,RODEIO BONITO,1722,1074,855,4519,3664,93,275
RS,88226,NOVA CANDELARIA,1030,598,287,2367,2080,98,58
RS,88234,ROLANTE,4111,3814,1244,12078,10834,488,648
RS,88242,FLORIANO PEIXOTO,895,555,393,2174,1781,46,98
RS,88250,RONDA ALTA,3156,1889,1286,7485,6199,143,303
RS,88269,CHUVISCA,690,1356,407,3999,3592,200,273
RS,88277,RONDINHA,2026,1552,923,5139,4216,89,193
RS,88285,ESPERANCA DO SUL,1204,763,570,3142,2572,56,114
RS,88293,ROQUE GONZALES,2067,1680,1439,6539,5100,159,369
RS,88307,DOUTOR RICARDO,534,608,253,1826,1573,91,146
RS,88315,ROSARIO DO SUL,8792,8121,5978,31413,25435,949,1526
RS,88323,HERVEIRAS,1185,132,398,2412,2014,68,192
RS,88331,SALVADOR DO SUL,1234,1983,393,4675,4282,151,200
RS,88340,CARAA,1124,2186,876,5630,4754,285,470
RS,88358,SANANDUVA,2878,4995,1514,11568,10054,411,583
RS,88366,FAZENDA VILANOVA,715,637,301,2297,1996,133,156
RS,88374,SANTA BARBARA DO SUL,2473,2033,1179,7384,6205,161,270
RS,88382,ITAARA,953,1120,534,3611,3077,100,217
RS,88390,SANTA CRUZ DO SUL,37484,10228,7746,79392,71646,2121,2409
RS,88404,ESTRELA VELHA,1005,977,361,2806,2445,114,145
RS,88412,SANTA MARIA,59328,43116,23084,171402,148318,4478,4888
RS,88420,BENJAMIN CONSTANT DO SUL,784,348,392,1854,1462,61,117
RS,88439,SANTANA DA BOA VISTA,1292,2165,1425,7550,6125,666,681
RS,88447,MACAMBARA,874,745,596,3233,2637,63,233
RS,88455,SANTANA DO LIVRAMENTO,24022,13317,10419,66087,55668,1265,1669
RS,88463,DOM PEDRO DE ALCANTARA,1064,643,311,2596,2285,51,113
RS,88471,SANTA ROSA,17944,10159,6773,44742,37969,597,1258
RS,88480,UNISTALDA,529,792,440,2605,2165,105,181
RS,88498,SANTA VITORIA DO PALMAR,9885,3575,3359,22845,19486,622,980
RS,88501,TURUCU,618,1284,265,3044,2779,77,184
RS,88510,SANTIAGO,11381,9772,5789,36476,30687,1456,1680
RS,88528,CRISTAL DO SUL,977,492,445,2403,1958,58,164
RS,88536,SANTO ANGELO,23204,8836,9956,56295,46339,1159,1914
RS,88544,MUITOS CAPOES,374,1026,377,2245,1868,106,134
RS,88552,SANTO ANTONIO DA PATRULHA,6148,10429,3339,27428,24089,1399,1857
RS,88560,NOVA RAMADA,921,508,279,2261,1982,43,132
RS,88579,SANTO ANTONIO DAS MISSOES,3323,1686,2094,9644,7550,352,471
RS,88587,JARI,566,1104,357,2723,2366,171,245
RS,88595,SANTO AUGUSTO,4311,2352,2388,11509,9121,259,607
RS,88609,UBIRETAMA,646,492,273,2137,1864,36,97
RS,88617,SANTO CRISTO,5251,3847,1422,12150,10728,174,385
RS,88625,BARRA DO QUARAI,1152,400,509,2693,2184,34,93
RS,88633,SAO BORJA,18310,8598,8866,46075,37209,999,1585
RS,88641,CERRITO,1525,1489,912,5743,4831,291,356
RS,88650,SAO FRANCISCO DE ASSIS,4118,5293,2907,16099,13192,880,926
RS,88668,VALE VERDE,793,591,305,2351,2046,103,144
RS,88676,SAO FRANCISCO DE PAULA,3880,5483,2378,15211,12833,625,886
RS,88684,NOVO CABRAIS,1066,776,259,3076,2817,86,137
RS,88692,SAO GABRIEL,12554,7764,7492,42449,34957,1299,1792
RS,88706,SETE DE SETEMBRO,843,549,293,1998,1705,29,99
RS,88714,SAO JERONIMO,4420,4144,2201,15046,12845,441,745
RS,88722,TABAI,793,1070,489,3171,2682,158,190
RS,88730,SAO JOSE DO NORTE,4154,7266,2110,18268,16158,597,981
RS,88749,VILA LANGARO,780,718,180,2030,1850,67,90
RS,88757,SAO JOSE DO OURO,1558,2096,867,5662,4795,245,330
RS,88765,SENADOR SALGADO FILHO,555,661,329,2444,2115,32,125
RS,88773,SAO LEOPOLDO,60740,26872,14901,131736,116835,2809,3642
RS,88781,VESPASIANO CORREA,403,1071,312,2170,1858,130,148
RS,88790,SAO LOURENCO DO SUL,10675,9249,4121,32810,28689,928,1322
RS,88803,MONTE ALEGRE DOS CAMPOS,607,915,709,3146,2437,170,215
RS,88811,SAO LUIS GONZAGA,9576,4970,5683,26899,21216,812,1235
RS,88820,MARQUES DE SOUZA,1349,1086,468,3699,3231,127,146
RS,88838,SAO MARCOS,3927,5142,1664,14203,12539,704,709
RS,88846,CHUI,1568,364,639,3143,2504,57,103
RS,88854,SAO MARTINHO,1987,1063,591,4763,4172,123,235
RS,88862,ARARICA,1175,777,322,2944,2622,85,110
RS,88870,SAO NICOLAU,1425,1048,1436,5201,3765,153,384
RS,88889,PASSA SETE,1277,920,544,3784,3240,187,194
RS,88897,SAO PAULO DAS MISSOES,2306,1067,991,5557,4566,131,209
RS,88900,TOROPI,609,1030,369,2701,2332,125,137
RS,88919,SAO PEDRO DO SUL,3872,4291,2434,14027,11593,686,714
RS,88927,BALNEARIO PINHAL,1460,1569,1308,5730,4422,93,264
RS,88935,SAO SEBASTIAO DO CAI,6021,5159,1652,16095,14443,429,661
RS,88943,MAMPITUBA,912,697,523,2747,2224,69,134
RS,88951,SAO SEPE,5847,5151,2878,18669,15791,793,955
RS,88978,SAO VALENTIM,1390,1055,592,3636,3044,71,201
RS,88986,ACEGUA,887,1220,513,3397,2884,48,116
RS,88994,SAPIRANGA,20268,11181,4789,47518,42729,1209,1753
RS,89001,ALMIRANTE TAMANDARE DO SUL,728,594,191,1810,1619,40,64
RS,89010,SAPUCAIA DO SUL,44936,15953,8672,88923,80251,1936,2452
RS,89028,ARROIO DO PADRE,198,882,231,2207,1976,40,61
RS,89036,SARANDI,4844,3098,2474,14370,11896,360,616
RS,89044,BOA VISTA DO CADEADO,467,621,276,1771,1495,73,73
RS,89052,SEBERI,2742,2464,1770,9076,7306,358,553
RS,89060,BOA VISTA DO INCRA,674,609,223,1839,1616,47,38
RS,89079,SELBACH,1231,1431,440,3756,3316,80,176
RS,89087,BOZANO,768,570,186,1919,1733,26,56
RS,89095,SERAFINA CORREA,3307,2344,902,8342,7440,480,436
RS,89109,CANUDOS DO VALE,519,551,238,1712,1474,69,94
RS,89117,SERTAO,1646,2061,826,5781,4955,179,328
RS,89125,CAPAO BONITO DO SUL,460,723,367,1966,1599,50,124
RS,89133,SEVERIANO DE ALMEIDA,1513,819,365,3279,2914,111,169
RS,89141,CAPAO DO CIPO,583,713,276,1965,1689,66,122
RS,89150,CAPAO DA CANOA,6172,6637,3164,21604,18440,609,848
RS,89168,COQUEIRO BAIXO,258,573,446,1585,1139,44,109
RS,89176,SOBRADINHO,3016,3475,1457,10177,8720,298,565
RS,89184,CORONEL PILAR,410,656,201,1601,1400,103,83
RS,89192,SOLEDADE,6829,5688,3305,20832,17527,817,1145
RS,89206,CRUZALTENSE,848,569,320,2062,1742,70,96
RS,89214,TAPEJARA,3516,3835,968,10432,9464,336,481
RS,89222,FORQUETINHA,531,823,278,2198,1920,109,160
RS,89230,TAPERA,2932,2063,947,7538,6591,237,377
RS,89247,SANTA CECILIA DO SUL,511,390,119,1302,1183,33,69
RS,89249,ITATI,531,913,634,2815,2181,114,222
RS,89257,TAPES,3833,3239,2007,12316,10309,388,625
RS,89265,JACUIZINHO,586,510,322,1889,1567,50,141
RS,89273,TAQUARA,10310,12008,4193,35314,31121,944,1422
RS,89281,LAGOA BONITA DO SUL,930,545,231,2151,1920,80,130
RS,89290,TAQUARI,6466,4805,2131,18759,16628,692,777
RS,89303,MATO QUEIMADO,844,327,325,1761,1436,38,83
RS,89311,TENENTE PORTELA,3487,3167,2016,10384,8368,131,632
RS,89320,NOVO XINGU,663,372,357,1628,1271,23,75
RS,89338,TORRES,7567,5681,2984,21387,18403,629,780
RS,89346,PAULO BENTO,854,341,187,1780,1593,53,92
RS,89354,TRAMANDAI,7242,6020,3901,22690,18789,510,925
RS,89362,PINHAL DA SERRA,497,527,421,1897,1476,97,140
RS,89370,TRES COROAS,5071,4046,1293,13857,12564,552,802
RS,89389,QUATRO IRMAOS,658,363,183,1447,1264,36,85
RS,89397,TRES DE MAIO,6682,5005,3089,18824,15735,387,693
RS,89400,ROLADOR,810,532,507,2520,2013,105,133
RS,89419,TRES PASSOS,7848,4674,3188,19057,15869,364,660
RS,89435,TRIUNFO,4854,5609,2634,19028,16394,772,1197
RS,89443,SANTA MARGARIDA DO SUL,728,708,482,2774,2292,88,155
RS,89451,TUCUNDUVA,1873,1528,793,5171,4378,88,217
RS,89460,SAO JOSE DO SUL,509,586,150,1660,1510,64,108
RS,89478,TUPANCIRETA,5034,4627,2241,15342,13101,511,899
RS,89486,SAO PEDRO DAS MISSOES,535,318,306,1643,1337,32,146
RS,89494,TUPARENDI,3348,1663,1075,7555,6480,272,276
RS,89508,TIO HUGO,705,568,158,1739,1581,63,81
RS,89516,URUGUAIANA,24112,22512,12542,82100,69558,1522,2425
RS,89524,WESTFALIA,802,666,191,2125,1934,90,62
RS,89532,VACARIA,10795,13301,5621,39300,33679,1720,1886
RS,89540,PINTO BANDEIRA,696,723,209,1999,1790,83,85
RS,89559,VENANCIO AIRES,20847,7331,4466,45084,40618,2129,1999
RS,89567,PEDRAS ALTAS,568,580,396,1914,1518,42,119
RS,89575,VERA CRUZ,7472,1519,1350,15335,13985,484,588
RS,89591,VERANOPOLIS,4487,5091,1622,15219,13597,867,737
RS,89613,VIADUTOS,1912,953,660,4698,4038,162,195
RS,89630,VIAMAO,46576,36093,13615,134281,120666,3855,4913
RS,89656,VICENTE DUTRA,1287,930,963,4400,3437,104,283
RS,89672,PALMARES DO SUL,2662,2415,1453,8962,7509,176,388
RS,89699,VICTOR GRAEFF,951,932,295,2617,2322,65,74
RS,89710,TAVARES,760,1625,587,4320,3733,167,246
RS,89737,CAPAO DO LEAO,5344,3081,2031,16168,14137,537,711
RS,89753,SALTO DO JACUI,3128,2106,1233,8075,6842,229,469
RS,89770,COTIPORA,1106,988,402,3421,3019,259,189
RS,98213,TEUTONIA,6491,4545,1539,16618,15079,596,659
RS,98230,BOM PRINCIPIO,2092,2815,510,6838,6328,272,267
RS,98256,PAROBE,13054,5814,2823,29058,26235,729,1224
RS,98272,FORTALEZA DOS VALOS,1672,923,430,3668,3238,85,145
RS,98299,JOIA,1911,1487,784,5675,4891,174,287
SC,80004,MONTE CARLO,2792,992,1230,6406,5176,206,527
SC,80012,ABELARDO LUZ,4916,1485,2316,11175,8859,290,769
SC,80020,IPORA DO OESTE,3240,659,1054,5932,4878,126,285
SC,80039,AGROLANDIA,1821,1466,689,5531,4842,189,366
SC,80047,LINDOIA DO SUL,2389,315,500,3768,3268,79,195
SC,80055,AGRONOMICA,1127,877,172,2827,2655,64,181
SC,80063,APIUNA,2633,1169,992,6428,5436,221,361
SC,80071,AGUA DOCE,2081,989,781,4852,4071,90,361
SC,80080,DOUTOR PEDRINHO,975,680,272,2506,2234,86,162
SC,80098,AGUAS DE CHAPECO,2164,344,857,4583,3726,170,245
SC,80101,JOSE BOITEUX,1058,751,540,3254,2714,93,254
SC,80110,AGUAS MORNAS,1136,1716,206,4165,3959,178,301
SC,80128,VITOR MEIRELES,1506,691,794,4090,3296,63,301
SC,80136,ALFREDO WAGNER,1546,2788,992,6817,5825,185,449
SC,80144,UNIAO DO OESTE,1315,396,492,2763,2271,78,168
SC,80152,ANCHIETA,2649,772,1502,5813,4311,98,309
SC,80160,URUPEMA,691,506,182,1890,1708,45,187
SC,80179,ANGELINA,1455,1426,361,4515,4154,99,380
SC,80187,IRACEMINHA,1666,478,723,3836,3113,93,231
SC,80195,ANITA GARIBALDI,1847,1906,2028,7472,5444,227,652
SC,80209,TIMBO GRANDE,1006,969,916,4238,3322,95,404
SC,80217,ANITAPOLIS,822,845,273,2490,2217,96,134
SC,80225,ABDON BATISTA,765,636,233,2159,1926,62,182
SC,80233,ANTONIO CARLOS,1795,1526,253,4707,4454,119,274
SC,80241,SANTA ROSA DO SUL,2507,914,889,5900,5011,169,343
SC,80250,ARAQUARI,4254,1718,1723,10034,8311,212,520
SC,80268,CELSO RAMOS,768,413,249,1941,1692,85,148
SC,80276,ARARANGUA,18006,5226,5570,38141,32571,695,1574
SC,80284,SERRA ALTA,1422,285,423,2491,2068,87,137
SC,80292,ARMAZEM,1950,1036,753,5172,4419,149,337
SC,80306,COCAL DO SUL,6060,868,1251,9868,8617,151,379
SC,80314,ARROIO TRINTA,1445,386,344,2788,2444,64,156
SC,80322,NOVA ITABERABA,1953,407,536,3567,3031,77,171
SC,80330,ASCURRA,2406,911,704,5308,4604,225,290
SC,80349,SANTA TEREZINHA,2845,775,831,5793,4962,143,377
SC,80357,ATALANTA,1122,618,349,2918,2569,61,152
SC,80365,MIRIM DOCE,918,369,217,2013,1796,28,167
SC,80373,AURORA,1815,789,518,4130,3612,107,196
SC,80381,CERRO NEGRO,793,639,938,3274,2336,128,274
SC,80390,BALNEARIO DE CAMBORIU,19951,11953,9485,55206,45721,981,1695
SC,80403,PASSO DE TORRES,1229,801,562,3558,2996,75,212
SC,80411,BARRA VELHA,2813,2216,2171,10634,8463,291,681
SC,80420,BRACO DO TROMBUDO,575,1119,351,2616,2265,56,189
SC,80438,BENEDITO NOVO,2680,2004,625,7038,6413,203,409
SC,80446,SUL BRASIL,1294,103,407,2388,1981,29,162
SC,80454,BIGUACU,11528,6538,3261,28892,25631,977,1695
SC,80462,VARGEM,613,819,643,2760,2117,76,247
SC,80470,BLUMENAU,67709,48959,19661,184132,164471,3859,6842
SC,80489,ARABUTA,1947,461,295,3261,2966,68,145
SC,80497,BOM RETIRO,1769,1863,1061,6191,5130,191,542
SC,80500,AGUAS FRIAS,1308,221,334,2180,1846,33,83
SC,80519,BOTUVERA,1626,520,153,2876,2723,148,199
SC,80527,GUATAMBU,1818,643,485,3774,3289,64,322
SC,80535,BRACO DO NORTE,7626,4462,1729,17341,15612,491,935
SC,80543,PLANALTO ALEGRE,1098,205,152,1881,1729,37,106
SC,80551,BRUSQUE,27731,9480,5103,54864,49761,871,1575
SC,80560,RIQUEZA,2134,348,775,3978,3203,69,280
SC,80578,CACADOR,22775,5475,6490,43463,36973,978,2227
SC,80586,LAGEADO GRANDE,758,158,114,1275,1161,17,110
SC,80594,CAIBI,2596,488,991,5050,4059,69,363
SC,80608,RIO RUFINO,580,509,314,1913,1599,56,177
SC,80616,CAMBORIU,8716,3668,3771,24509,20738,517,1237
SC,80624,PASSOS MAIA,1282,558,586,2902,2316,63,199
SC,80632,CAMPO ALEGRE,2483,2945,883,8209,7326,196,533
SC,80640,SAO JOAO DO OESTE,2917,417,753,4793,4040,60,167
SC,80659,CAMPO BELO DO SUL,1838,1302,1574,6358,4784,182,633
SC,80667,CALMON,775,173,330,2244,1914,19,220
SC,80675,CAMPO ERE,2973,894,2284,7920,5636,162,609
SC,80683,BALNEARIO DE BARRA DO SUL,1565,831,821,4607,3786,80,239
SC,80691,CAMPOS NOVOS,8045,4474,3691,21056,17365,770,1424
SC,80705,PARAISO,1731,536,749,3678,2929,66,205
SC,80713,CANELINHA,2432,1301,970,6477,5507,240,475
SC,80721,SANTA HELENA,1080,161,233,1887,1654,42,132
SC,80730,CANOINHAS,15250,7468,5580,36334,30754,713,1993
SC,80748,BELMONTE,1088,221,240,1941,1701,23,178
SC,80756,CAPINZAL,6904,1957,1899,13991,12092,362,949
SC,80764,NOVO HORIZONTE,1039,465,412,2439,2027,65,146
SC,80772,CATANDUVAS,2480,1083,745,5623,4878,125,437
SC,80780,SAO MIGUEL DA BOA VISTA,630,219,239,1449,1210,52,98
SC,80799,CAXAMBU DO SUL,2086,594,727,4418,3691,101,301
SC,80802,ARVOREDO,1092,159,139,1835,1696,26,129
SC,80810,CHAPECO,40957,16505,13188,94702,81514,1424,3557
SC,80829,IPUACU,1617,275,588,3533,2945,52,344
SC,80837,CONCORDIA,25317,7188,6236,46136,39900,780,1596
SC,80845,OURO VERDE,819,426,330,1950,1620,53,161
SC,80853,CORONEL FREITAS,3658,1462,977,7647,6670,224,455
SC,80861,IRATI,798,208,420,1917,1497,35,117
SC,80870,CORUPA,4587,2304,1058,9449,8391,192,496
SC,80888,FORMOSA DO SUL,1096,195,361,2098,1737,30,127
SC,80896,CRICIUMA,63273,11475,14576,118611,104035,1751,3956
SC,80900,MACIEIRA,737,153,138,1410,1272,45,102
SC,80918,CUNHA PORA,2864,1663,1349,8266,6917,179,501
SC,80926,PONTE ALTA DO NORTE,807,411,366,2022,1656,26,197
SC,80934,CURITIBANOS,10475,5037,5179,27020,21841,676,1932
SC,80942,SAO CRISTOVAO DO SUL,1104,448,599,2924,2325,68,246
SC,80950,DESCANSO,3833,885,1493,7441,5948,154,344
SC,80969,VARGEM BONITA,1710,454,311,3212,2901,55,200
SC,80977,DIONISIO CERQUEIRA,3746,1535,3555,11638,8083,174,844
SC,80985,BOMBINHAS,1838,1670,1204,6578,5374,145,272
SC,80993,DONA EMMA,1072,532,440,2641,2201,59,160
SC,81000,SANGAO,1845,1081,726,5082,4356,167,357
SC,81019,ERVAL VELHO,1184,907,302,3159,2857,79,259
SC,81027,CAPIVARI DE BAIXO,8648,1098,1770,13909,12139,177,633
SC,81035,FAXINAL DOS GUEDES,3602,1037,1025,6992,5967,118,391
SC,81043,CORDILHEIRA ALTA,1336,431,108,2215,2107,47,132
SC,81051,FLORIANOPOLIS,126343,45671,31503,256004,224501,4368,9108
SC,81060,FORQUILHINHA,7973,1051,1157,12786,11629,211,592
SC,81078,FRAIBURGO,11950,2366,4040,22822,18782,484,1343
SC,81086,MORRO GRANDE,1146,338,126,2159,2033,45,135
SC,81094,GALVAO,1525,368,670,3142,2472,73,191
SC,81108,CORONEL MARTINS,776,348,388,1982,1594,35,138
SC,81116,GOVERNADOR CELSO RAMOS,2338,2249,1608,9330,7722,226,582
SC,81124,SAO JOAO DO ITAPERIU,842,671,506,2653,2147,62,182
SC,81132,GAROPABA,3879,2742,1561,10191,8630,307,620
SC,81140,JARDINOPOLIS,902,167,261,1659,1398,26,112
SC,81159,GARUVA,2974,1648,1426,8118,6692,158,470
SC,81167,ERMO,1131,251,297,2392,2095,51,172
SC,81175,GASPAR,11850,7966,3258,31256,27998,764,1300
SC,81183,SAO PEDRO DE ALCANTARA,1287,975,324,3369,3045,106,234
SC,81191,GRAO PARA,1992,1005,429,4785,4356,137,381
SC,81205,SANTIAGO DO SUL,688,173,329,1391,1062,33,70
SC,81213,GRAVATAL,2785,1445,511,6337,5826,161,419
SC,81221,BELA VISTA DO TOLDO,1591,1042,557,4084,3527,96,296
SC,81230,GUABIRUBA,4989,1603,686,9127,8441,289,457
SC,81248,CAPAO ALTO,751,630,494,2783,2289,51,180
SC,81256,GUARACIABA,3930,1309,790,7590,6800,183,347
SC,81264,PAINEL,697,591,398,2330,1932,40,177
SC,81272,GUARAMIRIM,8856,2817,1959,17129,15170,322,654
SC,81280,BOCAINA DO SUL,727,688,467,2811,2344,50,270
SC,81299,GUARUJA DO SUL,1546,621,770,3699,2929,92,173
SC,81302,ALTO BELA VISTA,1113,132,235,1793,1558,20,76
SC,81310,HERVAL DO OESTE,6705,2639,1928,13858,11930,310,741
SC,81329,FREI ROGERIO,918,349,350,2077,1727,35,134
SC,81337,IBICARE,1383,467,271,2761,2490,95,181
SC,81345,TREVISO,1722,264,238,2750,2512,32,144
SC,81353,IBIRAMA,4228,2948,1615,11578,9963,314,694
SC,81361,IOMERE,979,555,259,2175,1916,58,110
SC,81370,ICARA,18690,2958,3997,33102,29105,652,1413
SC,81388,BOM JESUS,995,163,344,1887,1543,37,140
SC,81396,ILHOTA,3078,1646,1106,8272,7166,226,533
SC,81400,IBIAM,879,283,237,1693,1456,32,97
SC,81418,IMARUI,3851,1895,1739,10016,8277,264,916
SC,81426,ENTRE RIOS,735,155,447,2101,1654,62,192
SC,81434,IMBITUBA,13863,2702,4022,26266,22244,503,1476
SC,81442,PAIAL,829,221,324,1761,1437,29,70
SC,81450,IMBUIA,1198,1518,446,4050,3604,108,261
SC,81469,BOM JESUS DO OESTE,819,195,234,1624,1390,36,120
SC,81477,INDAIAL,10993,7344,3235,29074,25839,877,1495
SC,81485,SAO BERNARDINO,1143,177,396,2155,1759,43,138
SC,81493,IPIRA,1875,441,481,3535,3054,104,196
SC,81507,SANTA TEREZINHA DO PROGRESSO,1063,325,789,2799,2010,63,185
SC,81515,IPUMIRIM,2724,839,640,5336,4696,133,275
SC,81523,SALTINHO,1526,207,734,3133,2399,90,224
SC,81531,IRANI,3065,632,859,5813,4954,128,364
SC,81540,JUPIA,858,260,308,1758,1450,30,131
SC,81558,IRINEOPOLIS,2994,1074,1103,6833,5730,118,473
SC,81566,PALMEIRA,811,303,391,2252,1861,47,168
SC,81574,ITA,2594,629,882,4735,3853,74,172
SC,81582,BANDEIRANTE,1480,333,652,2862,2210,40,136
SC,81590,ITAIOPOLIS,5411,2919,2107,13679,11572,423,951
SC,81604,FLOR DO SERTAO,614,229,336,1442,1106,41,114
SC,81612,ITAJAI,42733,17679,14152,101330,87178,2251,3872
SC,81620,CUNHATAI,659,309,177,1501,1324,36,66
SC,81639,ITAPEMA,6093,4271,2724,18224,15500,400,774
SC,81647,PRINCESA,1013,325,370,2038,1668,63,107
SC,81655,ITAPIRANGA,6119,1230,1890,10782,8892,108,431
SC,81663,ITAPOA,2366,1311,1526,6698,5172,119,362
SC,81671,ITUPORANGA,6328,3337,1954,15222,13268,313,841
SC,81680,TIGRINHOS,826,148,318,1654,1336,40,116
SC,81698,JABORA,1644,672,481,3493,3012,92,238
SC,81701,CHAPADAO DO LAGEADO,857,490,289,2197,1908,47,132
SC,81710,JACINTO MACHADO,3455,940,708,7586,6878,247,603
SC,81728,BALNEARIO ARROIO DO SILVA,2320,513,938,4893,3955,62,297
SC,81736,JAGUARUNA,4365,2067,1511,10593,9082,255,635
SC,81744,BALNEARIO GAIVOTA,1981,496,724,4425,3701,83,258
SC,81752,JARAGUA DO SUL,42691,13735,7674,77326,69652,1195,2319
SC,81760,BARRA BONITA,1014,234,428,2062,1634,42,127
SC,81779,JOACABA,8105,3949,2654,18157,15503,334,817
SC,81787,BRUNOPOLIS,916,386,537,2577,2040,75,296
SC,81795,JOINVILLE,140160,54666,31523,290439,258916,3772,9347
SC,81809,LUZERNA,2138,994,483,4470,3987,65,187
SC,81817,LACERDOPOLIS,807,365,119,1626,1507,41,136
SC,81825,ZORTEA,1123,297,243,2013,1770,55,124
SC,81833,LAGES,37394,22210,16713,104391,87678,1970,4207
SC,81850,LAGUNA,15952,6170,3331,32840,29509,798,1553
SC,81876,LAURENTINO,1487,1010,223,3650,3427,139,252
SC,81892,LAURO MULLER,6116,1172,1305,10671,9366,236,599
SC,81914,LEBON REGIS,3400,982,1557,8054,6497,226,739
SC,81930,LEOBERTO LEAL,926,908,449,3093,2644,64,247
SC,81957,LONTRAS,2412,1584,963,6452,5489,197,429
SC,81973,LUIZ ALVES,2517,1688,595,5954,5359,157,316
SC,81990,MAFRA,16846,7272,4736,36748,32012,1002,1803
SC,82015,MAJOR GERCINO,819,590,291,2361,2070,105,165
SC,82031,MAJOR VIEIRA,2807,731,730,5219,4489,143,325
SC,82058,MARAVILHA,6784,2243,2831,14912,12081,322,707
SC,82066,MAREMA,1150,235,318,2089,1771,60,132
SC,82074,MASSARANDUBA,4481,1937,1092,9862,8770,247,443
SC,82090,MATOS COSTA,808,312,507,2355,1848,37,168
SC,82112,MELEIRO,2556,734,377,4956,4579,142,267
SC,82139,MODELO,1588,339,435,2950,2515,63,185
SC,82155,MONDAI,3588,871,1148,6825,5677,129,377
SC,82171,MONTE CASTELO,2113,1200,1430,6431,5001,155,454
SC,82198,MORRO DA FUMACA,5676,1163,1067,10446,9379,240,510
SC,82210,NAVEGANTES,9584,5610,4320,25727,21407,494,1174
SC,82236,NOVA ERECHIM,1451,354,306,2706,2400,38,143
SC,82252,NOVA TRENTO,3073,1742,925,7821,6896,413,391
SC,82279,NOVA VENEZA,4767,1086,637,8095,7458,218,382
SC,82295,ORLEANS,6379,3281,1681,14790,13109,511,846
SC,82317,OURO,2578,1153,648,5535,4887,127,389
SC,82333,PALHOCA,28254,12558,5988,60539,54551,1689,2932
SC,82350,PALMA SOLA,2689,609,1620,6118,4498,108,456
SC,82376,PALMITOS,5436,2144,2376,12293,9917,237,648
SC,82392,PAPANDUVA,5801,1596,2025,12196,10171,286,840
SC,82414,PAULO LOPES,1446,1045,452,4234,3782,141,315
SC,82430,PEDRAS GRANDES,1818,453,313,3396,3083,102,254
SC,82457,PENHA,3334,3065,2484,12066,9582,274,615
SC,82473,PERITIBA,1518,346,232,2535,2303,48,134
SC,82490,PETROLANDIA,1764,1030,642,5013,4371,105,320
SC,82511,PICARRAS,2881,2045,1655,8594,6939,154,448
SC,82538,PINHALZINHO,4930,1289,1267,9278,8011,164,428
SC,82554,PINHEIRO PRETO,1088,351,271,2096,1825,39,152
SC,82570,PIRATUBA,1627,678,384,3558,3174,99,274
SC,82597,POMERODE,7407,4091,1568,17049,15481,488,794
SC,82619,PONTE ALTA,1420,529,828,4043,3215,66,360
SC,82635,PONTE SERRADA,3357,1013,1608,7783,6175,166,517
SC,82651,PORTO BELO,2229,1726,1213,7246,6033,195,441
SC,82678,PORTO UNIAO,9484,3953,4241,22549,18308,439,1027
SC,82694,POUSO REDONDO,3208,2233,1505,8833,7328,267,577
SC,82716,PRAIA GRANDE,2598,811,939,5802,4863,126,480
SC,82732,PRESIDENTE CASTELO BRANCO,1005,178,120,1556,1436,29,96
SC,82759,PRESIDENTE GETULIO,4101,1991,1097,9154,8057,253,434
SC,82775,PRESIDENTE NEREU,649,504,170,1745,1575,38,149
SC,82791,QUILOMBO,3885,1000,1335,7935,6600,170,365
SC,82813,RANCHO QUEIMADO,747,608,183,2069,1886,82,164
SC,82830,RIO DAS ANTAS,2318,763,694,4958,4264,128,393
SC,82856,RIO DO CAMPO,1859,1225,850,5145,4295,104,270
SC,82872,RIO DO OESTE,2330,1202,599,5130,4531,136,260
SC,82899,RIO DOS CEDROS,3127,1780,864,7341,6477,155,491
SC,82910,RIO DO SUL,13301,10550,5090,37904,32814,813,1848
SC,82937,RIO FORTUNA,1413,762,182,3439,3257,97,214
SC,82953,RIO NEGRINHO,11348,5381,3059,25702,22643,446,1333
SC,82970,RODEIO,3563,2012,902,8074,7172,296,489
SC,82996,ROMELANDIA,1836,496,1701,5447,3746,90,324
SC,83011,SALETE,2048,1246,843,5381,4538,126,307
SC,83038,SALTO VELOSO,1302,445,351,2922,2571,54,225
SC,83054,SANTA CECILIA,3870,1822,2056,10451,8395,374,802
SC,83070,SANTA ROSA DE LIMA,625,313,83,1555,1472,37,95
SC,83097,SANTO AMARO DA IMPERATRIZ,4684,3569,1009,11975,10966,329,814
SC,83119,SAO BENTO DO SUL,24225,9241,4382,46170,41788,600,1709
SC,83135,SAO BONIFACIO,518,1157,208,2451,2243,133,152
SC,83151,SAO CARLOS,3404,995,1128,7209,6081,179,337
SC,83178,SAO DOMINGOS,3423,1023,1338,7370,6032,222,503
SC,83194,SAO FRANCISCO DO SUL,9544,4521,3877,23928,20051,404,1119
SC,83216,SAO JOAO BATISTA,4529,2486,1354,11472,10118,537,673
SC,83232,SAO JOAO DO SUL,2387,873,777,5538,4761,103,426
SC,83259,SAO JOAQUIM,6771,4258,2667,17371,14704,526,1181
SC,83275,SAO JOSE,56139,21070,12163,115079,102916,2610,4704
SC,83291,SAO JOSE DO CEDRO,5062,1438,2246,10658,8412,177,561
SC,83313,SAO JOSE DO CERRITO,2151,1859,2146,7733,5587,193,444
SC,83330,SAO LOURENCO DO OESTE,5680,3113,2970,14900,11930,442,812
SC,83356,SAO LUDGERO,3074,1204,644,6194,5550,197,308
SC,83372,SAO MARTINHO,827,903,207,2699,2492,132,163
SC,83399,SAO MIGUEL DO OESTE,11523,2960,4496,23111,18615,346,866
SC,83410,SAUDADES,3029,1292,700,6138,5438,116,249
SC,83437,SCHROEDER,5205,1161,802,8548,7746,144,291
SC,83453,SEARA,6297,2236,1512,12031,10519,207,512
SC,83470,SIDEROPOLIS,5671,880,1167,9236,8069,137,403
SC,83496,SOMBRIO,7844,1968,2268,16005,13737,317,885
SC,83518,TAIO,4338,2434,1852,12523,10671,315,840
SC,83534,TANGARA,2471,1656,448,5847,5399,166,469
SC,83550,TIJUCAS,7205,3717,2778,18406,15628,431,1118
SC,83577,TIMBO,9373,5641,1984,21939,19955,462,886
SC,83593,TRES BARRAS,5422,1258,2092,11962,9870,212,781
SC,83615,TREZE DE MAIO,2226,726,392,4515,4123,149,277
SC,83631,TREZE TILIAS,733,1535,547,3488,2941,68,184
SC,83658,TROMBUDO CENTRAL,1611,1131,678,4735,4057,122,272
SC,83674,TUBARAO,33559,10026,7309,63677,56368,1087,2790
SC,83682,TUNAPOLIS,2077,348,338,3377,3039,42,121
SC,83690,TURVO,4369,1169,1297,9165,7868,136,548
SC,83712,URUBICI,2114,2034,1262,7274,6012,135,493
SC,83739,URUSSANGA,8668,1715,1809,14755,12946,273,621
SC,83755,VARGEAO,1133,354,604,2611,2007,62,144
SC,83771,VIDAL RAMOS,1753,1150,640,4631,3991,152,291
SC,83798,VIDEIRA,14083,4725,4032,28847,24815,914,1462
SC,83810,WITMARSUM,1012,610,304,2545,2241,94,148
SC,83836,XANXERE,14156,3124,4320,27146,22826,444,1163
SC,83852,XAVANTINA,1864,759,325,3432,3107,51,146
SC,83879,XAXIM,8628,2030,2412,16733,14321,412,996
SC,83895,BOM JARDIM DA SERRA,816,1069,336,2979,2643,74,280
SC,83917,MARACAJA,2680,446,485,4469,3984,97,236
SC,83933,TIMBE DO SUL,1697,592,398,3960,3562,133,373
SC,83950,CORREIA PINTO,4480,1369,1092,10055,8963,194,581
SC,83976,OTACILIO COSTA,4953,1156,1822,10572,8750,167,488
SE,31003,SANTANA DO SAO FRANCISCO,588,621,421,3722,3301,142,503
SE,31011,AMPARO DO SAO FRANCISCO,438,483,261,1686,1425,31,162
SE,31038,AQUIDABA,2805,1289,3144,13440,10296,519,1666
SE,31054,ARACAJU,135078,22302,50243,311540,261297,6085,14723
SE,31070,ARAUA,1654,1367,1608,7788,6180,333,876
SE,31097,AREIA BRANCA,1636,1523,1014,8343,7329,316,1079
SE,31119,BARRA DOS COQUEIROS,4443,1576,1667,11259,9592,348,766
SE,31135,BREJO GRANDE,1222,392,1308,4758,3450,199,565
SE,31151,BOQUIM,6486,1713,3188,17752,14564,732,1753
SE,31194,CAMPO DO BRITO,2726,1779,1836,10674,8838,427,1162
SE,31216,CANHOBA,666,586,419,2944,2525,125,422
SE,31232,CANINDE DO SAO FRANCISCO,3942,1122,2084,11819,9735,283,1548
SE,31259,CAPELA,3359,3462,3653,16587,12934,786,1857
SE,31275,CARIRA,2007,2561,3242,13104,9862,339,1869
SE,31291,CARMOPOLIS,2406,487,1173,6713,5540,303,603
SE,31313,CEDRO DE SAO JOAO,1197,440,710,4263,3553,193,315
SE,31330,CRISTINAPOLIS,2517,1916,2431,9909,7478,276,1142
SE,31356,NOSSA SENHORA APARECIDA,636,1541,687,5198,4511,247,679
SE,31372,CUMBE,534,660,532,3121,2589,95,363
SE,31399,DIVINA PASTORA,705,248,165,2114,1949,77,271
SE,31410,ESTANCIA,13868,3515,4297,33057,28760,1355,2876
SE,31437,FEIRA NOVA,555,681,358,3334,2976,88,438
SE,31453,FREI PAULO,1210,2185,1253,8519,7266,370,1028
SE,31470,GENERAL MAYNARD,676,202,343,2010,1667,70,179
SE,31496,GARARU,1892,2030,1444,8169,6725,268,1045
SE,31518,GRACCHO CARDOSO,1471,519,761,4455,3694,199,564
SE,31534,ILHA DAS FLORES,855,1054,1339,5848,4509,256,643
SE,31550,INDIAROBA,1712,748,968,7170,6202,231,1005
SE,31577,ITABAIANA,11902,10683,6928,47685,40757,1291,4798
SE,31593,ITABAIANINHA,3744,6040,5330,23030,17700,1031,2584
SE,31615,ITABI,800,883,470,3613,3143,106,544
SE,31631,ITAPORANGA D AJUDA,4005,2003,1793,16008,14215,448,2180
SE,31658,JAPARATUBA,2658,997,2100,9795,7695,479,1014
SE,31674,JAPOATA,2068,2070,1117,8087,6970,369,1085
SE,31690,LAGARTO,14762,10919,11040,55326,44286,1890,6069
SE,31712,LARANJEIRAS,5459,1639,1214,13846,12632,719,1483
SE,31739,MACAMBIRA,704,1777,806,4878,4072,124,498
SE,31755,MALHADA DOS BOIS,967,328,357,2301,1944,90,232
SE,31771,MALHADOR,1324,1897,795,6942,6147,215,822
SE,31798,MARUIM,3230,1257,1201,9618,8417,421,985
SE,31810,MOITA BONITA,649,3413,852,6683,5831,304,815
SE,31836,MONTE ALEGRE DE SERGIPE,956,1424,1832,8070,6238,232,964
SE,31852,MURIBECA,843,894,1141,5397,4256,242,659
SE,31879,NEOPOLIS,3356,1764,1240,10772,9532,487,1248
SE,31895,NOSSA SENHORA DA GLORIA,5194,2658,3126,17317,14191,531,1871
SE,31917,NOSSA SENHORA DAS DORES,3008,2466,2879,14910,12031,952,1857
SE,31933,NOSSA SENHORA DE LOURDES,1398,611,321,3692,3371,134,444
SE,31950,NOSSA SENHORA DO SOCORRO,19146,4969,11760,58868,47108,1802,3525
SE,31976,PACATUBA,1929,1626,1999,8449,6450,533,971
SE,31992,PEDRA MOLE,534,180,266,2045,1779,45,262
SE,32018,PEDRINHAS,1220,907,1169,5873,4704,213,736
SE,32034,PINHAO,917,424,804,4376,3572,111,557
SE,32050,PIRAMBU,1312,326,987,5327,4340,248,519
SE,32077,POCO REDONDO,3331,2423,3052,13447,10395,344,1741
SE,32093,POCO VERDE,3090,2765,3779,15151,11372,468,1725
SE,32115,PORTO DA FOLHA,4737,2783,3152,16252,13100,522,1861
SE,32131,PROPRIA,6590,799,3652,17665,14013,503,1306
SE,32158,RIACHAO DO DANTAS,3003,3424,2737,13841,11104,595,1624
SE,32174,RIACHUELO,2478,1024,1099,6605,5506,255,667
SE,32190,RIBEIROPOLIS,1883,1764,1130,10058,8928,246,1348
SE,32212,ROSARIO DO CATETE,1596,371,809,5510,4701,154,535
SE,32239,SALGADO,3415,1822,1038,10526,9488,513,1261
SE,32255,SANTA LUZIA DO ITANHY,1592,1691,1838,7628,5790,448,850
SE,32298,SANTA ROSA DE LIMA,572,210,375,2569,2194,156,335
SE,32310,SANTO AMARO DAS BROTAS,1672,1013,1100,6669,5569,221,842
SE,32336,SAO CRISTOVAO,13918,3363,5939,37149,31210,1213,2804
SE,32352,SAO DOMINGOS,1354,626,1409,6105,4696,226,898
SE,32379,SAO FRANCISCO,363,355,324,2194,1870,49,254
SE,32395,SAO MIGUEL DO ALEIXO,171,512,346,2433,2087,50,404
SE,32417,SIMAO DIAS,6881,4837,2826,24015,21189,1064,2988
SE,32433,SIRIRI,1277,673,807,4886,4079,235,517
SE,32450,TELHA,760,155,333,2074,1741,50,199
SE,32476,TOBIAS BARRETO,6316,6484,7139,31170,24031,1099,3124
SE,32492,TOMAR DO GERU,923,2352,2189,8821,6632,203,1278
SE,32514,UMBAUBA,2266,1745,1595,10961,9366,679,1170
SP,61000,EUCLIDES DA CUNHA PAULISTA,2359,1650,2010,7436,5426,151,477
SP,61018,ADAMANTINA,6720,6527,5194,25250,20056,1225,1137
SP,61026,BOREBI,369,608,236,1538,1302,22,54
SP,61034,ADOLFO,947,731,355,2608,2253,127,156
SP,61042,TARUMA,3141,1610,1356,7966,6610,226,366
SP,61050,AGUAI,6898,3725,3496,19790,16294,704,1341
SP,61069,MOTUCA,1195,685,586,3024,2438,89,139
SP,61077,AGUAS DA PRATA,1789,1489,1037,5513,4476,157,252
SP,61085,IARAS,552,655,503,2056,1553,37,119
SP,61093,AGUAS DE LINDOIA,2713,3018,2323,10686,8363,369,695
SP,61107,GUATAPARA,947,1178,1065,4094,3029,146,176
SP,61115,AGUAS DE SAO PEDRO,504,797,284,2020,1736,41,52
SP,61123,DIRCE REIS,457,450,189,1382,1193,91,73
SP,61131,AGUDOS,7445,3467,4034,23524,19490,703,1468
SP,61140,ESPIRITO SANTO DO TURVO,806,812,781,2848,2067,98,114
SP,61158,ALFREDO MARCONDES,897,866,287,2864,2577,144,194
SP,61166,ROSANA,6191,2442,4616,17075,12459,319,870
SP,61174,ALTAIR,788,520,738,2835,2097,117,152
SP,61182,EMBAUBA,857,366,519,2349,1830,142,113
SP,61190,ALTINOPOLIS,4552,2546,1971,11604,9633,450,582
SP,61204,ILHA SOLTEIRA,6023,2733,3865,18614,14749,535,948
SP,61212,ALTO ALEGRE,963,952,321,3182,2861,178,235
SP,61220,ALUMINIO,5538,2118,2052,12472,10420,313,490
SP,61239,ALVARES FLORENCE,990,1189,810,3917,3107,210,248
SP,61247,PEDRINHAS PAULISTA,718,737,418,2271,1853,42,121
SP,61255,ALVARES MACHADO,5070,3104,2477,13631,11154,507,710
SP,61263,ARACARIGUAMA,1998,1857,1958,8811,6853,266,585
SP,61271,ALVARO DE CARVALHO,550,832,390,2433,2043,124,262
SP,61280,BERTIOGA,6632,4665,5116,22885,17769,428,1044
SP,61298,ALVINLANDIA,582,540,350,2082,1732,52,143
SP,61301,SUZANOPOLIS,697,529,503,2251,1748,174,173
SP,61310,AMERICANA,61410,27151,16629,137521,120892,3402,3932
SP,61328,SANTO ANTONIO DO ARACANGUA,1934,1245,1032,5189,4157,105,220
SP,61336,AMERICO BRASILIENSE,9291,2773,3425,19796,16371,677,1026
SP,61344,CANITAR,836,559,535,2731,2196,123,238
SP,61352,AMERICO DE CAMPOS,1051,1566,541,4280,3739,191,205
SP,61360,BARRA DO CHAPEU,684,1723,837,3845,3008,188,243
SP,61379,AMPARO,12711,12688,5970,41978,36008,1517,2244
SP,61387,EMILIANOPOLIS,913,367,270,2154,1884,86,167
SP,61395,ANALANDIA,768,1064,778,3341,2563,82,129
SP,61409,NOVAIS,757,1064,385,2756,2371,66,169
SP,61417,ANDRADINA,12338,9703,8169,40210,32041,1612,1775
SP,61425,NOVA CANAA PAULISTA,459,659,222,1695,1473,88,100
SP,61433,ANGATUBA,5027,3245,2603,13198,10595,336,718
SP,61441,SALTINHO,1323,1570,260,4503,4243,196,185
SP,61450,ANHEMBI,961,1053,910,3601,2691,109,189
SP,61468,UBARANA,1276,726,817,3445,2628,132,166
SP,61476,ANHUMAS,993,497,262,2255,1993,79,99
SP,61484,CAJATI,4633,3867,4192,18356,14164,425,1168
SP,61492,APARECIDA,8660,5348,1460,20563,19103,587,702
SP,61506,CAMPINA DO MONTE ALEGRE,1142,1019,664,3500,2836,102,151
SP,61514,APARECIDA D OESTE,938,1394,549,3564,3015,188,136
SP,61522,ASPASIA,514,496,439,1788,1349,81,113
SP,61530,APIAI,4153,5833,4613,18612,13999,786,1186
SP,61549,VARGEM,1466,1231,1238,5295,4057,209,418
SP,61557,ARACATUBA,33288,37324,20724,119762,99038,2958,4470
SP,61565,POTIM,3584,1810,1345,8658,7313,156,425
SP,61573,ARACOIABA DA SERRA,4970,5157,2971,16854,13883,522,692
SP,61581,ALAMBARI,552,1124,532,2760,2228,100,119
SP,61590,ARAMINA,1328,685,382,3267,2885,161,209
SP,61603,ITAOCA,643,782,968,2888,1920,170,172
SP,61611,ARANDU,1073,837,368,3374,3006,148,269
SP,61620,TUIUTI,1106,1101,784,4008,3224,227,237
SP,61638,ARARAQUARA,48422,30922,18070,124981,106911,4083,5250
SP,61646,ARAPEI,613,392,298,1970,1672,39,172
SP,61654,ARARAS,27909,15910,8762,73054,64292,2520,2927
SP,61662,ESTIVA GERBI,2842,933,812,6177,5365,211,215
SP,61670,AREALVA,1324,1681,553,4797,4244,376,266
SP,61689,ENGENHEIRO COELHO,1882,1581,1347,6577,5230,158,342
SP,61697,AREIAS,780,708,601,2859,2258,61,199
SP,61700,RIBEIRAO GRANDE,2189,1054,761,5231,4470,314,403
SP,61719,AREIOPOLIS,2323,1156,1347,6935,5588,325,514
SP,61727,HORTOLANDIA,40000,10048,13674,83365,69691,1854,2911
SP,61735,ARIRANHA,2549,686,916,5855,4939,321,413
SP,61743,HOLAMBRA,2520,2247,1039,6996,5957,202,278
SP,61751,ARTUR NOGUEIRA,8826,3801,3586,21917,18331,778,906
SP,61760,ELISIARIO,533,658,137,1821,1684,61,101
SP,61778,ARUJA,13891,8449,7728,43062,35334,1183,1931
SP,61786,BOM SUCESSO DE ITARARE,707,688,599,2365,1766,41,124
SP,61794,ASSIS,22402,11624,11285,60566,49281,1674,2358
SP,61808,PONTALINDA,904,656,607,2651,2044,124,113
SP,61816,ATIBAIA,16712,23247,12455,73357,60902,2567,3729
SP,61824,PARISI,529,451,198,1503,1305,46,80
SP,61832,AURIFLAMA,3829,2355,2359,11041,8682,332,533
SP,61840,TAQUARIVAI,793,928,777,3215,2438,100,141
SP,61859,AVAI,1197,682,688,3640,2952,118,112
SP,61867,MARAPOAMA,487,647,374,2020,1646,96,124
SP,61875,AVANHANDAVA,1882,1318,1265,6436,5171,202,313
SP,61883,SAO JOAO DE IRACEMA,467,219,237,1386,1149,58,74
SP,61891,AVARE,15227,11254,8062,48734,40672,1437,2470
SP,61905,SAO LOURENCO DA SERRA,1819,2559,1497,7497,6000,241,437
SP,61913,BADY BASSIT,2596,2153,1444,8276,6832,382,363
SP,61921,ZACARIAS,642,368,438,1791,1353,51,113
SP,61930,BALBINOS,247,345,132,1074,942,73,67
SP,61948,ITAPIRAPUA PAULISTA,626,937,726,2917,2191,143,250
SP,61956,BALSAMO,1704,1625,1206,5982,4776,316,307
SP,61964,MESOPOLIS,338,372,218,1416,1198,104,50
SP,61972,BANANAL,2113,1406,780,6666,5886,186,556
SP,61980,NOVA CAMPINA,1063,1172,850,4946,4096,161,383
SP,61999,BARBOSA,1244,919,1078,4634,3556,129,317
SP,62006,ILHA COMPRIDA,1224,1891,1181,5424,4243,108,181
SP,62014,BARAO DE ANTONINA,510,587,423,2086,1663,86,158
SP,62022,LOURDES,361,638,317,1685,1368,51,109
SP,62030,BARIRI,7177,5025,3420,20594,17174,1296,1153
SP,62049,TORRE DE PEDRA,492,421,392,1902,1510,73,96
SP,62057,BARRA BONITA,11167,5056,3906,26532,22626,1034,1347
SP,62065,ARCO IRIS,570,734,554,2360,1806,68,114
SP,62073,BARRA DO TURVO,1335,1240,2173,6339,4166,95,562
SP,62081,BREJO ALEGRE,792,383,362,1902,1540,63,120
SP,62090,BARRETOS,23833,19758,12006,71460,59454,1687,2666
SP,62103,CANAS,762,713,384,2446,2062,70,105
SP,62111,BARRINHA,6464,2619,3901,16918,13017,676,964
SP,62120,PRACINHA,293,426,321,1286,965,37,87
SP,62138,BARUERI,59296,24303,25884,164421,138537,4817,7438
SP,62146,PRATANIA,798,920,630,3009,2379,103,217
SP,62154,BASTOS,3685,4969,3567,16050,12483,664,698
SP,62162,QUADRA,601,633,606,2410,1804,78,114
SP,62170,BATATAIS,9153,10743,5463,35613,30150,1409,1794
SP,62189,SANTA CRUZ DA ESPERANCA,412,484,347,1594,1247,45,89
SP,62197,BAURU,83630,35691,31364,207934,176570,5393,7589
SP,62200,SANTA SALETE,467,411,280,1426,1146,65,62
SP,62219,BEBEDOURO,13707,13180,9928,51282,41354,1634,1949
SP,62227,VITORIA BRASIL,542,451,332,1631,1299,100,87
SP,62235,BENTO DE ABREU,581,784,409,2078,1669,49,90
SP,62243,IPIGUA,911,777,591,2964,2373,113,88
SP,62251,BERNADINO DE CAMPOS,2722,1953,1450,7683,6233,184,312
SP,62260,TAQUARAL,855,284,342,1895,1553,75,112
SP,62278,BILAC,1218,1805,494,4519,4025,203,300
SP,62286,FERNAO,402,315,290,1281,991,30,85
SP,62294,BIRIGUI,21097,16617,8536,63446,54910,2967,3300
SP,62308,GAVIAO PEIXOTO,1032,684,500,2823,2323,72,127
SP,62316,BIRITIBA MIRIM,4231,4653,3440,17211,13771,673,988
SP,62324,JUMIRIM,396,675,222,1569,1347,40,50
SP,62332,BOA ESPERANCA DO SUL,3510,1636,1756,9049,7293,451,583
SP,62340,NANTES,397,559,475,1829,1354,44,139
SP,62359,BOCAINA,2816,1606,1068,6844,5776,299,287
SP,62367,NOVA CASTILHO,315,346,275,1209,934,24,50
SP,62375,BOFETE,1410,1406,1758,6099,4341,217,426
SP,62383,OUROESTE,1641,1301,1327,5308,3981,263,289
SP,62391,BOITUVA,6365,7337,4115,24306,20191,954,1334
SP,62405,PAULISTANIA,336,528,354,1517,1163,44,94
SP,62413,BOM JESUS DOS PERDOES,2302,3020,1736,9881,8145,354,649
SP,62421,RIBEIRAO DOS INDIOS,641,446,361,1893,1532,112,159
SP,62430,BORA,242,252,247,1077,830,46,76
SP,62448,TRABIJU,527,263,297,1318,1021,34,83
SP,62456,BORACEIA,1360,458,673,3375,2702,183,120
SP,62472,BORBOREMA,3233,1695,1861,9840,7979,661,739
SP,62499,BOTUCATU,25478,16597,11032,73284,62252,2321,3584
SP,62510,BRAGANCA PAULISTA,27779,22383,12268,86311,74043,2849,4188
SP,62553,BRAUNA,706,1095,308,3114,2806,202,170
SP,62570,BRODOWSKI,3441,3403,2019,12344,10325,466,637
SP,62596,BROTAS,3880,4003,2310,13374,11064,599,861
SP,62618,BURI,3155,3040,2316,11139,8823,404,556
SP,62634,BURITAMA,2857,2782,2211,10495,8284,448,754
SP,62650,BURITIZAL,692,717,384,2505,2121,88,182
SP,62677,CABRALIA PAULISTA,1301,400,701,3391,2690,162,231
SP,62693,CABREUVA,7080,4741,3554,20424,16870,595,983
SP,62715,CACAPAVA,20472,12028,6098,53280,47182,1484,2161
SP,62731,CACHOEIRA PAULISTA,8318,2929,3162,19647,16485,518,895
SP,62758,CACONDE,2685,4759,2481,12114,9633,392,789
SP,62774,CAFELANDIA,3318,3348,2378,11750,9372,457,521
SP,62790,CAIABU,1026,656,418,3048,2630,188,234
SP,62812,CAIEIRAS,16097,8141,5277,43414,38137,1378,2138
SP,62839,CAIUA,883,972,340,2692,2352,44,162
SP,62855,CAJAMAR,14258,4307,3734,32828,29094,848,1513
SP,62871,CAJOBI,2364,1239,1544,7337,5793,383,441
SP,62898,CAJURU,4754,3634,3080,15001,11921,548,969
SP,62910,CAMPINAS,274766,130802,103996,656596,552600,13228,21452
SP,62936,CAMPO LIMPO PAULISTA,18827,7954,6592,44835,38243,960,1995
SP,62952,CAMPOS DO JORDAO,7233,9583,5921,31602,25681,1308,1394
SP,62979,CAMPOS NOVOS PAULISTA,721,828,876,3416,2540,168,206
SP,62995,CANANEIA,1912,2411,1915,8294,6379,174,401
SP,63010,CANDIDO MOTA,6756,4841,4245,21620,17375,1092,1203
SP,63037,CANDIDO RODRIGUES,756,383,264,2062,1798,168,135
SP,63053,CAPAO BONITO,9952,7690,6628,32279,25651,1288,2164
SP,63070,CAPELA DO ALTO,2293,3393,1653,9381,7728,411,410
SP,63096,CAPIVARI,7389,7196,4542,26734,22192,985,1395
SP,63118,CARAGUATATUBA,15308,11967,10664,52568,41904,1413,2375
SP,63134,CARAPICUIBA,93481,37565,32963,216989,184026,5499,7058
SP,63150,CARDOSO,2886,1530,2773,9758,6985,440,486
SP,63177,CASA BRANCA,5540,4254,3237,17836,14599,690,1185
SP,63193,CASSIA DOS COQUEIROS,611,1088,718,2922,2204,81,176
SP,63215,CASTILHO,4136,1885,2995,11911,8916,430,718
SP,63231,CATANDUVA,22820,16768,8980,68933,59953,2460,3306
SP,63258,CATIGUA,1967,1002,757,5477,4720,299,459
SP,63274,CEDRAL,1715,1350,913,5219,4306,254,272
SP,63290,CERQUEIRA CESAR,2764,2838,2105,10882,8777,493,676
SP,63312,CERQUILHO,6845,6224,2723,20764,18041,702,1088
SP,63339,CESARIO LANGE,2089,2713,1614,9167,7553,655,612
SP,63355,CHARQUEADA,3264,2824,1536,10287,8751,356,423
SP,63371,CHAVANTES,3257,1576,1574,8811,7237,320,436
SP,63398,CLEMENTINA,1229,868,904,4334,3430,145,248
SP,63410,COLINA,3884,3441,2815,12426,9611,456,547
SP,63436,COLOMBIA,1388,1132,1596,5252,3656,141,304
SP,63452,CONCHAL,4076,4489,3091,16342,13251,1003,960
SP,63479,CONCHAS,2982,3266,2144,10618,8474,398,543
SP,63495,CORDEIROPOLIS,5129,2140,1494,11920,10426,401,471
SP,63517,COROADOS,950,895,533,3133,2600,114,156
SP,63533,CORONEL MACEDO,1476,1233,652,4074,3422,114,282
SP,63550,CORUMBATAI,745,843,616,3045,2429,143,156
SP,63576,COSMOPOLIS,13598,4456,4432,31451,27019,1000,1202
SP,63592,COSMORAMA,1335,2096,1179,6020,4841,330,222
SP,63614,COTIA,35552,19376,14423,93393,78970,2487,3804
SP,63630,CRAVINHOS,5260,6238,2878,19026,16148,742,1189
SP,63657,CRISTAIS PAULISTA,1096,1661,995,4677,3682,95,184
SP,63673,CRUZALIA,762,605,321,2265,1944,58,111
SP,63690,CRUZEIRO,22090,8262,7171,51737,44566,1167,2274
SP,63711,CUBATAO,36372,8937,11609,81550,69941,1758,2982
SP,63738,CUNHA,2957,4025,4339,16870,12531,699,1235
SP,63754,DESCALVADO,7149,5433,3285,21285,18000,1145,1246
SP,63770,DIADEMA,124498,27540,37106,250960,213854,5299,9484
SP,63797,DIVINOLANDIA,1868,3349,2034,9044,7010,510,642
SP,63819,DOBRADA,2063,760,1105,5319,4214,188,336
SP,63835,DOIS CORREGOS,5519,3414,2489,15447,12958,899,717
SP,63851,DOLCINOPOLIS,464,631,267,1765,1498,76,160
SP,63878,DOURADO,2371,1489,1027,6433,5406,449,351
SP,63894,DRACENA,7816,9417,6801,31312,24511,1173,1564
SP,63916,DUARTINA,3692,1459,1979,9676,7697,297,587
SP,63932,DUMONT,1593,1121,623,4467,3844,271,217
SP,63959,ECHAPORA,1464,1127,1202,5019,3817,146,317
SP,63975,ELDORADO,1651,2495,2908,10359,7451,206,879
SP,63991,ELIAS FAUSTO,2677,2390,2318,9949,7631,358,634
SP,64017,EMBU,45526,26235,19470,130737,111267,4163,5937
SP,64033,EMBU GUACU,10552,8677,7966,38961,30995,1298,1820
SP,64050,ESTRELA D OESTE,1963,1715,1215,6662,5447,351,497
SP,64076,ESTRELA DO NORTE,477,524,311,1865,1554,57,140
SP,64092,FARTURA,3331,3488,2471,11156,8685,334,486
SP,64114,FERNANDOPOLIS,14194,12070,8390,43831,35441,1669,1635
SP,64130,FERNANDO PRESTES,1552,882,554,4116,3562,360,250
SP,64157,FERRAZ DE VASCONCELOS,31021,11507,14325,82808,68483,2168,3415
SP,64173,FLORA RICA,621,335,318,1699,1381,43,115
SP,64190,FLOREAL,912,648,351,2517,2166,176,139
SP,64211,FLORIDA PAULISTA,1906,2339,1837,8380,6543,461,443
SP,64238,FLORINEA,906,380,313,2241,1928,79,139
SP,64254,FRANCA,57387,53411,23013,182490,159477,4212,6184
SP,64270,FRANCISCO MORATO,24251,12893,12540,71727,59187,2211,3090
SP,64297,FRANCO DA ROCHA,25234,10890,8888,67468,58580,2240,3614
SP,64319,GABRIEL MONTEIRO,627,766,236,2062,1826,88,175
SP,64335,GALIA,1510,1360,1224,5323,4099,188,337
SP,64351,GARCA,7517,9201,6339,30255,23916,1433,1482
SP,64378,GASTAO VIDIGAL,898,801,427,2752,2325,210,182
SP,64394,GENERAL SALGADO,2667,2355,1707,8518,6811,403,371
SP,64416,GETULINA,2453,1752,1890,7938,6048,267,486
SP,64432,GLICERIO,1314,1197,862,4127,3265,118,188
SP,64459,GUAICARA,2258,1045,1254,6045,4791,246,341
SP,64475,GUAIMBE,940,942,497,3350,2853,121,290
SP,64491,GUAIRA,7831,8277,5132,25310,20178,823,790
SP,64513,GUAPIACU,3628,2952,2029,11263,9234,526,526
SP,64530,GUAPIARA,3725,3448,3427,13151,9724,441,1006
SP,64556,GUARA,3900,2622,3067,13614,10547,469,893
SP,64572,GUARACAI,1944,1551,1367,6736,5369,362,467
SP,64599,GUARACI,1966,1946,1996,7142,5146,145,283
SP,64610,GUARANI D OESTE,568,326,439,1678,1239,64,137
SP,64637,GUARANTA,1069,1122,1014,4528,3514,294,277
SP,64653,GUARARAPES,5236,6134,4325,21019,16694,799,1139
SP,64670,GUARAREMA,4210,4250,3361,16373,13012,431,1022
SP,64696,GUARATINGUETA,29598,15126,10072,73707,63635,1800,2325
SP,64718,GUAREI,1978,1639,1409,7289,5880,508,606
SP,64734,GUARIBA,9221,4563,3987,22694,18707,710,975
SP,64750,GUARUJA,64020,22391,26784,176038,149254,4603,7030
SP,64777,GUARULHOS,192677,102587,85565,592740,507175,15306,27415
SP,64793,GUZOLANDIA,913,1145,1053,3760,2707,96,172
SP,64815,HERCULANDIA,1533,1694,1201,5893,4692,147,432
SP,64831,IACANGA,1897,1443,1356,6701,5345,283,297
SP,64858,IACRI,1521,1448,1212,5429,4217,260,284
SP,64874,IBATE,6386,2437,2539,16442,13903,867,838
SP,64890,IBIRA,1606,2448,1259,7069,5810,311,506
SP,64912,IBIRAREMA,1230,1345,981,4881,3900,267,275
SP,64939,IBITINGA,11668,6715,5418,32981,27563,1436,1901
SP,64955,IBIUNA,6905,16327,9161,42719,33558,1307,2931
SP,64971,ICEM,2168,1090,1373,5870,4497,139,371
SP,64998,IEPE,1418,1560,1431,5870,4439,131,428
SP,65013,IGARACU DO TIETE,6607,2329,2579,16259,13680,1061,1112
SP,65030,IGARAPAVA,6711,3906,4134,19493,15359,774,1004
SP,65056,IGARATA,1738,2065,1476,7257,5781,271,429
SP,65072,IGUAPE,4091,6314,4402,20570,16168,520,1120
SP,65099,ILHABELA,3150,4069,2655,13294,10639,288,523
SP,65110,INDAIATUBA,45138,16448,14956,99703,84747,2753,3775
SP,65137,INDIANA,1324,1059,689,3988,3299,200,198
SP,65153,INDIAPORA,767,905,485,2843,2358,98,130
SP,65170,INUBIA PAULISTA,531,1070,507,2718,2211,85,172
SP,65196,IPAUCU,3125,2222,1637,8781,7144,301,340
SP,65218,IPERO,4361,2348,2241,11829,9588,343,509
SP,65234,IPEUNA,813,796,563,3161,2598,115,188
SP,65250,IPORANGA,809,513,827,2976,2149,152,235
SP,65277,IPUA,3124,1862,1547,8254,6707,401,519
SP,65293,IRACEMAPOLIS,4092,2884,1111,10998,9887,251,459
SP,65315,IRAPUA,1155,1609,1188,5230,4042,254,330
SP,65331,IRAPURU,1394,1316,1734,6166,4432,247,334
SP,65358,ITABERA,4568,3204,2349,12565,10216,519,598
SP,65374,ITAI,5194,3139,3209,14802,11593,620,935
SP,65390,ITAJOBI,3092,3041,1996,11333,9337,831,742
SP,65412,ITAJU,567,518,245,2044,1799,115,121
SP,65439,ITANHAEM,14208,9902,11084,49413,38329,1256,2159
SP,65455,ITAPECERICA DA SERRA,24950,19336,12059,78252,66193,2440,3404
SP,65471,ITAPETININGA,28784,18926,11695,79414,67719,3081,3619
SP,65498,ITAPEVA,19493,12385,9242,53168,43926,1748,2112
SP,65510,ITAPEVI,36246,16223,15436,92992,77556,2793,3809
SP,65536,ITAPIRA,18154,8957,6441,45301,38860,2232,2620
SP,65552,ITAPOLIS,8781,5675,4876,26987,22111,1675,1902
SP,65579,ITAPORANGA,2515,3665,3019,11387,8368,545,607
SP,65595,ITAPUI,2911,1212,938,6516,5578,295,246
SP,65617,ITAPURA,963,562,823,3077,2254,116,199
SP,65633,ITAQUAQUECETUBA,46988,18884,24881,132640,107759,4281,6365
SP,65650,ITARARE,8434,8072,6031,30800,24769,1193,1461
SP,65676,ITARIRI,1479,2178,1712,7546,5834,179,508
SP,65692,ITATIBA,17549,13940,7077,52888,45811,2079,2280
SP,65714,ITATINGA,3361,2328,2319,10520,8201,337,749
SP,65730,ITIRAPINA,2578,1872,1435,7749,6314,330,309
SP,65757,ITIRAPUA,1196,1019,838,4110,3272,119,252
SP,65773,ITOBI,1308,1472,955,5188,4233,263,397
SP,65790,ITU,34749,20863,13296,90067,76771,2394,3862
SP,65811,ITUPEVA,6678,4474,3768,19658,15890,648,741
SP,65838,ITUVERAVA,9234,6597,4674,26280,21606,888,1153
SP,65854,JABORANDI,1666,943,1030,4844,3814,231,296
SP,65870,JABOTICABAL,13894,12009,8124,45543,37419,1507,2062
SP,65897,JACAREI,49500,22973,20346,128830,108484,2671,4114
SP,65919,JACI,860,1177,412,3008,2596,149,146
SP,65935,JACUPIRANGA,2671,2992,2458,11397,8939,232,690
SP,65951,JAGUARIUNA,8420,4617,3320,20998,17678,782,927
SP,65978,JALES,11229,8663,6179,33781,27602,1482,1377
SP,65994,JAMBEIRO,881,1196,590,3573,2983,73,210
SP,66010,JANDIRA,19707,10918,10492,61318,50826,1795,2350
SP,66036,JARDINOPOLIS,6207,4944,3720,20558,16838,1005,1206
SP,66052,JARINU,2542,3168,2440,11366,8926,370,575
SP,66079,JAU,29507,18423,9709,76520,66811,3509,2957
SP,66095,JERIQUARA,728,722,521,2530,2009,52,181
SP,66117,JOANOPOLIS,1439,2876,1503,7712,6209,371,492
SP,66133,JOAO RAMALHO,692,1079,627,2983,2356,81,171
SP,66150,JOSE BONIFACIO,6449,5434,2926,19493,16567,1115,1017
SP,66176,JULIO MESQUITA,1132,895,418,3175,2757,106,252
SP,66192,JUNDIAI,107329,48220,27276,231793,204517,4666,8590
SP,66214,JUNQUEIROPOLIS,3231,3748,2937,12844,9907,566,510
SP,66230,JUQUIA,2445,3724,4138,15283,11145,314,926
SP,66257,JUQUITIBA,3369,5717,4165,18317,14152,610,1210
SP,66273,LAGOINHA,1196,1889,771,4831,4060,197,334
SP,66290,LARANJAL PAULISTA,4469,5368,2330,15983,13653,723,846
SP,66311,LAVINIA,1370,1129,899,4152,3253,139,245
SP,66338,LAVRINHAS,1697,1183,734,4809,4075,137,291
SP,66354,LEME,23946,10140,7533,54144,46611,1998,2248
SP,66370,LENCOIS PAULISTA,11891,8864,5084,36631,31547,1627,1858
SP,66397,LIMEIRA,67895,32197,22486,164548,142062,3922,5717
SP,66419,LINDOIA,1029,1576,874,4464,3590,133,320
SP,66435,LINS,11520,12306,8437,46989,38552,1367,1986
SP,66451,LORENA,21123,10624,9038,54639,45601,1209,1729
SP,66478,LOUVEIRA,5360,4810,2653,17421,14768,608,679
SP,66494,LUCELIA,4151,4055,3185,13892,10707,388,775
SP,66516,LUCIANOPOLIS,556,355,252,1714,1462,43,158
SP,66532,LUIS ANTONIO,1900,1177,1196,5604,4408,136,339
SP,66559,LUISIANIA,1068,705,393,2986,2593,94,238
SP,66575,LUPERCIO,992,785,664,3083,2419,89,187
SP,66591,LUTECIA,661,632,747,2652,1905,89,189
SP,66613,MACATUBA,4545,2014,2003,11341,9338,491,586
SP,66630,MACAUBAL,1328,2147,1214,6011,4797,471,222
SP,66656,MACEDONIA,1074,691,588,3054,2466,154,164
SP,66672,MAGDA,917,632,331,2489,2158,163,126
SP,66699,MAIRINQUE,11259,5153,5357,29173,23816,718,1371
SP,66710,MAIRIPORA,9925,9437,5489,37440,31951,1303,2318
SP,66737,MANDURI,1872,1869,1297,6685,5388,287,458
SP,66753,MARABA PAULISTA,715,935,648,3138,2490,79,259
SP,66770,MARACAI,3558,2014,2017,10436,8419,322,539
SP,66796,MARIAPOLIS,614,815,356,2638,2282,206,188
SP,66818,MARILIA,48405,27849,22658,133414,110756,4705,5201
SP,66834,MARINOPOLIS,504,553,235,1849,1614,115,100
SP,66850,MARTINOPOLIS,3721,4735,3584,15853,12269,571,766
SP,66877,MATAO,23397,9839,6787,50288,43501,1364,2101
SP,66893,MAUA,115488,25535,32090,236980,204890,5019,9776
SP,66915,MENDONCA,875,753,276,2665,2389,219,205
SP,66931,MERIDIANO,1004,933,445,3031,2586,97,192
SP,66958,MIGUELOPOLIS,4044,4043,3278,14491,11213,391,761
SP,66974,MINEIROS DO TIETE,3093,1514,1350,7906,6556,339,479
SP,66990,MIRACATU,2396,3714,3662,14209,10547,327,1003
SP,67016,MIRA ESTRELA,829,585,347,2223,1876,88,157
SP,67032,MIRANDOPOLIS,5518,4895,3879,18491,14612,841,1050
SP,67059,MIRANTE DO PARANAPANEMA,3270,2490,3247,12513,9266,562,893
SP,67075,MIRASSOL,12233,7125,5669,33321,27652,1265,1584
SP,67091,MIRASSOLANDIA,704,958,291,2721,2430,97,136
SP,67113,MOCOCA,15853,11170,7554,45155,37601,2451,2471
SP,67130,MOGI DAS CRUZES,78709,45153,30349,216213,185864,5887,8277
SP,67156,MOJI GUACU,36879,15524,11736,86166,74430,2618,3410
SP,67172,MOJI MIRIM,18302,12979,7400,52524,45124,2073,2194
SP,67199,MOMBUCA,760,522,479,2569,2090,122,208
SP,67210,MONCOES,400,464,239,1613,1374,193,100
SP,67237,MONGAGUA,7204,4988,5369,24095,18726,523,1017
SP,67253,MONTE ALEGRE DO SUL,1403,1629,805,5010,4205,206,335
SP,67270,MONTE ALTO,10531,7936,5202,31424,26222,1811,1577
SP,67296,MONTE APRAZIVEL,4687,3715,2819,14487,11668,799,727
SP,67318,MONTE AZUL PAULISTA,3969,4280,2244,14196,11952,702,965
SP,67334,MONTE CASTELO,989,851,424,2889,2465,136,210
SP,67350,MONTEIRO LOBATO,801,747,378,2782,2404,116,190
SP,67377,MONTE MOR,9045,4399,5144,25778,20634,806,1358
SP,67393,MORRO AGUDO,5363,3356,3148,16340,13192,796,1130
SP,67415,MORUNGABA,2069,2704,1438,8243,6805,301,401
SP,67431,MURUTINGA DO SUL,914,1001,407,2893,2486,108,172
SP,67458,NARANDIBA,954,761,727,3189,2462,99,245
SP,67474,NATIVIDADE DA SERRA,1399,1179,814,5334,4520,240,532
SP,67490,NAZARE PAULISTA,1782,3129,1929,9731,7802,560,766
SP,67512,NEVES PAULISTA,2254,1870,1245,6956,5711,476,413
SP,67539,NHANDEARA,2156,2365,985,7451,6466,614,302
SP,67555,NIPOA,676,877,332,2417,2085,100,137
SP,67571,NOVA ALIANCA,1174,989,477,3707,3230,262,228
SP,67598,NOVA EUROPA,2521,1032,1177,5766,4589,188,269
SP,67610,NOVA GRANADA,3594,3672,2389,12841,10452,482,764
SP,67636,NOVA GUATAPORANGA,445,579,247,1709,1462,58,164
SP,67652,NOVA INDEPENDENCIA,661,589,516,2101,1585,45,110
SP,67679,NOVA LUZITANIA,677,897,312,2242,1930,82,107
SP,67695,NOVA ODESSA,14443,3733,4145,30615,26470,718,1075
SP,67717,NOVO HORIZONTE,9168,4551,4022,23102,19080,1141,1049
SP,67733,NUPORANGA,1528,1236,800,4770,3970,268,272
SP,67750,OCAUCU,973,740,942,3753,2811,152,323
SP,67776,OLEO,640,618,247,2167,1920,109,166
SP,67792,OLIMPIA,9892,8699,6398,33269,26871,1735,1686
SP,67814,ONDA VERDE,892,752,529,2798,2269,80,154
SP,67830,ORIENTE,1652,1214,446,4308,3862,164,305
SP,67857,ORINDIUVA,861,1097,747,3240,2493,90,190
SP,67873,ORLANDIA,7646,8358,3385,24655,21270,923,1200
SP,67890,OSASCO,201501,75435,67259,453152,385893,8988,14314
SP,67911,OSCAR BRESSANE,551,598,264,1911,1647,62,134
SP,67938,OSVALDO CRUZ,5587,7465,4695,22520,17825,862,1081
SP,67954,OURINHOS,22653,14595,10768,61705,50937,1711,2354
SP,67970,OURO VERDE,1683,1231,1399,5623,4224,154,393
SP,67997,PACAEMBU,1940,2693,1064,7591,6527,396,484
SP,68012,PALESTINA,1460,2423,983,6707,5724,407,580
SP,68039,PALMARES PAULISTA,1716,1061,1012,5880,4868,370,548
SP,68055,PALMEIRA D OESTE,2188,2065,1973,8244,6271,485,385
SP,68071,PALMITAL,4544,4826,2853,15139,12286,515,594
SP,68098,PANORAMA,2068,2105,2082,8642,6560,338,421
SP,68110,PARAGUACU PAULISTA,8081,5891,5079,26468,21389,1136,1419
SP,68136,PARAIBUNA,3270,3384,1605,10987,9382,322,673
SP,68152,PARAISO,1203,1096,725,4077,3352,290,261
SP,68179,PARANAPANEMA,3992,3010,2231,11085,8854,241,581
SP,68195,PARANAPUA,696,957,373,2667,2294,175,147
SP,68217,PARAPUA,2084,1938,1801,7897,6096,396,581
SP,68233,PARDINHO,1112,1033,951,4046,3095,148,254
SP,68250,PARIQUERA-ACU,2895,3724,2366,12346,9980,327,673
SP,68276,PATROCINIO PAULISTA,2512,2463,1417,8300,6883,191,395
SP,68292,PAULICEIA,1117,717,510,3285,2775,99,197
SP,68314,PAULINIA,20024,4975,5890,40361,34471,1127,1400
SP,68330,PAULO DE FARIA,1344,2040,1649,6491,4842,237,443
SP,68357,PEDERNEIRAS,8391,5775,4381,25169,20788,1003,1396
SP,68373,PEDRA BELA,856,1355,888,3932,3044,175,280
SP,68390,PEDRANOPOLIS,634,638,236,1957,1721,78,137
SP,68411,PEDREGULHO,3258,3200,2610,12172,9562,554,802
SP,68438,PEDREIRA,10257,5247,3311,25163,21852,1125,1417
SP,68454,PEDRO DE TOLEDO,1396,1240,1637,6244,4607,177,388
SP,68470,PENAPOLIS,15827,8555,6491,38798,32307,1371,1695
SP,68497,PEREIRA BARRETO,5314,4007,4874,18974,14100,595,1037
SP,68519,PEREIRAS,1711,1248,1053,5087,4034,216,297
SP,68535,PERUIBE,8765,7369,8186,35260,27074,962,1547
SP,68551,PIACATU,1078,1240,835,3854,3019,113,285
SP,68578,PIEDADE,5376,11229,5365,30387,25022,1259,1821
SP,68594,PILAR DO SUL,3999,5332,2125,15042,12917,551,680
SP,68616,PINDAMONHANGABA,31143,18970,10420,80484,70064,1813,2587
SP,68632,PINDORAMA,3400,2314,1407,10074,8667,613,671
SP,68659,ESPIRITO SANTO DO PINHAL,10331,7607,4469,29142,24673,1156,1627
SP,68675,PINHALZINHO,1788,2655,1437,7812,6375,311,605
SP,68691,PIQUEROBI,920,810,636,2929,2293,114,175
SP,68713,PIQUETE,4827,1633,2268,12235,9967,259,407
SP,68730,PIRACAIA,3953,4981,3111,16385,13274,561,893
SP,68756,PIRACICABA,76291,58368,29988,218504,188516,6253,6875
SP,68772,PIRAJU,6341,5460,3814,20522,16708,685,998
SP,68799,PIRAJUI,3519,3257,2931,13944,11013,595,703
SP,68810,PIRANGI,2015,1842,1304,7122,5818,619,359
SP,68837,PIRAPORA DO BOM JESUS,1862,2019,1497,7466,5969,152,373
SP,68853,PIRAPOZINHO,5608,3839,3163,16772,13609,475,967
SP,68870,PIRACUNUNGA,17043,9513,7629,46015,38386,1803,1694
SP,68896,PIRATININGA,2449,1888,1484,8334,6850,350,394
SP,68918,PITANGUEIRAS,6789,3927,5143,21128,15985,943,1371
SP,68934,PLANALTO,700,1150,585,2981,2396,128,157
SP,68950,PLATINA,561,765,517,2405,1888,73,158
SP,68977,POA,26095,10181,9720,66059,56339,1588,2472
SP,68993,POLONI,1003,1369,525,3634,3109,206,136
SP,69019,POMPEIA,4290,4366,2445,14241,11796,491,760
SP,69035,PONGAI,807,961,442,2966,2524,120,124
SP,69051,PONTAL,7403,3779,4974,20690,15716,915,1220
SP,69078,PONTES GESTAL,600,519,715,2475,1760,72,172
SP,69094,POPULINA,1074,937,518,3272,2754,158,276
SP,69116,PORANGABA,1374,1192,641,4443,3802,175,323
SP,69132,PORTO FELIZ,9121,7877,4358,29945,25587,1123,1407
SP,69159,PORTO FERREIRA,12735,5820,4646,32446,27800,1478,1383
SP,69175,POTIRENDABA,2999,2232,1776,10190,8414,895,595
SP,69191,PRADOPOLIS,4397,1958,1396,9934,8538,343,494
SP,69213,PRAIA GRANDE,37664,19716,24521,120919,96398,2933,4967
SP,69230,PRESIDENTE ALVES,824,471,489,3117,2628,85,145
SP,69256,PRESIDENTE BERNARDES,3912,2561,2008,10347,8339,388,402
SP,69272,PRESIDENTE EPITACIO,7074,6296,5435,25485,20050,666,1343
SP,69299,PRESIDENTE PRUDENTE,45543,29284,24612,138913,114301,3661,5639
SP,69310,PRESIDENTE VENCESLAU,7267,6763,5270,26807,21537,814,1467
SP,69337,PROMISSAO,8878,3508,4242,22795,18553,866,1033
SP,69353,QUATA,2483,1681,2153,9059,6906,411,503
SP,69370,QUEIROZ,544,550,258,1670,1412,39,129
SP,69396,QUELUZ,2313,1080,1326,6628,5302,178,404
SP,69418,QUINTANA,1195,1142,905,4365,3460,185,332
SP,69434,RAFARD,2373,1868,1258,7673,6415,272,401
SP,69450,RANCHARIA,6309,5853,4474,21296,16822,685,987
SP,69477,REDENCAO DA SERRA,971,1051,450,3361,2911,114,273
SP,69493,REGENTE FEIJO,4245,2824,1972,11959,9987,399,585
SP,69515,REGINOPOLIS,951,1127,592,3862,3270,185,195
SP,69531,REGISTRO,9716,10600,8518,37708,29190,720,1551
SP,69558,RESTINGA,1614,834,348,3690,3342,83,195
SP,69574,RIBEIRA,655,831,344,2266,1922,95,161
SP,69590,RIBEIRAO BONITO,2533,1592,2029,9053,7024,380,604
SP,69612,RIBEIRAO BRANCO,2634,4084,3260,12331,9071,516,729
SP,69639,RIBEIRAO CORRENTE,775,659,372,2526,2154,89,154
SP,69655,RIBEIRAO DO SUL,1575,718,748,3715,2967,115,165
SP,69671,RIBEIRAO PIRES,29799,10618,10074,72078,62004,1840,3139
SP,69698,RIBEIRAO PRETO,108111,86634,58095,345079,286984,8800,15217
SP,69710,RIVERSUL,1512,1676,1847,6242,4395,267,428
SP,69736,RIFAINA,906,720,479,2894,2415,91,145
SP,69752,RINCAO,2454,1661,1311,6971,5660,350,355
SP,69779,RINOPOLIS,1416,2752,846,6524,5678,275,348
SP,69795,RIO CLARO,41063,24860,15889,114146,98257,3294,5162
SP,69817,RIO DAS PEDRAS,5905,3780,3049,18638,15589,762,836
SP,69833,RIO GRANDE DA SERRA,10523,3592,5064,28393,23329,919,1514
SP,69850,RIOLANDIA,1357,1792,1814,6178,4364,327,361
SP,69876,ROSEIRA,1993,1637,985,5807,4822,117,146
SP,69892,RUBIACEA,387,613,241,1643,1402,69,145
SP,69914,RUBINEIA,820,419,424,2152,1728,76,150
SP,69930,SABINO,1478,819,541,3756,3215,154,216
SP,69957,SAGRES,364,609,205,1602,1397,45,146
SP,69973,SALES,964,1115,433,3283,2850,150,195
SP,69990,SALES OLIVEIRA,1787,2142,945,6372,5427,291,341
SP,70017,SALESOPOLIS,2475,3925,2154,11749,9595,465,818
SP,70033,SALMORAO,653,1164,444,3017,2573,103,200
SP,70050,SALTO,32119,10887,8552,64215,55663,1539,2531
SP,70076,SALTO DE PIRAPORA,7985,4761,3490,20908,17418,884,1061
SP,70092,SALTO GRANDE,1691,1047,1300,5817,4517,225,373
SP,70114,SANDOVALINA,1000,295,356,2226,1870,49,116
SP,70130,SANTA ADELIA,3938,1638,1630,9852,8222,436,493
SP,70157,SANTA ALBERTINA,869,1420,667,4010,3343,234,216
SP,70173,SANTA BARBARA D OESTE,49902,15111,13835,105378,91543,3307,3938
SP,70190,AGUAS DE SANTA BARBARA,1079,941,850,3836,2986,100,299
SP,70211,SANTA BRANCA,3233,2319,1808,9954,8146,243,560
SP,70238,SANTA CLARA D OESTE,473,734,407,1954,1547,79,84
SP,70254,SANTA CRUZ DA CONCEICAO,992,745,588,2926,2338,100,110
SP,70270,SANTA CRUZ DAS PALMEIRAS,6770,4173,2834,18014,15180,797,1114
SP,70297,SANTA CRUZ DO RIO PARDO,8482,8576,4475,28483,24008,1313,1484
SP,70319,SANTA ERNESTINA,2089,545,944,4640,3696,102,203
SP,70335,SANTA FE DO SUL,5936,5943,4189,20200,16011,848,919
SP,70351,SANTA GERTRUDES,4681,1826,1651,11605,9954,455,568
SP,70378,SANTA ISABEL,9071,7816,4205,30756,26551,1024,1842
SP,70394,SANTA LUCIA,3059,863,962,6341,5379,364,334
SP,70416,SANTA MARIA DA SERRA,968,736,870,3501,2631,131,247
SP,70432,SANTA MERCEDES,478,556,339,1863,1524,50,152
SP,70459,SANTANA DA PONTE PENSA,451,399,244,1539,1295,106,107
SP,70475,SANTANA DE PARNAIBA,12481,8721,7410,43029,35619,1247,1813
SP,70491,SANTA RITA D OESTE,762,684,303,2193,1890,156,119
SP,70513,SANTA RITA DO PASSA QUATRO,6885,4253,3245,19185,15940,786,882
SP,70530,SANTA ROSA DE VITERBO,6705,3335,2666,16217,13551,638,689
SP,70556,SANTO ANASTACIO,4707,3609,3415,15935,12520,760,840
SP,70572,SANTO ANDRE,231499,79703,71399,500320,428921,9259,19417
SP,70599,SANTO ANTONIO DA ALEGRIA,1603,734,671,4379,3708,156,264
SP,70610,SANTO ANTONIO DA POSSE,4009,3223,2137,12353,10216,546,616
SP,70637,SANTO ANTONIO DO JARDIM,1564,1502,967,5207,4240,238,285
SP,70653,SANTO ANTONIO DO PINHAL,1070,1685,1095,5004,3909,136,401
SP,70670,SANTO EXPEDITO,750,424,548,2509,1961,96,221
SP,70696,SANTOPOLIS DO AGUAPEI,726,774,388,2616,2228,127,284
SP,70718,SANTOS,132388,63611,48455,335023,286568,5495,9811
SP,70734,SAO BENTO DO SAPUCAI,1652,2291,1610,7580,5970,228,660
SP,70750,SAO BERNARDO DO CAMPO,230368,72780,65852,472848,406996,7474,16352
SP,70777,SAO CAETANO DO SUL,40255,26123,9484,104253,94769,1860,3743
SP,70793,SAO CARLOS,48153,32285,18583,132153,113570,4442,5753
SP,70815,SAO FRANCISCO,824,627,728,2674,1946,170,99
SP,70831,SAO JOAO DA BOA VISTA,20671,13453,7799,54399,46600,1666,2283
SP,70858,SAO JOAO DAS DUAS PONTES,735,562,541,2426,1885,86,265
SP,70874,SAO JOAO DO PAU D ALHO,495,627,204,1688,1484,58,121
SP,70890,SAO JOAQUIM DA BARRA,12486,5423,4317,28712,24395,927,1459
SP,70912,SAO JOSE DA BELA VISTA,1531,1152,1249,5461,4212,382,308
SP,70939,SAO JOSE DO BARREIRO,948,1033,820,3634,2814,82,237
SP,70955,SAO JOSE DO RIO PARDO,11972,9864,5482,34148,28666,1383,1277
SP,70971,SAO JOSE DO RIO PRETO,81534,63026,36988,243186,206198,6539,8248
SP,70998,SAO JOSE DOS CAMPOS,142879,68464,56176,353716,297540,5486,10710
SP,71013,SAO LUIS DO PARAITINGA,2256,3366,1489,9270,7781,403,609
SP,71030,SAO MANUEL,9046,4192,4316,26020,21704,1275,1857
SP,71056,SAO MIGUEL ARCANJO,5768,5468,3768,19861,16093,812,1020
SP,71072,SAO PAULO,2458748,1795001,1171493,7531597,6360104,184758,321460
SP,71099,SAO PEDRO,5133,5754,4039,19752,15713,766,997
SP,71110,SAO PEDRO DO TURVO,1269,1745,1104,5159,4055,217,285
SP,71137,SAO ROQUE,14127,13282,7032,45626,38594,1269,2184
SP,71153,SAO SEBASTIAO,10870,8097,7445,37240,29795,1031,1433
SP,71170,SAO SEBASTIAO DA GRAMA,2214,2237,1786,8247,6461,351,568
SP,71196,SAO SIMAO,3320,2467,1786,10154,8368,294,496
SP,71218,SAO VICENTE,73199,25297,28587,199147,170560,4620,6368
SP,71234,SARAPUI,1642,1832,1126,5753,4627,245,281
SP,71250,SARUTAIA,856,559,346,2457,2111,83,200
SP,71277,SEBASTIANOPOLIS DO SUL,573,792,301,2151,1850,136,120
SP,71293,SERRA AZUL,1702,1363,1083,5392,4309,137,377
SP,71315,SERRANA,7786,4849,3743,22794,19051,1186,1481
SP,71331,SERRA NEGRA,4450,5287,3638,18363,14725,686,969
SP,71358,SERTAOZINHO,28318,11092,10533,62648,52115,2433,2871
SP,71374,SETE BARRAS,2080,2218,2824,9560,6736,195,639
SP,71390,SEVERINIA,2899,2260,2152,9813,7661,522,647
SP,71412,SILVEIRAS,1106,1231,911,4497,3586,151,338
SP,71439,SOCORRO,5320,7105,4142,22918,18776,922,1714
SP,71455,SOROCABA,142897,69978,41601,324269,282668,6835,11028
SP,71471,SUD MENUCCI,2233,1366,1438,6173,4735,292,320
SP,71498,SUMARE,52901,15909,18171,116264,98093,2790,4206
SP,71510,SUZANO,55630,24213,21789,145038,123249,3678,5473
SP,71536,TABAPUA,2501,2002,1008,7624,6616,486,521
SP,71552,TABATINGA,3288,2126,1856,9667,7811,646,622
SP,71579,TABOAO DA SERRA,52460,32765,23901,148278,124377,4054,5965
SP,71595,TACIBA,1404,927,967,4499,3532,137,276
SP,71617,TAGUAI,1731,1778,1214,5546,4332,105,275
SP,71633,TAIACU,1135,949,740,3862,3122,228,210
SP,71650,TAIUVA,1419,990,775,4181,3406,151,214
SP,71676,TAMBAU,5201,4087,1826,14666,12840,612,853
SP,71692,TANABI,5257,4930,2997,17248,14251,630,502
SP,71714,TAPIRAI,989,1461,1298,5437,4139,123,389
SP,71730,TAPIRATIBA,4104,1629,1549,8935,7386,204,541
SP,71757,TAQUARITINGA,14538,5417,6001,35338,29337,1562,1855
SP,71773,TAQUARITUBA,5297,4106,3906,16168,12262,698,927
SP,71790,TARABAI,1765,803,1207,4925,3718,132,337
SP,71811,TATUI,18480,16938,10526,63798,53272,2418,3015
SP,71838,TAUBATE,68587,30310,27054,161095,134041,3455,4404
SP,71854,TEJUPA,1123,997,828,3708,2880,133,279
SP,71870,TEODORO SAMPAIO,3833,3409,3614,14178,10564,426,812
SP,71897,TERRA ROXA,2355,1391,1154,5853,4699,187,245
SP,71919,TIETE,5328,7922,2979,21556,18577,741,1005
SP,71935,TIMBURI,706,500,293,2050,1757,79,231
SP,71951,TORRINHA,2175,1214,992,6176,5184,322,381
SP,71978,TREMEMBE,6719,4636,2975,19438,16463,518,936
SP,71994,TRES FRONTEIRAS,1206,1141,652,3902,3250,224,224
SP,72010,TUPA,12141,13979,8513,44685,36172,1183,1685
SP,72036,TUPI PAULISTA,3121,3417,2267,10979,8712,301,541
SP,72052,TURIUBA,466,513,368,1812,1444,52,134
SP,72079,TURMALINA,597,491,302,1807,1505,142,104
SP,72095,UBATUBA,11281,10881,8043,43445,35402,1278,2083
SP,72117,UBIRAJARA,823,840,356,2736,2380,69,213
SP,72133,UCHOA,2103,2013,1223,6861,5638,344,340
SP,72150,UNIAO PAULISTA,318,482,202,1231,1029,64,48
SP,72176,URANIA,2192,1720,1422,7057,5635,387,442
SP,72192,URU,309,379,351,1316,965,56,56
SP,72214,URUPES,2086,3502,1678,8808,7130,275,420
SP,72230,VALENTIM GENTIL,1796,1931,1084,6066,4982,248,276
SP,72257,VALINHOS,25118,12603,10480,61723,51243,1737,2053
SP,72273,VALPARAIZO,3623,4197,2819,13299,10480,363,647
SP,72311,VARGEM GRANDE DO SUL,6990,7225,4287,24422,20135,1307,1216
SP,72338,VARZEA PAULISTA,30566,7136,7109,60217,53108,1246,2371
SP,72354,VERA CRUZ,3018,2039,1613,8488,6875,297,496
SP,72370,VINHEDO,12548,9432,5396,36786,31390,1336,1392
SP,72397,VIRADOURO,3587,2705,1924,11341,9417,446,538
SP,72419,VISTA ALEGRE DO ALTO,1350,754,605,3776,3171,339,212
SP,72435,VOTORANTIM,33553,8691,7400,63408,56008,1448,2239
SP,72451,VOTUPORANGA,16203,16027,8128,51736,43608,1539,1867
SP,72737,VARGEM GRANDE PAULISTA,7958,5464,4553,24419,19866,850,1033
TO,73008,ABREULANDIA,483,206,328,1560,1232,25,215
TO,73016,PIRAQUE,483,562,373,1825,1452,9,223
TO,73024,RIACHINHO,720,620,482,2439,1957,58,318
TO,73032,DARCINOPOLIS,726,686,442,2958,2516,82,464
TO,73040,PALMEIRAS DO TOCANTINS,532,862,551,2905,2354,61,493
TO,73059,MAURILANDIA DO TOCANTINS,355,705,326,2075,1749,62,355
TO,73067,CACHOEIRINHA,301,380,235,1265,1030,12,197
TO,73075,ANGICO,394,765,334,2087,1753,70,286
TO,73083,PALMEIRANTE,442,925,472,2354,1882,28,335
TO,73091,CAMPOS LINDOS,532,1039,737,3275,2538,55,461
TO,73105,SAO FELIX DO TOCANTINS,171,298,353,1123,770,3,155
TO,73113,LAGOA DO TOCANTINS,387,478,378,1777,1399,19,292
TO,73121,BOM JESUS DO TOCANTINS,434,476,400,1764,1364,39,288
TO,73130,SANTA MARIA DO TOCANTINS,450,381,300,1676,1376,32,294
TO,73148,NOVO ALEGRE,515,259,380,1641,1261,22,227
TO,73156,SANDOLANDIA,380,653,559,2320,1761,16,354
TO,73164,TAIPAS DO TOCANTINS,290,237,295,1329,1034,12,295
TO,73172,NOVO JARDIM,469,375,302,1519,1217,30,256
TO,73180,SAO MIGUEL DO TOCANTINS,1163,958,747,4101,3354,68,555
TO,73199,FORTALEZA DO TABOCAO,536,447,366,2064,1698,61,283
TO,73202,ITAPIRATINS,251,1053,491,2351,1860,68,362
TO,73210,CENTENARIO,467,279,397,1630,1233,27,331
TO,73229,RECURSOLANDIA,283,701,506,2138,1632,14,491
TO,73237,TUPIRATINS,216,340,263,1083,820,24,164
TO,73245,BRASILANDIA DO TOCANTINS,332,486,333,1606,1273,19,217
TO,73253,JUARINA,530,302,316,1512,1196,36,142
TO,73261,PAU D'ARCO,726,723,693,2794,2101,52,355
TO,73270,MATEIROS,167,156,291,1051,760,7,241
TO,73288,SAO BENTO DO TOCANTINS,479,899,505,2579,2074,30,312
TO,73296,ESPERANTINA,1577,813,901,4432,3531,70,802
TO,73300,CARIRI DO TOCANTINS,830,489,489,2410,1921,18,257
TO,73318,ARAGUANA,841,876,783,3300,2517,57,506
TO,73326,CARMOLANDIA,593,487,491,2129,1638,25,317
TO,73334,ARAGOMINAS,945,1226,969,4213,3244,55,546
TO,73342,MURICILANDIA,444,599,498,2208,1710,35,392
TO,73350,SANTA FE DO ARAGUAIA,1040,1134,1083,4236,3153,85,468
TO,73369,JAU DO TOCANTINS,528,599,582,2505,1923,33,372
TO,73377,SUCUPIRA,273,326,124,1073,949,17,157
TO,73385,LAGOA DA CONFUSAO,1243,495,706,3506,2800,42,522
TO,73393,SAO SALVADOR DO TOCANTINS,458,396,357,1669,1312,23,285
TO,73407,LAGEADO,593,403,617,2187,1570,16,269
TO,73415,RIO DOS BOIS,316,265,316,1551,1235,27,252
TO,73423,CARRASCO BONITO,532,710,589,2336,1747,49,302
TO,73431,RIO DA CONCEICAO,361,190,193,1044,851,8,172
TO,73440,PALMAS,41393,16087,17340,101323,83983,819,3936
TO,73458,TUPIRAMA,232,367,193,1093,900,23,156
TO,73466,OLIVEIRA DE FATIMA,244,146,195,955,760,19,106
TO,73474,CHAPADA DE AREIA,334,380,317,1549,1232,21,157
TO,73482,CHAPADA DA NATIVIDADE,541,544,486,2258,1772,20,495
TO,73504,TALISMA,549,290,426,1794,1368,23,221
TO,73512,AGUIARNOPOLIS,513,882,290,2321,2031,30,323
TO,73520,LUZINOPOLIS,362,485,186,1517,1331,11,279
TO,73539,SANTA TEREZINHA DO TOCANTINS,358,684,198,1599,1401,30,207
TO,73547,SANTA RITA DO TOCANTINS,291,339,269,1166,897,9,160
TO,73555,CRIXAS DO TOCANTINS,395,402,374,1456,1082,17,135
TO,73563,MONTE SANTO,459,496,268,1727,1459,21,213
TO,73571,PUGMIL,404,342,266,1459,1193,27,144
TO,73580,BANDEIRANTE DO TOCANTINS,506,556,419,2060,1641,25,332
TO,73598,IPUEIRAS,278,395,175,1070,895,8,120
TO,73601,LAVANDEIRA,244,243,122,1001,879,17,168
TO,73610,BARRA DO OURO,329,866,528,2390,1862,25,383
TO,92002,BERNARDO SAYAO,521,700,503,2573,2070,47,313
TO,92045,BURITI DO TOCANTINS,1270,1271,1016,5048,4032,109,728
TO,92070,ALMAS,1145,1089,1236,4757,3521,54,886
TO,92088,CASEARA,669,499,538,2416,1878,20,381
TO,92134,ALVORADA,1590,1294,1615,5939,4324,70,520
TO,92142,COMBINADO,664,612,650,3195,2545,55,483
TO,92185,DIVINOPOLIS DO TOCANTINS,1153,786,715,3890,3175,58,506
TO,92193,ANANAS,1457,1947,1461,6579,5118,91,795
TO,92240,GOIANORTE,610,1060,703,3477,2774,69,408
TO,92304,MARIANOPOLIS DO TOCANTINS,565,686,420,2258,1838,66,238
TO,92371,ARAGUACEMA,649,1094,885,3657,2772,40,555
TO,92398,ARAGUACU,1081,1425,1569,6665,5096,98,880
TO,92401,NOVA ROSALANDIA,554,563,359,2131,1772,28,257
TO,92410,ARAGUAINA,22576,15015,13151,68830,55679,1097,5030
TO,92436,ARAGUATINS,2953,4590,2892,14688,11796,205,1996
TO,92452,ARAPOEMA,1348,1081,1351,5385,4034,92,667
TO,92479,ARRAIAS,1750,1185,1982,7246,5264,131,1327
TO,92487,PEQUIZEIRO,790,806,743,3204,2461,45,459
TO,92509,PORTO ALEGRE DO TOCANTINS,501,439,349,1729,1380,14,291
TO,92525,PRAIA NORTE,1120,1091,1020,4254,3234,103,523
TO,92533,AURORA DO TOCANTINS,764,500,546,2618,2072,102,384
TO,92541,SAMPAIO,613,549,502,2105,1603,22,286
TO,92576,AXIXA DO TOCANTINS,1748,2159,1597,7610,6013,121,1314
TO,92584,SANTA ROSA DO TOCANTINS,698,807,549,2724,2175,26,476
TO,92592,BABACULANDIA,762,2323,1153,5751,4598,115,910
TO,92606,SANTA TEREZA DO TOCANTINS,478,241,277,1684,1407,24,167
TO,92681,SAO VALERIO DA NATIVIDADE,973,751,713,3224,2511,35,519
TO,92738,BREJINHO DE NAZARE,1023,816,614,3456,2842,57,498
TO,93114,COLINAS DO TOCANTINS,4845,3909,3507,17106,13599,250,2121
TO,93130,CONCEICAO DO TOCANTINS,641,525,740,2751,2011,78,462
TO,93211,COUTO DE MAGALHAES,777,705,861,3260,2399,49,521
TO,93238,CRISTALANDIA,1805,1139,1126,5463,4337,60,704
TO,93416,DIANOPOLIS,3446,1996,2209,9790,7581,113,1214
TO,93459,DOIS IRMAOS DO TOCANTINS,1247,956,864,4214,3350,112,700
TO,93475,DUERE,1082,627,650,3144,2494,39,388
TO,93556,FILADELFIA,954,1933,1207,5568,4361,93,808
TO,93653,FORMOSO DO ARAGUAIA,3684,2799,3285,13503,10218,264,1216
TO,93858,GURUPI,16066,7474,9712,45223,35511,584,2826
TO,94056,ITACAJA,720,1535,1146,4726,3580,52,669
TO,94099,ITAGUATINS,1289,1177,867,4414,3547,52,646
TO,94170,ITAPORA DO TOCANTINS,455,703,450,2070,1620,39,288
TO,94617,MIRACEMA DO TOCANTINS,4251,2707,3043,13908,10865,245,1565
TO,94633,MIRANORTE,2216,2711,1824,9262,7438,202,1009
TO,94692,MONTE DO CARMO,1132,850,802,3747,2945,31,559
TO,94811,NATIVIDADE,1256,1541,1310,5831,4521,62,937
TO,94838,NAZARE,748,1341,554,3532,2978,84,474
TO,94994,NOVO ACORDO,477,563,630,2580,1950,31,361
TO,95192,PARAISO DO TOCANTINS,6714,5489,3926,24645,20719,364,2131
TO,95214,PARANA,853,1530,1481,5771,4290,79,1366
TO,95257,PEDRO AFONSO,1610,1595,1138,5876,4738,139,644
TO,95273,PEIXE,1434,1623,1203,5863,4660,76,897
TO,95290,COLMEIA,1379,1385,1446,6774,5328,121,929
TO,95338,GOIATINS,1028,1977,1550,6556,5006,84,1240
TO,95370,PINDORAMA DO TOCANTINS,549,1012,590,3030,2440,35,506
TO,95478,PIUM,853,997,775,4000,3225,79,588
TO,95516,PONTE ALTA DO BOM JESUS,386,982,780,3172,2392,75,652
TO,95532,PONTE ALTA DO TOCANTINS,881,1181,803,4158,3355,65,736
TO,95591,PORTO NACIONAL,11666,3557,4991,27851,22860,328,2813
TO,95699,LIZARDA,311,956,618,2604,1986,53,488
TO,96032,SAO SEBASTIAO DO TOCANTINS,590,541,637,2593,1956,53,398
TO,96130,SITIO NOVO DO TOCANTINS,1912,1513,1372,6537,5165,77,986
TO,96156,TAGUATINGA,1355,2397,2065,8996,6931,155,1706
TO,96199,TOCANTINIA,954,702,833,3530,2697,46,573
TO,96210,TOCANTINOPOLIS,4550,2245,2304,12587,10283,278,1615
TO,96270,GUARAI,3633,3362,2879,14248,11369,273,1233
TO,96296,PRESIDENTE KENNEDY,836,550,647,2871,2224,104,419
TO,96431,XAMBIOA,2029,2074,2228,8686,6458,109,1228
TO,96490,PALMEIROPOLIS,792,1348,1319,5182,3863,69,589
TO,96598,SILVANOPOLIS,989,792,733,3503,2770,57,526
TO,96636,NOVA OLINDA,1497,1484,1981,6843,4862,82,978
TO,96652,WANDERLANDIA,1704,1662,1990,7072,5082,130,860
TO,96679,FIGUEIROPOLIS,1222,1004,880,4281,3401,73,421
TO,96792,RIO SONO,916,836,765,3375,2610,35,521
TO,96830,FATIMA,670,685,395,2654,2259,77,299
TO,96857,AUGUSTINOPOLIS,2381,2181,2252,9201,6949,175,1167
TO,96954,ALIANCA DO TOCANTINS,1513,916,1040,4546,3506,63,506
TO,96970,APARECIDA DO RIO NEGRO,430,816,558,2565,2007,37,337
TO,96997,BARROLANDIA,1318,822,838,4304,3466,66,543