CD_MUNICIPIO,NM_MUNICIPIO,"('QT_VOTOS', 13)","('QT_VOTOS', 16)","('QT_VOTOS', 23)","('QT_VOTOS', 29)","('QT_VOTOS', 40)","('QT_VOTOS', 45)","('QT_VOTOS', 95)","('QT_VOTOS', 96)","('QT_VOTOS', 97)",QTD_ABSTENCOES,QTD_APTOS_TOT,QTD_COMPARECIMENTO,QTD_VOTOS_BRANCOS,QTD_VOTOS_NULOS
19.0,GUAJARA MIRIM,7050,86,3480,4,3226,1940,272,1378,0,5022,22458,17436,272,1378
35.0,PORTO VELHO,80181,1209,21385,54,39198,22351,2223,7574,0,36811,210986,174175,2223,7574
51.0,JI PARANA,22829,211,4148,20,12331,12327,748,3075,0,16180,71869,55689,748,3075
78.0,ARIQUEMES,13062,173,2615,14,7210,11482,975,2735,0,11442,49708,38266,975,2735
94.0,CACOAL,15299,158,2825,9,8725,6744,694,2628,0,10307,47389,37082,694,2628
116.0,PIMENTA BUENO,6622,66,1540,1,3475,4333,353,1060,0,5072,22522,17450,353,1060
132.0,VILHENA,12840,83,2794,6,5061,5670,560,1639,0,8105,36758,28653,560,1639
159.0,JARU,10714,67,1854,3,7435,5370,803,2582,0,8678,37506,28828,803,2582
175.0,OURO PRETO DO OESTE,8654,49,1279,11,5094,3898,393,1799,0,6916,28093,21177,393,1799
191.0,PRESIDENTE MEDICI,5400,37,733,6,3836,2262,431,1215,0,4822,18742,13920,431,1215
213.0,COSTA MARQUES,1663,24,639,2,809,824,117,455,0,1524,6057,4533,117,455
230.0,COLORADO DO OESTE,4703,35,1018,2,2731,2091,347,917,0,4010,15854,11844,347,917
256.0,ESPIGAO D'OESTE,6292,34,1127,2,2497,2822,406,959,0,3404,17543,14139,406,959
272.0,CEREJEIRAS,3379,25,949,0,2717,2040,246,756,0,3425,13537,10112,246,756
299.0,ROLIM DE MOURA,9514,76,1791,1,5620,4751,617,1678,0,6705,30753,24048,617,1678
310.0,ALTA FLORESTA DO OESTE,6089,32,826,2,1903,3631,341,1093,0,3754,17671,13917,341,1093
337.0,ALVORADA DO OESTE,3025,28,658,3,3319,1935,257,827,0,3520,13572,10052,257,827
353.0,SANTA LUZIA DO OESTE,2626,13,315,3,1221,1461,150,526,0,2155,8470,6315,150,526
370.0,NOVA BRASILANDIA,3347,28,610,0,2551,2440,249,891,0,2340,12456,10116,249,891
396.0,MACHADINHO DO OESTE,4284,15,521,0,1877,2516,303,1508,0,2849,13873,11024,303,1508
418.0,SAO MIGUEL DO GUAPORE,2661,19,634,2,1821,1837,236,655,0,2035,9900,7865,236,655
434.0,NOVA MAMORE,1744,20,965,0,1256,962,196,624,0,1716,7483,5767,196,624
450.0,CABIXI,1574,10,191,1,929,632,174,343,0,1162,5016,3854,174,343
477.0,CANDEIAS DO JAMARI,1764,28,477,0,1013,584,124,403,0,819,5212,4393,124,403
493.0,ITAPUA DO OESTE,870,3,289,0,560,448,57,255,0,315,2797,2482,57,255
515.0,NOVO HORIZONTE DO OESTE,2679,9,280,1,1561,1074,133,648,0,1863,8248,6385,133,648
531.0,CASTANHEIRAS,961,6,137,0,340,389,29,193,0,232,2287,2055,29,193
558.0,VALE DO PARAISO,2091,7,166,1,1107,744,93,602,0,1512,6323,4811,93,602
566.0,URUPA,2737,12,294,1,1957,857,224,662,0,2153,8897,6744,224,662
574.0,MIRANTE DA SERRA,2254,4,306,2,2372,975,133,608,0,2169,8823,6654,133,608
582.0,SERINGUEIRAS,2097,8,357,2,1081,710,94,501,0,1306,6156,4850,94,501
590.0,THEOBROMA,2109,14,219,3,1357,714,159,614,0,1731,6920,5189,159,614
604.0,MINISTRO ANDREAZZA,2453,8,176,1,1590,443,64,525,0,1532,6792,5260,64,525
612.0,GOVERNADOR JORGE TEIXEIRA,2161,9,231,0,1568,876,178,803,0,2016,7842,5826,178,803
620.0,CACAULANDIA,1214,16,157,1,518,849,89,332,0,639,3815,3176,89,332
639.0,ALTO PARAISO,1749,7,666,0,1317,1821,246,569,0,1926,8301,6375,246,569
647.0,RIO CRESPO,666,8,99,0,325,500,66,220,0,620,2504,1884,66,220
655.0,CORUMBIARA,1954,9,177,1,1116,666,105,349,0,1124,5501,4377,105,349
663.0,MONTE NEGRO,2188,9,375,2,1091,1465,186,696,0,1999,8011,6012,186,696
671.0,CAMPO NOVO DE RONDONIA,1298,11,245,1,969,862,156,510,0,1411,5463,4052,156,510
680.0,CUJUBIM,1173,4,184,1,678,799,124,338,0,910,4211,3301,124,338
698.0,VALE DO ANARI,1214,2,138,0,722,576,55,460,0,997,4164,3167,55,460
701.0,PARECIS,786,2,144,0,391,594,43,279,0,718,2957,2239,43,279
710.0,SAO FELIPE D OESTE,1383,12,213,0,656,1034,58,383,0,1094,4833,3739,58,383
728.0,PRIMAVERA DE RONDONIA,1077,13,157,0,495,626,55,202,0,697,3322,2625,55,202
736.0,ALTO ALEGRE DOS PARECIS,2300,27,345,1,813,821,165,345,0,1258,6075,4817,165,345
744.0,NOVA UNIAO,1854,6,156,2,1072,349,144,432,0,1133,5148,4015,144,432
752.0,TEIXEIROPOLIS,1364,14,132,1,517,679,50,416,0,1147,4320,3173,50,416
779.0,BURITIS,4229,26,665,1,2403,2117,384,1086,0,3153,14064,10911,384,1086
787.0,PIMENTEIRAS DO OESTE,458,1,206,0,193,208,15,96,0,338,1515,1177,15,96
795.0,SAO FRANCISCO DO GUAPORE,1601,8,482,2,1204,1316,115,373,0,1441,6542,5101,115,373
809.0,CHUPINGUAIA,1043,4,293,0,246,585,38,195,0,882,3286,2404,38,195
1007.0,BUJARI,1243,2,471,0,436,623,60,353,0,533,3721,3188,60,353
1015.0,CAPIXABA,1199,3,572,1,250,553,43,192,0,869,3682,2813,43,192
1023.0,PORTO ACRE,2299,9,953,1,1025,1060,84,619,0,2166,8216,6050,84,619
1031.0,SANTA ROSA,491,0,12,0,48,77,16,88,0,327,1059,732,16,88
1040.0,MARECHAL THAUMATURGO,1073,4,174,0,153,1473,26,432,0,1447,4782,3335,26,432
1058.0,BRASILEIA,4548,12,1108,4,939,2257,171,795,0,2400,12234,9834,171,795
1066.0,PORTO WALTER,1130,5,106,0,144,1137,36,373,0,1203,4134,2931,36,373
1074.0,CRUZEIRO DO SUL,8362,45,7401,3,3971,7667,408,2389,0,10024,40270,30246,408,2389
1082.0,RODRIGUES ALVES,1277,3,350,0,285,1586,59,566,0,1605,5731,4126,59,566
1090.0,MANCIO LIMA,1903,4,496,0,572,2067,114,630,0,1551,7337,5786,114,630
1104.0,JORDAO,860,3,69,0,82,468,41,294,0,838,2655,1817,41,294
1112.0,EPITACIOLANDIA,2559,6,759,1,635,666,88,428,0,1404,6546,5142,88,428
1120.0,ACRELANDIA,2032,2,503,1,909,1196,82,486,0,1211,6422,5211,82,486
1139.0,FEIJO,5729,9,862,2,596,1049,121,977,0,3587,12932,9345,121,977
1392.0,RIO BRANCO,64418,186,22565,27,29103,18209,1496,6844,0,32498,175346,142848,1496,6844
1457.0,SENA MADUREIRA,6055,25,1960,1,2233,2654,257,1403,0,4373,18961,14588,257,1403
1473.0,TARAUACA,5894,17,1194,3,707,2080,414,1747,0,4572,16628,12056,414,1747
1490.0,XAPURI,3023,5,884,1,737,1436,97,700,0,2336,9219,6883,97,700
1511.0,PLACIDO DE CASTRO,2975,11,1393,2,1395,1325,112,713,0,2201,10127,7926,112,713
1538.0,SENADOR GUIOMARD,4616,8,1698,2,1334,1419,159,857,0,2734,12827,10093,159,857
1554.0,MANUEL URBANO,1019,5,272,0,372,661,54,417,0,999,3799,2800,54,417
1570.0,ASSIS BRASIL,1294,2,193,1,303,587,30,271,0,477,3158,2681,30,271
2003.0,APUI,1456,9,497,0,642,1140,76,363,0,3242,7425,4183,76,363
2011.0,NOVO AYRAO,1369,13,421,0,663,1085,79,342,0,1713,5685,3972,79,342
2020.0,GUAJARA,1105,5,1173,0,465,763,97,563,0,3985,8156,4171,97,563
2038.0,ANORI,963,6,995,2,980,1101,65,472,0,1834,6418,4584,65,472
2046.0,CAREIRO DA VARZEA,2226,23,1366,1,1949,1789,87,789,0,2842,11072,8230,87,789
2054.0,ATALAIA DO NORTE,553,1,481,1,513,274,36,327,0,1282,3468,2186,36,327
2070.0,AUTAZES,2214,7,1101,0,1711,2887,134,706,0,4234,12994,8760,134,706
2097.0,BARCELOS,1057,4,484,0,564,1491,35,278,0,1713,5626,3913,35,278
2119.0,BARREIRINHA,3134,23,1223,0,881,2508,112,844,0,2903,11628,8725,112,844
2135.0,BENJAMIN CONSTANT,4106,3,1134,3,1157,1915,170,1140,0,3832,13460,9628,170,1140
2151.0,BOCA DO ACRE,2198,15,1054,5,2290,2358,198,919,0,5008,14045,9037,198,919
2178.0,BORBA,2722,19,1739,1,1365,1913,143,1064,0,4006,12972,8966,143,1064
2194.0,CANUTAMA,728,7,369,0,872,545,71,279,0,1526,4397,2871,71,279
2216.0,CARAUARI,2350,3,1061,4,753,2654,119,986,0,4823,12753,7930,119,986
2232.0,CAREIRO,3367,18,1330,1,2340,1382,194,1050,0,4432,14114,9682,194,1050
2259.0,COARI,9776,33,3800,0,2856,1693,203,1636,0,8430,28427,19997,203,1636
2275.0,CODAJAS,1621,14,1598,2,2088,829,107,533,0,3523,10315,6792,107,533
2291.0,EIRUNEPE,2295,23,1502,1,1200,1443,457,1170,0,5262,13353,8091,457,1170
2313.0,ENVIRA,678,6,889,1,839,1117,68,567,0,3661,7826,4165,68,567
2330.0,FONTE BOA,1600,7,1578,0,1009,1213,99,669,0,3141,9316,6175,99,669
2356.0,HUMAITA,3712,43,2197,3,3724,2102,295,834,0,3019,15929,12910,295,834
2372.0,SANTA ISABEL DO RIO NEGRO,516,1,929,0,245,675,52,354,0,1661,4433,2772,52,354
2399.0,IPIXUNA,845,4,620,0,489,1345,87,453,0,3425,7268,3843,87,453
2410.0,ITACOATIARA,19219,45,5956,2,4894,3816,309,1107,0,11034,46382,35348,309,1107
2437.0,ITAPIRANGA,1312,6,610,0,538,607,30,224,0,934,4261,3327,30,224
2453.0,JAPURA,147,0,180,0,311,396,16,136,0,1027,2213,1186,16,136
2470.0,JURUA,157,2,1087,0,369,349,26,363,0,1545,3898,2353,26,363
2496.0,JUTAI,649,4,1082,2,578,1229,83,616,0,2468,6711,4243,83,616
2518.0,LABREA,3978,15,1515,4,1764,1085,177,1166,0,5714,15418,9704,177,1166
2534.0,MANACAPURU,10739,77,3345,6,9224,4568,292,2333,0,10955,41539,30584,292,2333
2550.0,MANAUS,362024,4379,84289,227,167377,70515,8310,22784,0,124884,844789,719905,8310,22784
2577.0,MANICORE,2390,27,2409,2,1279,4245,216,1420,0,5248,17236,11988,216,1420
2593.0,MARAA,908,3,804,1,410,393,47,353,0,2786,5705,2919,47,353
2615.0,MAUES,9182,28,1981,2,1340,2207,223,1470,0,6506,22939,16433,223,1470
2631.0,NHAMUNDA,1695,14,971,1,467,3241,76,537,0,2601,9603,7002,76,537
2658.0,NOVA OLINDA DO NORTE,1716,15,1286,1,973,2410,120,758,0,3583,10862,7279,120,758
2674.0,NOVO ARIPUANA,1049,5,1235,1,1342,1119,147,600,0,2871,8369,5498,147,600
2690.0,PARINTINS,14005,85,5838,5,3628,8315,534,1888,0,10048,44346,34298,534,1888
2712.0,PAUINI,960,2,472,0,905,1086,125,442,0,3222,7214,3992,125,442
2739.0,SANTO ANTONIO DO ICA,689,8,516,0,528,2304,133,856,0,2510,7544,5034,133,856
2755.0,SAO PAULO DE OLIVENCA,2137,10,644,0,613,2635,170,519,0,1479,8207,6728,170,519
2771.0,SILVES,2471,6,241,1,397,280,59,211,0,951,4617,3666,59,211
2798.0,TAPAUA,375,3,765,0,1621,1458,107,416,0,2188,6933,4745,107,416
2810.0,TEFE,6965,35,2691,3,4044,1896,210,1434,0,11443,28721,17278,210,1434
2836.0,SAO GABRIEL DA CACHOEIRA,5263,17,2054,2,684,1232,257,1143,0,6018,16670,10652,257,1143
2852.0,URUCARA,3185,5,349,3,576,1070,77,394,0,2057,7716,5659,77,394
2879.0,URUCURITUBA,3065,9,470,1,813,720,104,416,0,1963,7561,5598,104,416
2895.0,ALVARAES,1791,7,789,0,603,364,46,413,0,1745,5758,4013,46,413
2917.0,AMATURA,374,1,671,0,358,470,92,326,0,1003,3295,2292,92,326
2933.0,ANAMA,821,7,367,0,441,1202,37,269,0,1587,4731,3144,37,269
2950.0,BERURI,489,3,444,0,707,1370,29,452,0,1059,4553,3494,29,452
2976.0,BOA VISTA DE RAMOS,2664,2,451,0,341,511,80,347,0,1852,6248,4396,80,347
2992.0,CAAPIRANGA,854,2,384,1,930,578,45,217,0,1877,4888,3011,45,217
3000.0,CAROEBE,1252,13,387,4,696,606,48,417,0,644,4067,3423,48,417
3018.0,BOA VISTA,48209,497,17304,106,26346,11543,1144,6466,0,20050,131665,111615,1144,6466
3026.0,IRACEMA,1412,6,421,2,575,358,43,364,0,624,3805,3181,43,364
3034.0,CARACARAI,2959,26,1151,1,1574,1040,76,771,0,1796,9394,7598,76,771
3042.0,AMAJARI,1183,7,733,1,755,320,58,290,0,818,4165,3347,58,290
3050.0,ALTO ALEGRE,2471,36,1398,5,1420,582,90,675,0,1201,7878,6677,90,675
3069.0,CANTA,2589,12,1004,4,1301,545,61,669,0,1340,7525,6185,61,669
3077.0,BONFIM,1138,8,902,1,909,590,39,439,0,799,4825,4026,39,439
3085.0,RORAINOPOLIS,2740,38,991,1,1343,1075,100,818,0,1480,8586,7106,100,818
3093.0,MUCAJAI,2580,14,1317,4,1399,709,86,582,0,1292,7983,6691,86,582
3107.0,UIRAMUTA,370,1,308,1,627,154,36,284,0,509,2290,1781,36,284
3115.0,NORMANDIA,1027,7,638,6,962,323,39,337,0,615,3954,3339,39,337
3123.0,PACARAIMA,1099,11,746,1,798,384,38,361,0,947,4385,3438,38,361
3131.0,SAO JOAO DA BALIZA,1413,12,337,2,513,505,40,386,0,551,3759,3208,40,386
3158.0,SAO LUIZ DO ANAUA,1510,5,426,1,756,461,46,391,0,647,4243,3596,46,391
4006.0,GOIANESIA DO PARA,2926,7,696,2,1801,2244,409,1096,0,3498,12679,9181,409,1096
4014.0,ABAETETUBA,31877,92,1495,4,7226,11121,633,2059,0,8842,63349,54507,633,2059
4022.0,TAILANDIA,5219,21,1142,0,2775,4888,391,1710,0,8834,24980,16146,391,1710
4030.0,ACARA,4987,15,469,5,3399,5599,365,1654,0,6486,22979,16493,365,1654
4049.0,BOM JESUS DO TOCANTINS,1877,6,256,2,838,1519,199,669,0,2250,7616,5366,199,669
4057.0,AFUA,3323,4,263,1,1146,2003,109,1146,0,4603,12598,7995,109,1146
4065.0,SAO JOAO DE PIRABAS,1639,16,996,1,1235,2879,266,815,0,2698,10545,7847,266,815
4073.0,ALENQUER,6332,15,1511,3,4686,6299,259,1522,0,8480,29107,20627,259,1522
4081.0,TUCUMA,4324,17,1906,3,2419,1933,428,1119,0,4627,16776,12149,428,1119
4090.0,ALMERIM,5911,19,642,2,2383,2948,343,798,0,5776,18822,13046,343,798
4103.0,MAE DO RIO,3874,20,1255,3,1655,4704,236,1008,0,3963,16718,12755,236,1008
4111.0,ALTAMIRA,11691,69,4134,1,4517,8716,792,2771,0,10016,42707,32691,792,2771
4120.0,ELDORADO DO CARAJAS,2887,13,728,0,1606,1629,401,963,0,3714,11941,8227,401,963
4138.0,ANAJAS,648,5,291,2,946,2418,37,436,0,3103,7886,4783,37,436
4146.0,SANTA LUZIA DO PARA,3485,10,411,0,745,2489,146,767,0,2277,10330,8053,146,767
4154.0,ANANINDEUA,66246,652,13139,33,38576,21502,2136,6086,0,24348,172718,148370,2136,6086
4162.0,PALESTINA DO PARA,628,5,124,0,385,1494,76,377,0,1045,4134,3089,76,377
4170.0,AUGUSTO CORREA,1720,14,2717,1,1737,7369,403,2140,0,5364,21465,16101,403,2140
4189.0,IPIXUNA DO PARA,2376,5,411,0,525,3034,129,697,0,2681,9858,7177,129,697
4197.0,AVEIRO,1800,10,551,0,507,1490,99,370,0,1652,6479,4827,99,370
4200.0,JACAREACANGA,1194,1,488,0,270,1482,59,247,0,2212,5953,3741,59,247
4219.0,BAGRE,1264,2,93,0,908,1086,74,508,0,2745,6680,3935,74,508
4227.0,BRASIL NOVO,2472,5,472,0,920,2556,200,632,0,2000,9257,7257,200,632
4235.0,BAIAO,4005,16,556,0,1193,3179,288,905,0,2446,12588,10142,288,905
4243.0,SANTA BARBARA DO PARA,2304,19,300,2,1871,2176,98,455,0,1218,8443,7225,98,455
4251.0,BARCARENA,14340,41,1466,1,7652,3772,375,1839,0,6853,36339,29486,375,1839
4260.0,AGUA AZUL DO NORTE,1651,4,331,1,956,1167,201,631,0,2421,7363,4942,201,631
4278.0,BELEM,321197,3900,79711,226,155998,124389,8868,21581,0,132182,848052,715870,8868,21581
4286.0,TRAIRAO,780,2,220,1,317,2159,104,387,0,1566,5536,3970,104,387
4294.0,BENEVIDES,6600,44,1052,4,4080,4297,236,992,0,3024,20329,17305,236,992
4308.0,PAU D'ARCO,1201,0,434,0,636,741,110,474,0,1346,4942,3596,110,474
4316.0,BONITO,893,2,355,0,794,3105,76,544,0,1468,7237,5769,76,544
4324.0,ULIANOPOLIS,1521,8,648,2,770,1930,178,566,0,2390,8013,5623,178,566
4332.0,BRAGANCA,9778,83,5484,14,6207,15001,531,2295,217,14414,54024,39610,531,2295
4340.0,AURORA DO PARA,1964,8,702,0,1033,2461,128,988,0,2604,9888,7284,128,988
4359.0,BREVES,9314,19,750,0,3276,6280,416,2058,0,17587,39700,22113,416,2058
4367.0,TERRA SANTA,2139,8,360,1,747,2058,110,439,0,1505,7367,5862,110,439
4375.0,BUJARU,3575,9,334,1,1231,2465,182,775,0,3101,11673,8572,182,775
4383.0,NOVO PROGRESSO,2363,15,875,0,644,1660,255,499,0,3059,9370,6311,255,499
4391.0,CACHOEIRA DO ARARI,2326,16,792,0,2190,1504,198,747,0,3157,10930,7773,198,747
4405.0,VITORIA DO XINGU,1288,9,340,0,600,1784,88,462,0,1558,6129,4571,88,462
4413.0,CAMETA,13255,89,1867,9,4967,18606,674,2977,0,10077,52521,42444,674,2977
4421.0,NOVO REPARTIMENTO,5725,17,902,4,2799,5612,536,2009,0,6032,23636,17604,536,2009
4430.0,CAPANEMA,8926,142,4801,7,4972,7873,686,1545,0,8841,37793,28952,686,1545
4448.0,BREU BRANCO,4276,4,683,3,2024,5708,270,1129,0,4157,18254,14097,270,1129
4456.0,CAPITAO POCO,4441,12,3430,2,2297,6590,613,1971,0,5975,25331,19356,613,1971
4464.0,SAO DOMINGOS DO ARAGUAIA,2830,14,765,1,1437,2117,226,1128,0,3025,11543,8518,226,1128
4472.0,CASTANHAL,22072,180,7654,9,9814,17398,1109,3362,0,13129,74727,61598,1109,3362
4480.0,NOVA ESPERANCA DO PIRIA,1121,2,186,0,887,2064,123,571,0,1950,6904,4954,123,571
4499.0,CHAVES,939,6,548,2,1211,1980,124,725,0,3047,8582,5535,124,725
4502.0,ABEL FIGUEIREDO,1576,3,131,0,398,741,63,434,0,1109,4455,3346,63,434
4510.0,COLARES,1774,8,357,0,815,1782,114,475,0,1208,6533,5325,114,475
4529.0,CUMARU DO NORTE,574,2,168,0,498,794,34,247,0,1015,3332,2317,34,247
4537.0,CONCEICAO DO ARAGUAIA,7631,25,2050,0,3034,3984,443,1976,0,11615,30758,19143,443,1976
4545.0,TERRA ALTA,2140,9,318,1,1069,798,109,393,0,1255,6092,4837,109,393
4553.0,CURRALINHO,2370,4,189,0,1138,1949,103,596,0,2655,9004,6349,103,596
4561.0,FLORESTA DO ARAGUAIA,1961,5,441,2,987,1754,150,922,0,3881,10103,6222,150,922
4570.0,CURUCA,5127,20,858,2,1856,5145,242,1206,0,3615,18071,14456,242,1206
4588.0,BANNACH,626,0,156,1,344,666,49,238,0,959,3039,2080,49,238
4596.0,FARO,1616,2,320,0,485,427,62,282,0,822,4016,3194,62,282
4600.0,NOVA IPIXUNA,2052,4,330,1,861,1634,125,722,0,2357,8086,5729,125,722
4618.0,GURUPA,3506,6,124,0,283,1940,79,583,0,2303,8824,6521,79,583
4626.0,PLACAS,1724,5,389,0,871,1560,185,463,0,1322,6519,5197,185,463
4634.0,IGARAPE ACU,4570,26,1921,2,2097,3930,373,1318,0,1932,16169,14237,373,1318
4642.0,MARITUBA,13173,96,2122,3,6462,5849,596,1862,0,6518,36681,30163,596,1862
4650.0,IGARAPE-MIRI,9481,33,967,3,5042,5689,487,2128,0,6904,30734,23830,487,2128
4669.0,TRACUATEUA,2099,7,652,0,1289,4857,200,1408,0,3494,14006,10512,200,1408
4677.0,INHANGAPI,1291,4,372,0,766,2019,123,451,0,1601,6627,5026,123,451
4685.0,QUATIPURU,874,7,674,0,561,2074,149,449,0,1772,6560,4788,149,449
4693.0,IRITUIA,5044,30,625,2,3088,3775,379,1253,0,3772,17968,14196,379,1253
4707.0,CANAA DOS CARAJAS,2175,5,397,0,1396,706,217,517,0,2086,7499,5413,217,517
4715.0,ITAITUBA,8460,54,7457,6,6709,12648,603,2795,0,17180,55912,38732,603,2795
4723.0,ANAPU,1239,3,234,1,497,2152,164,542,0,1789,6621,4832,164,542
4731.0,ITUPIRANGA,6864,12,1505,2,1648,2500,407,1650,0,6302,20890,14588,407,1650
4740.0,CURUA,1268,4,211,4,317,1852,123,376,0,983,5138,4155,123,376
4758.0,JACUNDA,6120,32,1712,4,3868,5637,607,1995,0,7435,27410,19975,607,1995
4766.0,CACHOEIRA DO PIRIA,1484,4,213,0,816,2148,132,447,0,2458,7702,5244,132,447
4774.0,JURUTI,5044,7,387,0,1533,3438,112,1075,0,3579,15175,11596,112,1075
4782.0,PICARRA,963,0,472,1,439,1339,125,587,0,2198,6124,3926,125,587
4790.0,LIMOEIRO DO AJURU,3138,6,128,0,1301,2943,195,782,0,2343,10836,8493,195,782
4804.0,BELTERRA,3638,9,687,1,772,1459,145,794,0,1638,9143,7505,145,794
4812.0,MAGALHAES BARATA,1525,4,239,0,690,1782,58,299,0,1252,5849,4597,58,299
4820.0,SAO JOAO DA PONTA,756,3,113,1,379,1349,65,185,0,853,3704,2851,65,185
4839.0,MARABA,32942,89,6307,3,11252,12642,1106,4700,0,19849,88890,69041,1106,4700
4847.0,SAPUCAIA,751,6,161,1,391,739,81,299,0,1080,3509,2429,81,299
4855.0,MARACANA,2762,16,1631,2,2570,5271,344,1282,0,4658,18536,13878,344,1282
4871.0,MARAPANIM,3942,21,1161,1,2194,3833,224,1004,0,3159,15539,12380,224,1004
4898.0,MELGACO,874,5,90,0,661,2227,156,490,0,4215,8718,4503,156,490
4910.0,MOCAJUBA,3283,5,770,0,1727,3701,248,623,0,2723,13080,10357,248,623
4936.0,MOJU,8626,19,1240,1,3026,5819,281,2177,0,8819,30008,21189,281,2177
4952.0,MONTE ALEGRE,10570,20,1666,0,4432,5494,333,1288,0,6125,29928,23803,333,1288
4979.0,MUANA,4081,12,420,2,1743,3252,272,1030,0,3287,14099,10812,272,1030
4995.0,NOVA TIMBOTEUA,2585,8,459,1,832,2127,191,567,0,1243,8013,6770,191,567
5010.0,OBIDOS,10540,23,1343,3,2239,3783,423,1332,0,6557,26243,19686,423,1332
5037.0,OEIRAS DO PARA,2658,10,172,1,1348,3646,109,926,0,2334,11204,8870,109,926
5053.0,ORIXIMINA,10968,22,2084,2,2780,4675,356,1983,0,6461,29331,22870,356,1983
5070.0,OUREM,2714,29,433,1,507,2698,181,903,0,2018,9484,7466,181,903
5096.0,PARAGOMINAS,9538,24,3024,3,5204,8884,639,2803,0,13595,43714,30119,639,2803
5118.0,PEIXE-BOI,1039,5,760,1,917,1336,87,522,0,897,5564,4667,87,522
5134.0,PONTA DE PEDRAS,1987,22,1446,0,2267,2299,215,909,0,3251,12396,9145,215,909
5150.0,PORTEL,3488,11,415,0,1090,5345,156,1345,0,7509,19359,11850,156,1345
5177.0,PORTO DE MOZ,2757,6,177,0,783,2247,88,593,0,3065,9716,6651,88,593
5193.0,PRAINHA,3763,4,479,3,1434,2785,177,1179,0,3313,13137,9824,177,1179
5215.0,PRIMAVERA,1128,5,510,0,456,3200,94,598,0,1868,7859,5991,94,598
5231.0,SALINOPOLIS,5199,17,874,1,1870,4493,255,1105,0,3509,17323,13814,255,1105
5258.0,SALVATERRA,1900,16,412,1,1152,2917,160,608,0,2177,9343,7166,160,608
5274.0,SANTA CRUZ DO ARARI,1085,3,184,1,845,573,77,286,0,1052,4106,3054,77,286
5290.0,SANTA IZABEL DO PARA,6510,73,1984,1,5278,5414,640,1730,0,4464,26094,21630,640,1730
5312.0,SANTA MARIA DO PARA,2950,22,1394,2,1391,3466,263,1270,0,3257,14015,10758,263,1270
5339.0,SANTANA DO ARAGUAIA,1809,9,1149,0,1222,2534,229,1392,0,3657,12001,8344,229,1392
5355.0,SANTAREM,55950,344,23274,21,24335,13261,1426,7506,0,33386,159503,126117,1426,7506
5371.0,SANTAREM NOVO,1041,4,213,0,410,1777,80,376,0,1134,5035,3901,80,376
5398.0,SANTO ANTONIO DO TAUA,3363,9,528,2,2493,3800,203,967,0,2581,13946,11365,203,967
5410.0,SAO CAETANO DE ODIVELAS,2460,12,474,0,1112,3082,226,580,0,2405,10351,7946,226,580
5436.0,SAO DOMINGOS DO CAPIM,2997,13,771,0,992,4498,261,1228,0,3597,14357,10760,261,1228
5452.0,SAO FELIX DO XINGU,3959,16,2137,5,2006,1995,362,1318,0,5090,16888,11798,362,1318
5479.0,SAO FRANCISCO DO PARA,1899,21,441,0,932,2942,154,482,0,1241,8112,6871,154,482
5495.0,SAO JOAO DO ARAGUAIA,1679,6,425,0,878,851,159,489,0,1185,5672,4487,159,489
5517.0,SAO MIGUEL DO GUAMA,5238,37,1950,3,2050,6968,280,1074,0,5783,23383,17600,280,1074
5533.0,SAO SEBASTIAO DA BOA VISTA,3791,13,150,2,1235,2095,146,597,0,2939,10968,8029,146,597
5550.0,SENADOR JOSE PORFIRIO,1502,0,400,0,456,1114,64,374,0,1724,5634,3910,64,374
5576.0,SOURE,3228,27,2283,2,1867,1780,209,740,0,3186,13322,10136,209,740
5592.0,TOME ACU,6265,14,1333,3,3579,5649,575,2190,0,7068,26676,19608,575,2190
5614.0,TUCURUI,15502,79,2601,4,7731,9348,952,2732,0,9412,48361,38949,952,2732
5630.0,VIGIA,6918,63,2384,4,3182,4504,684,1499,0,5415,24653,19238,684,1499
5657.0,VIZEU,5740,17,1279,2,4939,5785,703,2422,0,8700,29587,20887,703,2422
5673.0,REDENCAO,10298,34,3214,2,7308,7264,910,2937,0,9667,41634,31967,910,2937
5690.0,RIO MARIA,3446,18,684,2,1506,1814,281,926,0,3959,12636,8677,281,926
5711.0,XINGUARA,5920,19,1330,0,3093,3740,565,1644,0,6283,22594,16311,565,1644
5738.0,RONDON DO PARA,6717,20,1690,2,2675,3753,497,1881,0,7542,24777,17235,497,1881
5754.0,URUARA,4392,14,1376,1,1755,4567,507,1496,0,4054,18162,14108,507,1496
5770.0,MEDICILANDIA,2953,9,1003,0,1139,3331,294,1085,0,2617,12431,9814,294,1085
5797.0,SAO GERALDO DO ARAGUAIA,2886,8,668,3,1720,4340,398,1495,0,5709,17227,11518,398,1495
5819.0,CONCORDIA DO PARA,3311,10,475,2,1470,2999,273,1113,0,4584,14237,9653,273,1113
5835.0,PARAUAPEBAS,18238,88,2907,3,8156,5050,1327,3012,0,11607,50388,38781,1327,3012
5851.0,CURIONOPOLIS,3196,11,1121,0,1772,2470,311,1080,0,5215,15176,9961,311,1080
5878.0,GARRAFAO DO NORTE,1529,9,2534,3,775,2594,418,1117,0,3543,12522,8979,418,1117
5894.0,RUROPOLIS,2718,6,540,1,936,3992,184,703,0,2794,11874,9080,184,703
5916.0,PACAJA,2994,4,720,1,1257,4088,419,1108,0,3662,14253,10591,419,1108
5932.0,BREJO GRANDE DO ARAGUAIA,1132,3,390,1,672,872,76,458,0,1471,5075,3604,76,458
5959.0,OURILANDIA DO NORTE,1998,10,566,3,1509,1568,174,725,0,3091,9644,6553,174,725
5975.0,DOM ELISEU,4369,12,2017,2,2189,4110,511,1629,0,5664,20503,14839,511,1629
5991.0,SANTA MARIA DAS BARREIRAS,931,1,409,1,613,1289,94,497,0,2337,6172,3835,94,497
6009.0,PRACUUBA,304,3,246,0,379,68,8,80,0,92,1180,1088,8,80
6017.0,AMAPA,1472,17,659,1,965,225,29,244,0,577,4189,3612,29,244
6025.0,PORTO GRANDE,1827,17,767,1,1080,428,46,322,0,338,4826,4488,46,322
6033.0,CALCOENE,1213,9,683,0,1017,254,37,237,0,741,4191,3450,37,237
6041.0,ITAUBAL,637,3,159,0,630,148,9,108,0,112,1806,1694,9,108
6050.0,MACAPA,71135,846,22491,40,36406,11305,1080,6736,0,24554,174593,150039,1080,6736
6068.0,CUTIAS,688,2,112,1,760,117,10,147,0,449,2286,1837,10,147
6076.0,MAZAGAO,3374,18,834,2,1321,713,49,535,0,1151,7997,6846,49,535
6084.0,AMAPARI,769,3,145,1,347,289,13,101,0,186,1854,1668,13,101
6092.0,OIAPOQUE,2965,10,669,2,1038,719,92,423,0,2203,8121,5918,92,423
6106.0,SERRA DO NAVIO,786,3,222,0,421,103,10,81,0,177,1803,1626,10,81
6114.0,FERREIRA GOMES,941,8,325,0,633,145,17,204,0,379,2652,2273,17,204
6122.0,VITORIA DO JARI,2331,5,195,2,1010,649,53,341,0,1013,5599,4586,53,341
6130.0,LARANJAL DO JARI,6309,46,1886,3,3745,1550,251,912,0,3349,18051,14702,251,912
6157.0,SANTANA,20773,135,3992,9,10181,3320,285,1732,0,6101,46528,40427,285,1732
6173.0,TARTARUGALZINHO,983,9,622,0,1093,504,28,349,0,837,4425,3588,28,349
7005.0,AGUA DOCE,705,6,929,0,752,657,675,1125,0,1363,6212,4849,675,1125
7013.0,AFONSO CUNHA,465,0,1027,0,212,172,155,913,0,429,3373,2944,155,913
7021.0,ALTO ALEGRE DO MARANHAO,1827,5,932,2,2571,364,298,1211,0,2802,10012,7210,298,1211
7030.0,ALCANTARA,3425,28,836,3,2175,431,724,1402,0,1938,10962,9024,724,1402
7048.0,ALTO ALEGRE DO PINDARE,3386,3,1543,5,1191,1868,274,2465,0,3889,14624,10735,274,2465
7056.0,ALDEIAS ALTAS,2598,9,1569,1,540,833,412,2431,0,2757,11150,8393,412,2431
7064.0,APICUM ACU,494,4,816,1,1110,1015,239,837,0,1373,5889,4516,239,837
7072.0,ALTAMIRA DO MARANHAO,1178,1,993,0,658,131,91,834,0,1218,5104,3886,91,834
7080.0,AMAPA DO MARANHAO,731,4,443,1,370,381,129,643,0,1053,3755,2702,129,643
7099.0,ALTO PARNAIBA,696,5,1418,0,340,715,162,936,0,1967,6239,4272,162,936
7102.0,ARAGUANA,1322,6,518,3,970,402,103,888,0,1888,6100,4212,103,888
7110.0,AMARANTE DO MARANHAO,2818,7,2692,2,2260,1823,315,2156,0,3421,15494,12073,315,2156
7129.0,BACABEIRA,1658,6,1115,5,1206,379,225,1155,0,1172,6921,5749,225,1155
7137.0,ANAJATUBA,6220,16,614,1,1013,352,458,2027,0,3780,14481,10701,458,2027
7145.0,BACURITUBA,461,3,270,0,1041,79,80,502,0,1083,3519,2436,80,502
7153.0,ANAPURUS,1323,5,798,2,922,1332,573,1316,0,927,7198,6271,573,1316
7161.0,BELAGUA,1004,0,852,1,190,102,116,718,0,717,3700,2983,116,718
7170.0,ARAIOSES,2093,24,3612,6,1312,3475,1440,3725,0,6790,22477,15687,1440,3725
7188.0,BELA VISTA,1170,1,940,1,1025,270,147,943,0,1479,5976,4497,147,943
7196.0,ARARI,5760,20,959,2,2463,1020,539,2009,0,2724,15496,12772,539,2009
7200.0,BERNARDO DO MEARIM,537,2,973,2,549,192,102,595,0,540,3492,2952,102,595
7218.0,AXIXA,913,16,953,1,1623,591,202,719,0,1716,6734,5018,202,719
7226.0,CACHOEIRA GRANDE,947,5,197,0,1209,78,58,594,0,1318,4406,3088,58,594
7234.0,BACABAL,15602,78,7064,21,9103,2861,991,5622,0,15497,56839,41342,991,5622
7242.0,DAVINOPOLIS,1414,11,1164,2,1322,545,120,892,0,2095,7565,5470,120,892
7250.0,BACURI,1833,5,1114,2,855,947,189,1571,0,2219,8735,6516,189,1571
7269.0,BOM JESUS DAS SELVAS,2200,7,1305,2,1010,1106,223,1676,0,2644,10173,7529,223,1676
7277.0,BALSAS,7799,70,5240,6,3389,5219,809,3626,0,8848,35006,26158,809,3626
7285.0,BOM LUGAR,1564,15,1343,6,1166,583,135,1088,0,2049,7949,5900,135,1088
7293.0,BARAO DE GRAJAU,1560,6,3014,6,541,922,299,1859,0,1662,9869,8207,299,1859
7307.0,BREJO DE AREIA,1035,0,1267,4,411,135,175,1101,0,1333,5461,4128,175,1101
7315.0,BARRA DO CORDA,3845,28,9210,12,6268,4206,1429,6705,0,9799,41502,31703,1429,6705
7323.0,BOA VISTA DO GURUPI,585,3,200,1,577,445,81,490,0,788,3170,2382,81,490
7331.0,BARREIRINHAS,9045,22,2145,2,2363,1589,924,3772,0,5760,25622,19862,924,3772
7340.0,BURITICUPU,6627,13,2353,1,3487,2038,584,3223,0,5877,24203,18326,584,3223
7358.0,BENEDITO LEITE,468,7,772,1,259,484,127,695,0,790,3603,2813,127,695
7366.0,BURITIRANA,1223,1,1531,0,1803,727,149,1278,0,1582,8294,6712,149,1278
7374.0,BEQUIMAO,4245,20,952,1,2445,225,685,1806,0,5209,15588,10379,685,1806
7382.0,CAMPESTRE DO MARANHAO,1306,3,1309,3,808,489,139,982,0,1649,6688,5039,139,982
7390.0,BREJO,2123,12,2106,2,1335,4599,659,2782,0,4206,17824,13618,659,2782
7404.0,CAPINZAL DO NORTE,1460,4,1100,1,648,229,143,1222,0,976,5783,4807,143,1222
7412.0,BURITI,2674,15,1833,4,625,2503,774,2364,0,4073,14865,10792,774,2364
7420.0,CENTRAL DO MARANHAO,1377,3,262,1,544,63,76,686,0,1269,4281,3012,76,686
7439.0,BURITI BRAVO,2723,6,1802,3,873,1192,236,2355,0,2224,11414,9190,236,2355
7447.0,CENTRO DO GUILHERME,874,1,468,0,313,213,90,827,0,982,3768,2786,90,827
7455.0,CAJAPIO,1508,7,241,2,1507,171,150,1011,0,1250,5847,4597,150,1011
7463.0,CENTRO NOVO DO MARANHAO,1208,7,1087,2,536,704,134,1144,0,1536,6358,4822,134,1144
7471.0,CAJARI,3143,8,1010,3,1172,400,415,1336,0,3211,10698,7487,415,1336
7480.0,CIDELANDIA,1927,5,1371,1,784,503,125,786,0,2188,7690,5502,125,786
7498.0,CANDIDO MENDES,1138,7,1796,1,1600,802,154,1156,0,3349,10003,6654,154,1156
7501.0,CONCEICAO DO LAGO ACU,1195,8,875,3,1201,627,146,1197,0,1812,7064,5252,146,1197
7510.0,CANTANHEDE,1975,6,1108,1,728,814,107,1067,0,2399,8205,5806,107,1067
7528.0,FEIRA NOVA DO MARANHAO,1118,2,191,1,760,369,176,700,0,629,3946,3317,176,700
7536.0,CAROLINA,3613,15,2395,5,1140,2031,308,1741,0,4477,15725,11248,308,1741
7544.0,FERNANDO FALCAO,419,2,1454,5,645,250,107,1018,0,641,4541,3900,107,1018
7552.0,CARUTAPERA,1869,14,2920,1,1581,470,189,1298,0,2571,10913,8342,189,1298
7560.0,FORMOSA DA SERRA NEGRA,947,3,921,0,1065,1926,133,1186,0,916,7097,6181,133,1186
7579.0,CAXIAS,23956,184,8231,14,7809,6428,1697,10109,0,23676,82104,58428,1697,10109
7595.0,CEDRAL,766,11,755,2,2057,102,252,671,0,1416,6032,4616,252,671
7609.0,GOVERNADOR EDSON LOBAO,1259,3,1238,1,884,666,98,635,0,979,5763,4784,98,635
7617.0,CHAPADINHA,7757,41,4436,4,4802,2009,2244,5347,0,7386,34026,26640,2244,5347
7625.0,GOVERNADOR LUIZ ROCHA,690,4,1359,2,852,664,90,1032,0,823,5516,4693,90,1032
7633.0,CODO,12695,45,8791,10,5881,4322,1669,8585,0,20219,62217,41998,1669,8585
7641.0,GOVERNADOR NEWTON BELLO,978,3,1381,0,502,239,130,936,0,1728,5897,4169,130,936
7650.0,COELHO NETO,6248,27,3557,6,2619,1569,864,4976,0,7313,27179,19866,864,4976
7668.0,GOVERNADOR NUNES FREIRE,2196,5,1116,0,1449,772,184,1457,0,1797,8976,7179,184,1457
7676.0,COLINAS,2594,13,3259,2,1673,2289,448,3299,0,4958,18535,13577,448,3299
7684.0,IGARAPE DO MEIO,1263,7,674,2,720,253,121,936,0,1582,5558,3976,121,936
7692.0,COROATA,5765,49,1080,5,14281,891,702,3086,0,9949,35808,25859,702,3086
7706.0,ITAIPAVA DO GRAJAU,833,4,1444,2,440,619,90,813,132,1261,5638,4377,90,813
7714.0,CURURUPU,3253,17,2904,4,2601,2316,714,2334,0,3737,17880,14143,714,2334
7722.0,ITINGA DO MARANHAO,2620,14,1899,5,1155,2364,241,1594,0,3019,12911,9892,241,1594
7730.0,DOM PEDRO,1939,23,3695,5,1341,1387,484,1860,0,3475,14209,10734,484,1860
7749.0,JATOBA,603,1,960,0,382,376,131,649,0,901,4003,3102,131,649
7757.0,DUQUE BACELAR,1860,10,550,0,167,362,212,1206,0,1580,5947,4367,212,1206
7765.0,JENIPAPO DOS VIEIRAS,484,6,1838,0,694,1108,182,1400,0,1008,6720,5712,182,1400
7773.0,ESPERANTINOPOLIS,2956,7,1528,0,1541,718,307,1828,0,2099,10984,8885,307,1828
7781.0,JUNCO DO MARANHAO,898,4,441,0,351,353,74,559,0,799,3479,2680,74,559
7790.0,FORTALEZA DOS NOGUEIRAS,2291,12,855,1,466,660,163,973,0,1570,6991,5421,163,973
7803.0,LAGO DOS RODRIGUES,1796,5,688,2,1007,415,177,1062,0,841,5993,5152,177,1062
7811.0,FORTUNA,2042,5,1771,4,1422,679,330,1614,0,2171,10038,7867,330,1614
7820.0,LAGOA DO MATO,744,0,1137,1,560,653,156,1128,0,1339,5718,4379,156,1128
7838.0,GODOFREDO VIANA,525,11,626,0,675,432,154,659,0,1395,4477,3082,154,659
7846.0,LAGOA GRANDE DO MARANHAO,1380,4,1470,2,455,427,140,1292,0,1622,6792,5170,140,1292
7854.0,GONCALVES DIAS,1506,11,1778,4,1551,762,245,1857,0,2429,10143,7714,245,1857
7862.0,LAJEADO NOVO,554,1,1133,1,340,375,51,594,0,660,3709,3049,51,594
7870.0,GOVERNADOR ARCHER,936,2,1058,3,857,458,205,1213,0,1380,6112,4732,205,1213
7889.0,MARACACUME,1423,9,1142,2,1589,938,196,1505,0,3244,10048,6804,196,1505
7897.0,GOVERNADOR EUGENIO BARROS,1951,8,1388,1,806,267,247,1468,0,1272,7408,6136,247,1468
7900.0,MARAJA DO SENA,998,4,849,1,592,473,159,1285,0,969,5330,4361,159,1285
7919.0,GRACA ARANHA,680,4,757,2,962,294,137,836,0,881,4553,3672,137,836
7927.0,MARANHAOZINHO,1027,1,789,1,689,231,142,661,0,947,4488,3541,142,661
7935.0,GRAJAU,3678,10,6890,4,2471,1714,599,4041,0,5355,24762,19407,599,4041
7943.0,MATOES DO NORTE,1110,3,470,1,341,353,107,803,0,1315,4503,3188,107,803
7951.0,GUIMARAES,2156,11,1280,0,1071,243,383,985,0,1636,7765,6129,383,985
7960.0,MILAGRES DO MARANHAO,317,7,321,0,602,758,162,654,0,546,3367,2821,162,654
7978.0,HUMBERTO DE CAMPOS,3883,17,1031,1,1824,905,615,1956,0,2406,12638,10232,615,1956
7986.0,NOVA COLINAS,803,2,738,0,121,150,56,542,0,522,2934,2412,56,542
7994.0,ICATU,1986,5,1553,2,3107,1141,376,1787,0,1906,11863,9957,376,1787
8001.0,NOVA OLINDA DO MARANHAO,2032,6,1240,2,1732,388,216,1532,0,1508,8656,7148,216,1532
8010.0,IGARAPE GRANDE,1378,11,1250,1,872,893,170,1088,0,1555,7218,5663,170,1088
8028.0,OLINDA NOVA DO MARANHAO,894,0,686,2,972,562,250,923,0,1837,6126,4289,250,923
8036.0,IMPERATRIZ,28069,426,25130,22,26392,13033,1787,8271,0,31780,134910,103130,1787,8271
8044.0,PAULINO NEVES,1269,5,877,1,612,375,357,1152,0,2160,6808,4648,357,1152
8052.0,SAO LUIS GONZAGA DO MARANHAO,3694,15,2148,5,1355,1049,382,2499,0,4460,15607,11147,382,2499
8060.0,PEDRO DO ROSARIO,1763,6,596,4,2003,227,190,1699,0,2110,8598,6488,190,1699
8079.0,ITAPECURU MIRIM,9016,50,2495,7,2794,1425,556,4065,0,7570,27978,20408,556,4065
8087.0,PERITORO,2440,14,916,6,1587,667,296,1328,0,2734,9988,7254,296,1328
8095.0,JOAO LISBOA,2933,23,2491,3,2065,1931,277,1983,0,3883,15589,11706,277,1983
8109.0,PORTO RICO DO MARANHAO,646,12,586,1,1173,591,189,519,0,1461,5178,3717,189,519
8117.0,JOSELANDIA,941,6,1358,3,2500,498,237,1712,0,1583,8838,7255,237,1712
8125.0,PRESIDENTE MEDICI,819,4,591,0,611,140,77,542,0,583,3367,2784,77,542
8133.0,LAGO DA PEDRA,5569,18,3845,8,4813,1532,536,4722,0,7237,28280,21043,536,4722
8141.0,PRESIDENTE SARNEY,978,6,601,1,1948,235,149,1021,0,2378,7317,4939,149,1021
8150.0,LAGO DO JUNCO,1972,6,619,2,720,269,228,901,0,1243,5960,4717,228,901
8168.0,RAPOSA,2256,29,1825,1,3132,360,217,1326,0,2804,11950,9146,217,1326
8176.0,LAGO VERDE,2011,2,530,1,1531,487,356,1514,0,2500,8932,6432,356,1514
8184.0,RIBAMAR FIQUENE,728,4,1224,0,458,468,105,616,0,855,4458,3603,105,616
8192.0,LIMA CAMPOS,1744,13,697,3,1723,540,421,1421,0,1414,7976,6562,421,1421
8206.0,SANTA FILOMENA DO MARANHAO,379,4,1062,1,541,334,109,611,0,428,3469,3041,109,611
8214.0,LORETO,1454,6,1319,3,190,329,164,1075,0,1665,6205,4540,164,1075
8222.0,SANTANA DO MARANHAO,451,0,134,3,488,1176,63,806,0,993,4114,3121,63,806
8230.0,LUIS DOMINGUES DO MARANHAO,443,3,873,0,897,223,38,476,0,898,3851,2953,38,476
8249.0,SANTO AMARO DO MARANHAO,1437,20,542,4,916,455,451,969,0,1848,6642,4794,451,969
8257.0,MAGALHAES DE ALMEIDA,1469,6,1722,3,937,890,202,1394,0,2673,9296,6623,202,1394
8265.0,SAO DOMINGOS DO AZEITAO,908,0,1053,0,362,72,88,899,0,788,4170,3382,88,899
8273.0,MATA ROMA,1401,10,1086,4,1488,1272,554,1491,0,831,8137,7306,554,1491
8281.0,SAO FRANCISCO DO BREJAO,811,3,1124,1,551,505,76,616,0,639,4326,3687,76,616
8290.0,MATINHA,2830,6,1715,3,2463,674,623,1467,0,2389,12170,9781,623,1467
8303.0,SAO JOAO DO CARU,974,8,901,0,1053,635,211,1407,0,2259,7448,5189,211,1407
8311.0,MATOES,2379,16,1956,3,1512,1481,447,3023,0,2840,13657,10817,447,3023
8320.0,SAO JOAO DO PARAISO,943,3,1737,1,604,520,95,878,0,1440,6221,4781,95,878
8338.0,MIRADOR,1796,6,2140,4,1430,998,347,1965,0,2875,11561,8686,347,1965
8346.0,SAO JOAO DO SOTER,1608,6,1314,1,658,583,170,1519,0,2524,8383,5859,170,1519
8354.0,MIRINZAL,1729,10,1309,0,1289,358,223,845,0,2058,7821,5763,223,845
8362.0,SAO JOSE DOS BASILIOS,748,1,1366,3,840,230,67,981,0,877,5113,4236,67,981
8370.0,MONCAO,2967,8,1478,1,1965,1262,382,2244,0,3739,14046,10307,382,2244
8389.0,SAO PEDRO DA AGUA BRANCA,1776,6,1125,0,485,362,93,830,0,1972,6649,4677,93,830
8397.0,MONTES ALTOS,1151,13,2055,0,534,315,161,944,0,956,6129,5173,161,944
8400.0,SAO PEDRO DOS CRENTES,379,0,834,1,565,129,40,300,0,417,2665,2248,40,300
8419.0,MORROS,2471,10,547,2,1396,230,191,1475,0,2532,8854,6322,191,1475
8427.0,SAO RAIMUNDO DA DOCA BEZERRA,518,3,1050,3,308,312,81,713,0,693,3681,2988,81,713
8435.0,NINA RODRIGUES,1722,7,1193,0,468,223,83,976,0,955,5627,4672,83,976
8443.0,SAO ROBERTO,536,2,932,2,249,157,56,659,0,521,3114,2593,56,659
8451.0,NOVA IORQUE,448,4,453,0,329,599,78,599,0,575,3085,2510,78,599
8460.0,SATUBINHA,1349,4,422,0,396,171,86,699,0,775,3902,3127,86,699
8478.0,OLHO D AGUA DAS CUNHAS,2516,9,2453,1,948,1050,353,1957,0,3055,12342,9287,353,1957
8486.0,SENADOR ALEXANDRE COSTA,981,3,934,1,543,266,135,1030,0,2175,6068,3893,135,1030
8494.0,PACO DO LUMIAR,11455,146,3498,8,8378,1011,982,3022,0,6090,34590,28500,982,3022
8508.0,SENADOR LA ROQUE,2682,5,1639,5,2306,1136,305,2009,0,2283,12370,10087,305,2009
8516.0,PALMEIRANDIA,3459,10,776,3,1101,393,491,1695,0,2295,10223,7928,491,1695
8524.0,SERRANO DO MARANHAO,1271,8,587,0,513,576,415,1138,0,2068,6576,4508,415,1138
8532.0,PARAIBANO,2530,8,1879,4,1189,1037,430,2367,0,3627,13071,9444,430,2367
8540.0,SUCUPIRA DO RIACHAO,294,2,849,1,427,226,116,664,0,571,3150,2579,116,664
8559.0,PARNARAMA,4801,25,1969,3,1221,1945,780,3345,0,3802,17891,14089,780,3345
8567.0,TRIZIDELA DO VALE,3246,15,2340,3,1181,423,280,1704,0,3223,12415,9192,280,1704
8575.0,PASSAGEM FRANCA,1503,7,1817,1,1085,812,352,2030,0,2548,10155,7607,352,2030
8583.0,TUFILANDIA,489,0,915,2,457,210,90,738,0,1061,3962,2901,90,738
8591.0,PASTOS BONS,1715,16,2481,5,927,587,338,1881,0,1813,9763,7950,338,1881
8605.0,TURILANDIA,1843,12,710,2,1718,191,219,1514,0,2821,9030,6209,219,1514
8613.0,PEDREIRAS,6972,39,4157,6,3293,1250,438,3180,0,6565,25900,19335,438,3180
8621.0,VILA NOVA DOS MARTIRIOS,916,4,630,1,258,377,110,480,0,545,3321,2776,110,480
8630.0,PENALVA,4938,11,1809,4,2509,1187,260,2568,0,5097,18383,13286,260,2568
8656.0,PERI MIRIM,1568,16,1024,3,1541,219,287,1165,0,2532,8355,5823,287,1165
8672.0,PINDARE MIRIM,4497,19,2419,2,2243,1353,359,2629,0,2818,16339,13521,359,2629
8699.0,PINHEIRO,7561,32,6987,4,7685,1899,802,4184,0,12471,41625,29154,802,4184
8710.0,PIO XII,3120,10,2334,5,1715,672,743,2387,0,3315,14301,10986,743,2387
8737.0,PIRAPEMAS,2335,14,777,2,1204,772,237,1626,0,2068,9035,6967,237,1626
8753.0,POCAO DE PEDRAS,2240,18,1789,5,2060,1342,474,1981,0,3721,13630,9909,474,1981
8770.0,PORTO FRANCO,2451,1,2808,1,836,1270,140,1210,0,2257,10974,8717,140,1210
8796.0,PRESIDENTE DUTRA,3487,17,6179,4,2792,1901,551,2990,0,6141,24062,17921,551,2990
8818.0,PRESIDENTE JUSCELINO,1328,8,464,0,1136,82,74,823,0,1664,5579,3915,74,823
8834.0,PRESIDENTE VARGAS,1660,10,1051,1,622,437,194,1137,0,1102,6214,5112,194,1137
8850.0,PRIMEIRA CRUZ,1360,5,745,2,1258,602,480,1186,0,974,6612,5638,480,1186
8877.0,RIACHAO,3470,12,939,5,1200,1036,314,1565,0,2991,11532,8541,314,1565
8893.0,SAO JOSE DE RIBAMAR,12817,161,4036,6,11141,1656,807,2844,0,8350,41818,33468,807,2844
8915.0,ROSARIO,5782,42,1855,6,4141,844,701,2911,0,6665,22947,16282,701,2911
8931.0,SAMBAIBA,531,3,1562,1,284,275,80,575,0,1061,4372,3311,80,575
8958.0,SANTA HELENA,4507,19,1530,2,3053,526,460,2327,0,3726,16150,12424,460,2327
8974.0,SANTA LUZIA,10261,12,3610,8,4372,3088,1086,5973,0,10830,39240,28410,1086,5973
8990.0,SANTA QUITERIA DO MARANHAO,2361,11,1143,2,1252,2221,1079,2897,0,2064,13030,10966,1079,2897
9016.0,SANTA RITA,2912,16,1898,3,1619,1223,493,2258,0,4996,15418,10422,493,2258
9032.0,SANTO ANTONIO DOS LOPES,1669,7,1405,2,1573,800,200,1538,0,1586,8780,7194,200,1538
9059.0,SAO BENEDITO DO RIO PRETO,2060,13,1171,1,1337,590,573,1539,0,1609,8893,7284,573,1539
9075.0,SAO BENTO,4757,19,2903,2,1874,1863,630,2632,0,5300,19980,14680,630,2632
9091.0,SAO BERNARDO,1667,10,597,1,1633,3908,292,2270,0,3161,13539,10378,292,2270
9113.0,SAO DOMINGOS DO MARANHAO,2406,22,3683,4,2686,2912,581,3657,0,4967,20918,15951,581,3657
9130.0,SAO FELIX DE BALSAS,465,1,744,0,427,307,108,577,0,486,3115,2629,108,577
9156.0,SAO FRANCISCO DO MARANHAO,550,7,1334,1,498,1222,370,1481,0,2104,7567,5463,370,1481
9172.0,SAO JOAO BATISTA,4653,10,1747,2,1647,327,216,1842,0,4195,14639,10444,216,1842
9199.0,SAO JOAO DOS PATOS,2024,18,3764,3,1455,922,466,2135,0,4241,15028,10787,466,2135
9210.0,SAO LUIS,227320,2477,50560,197,105604,16620,8398,26648,765,107624,546213,438589,8398,26648
9237.0,SAO MATEUS DO MARANHAO,3842,23,1666,4,4268,1987,621,2647,0,6038,21096,15058,621,2647
9253.0,SAO RAIMUNDO DAS MANGABEIRAS,1440,11,2309,0,472,1144,339,1361,0,2560,9636,7076,339,1361
9270.0,SAO VICENTE FERRER,2011,7,945,1,2173,432,523,1809,0,4340,12241,7901,523,1809
9296.0,SITIO NOVO,895,4,3810,2,986,494,146,1665,0,2473,10475,8002,146,1665
9318.0,SUCUPIRA DO NORTE,795,4,1208,1,774,708,174,1308,0,1582,6554,4972,174,1308
9334.0,TASSO FRAGOSO,518,6,948,2,387,398,85,649,0,1050,4043,2993,85,649
9350.0,TIMBIRAS,1620,22,1608,4,2892,1128,284,1520,0,4589,13667,9078,284,1520
9377.0,TIMON,27482,154,5980,12,12778,4149,1404,7603,0,18875,78437,59562,1404,7603
9393.0,TUNTUM,3458,16,1979,10,4803,2284,735,3350,0,6062,22697,16635,735,3350
9415.0,TURIACU,2984,12,2018,0,2550,1251,783,2422,0,5472,17492,12020,783,2422
9431.0,TUTOIA,2534,21,3963,2,1568,2869,1328,3573,0,6366,22224,15858,1328,3573
9458.0,URBANO SANTOS,3899,13,795,4,1394,575,1165,2317,0,3306,13468,10162,1165,2317
9474.0,VARGEM GRANDE,5381,11,2836,12,1540,1835,467,3518,0,7036,22636,15600,467,3518
9490.0,VIANA,5998,48,4299,7,4769,1119,519,3620,0,9490,29869,20379,519,3620
9512.0,VITORIA DO MEARIM,4207,24,1242,7,2998,1776,686,2552,0,6950,20442,13492,686,2552
9539.0,VITORINO FREIRE,3777,16,2189,4,3161,1728,946,2895,0,5299,20015,14716,946,2895
9555.0,BOM JARDIM,4280,26,2812,4,2689,1911,738,3073,0,5235,20768,15533,738,3073
9571.0,SANTA INES,12276,66,7469,5,5828,4358,879,4977,0,7175,43033,35858,879,4977
9598.0,PAULO RAMOS,2024,7,1060,2,1834,1570,576,2084,0,2098,11255,9157,576,2084
9610.0,ACAILANDIA,11786,61,7409,6,8955,6247,1201,4875,0,12337,52877,40540,1201,4875
9636.0,ESTREITO,2895,22,2307,2,1290,2785,293,1558,0,3066,14218,11152,293,1558
9652.0,SANTA LUZIA DO PARUA,2472,5,1897,1,2775,581,245,1814,0,1869,11659,9790,245,1814
9679.0,ARAME,3337,7,1396,3,1193,1837,376,2459,0,3639,14247,10608,376,2459
9695.0,MIRANDA DO NORTE,3283,14,775,2,1511,264,259,1380,0,2923,10411,7488,259,1380
9717.0,ZE DOCA,3507,34,4510,8,3294,2276,717,3810,0,8396,26552,18156,717,3810
10006.0,BRASILEIRA,1236,2,488,0,239,1469,203,613,0,893,5143,4250,203,613
10014.0,AGRICOLANDIA,1808,4,323,0,374,678,79,434,0,1125,4825,3700,79,434
10022.0,ALEGRETE DO PIAUI,591,0,852,1,111,574,103,468,0,402,3102,2700,103,468
10030.0,AGUA BRANCA,3482,16,983,6,1025,1483,222,1110,0,1568,9895,8327,222,1110
10049.0,BAIXA GRANDE DO RIBEIRO,622,5,264,1,538,1413,75,639,0,1010,4567,3557,75,639
10057.0,ALTO LONGA,2180,13,1755,4,710,2101,176,1443,0,1818,10200,8382,176,1443
10065.0,BOM PRINCIPIO DO PIAUI,1137,4,1288,0,247,445,103,593,0,698,4515,3817,103,593
10073.0,ALTOS,8522,23,2431,9,1714,3351,612,2761,0,2908,22331,19423,612,2761
10081.0,BONFIM DO PIAUI,672,3,103,0,50,1445,74,494,0,554,3395,2841,74,494
10090.0,AMARANTE,2924,22,1121,3,793,2836,319,1436,0,1687,11141,9454,319,1436
10103.0,BURITI DOS MONTES,719,2,1687,1,108,634,100,819,0,520,4590,4070,100,819
10111.0,ANGICAL DO PIAUI,2362,6,492,1,479,827,127,496,0,754,5544,4790,127,496
10120.0,CABECEIRAS DO PIAUI,1651,4,1175,1,213,1072,110,878,0,807,5911,5104,110,878
10138.0,ANISIO DE ABREU,1168,5,249,0,205,1520,92,681,0,736,4656,3920,92,681
10146.0,CALDEIRAO GRANDE DO PIAUI,667,5,416,1,114,1523,79,490,0,445,3740,3295,79,490
10154.0,ANTONIO ALMEIDA,479,2,221,1,329,723,51,306,0,385,2497,2112,51,306
10162.0,CANAVIEIRA,634,1,344,0,162,700,41,430,0,325,2637,2312,41,430
10170.0,AROAZES,1289,2,1023,4,155,452,107,513,0,766,4311,3545,107,513
10189.0,COIVARAS,1038,5,421,1,384,641,56,425,0,374,3345,2971,56,425
10197.0,ARRAIAL,514,2,282,0,136,1131,39,480,0,510,3094,2584,39,480
10200.0,COLONIA DO GURGUEIA,744,2,600,2,515,641,60,449,0,529,3542,3013,60,449
10219.0,AVELINO LOPES,2095,3,353,1,806,1493,119,791,0,1314,6975,5661,119,791
10227.0,COLONIA DO PIAUI,1469,3,477,2,193,815,167,769,0,960,4855,3895,167,769
10235.0,BARRAS,8234,12,1381,2,1223,5588,508,3441,0,3736,24125,20389,508,3441
10243.0,CORONEL JOSE DIAS,1390,4,164,1,179,915,91,451,0,428,3623,3195,91,451
10251.0,BARREIRAS DO PIAUI,721,0,203,0,128,434,49,314,0,382,2231,1849,49,314
10260.0,FARTURA DO PIAUI,1069,0,43,1,175,946,53,447,0,416,3150,2734,53,447
10278.0,BARRO DURO,1344,6,521,1,774,868,102,531,0,866,5013,4147,102,531
10286.0,JACOBINA DO PIAUI,1272,5,157,1,356,917,119,458,0,435,3720,3285,119,458
10294.0,BATALHA,5629,5,1343,3,835,2929,303,1983,0,2639,15669,13030,303,1983
10308.0,JARDIM DO MULATO,702,5,181,1,297,843,75,355,0,356,2815,2459,75,355
10316.0,BENEDITINOS,1680,7,611,4,527,2441,236,1027,0,1040,7573,6533,236,1027
10324.0,LAGOA ALEGRE,1153,3,407,1,318,1555,108,733,0,643,4921,4278,108,733
10332.0,BERTOLINIA,808,0,836,1,361,592,92,423,0,514,3627,3113,92,423
10340.0,LAGOA DO BARRO DO PIAUI,689,1,118,1,153,984,141,470,0,481,3038,2557,141,470
10359.0,BOCAINA,2093,4,813,6,134,425,76,562,0,421,4534,4113,76,562
10367.0,MARCOLANDIA,893,2,659,2,297,965,166,749,0,1000,4733,3733,166,749
10375.0,BOM JESUS,2290,7,532,4,614,3387,217,1398,0,1290,9739,8449,217,1398
10383.0,PATOS DO PIAUI,1408,2,177,3,86,1106,114,749,0,595,4240,3645,114,749
10391.0,BURITI DOS LOPES,2846,9,1325,2,668,3310,212,1348,0,3644,13364,9720,212,1348
10405.0,PASSAGEM FRANCA DO PIAUI,879,4,75,0,365,687,61,360,0,543,2974,2431,61,360
10413.0,CAMPINAS DO PIAUI,1239,6,42,0,102,1285,72,572,0,527,3845,3318,72,572
10421.0,QUEIMADA NOVA,1900,6,525,2,220,711,167,748,0,899,5178,4279,167,748
10430.0,CAMPO MAIOR,11481,32,3495,5,1461,5606,791,2372,0,3847,29090,25243,791,2372
10448.0,SANTA CRUZ DOS MILAGRES,1016,1,266,1,114,228,59,288,0,669,2642,1973,59,288
10456.0,CANTO DO BURITI,3619,4,824,1,617,3464,283,1715,0,1796,12323,10527,283,1715
10464.0,SANTA ROSA DO PIAUI,804,0,381,1,283,1003,96,464,0,598,3630,3032,96,464
10472.0,CAPITAO DE CAMPOS,1698,7,949,3,394,1654,240,1111,0,1126,7182,6056,240,1111
10480.0,SANTANA DO PIAUI,751,3,226,0,116,1191,40,510,0,371,3208,2837,40,510
10499.0,CARACOL,1425,14,194,0,182,1708,164,1067,0,852,5606,4754,164,1067
10502.0,SAO BRAZ DO PIAUI,876,6,105,0,76,929,44,364,0,424,2824,2400,44,364
10510.0,CASTELO DO PIAUI,2691,7,3310,2,528,1529,296,2045,0,2002,12410,10408,296,2045
10529.0,SAO JOSE DO DIVINO,690,2,699,29,226,920,62,501,0,491,3620,3129,62,501
10537.0,COCAL,3222,8,1466,1,598,3923,598,2152,0,3924,15892,11968,598,2152
10545.0,SIGEFREDO PACHECO,1786,2,526,2,372,1363,174,627,0,611,5463,4852,174,627
10553.0,CONCEICAO DO CANINDE,1180,3,499,0,173,764,122,446,0,540,3727,3187,122,446
10561.0,SAO LOURENCO DO PIAUI,1468,2,194,1,118,755,70,459,0,635,3702,3067,70,459
10570.0,CORRENTE,3866,7,1291,4,1115,3412,154,1920,0,2298,14067,11769,154,1920
10588.0,VARZEA BRANCA,665,5,425,0,157,747,63,422,0,518,3002,2484,63,422
10596.0,CRISTALANDIA DO PIAUI,743,1,178,0,112,1971,39,501,0,705,4250,3545,39,501
10600.0,BARRA D'ALCANTARA,468,1,60,3,156,807,53,364,0,693,2605,1912,53,364
10618.0,CRISTINO CASTRO,1733,5,301,0,377,1268,123,865,0,903,5575,4672,123,865
10626.0,BELA VISTA DO PIAUI,672,3,89,5,151,661,121,388,0,154,2244,2090,121,388
10634.0,CURIMATA,1805,5,338,0,338,2344,110,513,0,729,6182,5453,110,513
10642.0,BREJO DO PIAUI,510,5,146,0,254,782,83,410,0,345,2535,2190,83,410
10650.0,DEMERVAL LOBAO,3111,10,530,1,667,1579,178,992,0,1031,8099,7068,178,992
10669.0,BOA HORA,1091,2,374,0,261,882,144,657,0,591,4002,3411,144,657
10677.0,DOM EXPEDITO LOPES,1942,4,287,3,200,1356,94,505,0,844,5235,4391,94,505
10685.0,DOM INOCENCIO,1409,0,125,2,119,1914,176,859,0,738,5342,4604,176,859
10693.0,ELESBAO VELOSO,3437,5,1127,6,447,2407,225,1721,0,2252,11627,9375,225,1721
10707.0,CAPITAO GERVASIO OLIVEIRA,936,2,55,5,70,806,127,436,0,469,2906,2437,127,436
10715.0,ELISEU MARTINS,972,4,120,1,338,726,60,422,0,430,3073,2643,60,422
10723.0,CAMPO GRANDE DO PIAUI,739,2,490,1,172,866,85,454,0,335,3144,2809,85,454
10731.0,ESPERANTINA,8853,24,1938,2,1230,2914,707,2551,0,2987,21206,18219,707,2551
10740.0,CAMPO LARGO DO PIAUI,679,2,192,0,63,1271,134,529,0,401,3271,2870,134,529
10758.0,FLORES DO PIAUI,571,1,154,0,227,1380,53,453,0,405,3244,2839,53,453
10766.0,CURRAIS,418,1,124,0,124,1442,57,692,0,442,3300,2858,57,692
10774.0,FLORIANO,9490,33,5743,3,2504,6184,672,2515,0,4672,31816,27144,672,2515
10782.0,GEMINIANO,961,4,276,3,128,866,186,589,0,422,3435,3013,186,589
10790.0,FRANCINOPOLIS,1859,2,127,1,182,710,106,512,0,636,4135,3499,106,512
10804.0,GUARIBAS,272,1,58,0,71,1055,47,464,0,562,2530,1968,47,464
10812.0,FRANCISCO AYRES,546,5,254,4,261,1348,91,468,0,607,3584,2977,91,468
10820.0,ILHA GRANDE,2017,3,907,0,365,416,164,586,0,907,5365,4458,164,586
10839.0,FRANCISCO SANTOS,2350,8,805,0,235,466,118,745,0,1046,5773,4727,118,745
10847.0,JUREMA,569,1,98,0,66,1225,59,586,0,386,2990,2604,59,586
10855.0,FRONTEIRAS,1789,6,807,2,606,1490,265,880,0,930,6775,5845,265,880
10863.0,LAGOA DE SAO FRANCISCO,645,1,1327,0,111,315,102,722,0,616,3839,3223,102,722
10871.0,GILBUES,1540,7,509,2,300,1738,132,749,0,1059,6036,4977,132,749
10880.0,MORRO CABECA NO TEMPO,660,0,138,0,117,1000,49,413,0,726,3103,2377,49,413
10898.0,GUADALUPE,2306,4,308,0,418,1433,89,677,0,1099,6334,5235,89,677
10901.0,NOVO SANTO ANTONIO,1094,1,560,0,234,410,85,380,0,541,3305,2764,85,380
10910.0,HUGO NAPOLEAO,1165,5,163,2,159,726,68,363,0,518,3169,2651,68,363
10928.0,NOSSA SENHORA DE NAZARE,1463,2,539,2,129,468,65,344,0,429,3441,3012,65,344
10936.0,INHUMA,3592,13,1088,5,717,1220,210,1336,0,2222,10403,8181,210,1336
10944.0,PAQUETA,1707,2,177,1,118,370,57,450,0,379,3261,2882,57,450
10952.0,IPIRANGA DO PIAUI,1987,7,357,1,377,1134,161,891,0,672,5587,4915,161,891
10960.0,NOVA SANTA RITA,972,1,144,0,75,837,86,468,0,355,2938,2583,86,468
10979.0,ISAIAS COELHO,1725,4,477,1,281,925,129,777,0,653,4972,4319,129,777
10987.0,SAO JOAO DO ARRAIAL,1131,2,70,1,174,1307,104,556,0,771,4116,3345,104,556
10995.0,ITAINOPOLIS,2654,6,295,3,182,2168,410,1175,0,916,7809,6893,410,1175
11010.0,ITAUEIRA,2189,8,904,2,615,1275,233,1113,0,942,7281,6339,233,1113
11037.0,JAICOS,2688,6,694,1,394,2741,376,1478,0,1274,9652,8378,376,1478
11053.0,JERUMENHA,921,6,352,1,254,873,59,407,0,447,3320,2873,59,407
11070.0,JOAQUIM PIRES,2317,7,506,0,252,2193,180,1192,0,1120,7767,6647,180,1192
11088.0,SAO JOAO DA CANABRAVA,890,3,657,1,118,686,88,396,0,456,3295,2839,88,396
11096.0,JOSE DE FREITAS,6190,19,2213,3,1589,4950,639,2568,0,3596,21767,18171,639,2568
11118.0,LANDRI SALES,992,3,120,1,188,1325,54,396,0,581,3660,3079,54,396
11134.0,LUIS CORREIA,4449,10,3159,4,1098,3696,379,2099,0,3231,18125,14894,379,2099
11150.0,LUZILANDIA,2802,10,1374,2,885,4860,443,2013,0,1687,14076,12389,443,2013
11177.0,MANOEL EMIDIO,743,4,479,0,130,946,71,442,0,456,3271,2815,71,442
11193.0,MARCOS PARENTE,559,2,137,1,373,1442,70,428,0,609,3621,3012,70,428
11215.0,MATIAS OLIMPIO,1298,7,213,1,260,2522,236,772,0,1047,6356,5309,236,772
11231.0,MIGUEL ALVES,5318,13,910,3,574,3692,428,2453,0,2642,16033,13391,428,2453
11258.0,MIGUEL LEAO,138,2,31,0,102,321,2,122,0,118,836,718,2,122
11274.0,MONSENHOR GIL,2284,4,1497,4,702,638,131,1039,0,800,7099,6299,131,1039
11290.0,MONSENHOR HIPOLITO,1862,3,1194,2,212,528,101,911,0,887,5700,4813,101,911
11312.0,MONTE ALEGRE DO PIAUI,1143,5,1265,3,150,1697,103,770,0,1099,6235,5136,103,770
11339.0,NAZARE DO PIAUI,1445,6,615,3,181,1262,119,766,0,1026,5423,4397,119,766
11355.0,NOSSA SENHORA DOS REMEDIOS,1129,1,184,0,224,1819,216,770,0,651,4994,4343,216,770
11371.0,NOVO ORIENTE DO PIAUI,1736,11,428,2,265,650,141,609,0,1032,4874,3842,141,609
11398.0,OEIRAS,6593,27,4165,4,818,4252,657,2997,0,3240,22753,19513,657,2997
11410.0,DOMINGOS MOURAO,600,4,827,1,124,273,77,445,0,610,2961,2351,77,445
11436.0,PADRE MARCOS,1466,5,553,3,480,728,123,769,0,624,4751,4127,123,769
11452.0,PAES LANDIM,1059,1,84,0,202,769,73,292,0,295,2775,2480,73,292
11479.0,PALMEIRA DO PIAUI,862,1,274,1,156,1094,78,471,0,649,3586,2937,78,471
11495.0,PALMEIRAIS,2605,6,893,1,941,1555,213,1148,0,1252,8614,7362,213,1148
11517.0,PARNAGUA,795,0,360,1,266,2082,92,702,0,845,5143,4298,92,702
11533.0,PARNAIBA,25908,127,13177,11,9075,7690,1242,4959,0,16479,78668,62189,1242,4959
11550.0,PAULISTANA,4200,11,658,4,978,2543,289,1817,0,1839,12339,10500,289,1817
11576.0,PEDRO II,5408,12,4561,9,1122,4597,635,2975,0,4560,23879,19319,635,2975
11592.0,PICOS,13261,55,4886,5,2569,6532,978,3258,0,4858,36402,31544,978,3258
11614.0,PIMENTEIRAS,2789,6,932,2,388,1204,109,1001,0,814,7245,6431,109,1001
11630.0,PIO IX,3689,7,2796,3,316,869,145,1331,0,1205,10361,9156,145,1331
11657.0,PIRACURUCA,4821,9,1514,1,1283,4411,275,1887,0,2331,16532,14201,275,1887
11673.0,PIRIPIRI,7288,26,5963,4,2701,6683,1563,4747,0,5694,34669,28975,1563,4747
11690.0,PORTO,1595,7,1239,1,264,952,171,965,0,869,6063,5194,171,965
11711.0,PRATA DO PIAUI,762,6,112,0,136,952,70,384,0,681,3103,2422,70,384
11738.0,REDENCAO DO GURGUEIA,756,2,578,1,302,1680,68,725,0,777,4889,4112,68,725
11754.0,REGENERACAO,3692,10,626,5,439,2456,229,1611,0,1689,10757,9068,229,1611
11770.0,RIBEIRO GONCALVES,1224,2,106,0,275,1092,44,658,0,563,3964,3401,44,658
11797.0,RIO GRANDE DO PIAUI,913,2,1074,1,395,771,129,757,0,1160,5202,4042,129,757
11819.0,SANTA CRUZ DO PIAUI,1634,3,450,2,231,850,139,592,0,455,4356,3901,139,592
11835.0,SANTA FILOMENA,641,0,372,0,107,1018,92,457,0,616,3303,2687,92,457
11851.0,SANTA LUZ,563,1,129,0,152,1307,76,502,0,369,3099,2730,76,502
11878.0,SANTO ANTONIO DE LISBOA,1694,4,682,0,187,445,60,449,0,420,3941,3521,60,449
11894.0,SANTO INACIO DO PIAUI,623,2,226,0,50,1123,43,279,0,321,2667,2346,43,279
11916.0,SAO FELIX DO PIAUI,1026,2,604,0,95,274,67,320,0,404,2792,2388,67,320
11932.0,SAO FRANCISCO DO PIAUI,1458,1,378,0,101,1035,94,719,0,793,4579,3786,94,719
11959.0,SAO GONCALO DO PIAUI,1224,6,362,1,281,716,57,358,0,376,3381,3005,57,358
11975.0,SAO JOAO DA SERRA,1439,4,474,0,326,1177,214,778,0,885,5297,4412,214,778
11991.0,SAO JOAO DO PIAUI,3272,6,393,0,565,3101,171,1358,0,1413,10279,8866,171,1358
12009.0,SAO JOAO DA FRONTEIRA,531,3,613,2,101,999,55,459,0,505,3268,2763,55,459
12017.0,SAO JOSE DO PEIXE,616,0,283,0,109,810,62,367,0,443,2690,2247,62,367
12025.0,SAO JOAO DA VARJOTA,834,5,87,1,55,1077,96,405,0,353,2913,2560,96,405
12033.0,SAO JOSE DO PIAUI,1263,3,577,1,284,1054,174,653,0,782,4791,4009,174,653
12041.0,SEBASTIAO BARROS,779,3,228,0,54,1191,56,456,0,503,3270,2767,56,456
12050.0,SAO JULIAO,1213,5,576,0,150,991,58,544,0,538,4075,3537,58,544
12068.0,SEBASTIAO LEAL,666,1,314,0,207,657,128,330,0,254,2557,2303,128,330
12076.0,SAO MIGUEL DO TAPUIO,2249,6,1247,1,509,4041,541,1877,0,1601,12072,10471,541,1877
12084.0,ALVORADA DO GURGUEIA,533,0,596,1,265,280,86,395,0,402,2558,2156,86,395
12092.0,SAO PEDRO DO PIAUI,2232,4,301,1,408,2655,141,1086,0,1319,8147,6828,141,1086
12106.0,ASSUNCAO DO PIAUI,713,3,671,1,140,1273,290,758,0,949,4798,3849,290,758
12114.0,SAO RAIMUNDO NONATO,5693,9,631,4,736,4975,359,1716,0,2303,16426,14123,359,1716
12122.0,BETANIA DO PIAUI,1053,3,870,0,98,595,73,687,0,620,3999,3379,73,687
12130.0,SIMOES,2489,4,363,1,363,2549,206,1430,0,1041,8446,7405,206,1430
12149.0,BOQUEIRAO DO PIAUI,843,2,367,1,246,782,174,437,0,683,3535,2852,174,437
12157.0,SIMPLICIO MENDES,2740,6,644,1,352,1703,142,926,0,905,7419,6514,142,926
12165.0,CARIDADE DO PIAUI,851,1,244,2,109,765,60,468,0,431,2931,2500,60,468
12173.0,SOCORRO DO PIAUI,929,3,167,1,219,1212,51,428,0,403,3413,3010,51,428
12181.0,CURRAL NOVO DO PIAUI,706,3,127,1,86,644,77,462,0,566,2672,2106,77,462
12190.0,TERESINA,203648,707,37849,73,55605,39324,5130,19118,0,69376,430830,361454,5130,19118
12203.0,JULIO BORGES,1424,4,77,0,213,637,52,369,0,374,3150,2776,52,369
12211.0,UNIAO,9987,24,1735,9,1273,4168,533,3125,0,3282,24136,20854,533,3125
12220.0,LAGOA DO SITIO,1132,1,343,2,158,649,50,549,0,442,3326,2884,50,549
12238.0,URUCUI,2818,6,502,1,669,2965,266,1481,0,1510,10218,8708,266,1481
12246.0,MILTON BRANDAO,591,1,215,2,128,1838,52,646,0,730,4203,3473,52,646
12254.0,VALENCA DO PIAUI,4027,9,1309,4,1211,2682,251,1812,0,1995,13300,11305,251,1812
12262.0,PAJEU DO PIAUI,382,0,170,0,135,865,57,377,0,625,2611,1986,57,377
12270.0,VARZEA GRANDE,933,8,218,0,599,642,83,431,0,521,3435,2914,83,431
12289.0,PAVUSSU,733,2,431,1,68,822,37,363,0,661,3118,2457,37,363
12297.0,DIRCEU ARCOVERDE,1020,6,170,0,135,1418,122,587,0,639,4097,3458,122,587
12300.0,RIACHO FRIO,926,1,346,0,81,762,45,324,0,411,2896,2485,45,324
12319.0,ALAGOINHA,1660,6,265,4,92,1638,87,753,0,577,5082,4505,87,753
12327.0,ACAUA,1155,5,245,0,363,1145,168,508,0,529,4118,3589,168,508
12335.0,BELEM DO PIAUI,682,0,145,0,258,365,55,242,0,200,1947,1747,55,242
12343.0,CAJAZEIRAS DO PIAUI,472,2,127,0,71,799,91,366,0,286,2214,1928,91,366
12351.0,CAMPO ALEGRE DO FIDALGO,556,1,131,2,198,1321,81,518,0,545,3353,2808,81,518
12360.0,COCAL DE TELHA,838,5,351,0,100,739,155,472,0,657,3317,2660,155,472
12378.0,FRANCISCO MACEDO,335,0,430,0,59,280,47,277,0,208,1636,1428,47,277
12386.0,JOAO COSTA,1050,0,117,0,91,463,43,405,0,251,2420,2169,43,405
12394.0,JATOBA DO PIAUI,1163,4,288,2,150,1131,118,472,0,541,3869,3328,118,472
12408.0,JOCA MARQUES,523,5,629,3,100,689,142,488,0,632,3211,2579,142,488
12416.0,JUAZEIRO DO PIAUI,1220,3,954,3,446,766,117,640,0,604,4753,4149,117,640
12424.0,LAGOA DO PIAUI,727,0,433,1,153,447,59,398,0,313,2531,2218,59,398
12432.0,LAGOINHA DO PIAUI,631,3,73,0,88,663,18,207,0,312,1995,1683,18,207
12440.0,MADEIRO,616,7,291,0,303,1754,73,571,0,805,4420,3615,73,571
12459.0,MORRO DO CHAPEU DO PIAUI,1405,2,162,0,121,1088,120,495,0,834,4227,3393,120,495
12467.0,MASSAPE DO PIAUI,852,8,261,1,100,1686,204,747,0,512,4371,3859,204,747
12475.0,MURICI DOS PORTELAS,938,5,294,2,141,1519,122,608,0,571,4200,3629,122,608
12483.0,OLHO DAGUA DO PIAUI,566,5,125,0,110,629,32,209,0,373,2049,1676,32,209
12491.0,PEDRO LAURENTINO,634,0,119,2,183,410,26,251,0,222,1847,1625,26,251
12505.0,SAO FRANCISCO DE ASSIS DO PIAUI,972,2,284,3,112,542,70,424,0,521,2930,2409,70,424
12513.0,SUSSUAPARA,1759,2,438,1,188,632,150,598,0,521,4289,3768,150,598
12521.0,TANQUE DO PIAUI,371,1,135,0,107,634,54,205,0,212,1719,1507,54,205
12530.0,TAMBORIL DO PIAUI,221,0,718,0,114,385,20,327,0,487,2272,1785,20,327
12548.0,VILA NOVA DO PIAUI,582,3,200,1,119,640,54,233,0,305,2137,1832,54,233
12556.0,VERA MENDES,510,4,109,0,112,604,147,469,0,293,2248,1955,147,469
12564.0,WALL FERRAZ,576,0,67,2,58,1436,76,452,0,400,3067,2667,76,452
12572.0,CAJUEIRO DA PRAIA,1427,2,833,0,256,611,72,502,0,786,4489,3703,72,502
12580.0,CURRALINHOS,917,1,176,0,134,471,35,408,0,289,2431,2142,35,408
12599.0,PORTO ALEGRE DO PIAUI,243,1,564,0,42,169,9,146,0,198,1372,1174,9,146
12602.0,RIBEIRA DO PIAUI,535,0,760,1,128,478,43,433,0,308,2686,2378,43,433
12610.0,SAO GONCALO DO GURGUEIA,405,1,261,1,143,209,44,208,0,383,1655,1272,44,208
12629.0,SAO LUIS DO PIAUI,485,2,654,0,53,199,31,262,0,222,1908,1686,31,262
12637.0,FLORESTA DO PIAUI,360,2,44,0,76,938,23,232,0,394,2069,1675,23,232
12653.0,SANTO ANTONIO DOS MILAGRES,760,4,23,0,113,184,25,152,0,199,1460,1261,25,152
12661.0,SAO MIGUEL DA BAIXA GRANDE,484,2,543,0,104,80,31,237,0,315,1796,1481,31,237
12670.0,CARAUBAS DO PIAUI,517,0,382,0,72,1314,100,565,0,499,3449,2950,100,565
12688.0,CAXINGO,578,3,774,0,256,572,69,432,0,362,3046,2684,69,432
12696.0,COCAL DOS ALVES,500,2,141,1,288,1145,110,488,0,710,3385,2675,110,488
12700.0,SAO MIGUEL DO FIDALGO,701,1,88,0,76,467,77,298,0,332,2040,1708,77,298
12718.0,PAU DARCO DO PIAUI,1080,3,403,2,181,377,93,378,0,558,3075,2517,93,378
13005.0,JIJOCA DE JERICOACOARA,1243,1,2768,1,249,708,124,596,0,1998,7688,5690,124,596
13013.0,ABAIARA,1131,2,1632,2,161,592,184,650,0,923,5277,4354,184,650
13021.0,MADALENA,2923,5,2422,0,264,426,150,886,0,2301,9377,7076,150,886
13030.0,ACARAU,5474,31,8501,5,1749,2392,755,2768,0,9242,30917,21675,755,2768
13048.0,PIRES FERREIRA,288,1,4139,2,60,496,90,437,0,1321,6834,5513,90,437
13056.0,ACOPIARA,7035,16,10329,5,2119,2507,1729,3951,0,6010,33701,27691,1729,3951
13064.0,GRACA,549,2,4604,1,156,875,187,993,0,3201,10568,7367,187,993
13072.0,AIUABA,1245,6,3800,1,168,729,151,1391,0,2942,10433,7491,151,1391
13080.0,TURURU,2213,4,2998,1,417,943,262,694,0,1221,8753,7532,262,694
13099.0,ALCANTARAS,335,2,3710,4,70,509,131,437,0,1738,6936,5198,131,437
13102.0,QUITERIANOPOLIS,2081,5,5596,1,689,866,256,1135,0,3041,13670,10629,256,1135
13110.0,ALTANEIRA,780,2,1518,0,137,389,112,431,0,672,4041,3369,112,431
13129.0,BARREIRA,1685,9,5051,0,1289,876,236,1061,0,2300,12507,10207,236,1061
13137.0,ALTO SANTO,1624,13,3926,0,563,553,306,788,0,1487,9260,7773,306,788
13145.0,ACARAPE,1910,2,2754,0,816,479,242,688,0,1413,8304,6891,242,688
13153.0,ANTONINA DO NORTE,705,13,1940,0,85,479,120,448,0,1024,4814,3790,120,448
13161.0,CHOROZINHO,2498,2,4635,0,1002,806,255,979,0,1468,11645,10177,255,979
13170.0,APUIARES,1932,6,3623,1,180,745,153,606,0,1940,9186,7246,153,606
13188.0,HORIZONTE,6251,15,6303,1,1493,892,584,1520,0,3562,20621,17059,584,1520
13196.0,AQUIRAZ,10840,21,10235,2,2575,2053,897,3071,0,7200,36894,29694,897,3071
13200.0,ERERE,355,3,2079,0,74,483,88,335,0,1460,4877,3417,88,335
13218.0,ARACATI,14642,21,10025,3,1478,2306,968,2757,0,6652,38852,32200,968,2757
13226.0,EUZEBIO,8139,15,4851,1,2946,1128,455,1423,0,3671,22629,18958,455,1423
13234.0,ARACOIABA,4765,18,5188,0,826,1780,496,1905,0,4231,19209,14978,496,1905
13242.0,GUAIUBA,3348,8,4476,2,794,1156,244,1134,0,2683,13845,11162,244,1134
13250.0,ARARIPE,1326,5,5458,3,143,1344,310,1587,0,3364,13540,10176,310,1587
13269.0,POTIRETAMA,741,1,1692,0,117,341,104,252,0,796,4044,3248,104,252
13277.0,ARATUBA,2043,5,2519,1,363,719,215,946,0,2345,9156,6811,215,946
13285.0,PINDORETAMA,3005,8,3352,1,477,752,150,862,0,1115,9722,8607,150,862
13293.0,ARNEIROZ,795,3,2389,1,123,444,100,414,0,1003,5272,4269,100,414
13307.0,OCARA,3617,3,6053,5,546,1368,309,1272,0,2885,16058,13173,309,1272
13315.0,ASSARE,2401,6,5195,0,385,921,389,1865,0,3912,15074,11162,389,1865
13323.0,TEJUSSUOCA,1302,2,4330,0,348,637,160,673,0,1152,8604,7452,160,673
13331.0,AURORA,3151,26,4590,4,2430,2274,628,1519,0,3127,17749,14622,628,1519
13340.0,IPAPORANGA,1350,6,2923,0,251,561,110,945,0,1749,7895,6146,110,945
13358.0,BAIXIO,1035,4,1535,1,136,395,89,373,0,730,4298,3568,89,373
13366.0,TARRAFAS,615,4,2289,0,184,566,103,559,0,1160,5480,4320,103,559
13374.0,BARBALHA,11899,37,5119,6,762,2878,882,2474,0,6908,30965,24057,882,2474
13382.0,BANABUIU,1862,4,4229,1,401,715,300,799,0,2455,10766,8311,300,799
13390.0,BARRO,3157,13,3722,2,472,1787,324,1670,0,2911,14058,11147,324,1670
13404.0,BARROQUINHA,953,3,5107,0,239,1040,375,731,0,2536,10984,8448,375,731
13412.0,BATURITE,7578,9,5639,6,824,1013,608,1324,0,5516,22517,17001,608,1324
13420.0,ARARENDA,1240,4,1956,0,272,1280,97,1038,0,2635,8522,5887,97,1038
13439.0,BEBERIBE,6339,12,10846,2,1802,1707,821,1482,0,6139,29150,23011,821,1482
13447.0,SENADOR CATUNDA,596,2,3040,3,138,602,161,529,0,1987,7058,5071,161,529
13455.0,BELA CRUZ,2991,9,6446,2,269,1119,509,1616,0,4610,17571,12961,509,1616
13463.0,CHORO,2799,1,1488,2,330,635,185,791,0,2185,8416,6231,185,791
13471.0,BOA VIAGEM,6875,12,10915,3,1147,2630,1374,3446,0,9984,36386,26402,1374,3446
13480.0,ITAITINGA,5417,11,4246,4,1134,878,358,1158,0,2689,15895,13206,358,1158
13498.0,BREJO SANTO,12556,33,2513,3,2345,1275,458,2057,0,5605,26845,21240,458,2057
13501.0,FORTIM,2161,1,3044,0,411,642,193,899,0,1569,8920,7351,193,899
13510.0,CAMOCIM,5962,16,13460,5,1031,3283,811,2089,0,6021,32678,26657,811,2089
13536.0,CAMPOS SALES,1488,20,7208,4,321,1686,322,1849,0,3508,16406,12898,322,1849
13552.0,CANINDE,8612,15,14258,8,1076,1973,1134,5049,0,11604,43729,32125,1134,5049
13579.0,CAPISTRANO,3846,8,2240,0,550,1111,412,1012,0,2777,11956,9179,412,1012
13595.0,CARIDADE,2245,6,4379,1,264,775,153,641,0,1317,9781,8464,153,641
13617.0,CARIRE,624,4,6936,1,415,1170,270,1100,0,4058,14578,10520,270,1100
13633.0,CARIRIACU,1548,14,7866,1,266,1857,399,1470,0,5120,18541,13421,399,1470
13650.0,CARIUS,2342,5,4571,0,577,965,573,1413,0,3468,13914,10446,573,1413
13676.0,CARNAUBAL,650,4,3811,0,152,1855,229,758,0,3458,10917,7459,229,758
13692.0,CASCAVEL,8506,27,13118,0,2270,2604,1109,3220,0,7603,38457,30854,1109,3220
13714.0,CATARINA,1101,2,2584,2,253,513,113,528,0,1972,7068,5096,113,528
13730.0,CAUCAIA,40045,179,34405,26,11065,5135,2124,6773,0,19261,119013,99752,2124,6773
13757.0,CEDRO,3635,16,6582,4,939,1717,401,1456,0,2603,17353,14750,401,1456
13773.0,CHAVAL,1415,3,3511,1,216,816,340,652,0,1321,8275,6954,340,652
13811.0,COREAU,2090,9,5217,4,315,1799,504,1597,0,3558,15093,11535,504,1597
13838.0,CRATEUS,13097,26,13332,3,2180,2719,1565,4034,0,13901,50857,36956,1565,4034
13854.0,CRATO,24224,83,17872,12,1550,5037,1303,4657,0,14893,69631,54738,1303,4657
13870.0,FARIAS BRITO,2980,10,4897,1,223,1209,379,1795,0,2205,13699,11494,379,1795
13897.0,FORTALEZA,562897,1980,338980,168,99217,28845,15188,34761,0,180168,1262204,1082036,15188,34761
13919.0,FRECHEIRINHA,1090,0,3265,5,198,989,281,814,0,1314,7956,6642,281,814
13935.0,GENERAL SAMPAIO,878,1,1808,1,122,402,84,360,0,859,4515,3656,84,360
13951.0,GRANJA,3820,8,9771,4,382,3343,1315,3670,0,6553,28866,22313,1315,3670
13978.0,GRANGEIRO,448,6,1522,0,122,406,130,358,0,723,3715,2992,130,358
13994.0,GROAIRAS,805,3,2884,0,168,372,305,561,0,1032,6130,5098,305,561
14010.0,GUARACIABA DO NORTE,1178,8,10507,3,896,1501,385,2534,0,7232,24244,17012,385,2534
14036.0,GUARAMIRANGA,1283,11,1054,0,115,169,149,476,0,1026,4283,3257,149,476
14052.0,HIDROLANDIA,1447,1,4680,3,535,1140,242,1226,0,2414,11688,9274,242,1226
14060.0,IBARETAMA,1839,1,3203,2,360,727,227,912,0,1175,8446,7271,227,912
14079.0,IBIAPINA,1233,10,6364,4,281,1259,298,1386,0,4388,15223,10835,298,1386
14095.0,ICO,5487,16,15755,7,1426,4419,1110,3604,0,11968,43792,31824,1110,3604
14117.0,IGUATU,18203,43,13792,3,3514,4867,1359,4103,0,13645,59529,45884,1359,4103
14133.0,INDEPENDENCIA,3659,7,7279,6,631,1362,551,1615,0,3252,18362,15110,551,1615
14150.0,IPAUMIRIM,2098,6,2490,1,223,825,249,979,0,2127,8998,6871,249,979
14176.0,IPU,2449,12,11393,3,715,1906,766,2163,0,8397,27804,19407,766,2163
14192.0,IPUEIRAS,4965,12,7975,4,653,1921,658,2544,0,9147,27879,18732,658,2544
14214.0,IRACEMA,1516,2,3953,0,228,746,210,753,0,2801,10209,7408,210,753
14230.0,IRAUCUBA,1847,3,5984,0,499,693,222,1110,0,3047,13405,10358,222,1110
14257.0,ITAICABA,1653,3,1697,1,232,212,147,261,0,1116,5322,4206,147,261
14273.0,ITAPAGE,4430,15,12393,3,1376,1693,741,2182,0,5709,28542,22833,741,2182
14290.0,ITAPIPOCA,13229,26,22618,5,2445,3426,1191,3576,0,13703,60219,46516,1191,3576
14311.0,ITAPIUNA,4057,6,2454,1,577,881,288,1441,0,1570,11275,9705,288,1441
14338.0,ITATIRA,1101,2,4942,1,257,700,200,1011,0,1969,10183,8214,200,1011
14354.0,JAGUARETAMA,2883,6,4760,1,332,910,428,1443,0,2088,12851,10763,428,1443
14370.0,JAGUARIBARA,1429,4,2564,0,295,450,200,568,0,1132,6642,5510,200,568
14397.0,JAGUARIBE,3979,10,8887,6,1156,2055,729,1899,0,6264,24985,18721,729,1899
14419.0,JAGUARUANA,6812,20,5486,1,853,1379,1306,1624,0,4442,21923,17481,1306,1624
14435.0,JARDIM,4403,18,4842,5,271,2010,492,1841,0,4659,18541,13882,492,1841
14451.0,JATI,762,8,2400,0,195,460,90,421,0,879,5215,4336,90,421
14478.0,JUAZEIRO DO NORTE,38055,306,37171,21,3871,10324,2643,7851,0,32736,132978,100242,2643,7851
14494.0,JUCAS,2062,5,4610,3,876,2269,558,1857,0,3032,15272,12240,558,1857
14516.0,LAVRAS DA MANGABEIRA,4301,12,6286,1,608,2283,541,2506,0,6799,23337,16538,541,2506
14532.0,LIMOEIRO DO NORTE,12664,41,10027,8,1461,2212,1253,1855,0,6442,35963,29521,1253,1855
14559.0,MARANGUAPE,19694,45,16192,4,3749,2713,1193,3110,0,8758,55458,46700,1193,3110
14575.0,MARCO,2164,8,6841,5,283,1103,480,1260,0,2328,14472,12144,480,1260
14591.0,MARTINOPOLE,1158,2,2407,1,56,692,251,379,0,848,5794,4946,251,379
14613.0,MASSAPE,2459,7,8529,4,604,2369,729,1738,0,4819,21258,16439,729,1738
14630.0,MAURITI,6975,11,6889,4,1001,2396,635,2443,0,6433,26787,20354,635,2443
14656.0,MERUOCA,905,7,4224,0,351,476,181,679,0,1269,8092,6823,181,679
14672.0,MILAGRES,4538,13,5878,2,474,2314,409,1755,0,4469,19852,15383,409,1755
14680.0,MIRAIMA,1070,5,4004,1,174,746,111,603,0,2049,8763,6714,111,603
14699.0,MISSAO VELHA,4979,8,4391,4,1588,3157,584,2104,0,5635,22450,16815,584,2104
14710.0,MOMBACA,4578,10,8823,5,987,3104,798,3965,0,5588,27858,22270,798,3965
14737.0,MONSENHOR TABOSA,2129,4,4197,1,275,860,246,911,0,2266,10889,8623,246,911
14753.0,MORADA NOVA,10396,12,15417,6,5604,2605,1200,3818,0,10065,49123,39058,1200,3818
14770.0,MORAUJO,539,1,2500,1,77,597,184,443,0,824,5166,4342,184,443
14796.0,MORRINHOS,2106,0,4729,2,488,770,179,879,0,2940,12093,9153,179,879
14818.0,MUCAMBO,458,5,4904,2,193,902,182,792,0,1819,9257,7438,182,792
14834.0,MULUNGU,1336,3,2388,2,218,459,169,635,0,1284,6494,5210,169,635
14850.0,NOVA OLINDA,1185,6,3666,1,347,897,175,655,0,1293,8225,6932,175,655
14877.0,NOVA RUSSAS,3606,7,7263,5,656,1727,475,1971,0,7590,23300,15710,475,1971
14893.0,NOVO ORIENTE,3234,8,6206,3,834,1406,658,1454,0,3638,17441,13803,658,1454
14915.0,OROS,3056,6,5458,2,926,1416,589,1613,0,2989,16055,13066,589,1613
14931.0,PACAJUS,5339,15,11461,6,1777,1420,728,2393,0,4926,28065,23139,728,2393
14958.0,PACATUBA,10292,29,6272,11,2395,1200,436,1778,0,4788,27201,22413,436,1778
14974.0,PACOTI,2066,5,2685,1,247,718,285,580,0,2093,8680,6587,285,580
14990.0,PACUJA,447,2,2056,0,108,263,99,603,0,800,4378,3578,99,603
15016.0,PALHANO,803,3,3339,0,187,609,134,344,0,746,6165,5419,134,344
15032.0,PALMACIA,2352,9,2040,1,263,467,190,747,0,1126,7195,6069,190,747
15059.0,PARACURU,3084,10,7642,2,866,1227,382,1448,0,4093,18754,14661,382,1448
15075.0,PARAMBU,2510,7,7443,2,1707,2328,637,1808,0,7280,23722,16442,637,1808
15091.0,PARAMOTI,1076,1,3824,1,80,646,124,698,0,1326,7776,6450,124,698
15113.0,PEDRA BRANCA,3832,4,8986,2,753,1657,819,3148,0,8699,27900,19201,819,3148
15130.0,PENAFORTE,982,19,2007,0,490,465,112,349,0,674,5098,4424,112,349
15156.0,PENTECOSTE,6273,10,7868,3,1013,1561,382,1630,0,3531,22271,18740,382,1630
15172.0,PEREIRO,1180,5,3175,4,321,2649,236,870,0,2895,11335,8440,236,870
15199.0,PIQUET CARNEIRO,2146,1,3151,1,279,998,330,962,0,1655,9523,7868,330,962
15210.0,PORANGA,1278,7,2687,1,297,937,118,905,0,1731,7961,6230,118,905
15237.0,PORTEIRAS,3690,6,2134,1,598,1126,184,1134,0,1916,10789,8873,184,1134
15253.0,POTENGI,776,2,2688,0,70,555,196,490,0,997,5774,4777,196,490
15270.0,QUIXADA,14437,24,12563,6,1862,2728,828,2404,0,10083,44935,34852,828,2404
15296.0,QUIXERAMOBIM,11081,13,12791,4,1564,2794,736,3015,0,9158,41156,31998,736,3015
15318.0,QUIXERE,3817,14,3322,1,528,836,305,932,0,2009,11764,9755,305,932
15334.0,REDENCAO,4979,10,5563,3,1007,1167,444,1619,0,3453,18245,14792,444,1619
15350.0,RERIUTABA,1103,6,6336,2,250,883,277,1133,0,4082,14072,9990,277,1133
15377.0,RUSSAS,9956,28,13664,1,1480,1823,1058,2688,0,6627,37325,30698,1058,2688
15393.0,SABOEIRO,1382,4,4196,2,410,1126,257,1527,0,2199,11103,8904,257,1527
15415.0,SANTANA DO ACARAU,6294,3,6242,1,1011,920,511,1775,0,4427,21184,16757,511,1775
15431.0,SANTANA DO CARIRI,2467,10,3376,2,137,925,224,1071,0,3193,11405,8212,224,1071
15440.0,SALITRE,319,4,3550,2,145,1060,149,811,0,2137,8177,6040,149,811
15458.0,SANTA QUITERIA,2383,13,14308,10,388,1378,648,2389,0,7616,29133,21517,648,2389
15474.0,SAO BENEDITO,3553,28,10929,9,744,3184,593,2368,0,8596,30004,21408,593,2368
15490.0,SAO GONCALO DO AMARANTE,5511,20,9032,4,1876,1850,457,1708,0,5446,25904,20458,457,1708
15512.0,SAO JOAO DO JAGUARIBE,2608,7,1621,1,312,351,212,527,0,1081,6720,5639,212,527
15539.0,SAO LUIS DO CURU,1786,4,3670,1,601,576,285,859,0,1423,9205,7782,285,859
15555.0,SENADOR POMPEU,5721,6,4322,1,669,1301,416,1938,0,3076,17450,14374,416,1938
15571.0,SENADOR SA,357,2,2053,0,73,468,90,549,0,652,4244,3592,90,549
15598.0,SOBRAL,9312,47,55791,10,1681,5361,2627,5527,0,15760,96116,80356,2627,5527
15610.0,SOLONOPOLE,1776,6,4393,1,426,1083,267,1702,0,2990,12644,9654,267,1702
15636.0,TABULEIRO DO NORTE,7677,18,4967,2,950,937,572,1613,0,4646,21382,16736,572,1613
15652.0,TAMBORIL,4541,11,5396,0,461,1645,471,1737,0,6112,20374,14262,471,1737
15679.0,TAUA,5387,10,14893,5,2383,1967,932,2685,0,6049,34311,28262,932,2685
15695.0,TIANGUA,5902,29,13532,6,1224,2671,1327,3314,0,7799,35804,28005,1327,3314
15717.0,TRAIRI,5500,24,11442,2,1139,2368,607,1376,0,6489,28947,22458,607,1376
15733.0,UBAJARA,1667,13,8960,4,402,1567,506,1477,0,4733,19329,14596,506,1477
15750.0,UMARI,1356,3,1532,1,167,551,113,477,0,1000,5200,4200,113,477
15776.0,URUBURETAMA,2985,5,5216,3,515,1253,376,1085,0,1658,13096,11438,376,1085
15792.0,URUOCA,1163,4,3215,2,211,1181,181,714,0,1787,8458,6671,181,714
15814.0,VARZEA ALEGRE,6492,28,5993,4,942,2498,884,2505,0,7278,26624,19346,884,2505
15830.0,VICOSA DO CEARA,5639,13,13353,8,455,2501,540,2670,0,7428,32607,25179,540,2670
15857.0,MARACANAU,46114,174,20658,16,10236,2977,1732,4202,0,15906,102015,86109,1732,4202
15873.0,AMONTADA,3787,7,8334,3,1082,1552,410,1845,0,6103,23123,17020,410,1845
15881.0,CROATA,1257,4,4231,2,341,1087,189,937,0,3491,11539,8048,189,937
15890.0,CRUZ,2350,4,6228,2,611,1059,237,917,0,3986,15394,11408,237,917
15911.0,FORQUILHA,927,3,7028,1,113,758,402,946,0,2856,13034,10178,402,946
15920.0,IBICUITINGA,2252,5,2903,1,361,545,219,588,0,1119,7993,6874,219,588
15938.0,ICAPUI,5258,10,1404,0,682,1066,209,626,0,2250,11505,9255,209,626
15954.0,ITAREMA,2633,10,6818,5,637,1410,329,1476,0,5868,19186,13318,329,1476
15970.0,MILHA,2023,1,3350,0,406,465,186,1153,0,1371,8955,7584,186,1153
15989.0,DEP IRAPUAN PINHEIRO,1042,0,2694,0,156,481,109,912,0,1161,6555,5394,109,912
15997.0,PARAIPABA,1895,10,7995,6,1073,1323,291,1181,0,2106,15880,13774,291,1181
16004.0,TENENTE LAURENTINO CRUZ,713,4,367,3,304,832,119,504,0,524,3370,2846,119,504
16012.0,ACARI,2833,22,1165,3,434,1472,236,856,0,1429,8450,7021,236,856
16020.0,SERRA DO MEL,1226,6,460,2,1062,896,280,711,0,600,5243,4643,280,711
16039.0,ASSU,10659,44,5039,4,3100,3424,1291,3318,0,6108,32987,26879,1291,3318
16047.0,CAICARA DO NORTE,873,4,540,0,661,913,125,446,0,765,4327,3562,125,446
16055.0,AFONSO BEZERRA,2035,8,541,2,960,1792,309,1194,0,1390,8231,6841,309,1194
16063.0,SAO MIGUEL DE TOUROS,1111,8,163,1,510,1028,155,658,0,727,4361,3634,155,658
16071.0,AGUA NOVA,318,2,206,0,137,618,66,312,0,372,2031,1659,66,312
16080.0,ITAJA,1200,5,1023,0,343,879,133,642,0,535,4760,4225,133,642
16098.0,ALEXANDRIA,3528,8,552,0,689,2108,174,1296,0,2686,11041,8355,174,1296
16101.0,BODO,471,1,278,0,147,448,54,372,0,297,2068,1771,54,372
16110.0,ALMINO AFONSO,1096,10,192,2,380,1424,124,561,0,420,4209,3789,124,561
16128.0,TRIUNFO POTIGUAR,450,4,146,0,396,890,61,404,0,346,2697,2351,61,404
16136.0,ALTO DO RODRIGUES,2371,4,1094,1,719,519,261,849,0,340,6158,5818,261,849
16144.0,FERNANDO PEDROSA,506,0,201,0,357,591,86,287,0,299,2327,2028,86,287
16152.0,ANGICOS,1809,11,1587,1,1116,1900,212,1114,0,1573,9323,7750,212,1114
16160.0,MAJOR SALES,391,0,611,1,115,422,20,292,0,509,2361,1852,20,292
16179.0,ANTONIO MARTINS,975,9,483,0,579,1571,174,777,0,1219,5787,4568,174,777
16187.0,VENHA VER,340,2,379,1,62,698,80,548,0,521,2631,2110,80,548
16195.0,APODI,7344,25,2591,5,2323,3684,863,2533,0,3833,23201,19368,863,2533
16209.0,SERRINHA DOS PINTOS,438,2,999,2,369,391,56,585,0,754,3596,2842,56,585
16217.0,AREIA BRANCA,6452,26,2664,2,1549,1999,581,1787,0,3427,18487,15060,581,1787
16225.0,TIBAU,807,3,337,0,164,233,84,274,0,275,2177,1902,84,274
16233.0,ARES,2307,13,634,3,858,2124,510,1019,0,1565,9033,7468,510,1019
16241.0,SANTA MARIA,732,2,393,0,520,466,135,415,0,572,3235,2663,135,415
16250.0,CAMPO GRANDE,2045,5,578,3,469,1772,307,864,0,1226,7269,6043,307,864
16268.0,RIO DO FOGO,1335,4,1041,1,691,1779,307,926,0,1868,7952,6084,307,926
16276.0,BAIA FORMOSA,1345,10,332,1,1344,619,251,649,0,1519,6070,4551,251,649
16284.0,PORTO DO MANGUE,668,3,214,0,266,782,75,418,0,436,2862,2426,75,418
16292.0,BARCELONA,598,4,449,2,329,946,82,440,0,283,3133,2850,82,440
16306.0,JUNDIA,608,4,178,0,281,547,101,370,0,769,2858,2089,101,370
16314.0,BENTO FERNANDES,1163,8,542,2,551,368,90,626,0,556,3906,3350,90,626
16330.0,BOM JESUS,1268,17,828,1,855,1278,257,875,0,1454,6833,5379,257,875
16357.0,BREJINHO,1269,4,345,0,818,1986,275,1091,0,1683,7471,5788,275,1091
16373.0,CAICARA DO RIO DO VENTO,659,3,737,1,217,297,51,456,0,200,2621,2421,51,456
16390.0,CAICO,16847,68,4701,4,3274,4807,1021,2504,0,6247,39473,33226,1021,2504
16411.0,CAMPO REDONDO,973,8,982,3,1321,1124,203,1022,0,830,6466,5636,203,1022
16438.0,CANGUARETAMA,6890,22,911,2,1708,1501,853,2193,0,4360,18440,14080,853,2193
16454.0,CARAUBAS,4285,12,2019,3,1572,1726,1025,1886,0,2907,15435,12528,1025,1886
16470.0,CARNAUBA DOS DANTAS,1013,22,528,4,452,1666,134,461,0,662,4942,4280,134,461
16497.0,CARNAUBAIS,2116,11,914,0,714,928,293,802,0,1089,6867,5778,293,802
16519.0,CEARA MIRIM,10172,94,2120,7,4192,9238,1507,4218,0,8636,40184,31548,1507,4218
16535.0,CERRO-CORA,983,6,646,1,559,2258,194,1116,0,1527,7290,5763,194,1116
16551.0,CORONEL EZEQUIEL,492,5,454,0,495,895,91,644,0,566,3642,3076,91,644
16578.0,CORONEL JOAO PESSOA,533,7,741,1,275,508,94,602,0,982,3743,2761,94,602
16594.0,CRUZETA,1793,14,774,2,439,1297,273,777,0,1287,6656,5369,273,777
16616.0,CURRAIS NOVOS,8101,43,4925,3,2484,4905,1024,2646,0,5772,29903,24131,1024,2646
16632.0,DOUTOR SEVERIANO,533,5,1267,1,200,995,114,801,0,995,4911,3916,114,801
16659.0,ENCANTO,910,2,959,0,131,249,102,542,0,852,3747,2895,102,542
16675.0,EQUADOR,921,9,131,0,437,1019,125,541,0,813,3996,3183,125,541
16691.0,ESPIRITO SANTO,1314,9,841,0,681,971,178,830,0,1034,5858,4824,178,830
16713.0,EXTREMOZ,3819,20,1037,4,2097,3668,513,1373,0,3869,16400,12531,513,1373
16730.0,FELIPE GUERRA,1743,6,616,2,651,608,248,666,0,440,4980,4540,248,666
16756.0,FLORANIA,1677,11,1153,1,377,1918,191,958,0,1377,7663,6286,191,958
16772.0,FRANCISCO DANTAS,469,4,545,1,122,625,44,297,0,238,2345,2107,44,297
16799.0,GALINHOS,430,1,243,0,297,132,29,222,0,143,1497,1354,29,222
16810.0,GOIANINHA,3521,18,917,1,1602,3257,587,1809,0,1962,13674,11712,587,1809
16837.0,GOVERNADOR DIX-SEPT ROSADO,3023,14,815,2,889,1071,524,1073,0,1414,8825,7411,524,1073
16853.0,GROSSOS,1697,6,1746,0,591,376,243,533,0,656,5848,5192,243,533
16870.0,GUAMARE,1988,7,1749,2,1050,934,172,1187,0,1890,8979,7089,172,1187
16896.0,IELMO MARINHO,1259,8,975,0,664,1296,284,981,0,1304,6771,5467,284,981
16918.0,IPANGUACU,2826,4,950,0,755,1620,320,1136,0,1870,9481,7611,320,1136
16934.0,IPUEIRA,566,12,307,3,147,228,24,121,0,151,1559,1408,24,121
16950.0,ITAU,986,4,684,0,530,746,56,545,0,756,4307,3551,56,545
16977.0,JACANA,745,5,217,1,416,1825,128,641,0,763,4741,3978,128,641
16993.0,JANDAIRA,757,6,613,1,625,1107,265,613,0,805,4792,3987,265,613
17019.0,JANDUIS,1581,6,556,2,265,653,171,494,0,890,4618,3728,171,494
17035.0,BOA SAUDE,683,2,822,0,558,1418,179,871,0,1116,5649,4533,179,871
17051.0,JAPI,657,4,781,0,608,1107,95,747,0,1149,5148,3999,95,747
17078.0,JARDIM DE ANGICOS,724,2,277,1,147,425,21,344,0,181,2122,1941,21,344
17094.0,JARDIM DE PIRANHAS,3367,9,531,2,575,1583,279,924,0,1780,9050,7270,279,924
17116.0,JARDIM DO SERIDO,2102,41,1068,11,680,2649,310,970,0,1507,9338,7831,310,970
17132.0,JOAO CAMARA,6549,17,2355,2,2138,2252,894,2795,0,4035,21037,17002,894,2795
17159.0,JOAO DIAS,414,0,72,0,168,1028,35,210,0,251,2178,1927,35,210
17175.0,JOSE DA PENHA,1318,7,301,0,509,919,111,585,0,1030,4780,3750,111,585
17191.0,JUCURUTU,3097,9,1712,6,1073,2955,348,1802,0,2310,13312,11002,348,1802
17213.0,MESSIAS TARGINO,1413,5,474,0,109,282,99,466,0,260,3108,2848,99,466
17230.0,LAGOA D ANTA,824,2,233,0,358,1227,71,693,0,947,4355,3408,71,693
17256.0,LAGOA DE PEDRAS,708,3,297,0,362,1533,175,737,0,906,4721,3815,175,737
17272.0,LAGOA DE VELHOS,528,7,225,0,190,631,81,279,0,226,2167,1941,81,279
17299.0,LAGOA NOVA,1115,16,1630,7,438,2902,243,1271,0,1973,9595,7622,243,1271
17310.0,LAGOA SALGADA,1054,11,1157,2,580,962,329,1070,0,709,5874,5165,329,1070
17337.0,LAJES,2047,6,836,2,516,1955,142,1100,0,1256,7860,6604,142,1100
17353.0,LAJES PINTADAS,705,5,789,1,258,559,132,618,0,488,3555,3067,132,618
17370.0,LUCRECIA,1015,6,209,0,382,243,43,302,0,307,2507,2200,43,302
17396.0,LUIS GOMES,1493,5,300,3,459,2207,142,1020,0,1577,7206,5629,142,1020
17418.0,MACAIBA,8505,71,2311,12,5045,6897,1467,4086,0,6121,34515,28394,1467,4086
17434.0,MACAU,7744,21,1470,9,2287,2328,597,1247,0,4392,20095,15703,597,1247
17450.0,MARCELINO VIEIRA,1687,5,1323,0,553,561,152,824,0,1263,6368,5105,152,824
17477.0,MARTINS,1471,5,1324,0,446,642,113,688,0,1360,6049,4689,113,688
17493.0,MAXARANGUAPE,1279,14,820,0,666,1812,192,938,0,2014,7735,5721,192,938
17515.0,FRUTUOSO GOMES,1030,7,352,0,379,686,91,431,0,943,3919,2976,91,431
17531.0,MONTANHAS,2550,8,818,2,422,702,180,1063,0,2063,7808,5745,180,1063
17558.0,MONTE ALEGRE,3101,11,840,2,1101,2172,397,1606,0,2485,11715,9230,397,1606
17574.0,MONTE DAS GAMELEIRAS,571,2,40,0,140,410,35,416,0,371,1985,1614,35,416
17590.0,MOSSORO,53708,240,21316,29,13852,10750,3838,10271,0,21512,135516,114004,3838,10271
17612.0,NATAL,178283,1503,45028,169,76351,46375,9099,20922,0,69111,446841,377730,9099,20922
17639.0,NISIA FLORESTA,3163,19,774,6,1638,1860,676,1127,0,1765,11028,9263,676,1127
17655.0,NOVA CRUZ,4656,23,2692,6,2618,4398,697,3097,0,6219,24406,18187,697,3097
17671.0,OLHO D'AGUA DO BORGES,713,4,546,0,312,802,202,615,0,786,3980,3194,202,615
17698.0,OURO BRANCO,946,5,364,1,357,1111,88,387,0,380,3639,3259,88,387
17710.0,PARANA,819,3,142,3,159,874,86,413,0,479,2978,2499,86,413
17736.0,PARAU,574,2,607,0,611,538,130,462,0,520,3444,2924,130,462
17752.0,PARAZINHO,698,1,578,0,345,407,113,440,0,336,2918,2582,113,440
17779.0,PARELHAS,3575,69,1790,17,1249,3212,465,1497,0,2612,14486,11874,465,1497
17795.0,PARNAMIRIM,22790,151,5507,19,11462,8517,1807,3616,0,9560,63429,53869,1807,3616
17817.0,PASSA E FICA,767,8,217,1,497,1948,178,886,0,1452,5954,4502,178,886
17833.0,PASSAGEM,563,4,247,0,167,542,67,380,0,252,2222,1970,67,380
17850.0,PATU,2058,9,808,1,1012,2018,338,1132,0,995,8371,7376,338,1132
17876.0,PAU DOS FERROS,4499,12,2672,1,945,2751,448,1627,0,2965,15920,12955,448,1627
17892.0,PEDRA GRANDE,824,3,216,3,294,699,115,345,0,596,3095,2499,115,345
17914.0,PEDRA PRETA,434,2,172,0,228,881,61,341,0,266,2385,2119,61,341
17930.0,PEDRO AVELINO,1435,4,885,4,335,1369,182,992,0,807,6013,5206,182,992
17957.0,PEDRO VELHO,3207,11,618,1,1521,959,397,1120,0,2798,10632,7834,397,1120
17973.0,PENDENCIAS,3095,4,1274,1,1009,667,270,1085,0,1743,9148,7405,270,1085
17990.0,PILOES,620,3,525,0,179,478,50,320,0,450,2625,2175,50,320
18015.0,POCO BRANCO,2506,13,492,6,922,1574,414,1188,0,1699,8814,7115,414,1188
18031.0,PORTALEGRE,688,7,905,0,271,1681,111,889,0,919,5471,4552,111,889
18058.0,SERRA CAIADA,906,6,390,3,256,1933,133,869,0,1213,5709,4496,133,869
18074.0,PUREZA,1320,1,350,2,336,1388,144,666,0,682,4889,4207,144,666
18090.0,RAFAEL FERNANDES,643,1,859,1,176,486,134,582,0,690,3572,2882,134,582
18112.0,RIACHO DA CRUZ,285,3,821,0,92,415,27,361,0,266,2270,2004,27,361
18139.0,RIACHO DE SANTANA,649,7,753,0,211,355,53,476,0,665,3169,2504,53,476
18155.0,RIACHUELO,1073,2,378,1,478,1215,66,559,0,718,4490,3772,66,559
18171.0,RODOLFO FERNANDES,503,2,1517,0,296,443,46,672,0,258,3737,3479,46,672
18198.0,RUY BARBOSA,405,2,121,0,324,1195,57,343,0,459,2906,2447,57,343
18210.0,SAO FRANCISCO DO OESTE,526,4,529,0,228,548,150,379,0,560,2924,2364,150,379
18236.0,SANTA CRUZ,5619,15,2617,4,2228,3446,770,2677,0,3945,21321,17376,770,2677
18252.0,SANTANA DO SERIDO,596,19,76,3,225,360,57,188,0,118,1642,1524,57,188
18279.0,SANTANA DO MATOS,1914,13,2066,5,754,1835,436,1382,0,1899,10304,8405,436,1382
18295.0,SANTO ANTONIO,4545,21,1307,1,1623,1215,658,2096,0,3652,15118,11466,658,2096
18317.0,SAO BENTO DO NORTE,837,8,331,0,203,461,74,402,0,369,2685,2316,74,402
18333.0,SAO BENTO DO TRAIRI,391,4,73,0,314,1238,65,414,0,284,2783,2499,65,414
18350.0,SAO FERNANDO,936,7,396,1,238,471,134,290,0,353,2826,2473,134,290
18376.0,SAO GONCALO DO AMARANTE,13396,141,3504,17,8615,8080,1886,3792,0,9483,48914,39431,1886,3792
18392.0,SAO JOAO DO SABUGI,1679,19,344,1,315,1133,80,365,0,509,4445,3936,80,365
18414.0,SAO JOSE DE MIPIBU,7247,45,1914,7,2659,3153,809,2756,0,4455,23045,18590,809,2756
18430.0,SAO JOSE DE CAMPESTRE,2129,12,1010,3,797,1420,415,1307,0,1927,9020,7093,415,1307
18457.0,SAO JOSE DO SERIDO,1178,5,420,0,213,392,164,287,0,275,2934,2659,164,287
18473.0,SAO MIGUEL,2353,20,2930,3,777,2409,757,2589,0,3802,15640,11838,757,2589
18490.0,SAO PAULO DO POTENGI,2138,8,753,5,752,2840,509,1241,0,2029,10275,8246,509,1241
18511.0,SAO PEDRO,1163,4,817,1,453,1043,149,751,0,514,4895,4381,149,751
18538.0,SAO RAFAEL,1798,6,668,0,613,1233,233,950,0,1248,6749,5501,233,950
18554.0,SAO TOME,1855,23,1046,3,788,1251,370,1256,0,1545,8137,6592,370,1256
18570.0,SAO VICENTE,685,14,430,3,196,1485,150,572,0,487,4022,3535,150,572
18597.0,SENADOR ELOI DE SOUZA,729,4,345,3,359,755,183,559,0,950,3887,2937,183,559
18619.0,SENADOR GEORGINO AVELINO,732,4,197,1,232,951,73,324,0,331,2845,2514,73,324
18635.0,SERRA DE SAO BENTO,974,7,308,0,557,757,96,652,0,720,4071,3351,96,652
18651.0,SERRA NEGRA DO NORTE,2317,7,532,0,383,894,99,512,0,1403,6147,4744,99,512
18678.0,SERRINHA,1607,8,164,1,1158,473,199,789,0,692,5091,4399,199,789
18694.0,SEVERIANO MELO,1383,5,1294,1,262,695,177,840,0,1611,6268,4657,177,840
18716.0,SITIO NOVO,618,4,544,0,352,658,136,503,0,741,3556,2815,136,503
18732.0,TABOLEIRO GRANDE,267,0,315,1,413,388,21,239,0,137,1781,1644,21,239
18759.0,TAIPU,2706,10,852,2,582,1371,415,1262,0,2112,9312,7200,415,1262
18775.0,TANGARA,1691,13,1198,1,1240,1478,382,1276,0,1890,9169,7279,382,1276
18791.0,TENENTE ANANIAS,1083,7,1541,3,457,1270,118,726,0,1719,6924,5205,118,726
18813.0,TIBAU DO SUL,1441,5,908,1,1072,522,257,759,0,651,5616,4965,257,759
18830.0,TIMBAUBA DOS BATISTAS,617,3,290,1,166,256,55,216,0,203,1807,1604,55,216
18856.0,TOUROS,3721,20,1149,1,2268,3061,915,2046,0,3246,16427,13181,915,2046
18872.0,UMARIZAL,1891,35,1419,2,721,1654,321,1097,0,1798,8938,7140,321,1097
18899.0,UPANEMA,1789,2,1368,1,1331,1219,271,988,0,942,7911,6969,271,988
18910.0,VARZEA,760,4,839,1,607,392,96,573,0,1002,4274,3272,96,573
18937.0,RAFAEL GODEIRO,574,3,144,0,267,781,71,242,0,295,2377,2082,71,242
18953.0,VERA CRUZ,1177,5,910,3,794,1532,419,1086,0,1411,7337,5926,419,1086
18970.0,VICOSA,382,0,297,0,128,144,29,201,0,295,1476,1181,29,201
18996.0,VILA FLOR,500,2,179,0,252,251,111,270,0,394,1959,1565,111,270
19003.0,RIACHAO DO POCO,884,1,147,0,174,672,86,471,0,385,2820,2435,86,471
19011.0,AGUA BRANCA,777,5,317,4,73,2215,152,766,0,856,5165,4309,152,766
19020.0,SOBRADO,994,3,180,1,352,1270,185,603,0,1184,4772,3588,185,603
19038.0,AGUIAR,1879,2,334,2,154,566,60,782,0,576,4355,3779,60,782
19046.0,SAO JOSE DOS RAMOS,1235,3,48,0,103,719,86,485,0,756,3435,2679,86,485
19054.0,ALAGOA GRANDE,6116,19,1113,3,1411,3264,897,2727,0,3180,18730,15550,897,2727
19062.0,CAPIM,531,0,97,1,475,760,240,412,0,833,3349,2516,240,412
19070.0,ALAGOA NOVA,3453,18,690,6,795,2698,597,1843,0,2024,12124,10100,597,1843
19089.0,CUITE DE MAMANGUAPE,1220,12,103,1,264,983,124,657,0,1308,4672,3364,124,657
19097.0,ALAGOINHA,2921,11,174,0,842,1377,367,1323,0,1106,8121,7015,367,1323
19100.0,CURRAL DE CIMA,478,2,37,3,213,1472,124,674,0,1297,4300,3003,124,674
19119.0,ALHANDRA,3697,5,357,1,2075,2079,586,1133,0,3009,12942,9933,586,1133
19127.0,RIACHAO DO BACAMARTE,795,3,65,0,233,811,126,530,0,824,3387,2563,126,530
19135.0,SAO JOAO DO RIO DO PEIXE,3395,26,1685,1,796,2068,738,1688,0,1885,12282,10397,738,1688
19143.0,MATINHAS,817,6,47,0,228,616,154,431,0,894,3193,2299,154,431
19151.0,ARACAGI,3423,16,209,1,803,2209,375,1627,0,4016,12679,8663,375,1627
19160.0,LOGRADOURO,965,0,47,0,259,385,53,403,0,384,2496,2112,53,403
19178.0,ARARA,1849,10,115,2,277,1912,225,896,0,1321,6607,5286,225,896
19186.0,SERTAOZINHO,1127,3,71,1,182,435,63,344,0,430,2656,2226,63,344
19194.0,ARARUNA,3498,9,167,3,705,2505,295,1711,0,1595,10488,8893,295,1711
19208.0,RIACHAO,721,5,28,5,78,755,24,196,0,426,2238,1812,24,196
19216.0,AREIA,4556,30,750,4,1233,3450,830,2142,0,1960,14955,12995,830,2142
19224.0,SAO DOMINGOS DO CARIRI,441,2,72,0,107,722,17,185,0,370,1916,1546,17,185
19232.0,AREIAL,1190,7,245,0,244,964,181,471,0,655,3957,3302,181,471
19240.0,CARAUBAS,568,4,176,2,174,1039,76,342,0,374,2755,2381,76,342
19259.0,AROEIRAS,1816,16,285,3,878,4373,492,2282,0,1897,12042,10145,492,2282
19267.0,SANTO ANDRE,295,7,223,1,184,602,80,321,0,223,1936,1713,80,321
19275.0,DAMIAO,932,7,76,0,167,697,47,490,0,585,3001,2416,47,490
19283.0,SOSSEGO,288,1,224,1,248,556,40,264,0,164,1786,1622,40,264
19291.0,BAIA DA TRAICAO,771,3,130,0,381,959,341,570,0,968,4123,3155,341,570
19305.0,BARAUNAS,471,4,92,0,153,807,66,407,0,313,2313,2000,66,407
19313.0,BANANEIRAS,5204,11,347,0,1054,2556,508,1977,0,2194,13851,11657,508,1977
19321.0,ASSUNCAO,425,0,70,1,286,928,51,248,0,206,2215,2009,51,248
19330.0,BARRA DE SANTA ROSA,2689,8,137,1,372,2584,98,1187,0,1000,8076,7076,98,1187
19348.0,ZABELE,312,8,163,1,91,400,67,216,0,176,1434,1258,67,216
19356.0,BARRA DE SAO MIGUEL,901,7,221,0,230,1324,114,493,0,746,4036,3290,114,493
19364.0,CACIMBAS,311,8,146,1,97,1787,146,730,0,1454,4680,3226,146,730
19372.0,BAYEUX,23054,89,2522,18,11732,6166,2890,4705,0,10612,61788,51176,2890,4705
19380.0,CAJAZEIRINHAS,838,2,107,0,78,745,85,496,0,396,2747,2351,85,496
19399.0,BELEM,3604,6,282,1,817,2298,405,1395,0,2022,10830,8808,405,1395
19402.0,SAO BENTINHO,1123,1,106,0,68,316,36,460,0,591,2701,2110,36,460
19410.0,BELEM DO BREJO DO CRUZ,678,8,503,0,186,1521,182,628,0,681,4387,3706,182,628
19429.0,SAO DOMINGOS DE POMBAL,470,1,279,0,217,726,95,333,0,651,2772,2121,95,333
19437.0,BOA VENTURA,1117,2,190,1,281,942,80,647,0,694,3954,3260,80,647
19445.0,SAO JOSE DE PRINCESA,594,3,129,1,90,698,46,421,0,818,2800,1982,46,421
19453.0,BOM JESUS,543,6,151,0,60,442,66,241,0,238,1747,1509,66,241
19461.0,MARIZOPOLIS,1283,3,370,1,320,1062,168,501,0,625,4333,3708,168,501
19470.0,BOM SUCESSO,1150,7,691,2,220,533,128,527,0,640,3898,3258,128,527
19488.0,MATO GROSSO,211,0,24,0,29,1026,19,255,0,201,1765,1564,19,255
19496.0,BONITO DE SANTA FE,1696,9,931,1,288,1017,122,875,0,1039,5978,4939,122,875
19500.0,BERNARDINO BATISTA,193,2,58,0,98,887,39,255,0,291,1823,1532,39,255
19518.0,BOQUEIRAO,3148,24,898,1,741,2732,361,1660,0,2940,12505,9565,361,1660
19526.0,POCO DE JOSE DE MOURA,1182,15,357,9,160,379,79,533,0,384,3098,2714,79,533
19534.0,IGARACY,1509,3,222,0,270,727,78,723,0,988,4520,3532,78,723
19542.0,SAO JOSE DO BREJO CRUZ,471,2,185,1,73,211,39,162,0,153,1297,1144,39,162
19550.0,BORBOREMA,1108,4,140,0,202,563,115,480,0,547,3159,2612,115,480
19569.0,SANTA INES,654,1,108,0,40,1021,40,461,0,391,2716,2325,40,461
19577.0,BREJO DO CRUZ,1782,9,1144,4,379,2070,283,1105,0,2263,9039,6776,283,1105
19585.0,AMPARO,326,1,70,0,65,543,44,184,0,172,1405,1233,44,184
19593.0,BREJO DOS SANTOS,920,2,175,0,656,1421,177,573,0,861,4785,3924,177,573
19607.0,CASSERENGUE,1071,7,370,1,144,1112,105,797,0,705,4312,3607,105,797
19615.0,CAAPORA,4184,13,281,1,1621,2451,634,1267,0,3113,13565,10452,634,1267
19623.0,GADO BRAVO,602,6,230,2,253,2394,294,973,0,1700,6454,4754,294,973
19631.0,CABACEIRAS,1129,17,402,4,374,585,100,369,0,433,3413,2980,100,369
19640.0,POCO DANTAS,520,1,191,0,168,554,110,331,0,401,2276,1875,110,331
19658.0,CABEDELO,9410,78,1975,15,4937,3536,1236,1707,0,4442,27336,22894,1236,1707
19666.0,SANTAREM,695,4,102,0,107,462,31,289,0,508,2198,1690,31,289
19674.0,CACHOEIRA DOS INDIOS,1928,2,589,2,95,981,166,651,0,957,5371,4414,166,651
19682.0,TENORIO,549,4,64,1,103,414,52,317,0,325,1829,1504,52,317
19690.0,CACIMBA DE AREIA,689,4,219,0,124,770,111,278,0,387,2582,2195,111,278
19704.0,COXIXOLA,262,8,178,2,108,201,134,163,0,135,1191,1056,134,163
19712.0,CACIMBA DE DENTRO,2801,5,103,1,665,3619,138,1446,0,1890,10668,8778,138,1446
19720.0,PARARI,260,1,90,0,145,438,33,214,0,213,1394,1181,33,214
19739.0,CAICARA,2086,5,111,1,433,814,84,708,0,935,5177,4242,84,708
19747.0,PEDRO REGIS,629,1,61,1,364,585,166,489,0,822,3118,2296,166,489
19755.0,CAJAZEIRAS,15034,32,3441,10,1363,4289,1294,3387,0,9399,38249,28850,1294,3387
19763.0,ALCANTIL,780,7,443,1,198,804,102,516,0,296,3147,2851,102,516
19771.0,CALDAS BRANDAO,1325,3,146,0,436,622,221,484,0,493,3730,3237,221,484
19780.0,BARRA DE SANTANA,805,3,478,2,342,1865,262,881,0,628,5266,4638,262,881
19798.0,CAMALAU,886,5,576,0,187,738,238,649,0,465,3744,3279,238,649
19801.0,CATURITE,731,8,297,0,197,873,157,325,0,270,2858,2588,157,325
19810.0,CAMPINA GRANDE,89977,714,16466,100,31432,38795,8197,14387,0,39781,239849,200068,8197,14387
19828.0,RIACHO DE SANTO ANTONIO,273,1,283,0,71,302,34,163,0,155,1282,1127,34,163
19836.0,CARRAPATEIRA,597,4,22,0,100,276,37,210,0,432,1678,1246,37,210
19844.0,APARECIDA,1623,3,429,0,226,889,249,608,0,762,4789,4027,249,608
19852.0,CATINGUEIRA,873,3,634,0,194,828,101,426,0,644,3703,3059,101,426
19860.0,SAO FRANCISCO,1102,1,188,0,62,744,104,405,0,316,2922,2606,104,405
19879.0,CATOLE DO ROCHA,6556,15,1315,3,1246,4232,347,2133,0,1964,17811,15847,347,2133
19887.0,VIEIROPOLIS,1227,2,208,0,148,894,114,671,0,516,3780,3264,114,671
19895.0,CONCEICAO,3045,11,851,1,334,3325,389,2068,0,2130,12154,10024,389,2068
19909.0,AREIA DE BARAUNAS,299,1,58,0,57,671,38,178,0,139,1441,1302,38,178
19917.0,CONDADO,1259,3,734,2,214,1341,131,565,0,1063,5312,4249,131,565
19925.0,ALGODAO DE JANDAIRA,615,6,41,1,91,389,36,238,0,257,1674,1417,36,238
19933.0,CONDE,3628,11,453,4,1073,1445,833,1167,0,2719,11333,8614,833,1167
19941.0,BOA VISTA,1096,8,313,2,265,1287,94,436,0,525,4026,3501,94,436
19950.0,CONGO,896,1,262,2,201,855,134,394,0,361,3106,2745,134,394
19968.0,MARCACAO,528,3,88,0,404,828,309,448,0,999,3607,2608,309,448
19976.0,COREMAS,3027,6,493,0,731,2168,298,1432,0,1571,9726,8155,298,1432
19984.0,MATUREIA,777,6,98,1,208,1296,149,595,0,987,4117,3130,149,595
19992.0,CRUZ DO ESPIRITO SANTO,3180,13,361,13,1422,1571,660,1210,0,1001,9431,8430,660,1210
20001.0,SANTA CECILIA DE UMBUZEIRO,406,0,139,0,98,2117,126,582,0,1134,4602,3468,126,582
20010.0,CUBATI,719,6,293,2,301,1793,141,714,0,492,4461,3969,141,714
20036.0,CUITE,2786,16,741,1,821,4373,384,1914,0,3575,14611,11036,384,1914
20052.0,CUITEGI,1193,5,198,1,264,853,185,659,0,688,4046,3358,185,659
20079.0,CURRAL VELHO,261,1,120,0,24,807,14,286,0,398,1911,1513,14,286
20095.0,DESTERRO,726,5,442,2,198,1976,171,728,0,769,5017,4248,171,728
20117.0,VISTA SERRANA,525,0,108,0,170,707,27,253,0,370,2160,1790,27,253
20133.0,DIAMANTE,1223,6,353,1,190,1017,110,904,0,740,4544,3804,110,904
20150.0,DONA INES,2361,5,176,1,368,1709,129,1029,0,1060,6838,5778,129,1029
20176.0,DUAS ESTRADAS,1138,1,38,0,148,647,78,409,0,479,2938,2459,78,409
20192.0,EMAS,351,3,534,1,95,622,46,325,0,284,2261,1977,46,325
20214.0,ESPERANCA,6577,40,762,6,1125,4879,794,2297,0,5266,21746,16480,794,2297
20230.0,FAGUNDES,1787,3,211,3,383,2612,180,1450,0,1813,8442,6629,180,1450
20257.0,FREI MARTINHO,563,2,204,1,101,716,37,306,0,133,2063,1930,37,306
20273.0,GUARABIRA,12370,52,1388,12,3573,5925,1113,3436,0,4210,32079,27869,1113,3436
20290.0,GURINHEM,3018,6,236,1,696,2298,355,1018,0,2401,10029,7628,355,1018
20311.0,GURJAO,474,4,244,1,113,845,46,350,0,238,2315,2077,46,350
20338.0,IBIARA,815,4,513,0,255,1215,211,642,0,697,4352,3655,211,642
20354.0,IMACULADA,1229,11,161,2,424,2236,227,1139,0,994,6423,5429,227,1139
20370.0,INGA,3674,7,314,1,974,2230,423,2010,0,3635,13268,9633,423,2010
20397.0,ITABAIANA,5261,37,776,1,1811,3898,896,2239,0,5624,20543,14919,896,2239
20419.0,ITAPORANGA,5198,10,1029,2,504,2500,326,1679,0,3965,15213,11248,326,1679
20435.0,ITAPOROROCA,1340,5,240,0,802,3277,423,1427,0,1128,8642,7514,423,1427
20451.0,ITATUBA,1643,3,138,2,516,1873,328,1143,0,1836,7482,5646,328,1143
20478.0,JACARAU,2342,7,349,7,1459,1824,294,1096,0,1594,8972,7378,294,1096
20494.0,JERICO,1631,5,222,0,331,1241,140,700,0,712,4982,4270,140,700
20516.0,JOAO PESSOA,177832,896,26894,190,50120,40079,10966,17943,0,51902,376822,324920,10966,17943
20532.0,JUAREZ TAVORA,1814,6,175,1,579,647,358,721,0,652,4953,4301,358,721
20559.0,JUAZEIRINHO,2572,30,867,7,964,2118,336,1415,0,1184,9493,8309,336,1415
20575.0,JUNCO DO SERIDO,821,8,273,1,199,1530,136,565,0,669,4202,3533,136,565
20591.0,JURIPIRANGA,3100,10,165,2,383,1039,247,1061,0,2699,8706,6007,247,1061
20613.0,JURU,1012,3,82,0,85,2479,190,994,0,2287,7132,4845,190,994
20630.0,LAGOA,1153,9,249,0,329,538,205,529,0,495,3507,3012,205,529
20656.0,LAGOA DE DENTRO,1511,4,109,2,268,1223,178,559,0,978,4832,3854,178,559
20672.0,LAGOA SECA,4416,21,437,6,939,3751,958,1801,0,1684,14013,12329,958,1801
20699.0,LASTRO,1270,1,141,0,94,350,103,410,0,279,2648,2369,103,410
20710.0,LIVRAMENTO,522,1,203,2,235,1872,137,712,0,553,4237,3684,137,712
20737.0,LUCENA,1689,3,204,0,1143,813,441,712,0,1744,6749,5005,441,712
20753.0,MAE D AGUA,677,5,68,1,191,1036,84,367,0,450,2879,2429,84,367
20770.0,MALTA,1148,1,343,0,158,980,166,683,0,851,4330,3479,166,683
20796.0,MAMANGUAPE,5564,23,1178,1,3312,6116,1077,2929,0,6333,26533,20200,1077,2929
20818.0,MANAIRA,1602,17,282,0,355,1605,157,1105,0,2596,7719,5123,157,1105
20834.0,MARI,3222,18,536,1,2002,1849,506,1608,0,1920,11662,9742,506,1608
20850.0,MASSARANDUBA,2026,6,265,2,680,2004,584,1195,0,1600,8362,6762,584,1195
20877.0,MATARACA,1220,3,249,2,514,781,178,572,0,637,4156,3519,178,572
20893.0,MOGEIRO,2348,4,231,2,545,2310,261,973,0,2627,9301,6674,261,973
20915.0,MONTADAS,586,10,455,0,201,581,109,444,0,492,2878,2386,109,444
20931.0,MONTE HOREBE,851,7,256,0,151,573,94,394,0,679,3005,2326,94,394
20958.0,MONTEIRO,4741,16,1024,1,916,5846,693,2765,0,2473,18475,16002,693,2765
20974.0,MULUNGU,2288,7,268,1,433,1617,210,934,0,888,6646,5758,210,934
20990.0,NATUBA,650,6,159,1,340,2008,305,934,0,719,5122,4403,305,934
21016.0,NAZAREZINHO,1582,7,716,1,275,879,164,872,0,974,5470,4496,164,872
21032.0,NOVA FLORESTA,1177,7,445,2,332,2176,205,607,0,807,5758,4951,205,607
21059.0,NOVA OLINDA,729,5,706,0,112,918,113,780,0,1813,5176,3363,113,780
21075.0,NOVA PALMEIRA,914,9,49,2,76,856,95,346,0,333,2680,2347,95,346
21091.0,OLHO D AGUA,1464,3,236,0,202,2235,100,756,0,824,5820,4996,100,756
21113.0,OLIVEDOS,607,10,356,0,119,688,93,407,0,492,2772,2280,93,407
21130.0,OURO VELHO,850,5,146,1,61,564,43,311,0,310,2291,1981,43,311
21156.0,PASSAGEM,270,2,127,0,177,601,30,181,0,180,1568,1388,30,181
21172.0,PATOS,18159,91,5907,11,3662,13389,1574,4190,0,11890,58873,46983,1574,4190
21199.0,PAULISTA,1382,21,1123,2,456,2360,228,961,0,1267,7800,6533,228,961
21210.0,PEDRA BRANCA,653,2,166,0,78,1001,44,431,0,368,2743,2375,44,431
21237.0,PEDRA LAVRADA,1230,10,258,2,311,1770,106,702,0,615,5004,4389,106,702
21253.0,PEDRAS DE FOGO,4979,18,642,3,1969,3586,749,2444,0,5078,19468,14390,749,2444
21270.0,PIANCO,3024,3,437,3,405,3219,333,1402,0,1580,10406,8826,333,1402
21296.0,PICUI,2869,20,372,0,752,3948,432,1702,0,2654,12749,10095,432,1702
21318.0,PILAR,2984,6,122,1,650,1277,292,937,0,774,7043,6269,292,937
21334.0,PILOES,2503,13,213,1,140,477,148,778,0,750,5023,4273,148,778
21350.0,PILOEZINHOS,1126,3,88,0,233,809,155,567,0,755,3736,2981,155,567
21377.0,PIRPIRITUBA,1994,3,203,3,532,1311,252,772,0,994,6064,5070,252,772
21393.0,PITIMBU,1734,6,293,1,1170,1349,288,688,0,1561,7090,5529,288,688
21415.0,POCINHOS,2599,14,490,5,571,3564,390,1248,0,1313,10194,8881,390,1248
21431.0,POMBAL,7681,18,1342,3,1410,3901,569,2629,0,2700,20253,17553,569,2629
21458.0,PRATA,669,4,192,1,202,781,129,351,0,727,3056,2329,129,351
21474.0,PRINCESA ISABEL,2984,43,332,1,368,3615,317,1335,0,2067,11062,8995,317,1335
21490.0,PUXINANA,2294,19,401,2,481,2391,439,882,0,674,7583,6909,439,882
21512.0,QUEIMADAS,5766,69,1083,4,2398,6266,1179,3105,0,3901,23771,19870,1179,3105
21539.0,QUIXABA,286,2,57,0,32,658,13,153,0,167,1368,1201,13,153
21555.0,REMIGIO,3157,24,552,2,522,2454,394,1144,0,1579,9828,8249,394,1144
21571.0,RIACHO DOS CAVALOS,833,2,356,1,377,2293,242,714,0,583,5401,4818,242,714
21598.0,RIO TINTO,4233,19,552,1,1582,3091,821,1547,0,4590,16436,11846,821,1547
21610.0,SALGADINHO,303,1,148,0,174,779,81,297,0,392,2175,1783,81,297
21636.0,SALGADO DE SAO FELIX,2178,7,151,1,582,1769,343,1053,0,2761,8845,6084,343,1053
21652.0,SANTA CRUZ,2111,8,268,0,170,760,212,608,0,1139,5276,4137,212,608
21679.0,SANTA HELENA,1667,7,479,1,223,461,158,560,0,602,4158,3556,158,560
21695.0,SANTA LUZIA,2552,18,773,4,698,3629,585,722,0,1622,10603,8981,585,722
21717.0,SANTANA DE MANGUEIRA,729,1,413,1,154,1173,196,522,0,692,3881,3189,196,522
21733.0,SANTANA DOS GARROTES,1176,4,639,0,153,1378,146,958,0,786,5240,4454,146,958
21750.0,SANTA RITA,24726,105,3045,17,12118,7271,3417,6143,0,12973,69815,56842,3417,6143
21776.0,SANTA TERESINHA,844,4,273,1,142,1413,99,468,0,727,3971,3244,99,468
21792.0,SAO BENTO,4575,31,1188,1,1004,6070,425,1676,0,3336,18306,14970,425,1676
21814.0,SAO JOAO DO CARIRI,868,6,287,0,311,718,98,502,0,392,3182,2790,98,502
21830.0,SAO JOAO DO TIGRE,565,8,241,1,106,985,89,429,0,337,2761,2424,89,429
21857.0,SAO JOSE DA LAGOA TAPADA,1344,2,440,0,204,1692,251,816,0,1460,6209,4749,251,816
21873.0,SAO JOSE DE CAIANA,924,4,102,1,120,1195,141,690,0,855,4032,3177,141,690
21890.0,SAO JOSE DE ESPINHARAS,998,2,424,1,168,1114,146,566,0,695,4114,3419,146,566
21911.0,SAO JOSE DE PIRANHAS,3815,14,890,5,666,2196,541,1413,0,2166,11706,9540,541,1413
21938.0,SAO JOSE DO BONFIM,823,3,154,2,162,762,57,371,0,221,2555,2334,57,371
21954.0,SAO JOSE DO SABUGI,490,10,141,1,249,1309,99,404,0,232,2935,2703,99,404
21970.0,SAO JOSE DOS CORDEIROS,709,4,128,0,230,893,106,394,0,351,2815,2464,106,394
21997.0,SAO MAMEDE,1931,9,354,3,477,1386,167,684,0,1186,6197,5011,167,684
22012.0,SAO MIGUEL DE TAIPU,1309,3,57,0,485,472,144,545,0,471,3486,3015,144,545
22039.0,SAO SEB. DE LAGOA DE ROCA,1969,16,199,4,488,1808,365,781,0,1247,6877,5630,365,781
22055.0,SAO SEBASTIAO DO UMBUZEIRO,850,4,117,1,104,410,47,350,0,256,2139,1883,47,350
22071.0,SAPE,9815,19,1379,3,2727,5068,1522,3634,0,9555,33722,24167,1522,3634
22098.0,SAO VICENTE DO SERIDO,837,7,244,2,383,2171,300,880,0,1502,6326,4824,300,880
22110.0,SERRA BRANCA,2422,9,799,2,591,1623,401,1016,0,1123,7986,6863,401,1016
22136.0,SERRA DA RAIZ,807,3,69,0,184,546,86,273,0,431,2399,1968,86,273
22152.0,SERRA GRANDE,634,2,66,1,50,608,62,301,0,284,2008,1724,62,301
22179.0,SERRA REDONDA,1641,3,119,2,448,983,220,833,0,767,5016,4249,220,833
22195.0,SERRARIA,1538,9,81,3,166,1433,181,716,0,1049,5176,4127,181,716
22217.0,SOLANEA,5285,35,508,2,1032,4737,716,2211,0,6609,21135,14526,716,2211
22233.0,SOLEDADE,2461,29,447,0,485,2296,304,1188,0,1423,8633,7210,304,1188
22250.0,SOUSA,14223,52,3923,5,2182,5640,1719,4367,0,9573,41684,32111,1719,4367
22276.0,SUME,2393,17,818,0,531,2942,383,1427,0,1486,9997,8511,383,1427
22292.0,CAMPO DE SANTANA,1849,7,89,0,398,1649,242,783,0,921,5938,5017,242,783
22314.0,TAPEROA,1801,15,288,3,294,3649,250,1119,0,1251,8670,7419,250,1119
22330.0,TAVARES,1568,5,213,1,183,2637,334,1259,0,1727,7927,6200,334,1259
22357.0,TEIXEIRA,2046,14,711,4,286,2547,229,1177,0,1058,8072,7014,229,1177
22373.0,TRIUNFO,1231,11,1537,2,427,748,187,745,0,1803,6691,4888,187,745
22390.0,UIRAUNA,3183,15,617,2,446,2429,233,1116,0,1310,9351,8041,233,1116
22411.0,UMBUZEIRO,1038,4,147,1,250,2246,198,962,0,1010,5856,4846,198,962
22438.0,VARZEA,570,11,145,1,117,581,41,174,0,222,1862,1640,41,174
23000.0,QUIXABA,1190,6,30,2,231,1599,230,676,0,2057,6021,3964,230,676
23019.0,AFOGADOS DA INGAZEIRA,6589,5,321,3,1050,5501,686,2081,0,6141,22377,16236,686,2081
23027.0,LAGOA DO CARRO,3101,6,144,2,984,2346,403,1036,0,1996,10018,8022,403,1036
23035.0,AFRANIO,1974,12,1048,3,581,3809,458,1778,0,1797,11460,9663,458,1778
23043.0,SANTA CRUZ DA BAIXA VERDE,2325,9,569,4,300,2145,459,804,0,1346,7961,6615,459,804
23051.0,AGRESTINA,4282,12,254,1,855,4151,854,1981,0,5020,17410,12390,854,1981
23060.0,XEXEU,1426,5,81,1,866,1813,246,917,0,2725,8080,5355,246,917
23078.0,AGUA PRETA,5478,14,499,1,2771,2114,886,1833,0,6650,20246,13596,886,1833
23086.0,VERTENTE DO LERIO,1050,2,75,0,258,2219,377,931,0,2262,7174,4912,377,931
23094.0,AGUAS BELAS,4251,45,1328,2,1682,5693,1275,4903,0,8457,27636,19179,1275,4903
23108.0,SANTA CRUZ,2108,13,1045,1,409,896,339,1161,0,2161,8133,5972,339,1161
23116.0,ALAGOINHA,2912,10,937,0,186,1871,320,1200,0,2309,9745,7436,320,1200
23124.0,JUCATI,1228,9,94,2,283,2325,437,1022,0,1936,7336,5400,437,1022
23132.0,ALIANCA,6544,27,472,4,3917,4178,1294,2913,0,7666,27015,19349,1294,2913
23140.0,DORMENTES,3460,11,540,1,782,2146,567,1509,0,1785,10801,9016,567,1509
23159.0,ALTINHO,3340,12,617,2,818,3660,1514,2154,0,4087,16204,12117,1514,2154
23167.0,CARNAUBEIRA DA PENHA,2807,5,119,0,138,654,567,807,0,1921,7018,5097,567,807
23175.0,AMARAJI,3930,19,471,0,2662,1503,946,1739,0,4250,15520,11270,946,1739
23183.0,LAGOA GRANDE,4743,8,673,1,530,1318,305,1554,0,3447,12579,9132,305,1554
23191.0,ANGELIM,2116,5,97,1,207,1951,181,944,0,915,6417,5502,181,944
23205.0,ARACOIABA,2897,6,137,0,2178,1414,464,780,0,2531,10407,7876,464,780
23213.0,ARARIPINA,8950,42,5814,24,1862,6601,1706,6988,0,12574,44561,31987,1706,6988
23221.0,CASINHAS,1875,10,177,1,300,2650,477,1446,0,2671,9607,6936,477,1446
23230.0,ARCOVERDE,14037,39,1887,7,2055,7771,1498,3426,0,9195,39915,30720,1498,3426
23248.0,MANARI,685,7,61,0,128,3294,309,1562,0,2028,8074,6046,309,1562
23256.0,BARRA DE GUABIRABA,1631,4,269,0,683,1769,604,1028,0,2290,8278,5988,604,1028
23264.0,JATOBA,3845,19,274,0,283,857,190,823,0,2213,8504,6291,190,823
23272.0,BARREIROS,4962,20,983,3,5596,3607,1372,2222,0,10125,28890,18765,1372,2222
23280.0,TAMANDARE,3451,6,298,1,1472,1108,418,840,0,3055,10649,7594,418,840
23299.0,BELEM DE MARIA,1602,6,232,1,433,1915,485,1348,0,2764,8786,6022,485,1348
23302.0,JAQUEIRA,2414,9,90,1,320,1600,180,805,0,2063,7482,5419,180,805
23310.0,BELEM DE SAO FRANCISCO,3978,13,847,1,643,2281,393,1357,0,3843,13356,9513,393,1357
23329.0,SANTA FILOMENA,1659,5,724,2,516,1514,335,1221,0,1906,7882,5976,335,1221
23337.0,BELO JARDIM,15326,47,748,6,2128,12049,1757,4757,0,11470,48288,36818,1757,4757
23353.0,BETANIA,1137,2,2011,2,192,1176,274,1532,0,1397,7723,6326,274,1532
23370.0,BEZERROS,9159,80,1058,12,2052,10593,2746,4272,0,8182,38154,29972,2746,4272
23396.0,BODOCO,5144,14,1467,4,301,5201,746,2723,0,2725,18325,15600,746,2723
23418.0,BOM CONSELHO,4295,35,1627,4,1280,7724,1622,4253,0,9543,30383,20840,1622,4253
23434.0,BOM JARDIM,5513,15,243,3,936,8022,1137,3159,0,7409,26437,19028,1137,3159
23450.0,BONITO,5490,20,699,3,1548,5408,1661,3255,0,6485,24569,18084,1661,3255
23477.0,BREJAO,2851,18,118,0,450,1305,312,726,0,835,6615,5780,312,726
23493.0,BREJINHO,821,8,1007,0,182,1083,286,791,0,1891,6069,4178,286,791
23515.0,BREJO DA MADRE DE DEUS,3555,15,442,3,1130,7583,1071,3230,0,5410,22439,17029,1071,3230
23531.0,BUENOS AIRES,2995,10,182,1,947,1555,375,1302,0,2653,10020,7367,375,1302
23558.0,BUIQUE,3406,33,617,2,1354,8692,1389,5960,0,7850,29303,21453,1389,5960
23574.0,CABO,38038,187,3930,17,25888,11203,5287,6527,0,19592,110669,91077,5287,6527
23590.0,CABROBO,4174,19,784,5,1334,4288,859,2134,0,4674,18271,13597,859,2134
23612.0,CACHOEIRINHA,2782,9,244,3,307,3973,515,1716,0,3388,12937,9549,515,1716
23639.0,CAETES,3916,20,151,5,367,2809,679,1693,0,4181,13821,9640,679,1693
23655.0,CALCADO,777,7,60,0,264,2453,273,920,0,1690,6444,4754,273,920
23671.0,CALUMBI,1798,12,215,0,144,967,329,644,0,1912,6021,4109,329,644
23698.0,CAMOCIM DE SAO FELIX,3168,11,379,0,560,2658,835,1645,0,2817,12073,9256,835,1645
23710.0,CAMUTANGA,2105,4,141,1,563,1566,308,572,0,1984,7244,5260,308,572
23736.0,CANHOTINHO,2652,10,251,3,840,4425,725,2079,0,5481,16466,10985,725,2079
23752.0,CAPOEIRAS,3246,18,301,6,399,3279,1058,1422,0,3905,13634,9729,1058,1422
23779.0,CARNAIBA,3099,4,128,1,934,3444,524,1931,0,4504,14569,10065,524,1931
23795.0,CARPINA,12914,42,1505,4,7374,6312,2106,3212,0,8206,41675,33469,2106,3212
23817.0,CARUARU,39121,198,8144,36,15274,43502,9974,11110,0,26638,153997,127359,9974,11110
23833.0,CATENDE,4874,32,1024,3,3033,3569,1259,2380,0,6464,22638,16174,1259,2380
23850.0,CEDRO,1701,21,388,2,209,1545,283,1110,0,1997,7256,5259,283,1110
23876.0,CHA DE ALEGRIA,2378,11,169,3,959,2095,578,1134,0,2278,9605,7327,578,1134
23892.0,CHA GRANDE,2508,16,183,1,1362,3249,823,1757,0,1981,11880,9899,823,1757
23914.0,CONDADO,4376,14,332,1,1975,2051,744,1355,0,4159,15007,10848,744,1355
23930.0,CORRENTES,3023,9,249,4,505,2105,588,1618,0,3675,11776,8101,588,1618
23957.0,CORTES,2478,6,213,0,1538,2117,330,1240,0,3757,11679,7922,330,1240
23973.0,CUMARU,2597,7,188,0,569,4046,722,1961,0,3702,13792,10090,722,1961
23990.0,CUPIRA,2830,17,251,1,1005,4812,804,2038,0,5666,17424,11758,804,2038
24015.0,CUSTODIA,5145,19,310,3,695,5255,968,3204,0,6820,22419,15599,968,3204
24031.0,ESCADA,11929,54,1038,3,8744,5592,1309,2910,0,9220,40799,31579,1309,2910
24058.0,EXU,7458,32,984,1,653,3543,602,2988,0,7047,23308,16261,602,2988
24074.0,FEIRA NOVA,2339,10,244,0,1737,3998,836,1991,0,3782,14937,11155,836,1991
24090.0,FERREIROS,3291,16,240,1,474,990,384,775,0,2369,8540,6171,384,775
24112.0,FLORES,4078,16,930,5,538,2572,818,2112,0,5329,16398,11069,818,2112
24139.0,FLORESTA,8499,17,705,5,484,1774,455,1843,0,3908,17690,13782,455,1843
24155.0,FREI MIGUELINHO,1337,10,307,1,332,4221,503,1311,0,1425,9447,8022,503,1311
24171.0,GAMELEIRA,3953,9,348,1,1924,1536,489,1284,0,4368,13912,9544,489,1284
24198.0,GARANHUNS,29880,141,2924,11,5097,9312,2512,4802,0,14824,69503,54679,2512,4802
24210.0,GLORIA DO GOITA,3553,13,249,1,1462,4845,965,2717,0,4795,18600,13805,965,2717
24236.0,GOIANA,13667,90,1927,9,10046,6798,2347,2983,0,9787,47654,37867,2347,2983
24252.0,GRANITO,1303,9,283,1,111,818,143,615,0,594,3877,3283,143,615
24279.0,GRAVATA,8726,69,1428,6,2485,14484,2387,5367,0,12057,47009,34952,2387,5367
24295.0,IATI,2056,14,1292,3,397,2713,357,2019,0,4133,12984,8851,357,2019
24317.0,IBIMIRIM,2955,6,538,0,604,4297,834,2014,0,5727,16975,11248,834,2014
24333.0,IBIRAJUBA,845,3,77,0,223,2057,288,996,0,1780,6269,4489,288,996
24350.0,IGARASSU,17839,102,1434,3,11926,6102,2090,2555,0,9945,51996,42051,2090,2555
24376.0,IGUARACI,2067,5,264,1,295,1894,345,1121,0,2782,8774,5992,345,1121
24392.0,INAJA,1311,8,589,4,234,2457,358,1028,0,1901,7890,5989,358,1028
24414.0,INGAZEIRA,950,1,126,0,84,974,154,495,0,934,3718,2784,154,495
24430.0,IPOJUCA,9346,36,862,4,9029,5723,2118,4191,0,8997,40306,31309,2118,4191
24457.0,IPUBI,2427,9,787,3,388,3821,584,2296,0,4562,14877,10315,584,2296
24473.0,ITACURUBA,1473,2,72,0,98,482,95,374,0,953,3549,2596,95,374
24490.0,ITAIBA,2787,25,494,2,584,4532,501,2640,0,4121,15686,11565,501,2640
24511.0,ITAMARACA,3921,10,653,1,1652,2115,468,687,0,2227,11734,9507,468,687
24538.0,ITAPETIM,1888,16,142,1,302,3264,726,1295,0,3496,11130,7634,726,1295
24554.0,ITAQUITINGA,3159,15,262,4,2141,757,332,1244,0,2899,10813,7914,332,1244
24570.0,JABOATAO,124930,755,13991,52,69972,44135,13078,15742,0,52139,334794,282655,13078,15742
24597.0,JATAUBA,1987,25,170,0,199,3623,362,1581,0,2516,10463,7947,362,1581
24619.0,JOAO ALFREDO,3268,17,327,4,644,6043,1271,3995,0,5985,21554,15569,1271,3995
24635.0,JOAQUIM NABUCO,3721,13,187,1,1801,1449,458,1063,0,3905,12598,8693,458,1063
24651.0,JUPI,2302,12,212,1,608,1886,454,1599,0,2792,9866,7074,454,1599
24678.0,JUREMA,966,10,110,4,561,3059,411,1563,0,1434,8118,6684,411,1563
24694.0,LAGOA DE ITAENGA,4195,11,196,4,1374,4659,627,1814,0,3904,16784,12880,627,1814
24716.0,LAGOA DO OURO,1764,10,1873,2,277,1110,264,1509,0,2809,9618,6809,264,1509
24732.0,LAGOA DOS GATOS,1504,5,150,3,276,3221,575,1653,0,3455,10842,7387,575,1653
24759.0,LAJEDO,5906,49,530,3,1149,7632,1328,3172,0,6770,26539,19769,1328,3172
24775.0,LIMOEIRO,10888,27,1461,9,2778,11056,2421,4307,0,9457,42404,32947,2421,4307
24791.0,MACAPARANA,4067,20,387,2,1598,4501,774,2510,0,6518,20377,13859,774,2510
24813.0,MACHADOS,1792,8,368,3,461,2011,497,944,0,2496,8580,6084,497,944
24830.0,MARAIAL,2070,12,239,2,732,1892,399,1269,0,3256,9871,6615,399,1269
24856.0,MIRANDIBA,3477,13,321,0,240,1764,390,1258,0,2788,10251,7463,390,1258
24872.0,MORENO,11245,49,1643,11,7114,4113,1846,2393,0,7574,35988,28414,1846,2393
24899.0,NAZARE DA MATA,6047,33,1098,5,4295,2957,1643,2076,0,4782,22936,18154,1643,2076
24910.0,OLINDA,111344,704,14064,50,44197,40073,8071,11611,0,35686,265800,230114,8071,11611
24937.0,OROBO,2713,11,377,1,812,4387,870,2248,0,5246,16665,11419,870,2248
24953.0,OROCO,2244,12,411,2,318,2069,256,1200,0,1977,8489,6512,256,1200
24970.0,OURICURI,5774,35,1885,5,2155,9734,1276,5306,0,9638,35808,26170,1276,5306
24996.0,PALMARES,11600,36,1320,0,6034,4957,1495,3253,0,11856,40551,28695,1495,3253
25011.0,PALMEIRINA,1181,5,93,0,266,1943,229,949,0,1838,6504,4666,229,949
25038.0,PANELAS,2449,15,168,7,283,7253,352,2349,0,5769,18645,12876,352,2349
25054.0,PARANATAMA,1931,9,56,2,393,2465,373,1306,0,3405,9940,6535,373,1306
25070.0,PARNAMIRIM,3301,12,548,2,404,3872,644,1601,0,3110,13494,10384,644,1601
25097.0,PASSIRA,5085,12,178,3,1200,6228,1350,2518,0,5320,21894,16574,1350,2518
25119.0,PAUDALHO,5796,19,744,1,5455,6190,1634,2803,0,5382,28024,22642,1634,2803
25135.0,PAULISTA,65246,386,7180,31,30957,20789,4588,5642,0,24825,159644,134819,4588,5642
25151.0,PEDRA,3090,20,866,7,730,3829,690,2259,0,4021,15512,11491,690,2259
25178.0,PESQUEIRA,14331,104,1348,6,963,8045,1645,4161,0,10670,41273,30603,1645,4161
25194.0,PETROLANDIA,8821,27,891,0,582,1605,538,1775,0,3757,17996,14239,538,1775
25216.0,PETROLINA,55897,271,12685,26,9755,12875,3734,8281,0,24308,127832,103524,3734,8281
25232.0,POCAO,1978,19,179,2,160,2367,440,1298,0,1083,7526,6443,440,1298
25259.0,POMBOS,3239,10,340,4,1912,4749,1263,2057,0,4923,18497,13574,1263,2057
25275.0,PRIMAVERA,2265,6,302,0,1159,1230,512,828,0,2151,8453,6302,512,828
25291.0,QUIPAPA,2596,14,760,6,949,2626,676,2475,0,5693,15795,10102,676,2475
25313.0,RECIFE,389854,2376,58640,206,153091,167829,27260,35633,0,147622,982511,834889,27260,35633
25330.0,RIACHO DAS ALMAS,2534,15,252,4,793,4532,1571,1707,0,3830,15238,11408,1571,1707
25356.0,RIBEIRAO,7053,30,970,3,6133,2545,1035,2451,0,8616,28836,20220,1035,2451
25372.0,RIO FORMOSO,4052,10,254,3,2520,3051,496,1417,0,4830,16633,11803,496,1417
25399.0,SAIRE,2441,10,151,3,540,3006,966,1581,0,2958,11656,8698,966,1581
25410.0,SALGADINHO,698,1,65,1,227,1797,287,779,0,460,4315,3855,287,779
25437.0,SALGUEIRO,11027,54,1920,2,1733,6362,1007,2712,0,6935,31752,24817,1007,2712
25453.0,SALOA,1885,13,307,4,558,2995,549,1552,0,2947,10810,7863,549,1552
25470.0,SANHARO,3897,26,277,2,404,2995,726,2146,0,3787,14260,10473,726,2146
25496.0,SANTA CRUZ DO CAPIBARIBE,9591,50,1928,5,4128,9244,2419,4158,0,7190,38713,31523,2419,4158
25518.0,SANTA MARIA DA BOA VISTA,8475,28,621,4,880,2781,534,2180,0,4517,20020,15503,534,2180
25534.0,SANTA MARIA DO CAMBUCA,1431,7,121,3,350,3319,425,1133,0,3034,9823,6789,425,1133
25550.0,SANTA TEREZINHA,1168,6,421,2,402,2030,216,997,0,2126,7368,5242,216,997
25577.0,SAO BENEDITO DO SUL,1323,7,46,0,260,1698,350,897,0,2599,7180,4581,350,897
25593.0,SAO BENTO DO UNA,6919,36,658,2,1113,7660,1356,3048,0,7638,28430,20792,1356,3048
25615.0,SAO CAETANO,4730,28,987,6,1446,6144,1799,3797,0,5665,24602,18937,1799,3797
25631.0,SAO JOAO,3689,15,147,3,1038,2379,551,1600,0,3837,13259,9422,551,1600
25658.0,SAO JOAQUIM DO MONTE,2742,26,200,0,660,4087,1058,2129,0,3985,14887,10902,1058,2129
25674.0,SAO JOSE DA COROA GRANDE,1483,5,265,0,1855,2011,586,1257,0,3785,11247,7462,586,1257
25690.0,SAO JOSE DO BELMONTE,4648,21,2301,6,481,4034,976,2615,0,7334,22416,15082,976,2615
25712.0,SAO JOSE DO EGITO,5618,31,379,2,657,5094,934,2433,0,6219,21367,15148,934,2433
25739.0,SAO LOURENCO DA MATA,18287,154,1746,9,12444,8485,2442,4628,0,10978,59173,48195,2442,4628
25755.0,SAO VICENTE FERRER,2421,13,166,2,1287,2274,656,1641,0,3576,12036,8460,656,1641
25771.0,SERRA TALHADA,13116,67,4355,7,1812,9538,1425,4956,0,13162,48438,35276,1425,4956
25798.0,SERRITA,2936,10,322,1,174,3915,267,1514,0,3114,12253,9139,267,1514
25810.0,SERTANIA,5034,16,441,5,3799,4865,952,2168,0,7018,24298,17280,952,2168
25836.0,SIRINHAEM,5943,15,383,3,4705,3522,989,2233,0,6377,24170,17793,989,2233
25852.0,MOREILANDIA,2413,35,352,1,220,1448,244,1076,0,2526,8315,5789,244,1076
25879.0,SOLIDAO,1020,3,38,1,72,1346,188,722,0,1482,4872,3390,188,722
25895.0,SURUBIM,7612,24,1227,4,2170,9189,2385,2963,0,7622,33196,25574,2385,2963
25917.0,TABIRA,5424,17,934,1,457,3177,864,1955,0,4603,17432,12829,864,1955
25933.0,TACAIMBO,1493,8,98,0,102,2739,487,1264,0,2275,8466,6191,487,1264
25950.0,TACARATU,2225,15,479,3,443,2727,452,1514,0,3288,11146,7858,452,1514
25976.0,ITAMBE,6161,42,645,4,1799,3351,854,2070,0,5926,20852,14926,854,2070
25992.0,TAQUARITINGA DO NORTE,3381,21,361,4,769,3730,705,1757,0,2569,13297,10728,705,1757
26018.0,TEREZINHA,891,7,59,0,237,1593,359,735,0,1667,5548,3881,359,735
26034.0,TERRA NOVA,1531,11,378,2,141,1963,264,922,0,730,5942,5212,264,922
26050.0,TIMBAUBA,13201,48,1634,0,2882,6546,1740,3423,0,11093,40567,29474,1740,3423
26077.0,TORITAMA,2558,6,334,2,1545,3780,942,1530,0,3193,13890,10697,942,1530
26093.0,TRACUNHAEM,2533,12,156,2,1774,1213,587,791,0,2293,9361,7068,587,791
26115.0,TRINDADE,2355,13,1462,2,440,3921,598,1891,0,4313,14995,10682,598,1891
26131.0,TRIUNFO,3566,31,508,2,275,2834,587,1141,0,3475,12419,8944,587,1141
26158.0,TUPANATINGA,1176,20,931,1,381,3845,676,2615,0,4344,13989,9645,676,2615
26174.0,TUPARETAMA,2446,3,279,3,373,975,457,912,0,2110,7558,5448,457,912
26190.0,VENTUROSA,2199,20,400,2,515,3226,387,1398,0,2691,10838,8147,387,1398
26212.0,VERDEJANTE,1472,7,282,1,171,1895,227,1039,0,2067,7161,5094,227,1039
26239.0,VERTENTES,2080,10,304,1,429,3832,852,1444,0,1466,10418,8952,852,1444
26255.0,VICENCIA,6125,18,512,5,2055,2943,1012,2331,0,6223,21224,15001,1012,2331
26271.0,VITORIA DE SANTO ANTAO,20097,124,2628,17,11485,16915,4635,6309,0,16294,78504,62210,4635,6309
26298.0,CAMARAGIBE,33962,192,2876,16,19451,10500,3125,4269,0,12291,86682,74391,3125,4269
26310.0,ABREU E LIMA,23597,124,1784,16,17810,6497,2232,3469,0,9980,65509,55529,2232,3469
26336.0,ITAPISSUMA,4085,12,301,0,2517,2531,767,1156,0,2787,14156,11369,767,1156
27006.0,PARIPUEIRA,874,8,831,0,1618,897,276,532,0,415,5451,5036,276,532
27014.0,AGUA BRANCA,2221,17,1375,1,1412,2420,307,1211,0,3112,12076,8964,307,1211
27022.0,PARICONHA,861,8,953,1,484,1390,155,695,0,1572,6119,4547,155,695
27030.0,ANADIA,1569,33,1753,4,1520,1845,420,1285,0,3562,11991,8429,420,1285
27049.0,ESTRELA DE ALAGOAS,572,2,692,2,852,2398,220,1100,0,2726,8564,5838,220,1100
27057.0,ARAPIRACA,17517,171,9135,96,14368,29414,2782,7942,0,19055,100480,81425,2782,7942
27065.0,JEQUIA DA PRAIA,570,6,508,2,1002,1725,198,668,0,1728,6407,4679,198,668
27073.0,ATALAIA,2161,25,2759,7,3516,6144,755,2518,0,5706,23591,17885,755,2518
27081.0,CAMPESTRE,639,5,110,0,796,548,97,367,0,1103,3665,2562,97,367
27090.0,BARRA DE SANTO ANTONIO,1022,9,622,1,1624,713,243,689,0,495,5418,4923,243,689
27111.0,BARRA DE SAO MIGUEL,478,2,388,0,520,1065,81,319,0,234,3087,2853,81,319
27138.0,BATALHA,1691,9,1050,1,2275,1119,220,830,0,2017,9212,7195,220,830
27154.0,BELEM,429,1,201,0,1080,822,193,444,0,726,3896,3170,193,444
27170.0,BELO MONTE,684,6,817,2,557,525,170,424,0,923,4108,3185,170,424
27197.0,BOCA DA MATA,2412,28,1524,10,2734,3356,643,1515,0,3558,15780,12222,643,1515
27219.0,BRANQUINHA,900,11,206,0,931,1548,201,696,0,1587,6080,4493,201,696
27235.0,CACIMBINHAS,640,7,557,1,549,2321,168,598,0,1362,6203,4841,168,598
27251.0,CAJUEIRO,1365,11,1404,2,1379,2730,343,1383,0,2404,11021,8617,343,1383
27278.0,CAMPO ALEGRE,1814,27,2223,2,4321,1618,565,1959,0,5079,17608,12529,565,1959
27294.0,CAMPO GRANDE,750,2,704,0,1027,1188,175,511,0,532,4889,4357,175,511
27316.0,CANAPI,1965,9,498,1,906,3260,263,1052,0,2737,10691,7954,263,1052
27332.0,CAPELA,1142,9,802,3,1645,3358,384,1221,0,2498,11062,8564,384,1221
27359.0,CARNEIROS,981,4,1014,1,208,417,55,498,0,618,3796,3178,55,498
27375.0,CHA PRETA,585,5,477,1,444,1483,212,621,0,299,4127,3828,212,621
27391.0,COITE DO NOIA,743,6,1340,5,845,1170,249,807,0,1762,6927,5165,249,807
27413.0,COLONIA LEOPOLDINA,1881,17,1215,5,2372,1301,489,1104,0,3041,11425,8384,489,1104
27430.0,COQUEIRO SECO,628,5,396,0,550,484,142,304,0,294,2803,2509,142,304
27456.0,CORURIPE,3978,36,4426,4,6375,4514,809,2824,0,6675,29641,22966,809,2824
27472.0,DELMIRO GOUVEIA,9753,28,1552,3,2721,4604,1003,2311,0,7114,29089,21975,1003,2311
27499.0,DOIS RIACHOS,657,1,1290,1,1168,1255,92,876,0,1598,6938,5340,92,876
27510.0,FEIRA GRANDE,1832,14,1540,5,1628,2305,532,1481,0,2794,12131,9337,532,1481
27537.0,FELIZ DESERTO,223,2,379,0,360,710,76,241,0,234,2225,1991,76,241
27553.0,FLEXEIRAS,337,4,252,0,846,2658,114,750,0,634,5595,4961,114,750
27570.0,GIRAU DO PONCIANO,1855,31,2582,8,4130,2330,483,2083,0,4664,18166,13502,483,2083
27596.0,IBATEGUARA,1183,3,116,0,857,2094,397,957,0,2666,8273,5607,397,957
27618.0,IGACI,1536,27,2492,3,1705,3504,625,1525,0,4841,16258,11417,625,1525
27634.0,IGREJA NOVA,2369,19,568,4,1813,3104,931,1475,0,3381,13664,10283,931,1475
27650.0,INHAPI,2434,4,404,2,741,2423,303,1112,0,2630,10053,7423,303,1112
27677.0,JACARE DOS HOMENS,1111,8,483,2,476,615,82,425,0,715,3917,3202,82,425
27693.0,JACUIPE,709,2,354,1,725,857,123,481,0,1021,4273,3252,123,481
27715.0,JAPARATINGA,433,4,195,0,1482,494,197,320,0,1012,4137,3125,197,320
27731.0,JARAMATAIA,587,7,178,0,427,1062,100,465,0,708,3534,2826,100,465
27758.0,JOAQUIM GOMES,1432,18,697,2,2097,2200,353,1606,0,3784,12189,8405,353,1606
27774.0,JUNDIA,254,3,593,1,612,329,76,376,0,288,2532,2244,76,376
27790.0,JUNQUEIRO,2439,23,635,1,2053,4026,459,1565,0,3824,15025,11201,459,1565
27812.0,LAGOA DA CANOA,1427,21,1058,3,1516,2256,342,1133,0,2902,10658,7756,342,1133
27839.0,LIMOEIRO DE ANADIA,1439,12,3187,3,1771,1766,561,1826,0,3377,13942,10565,561,1826
27855.0,MACEIO,123450,1616,47497,101,93043,54671,7561,17204,0,70874,416017,345143,7561,17204
27871.0,MAJOR ISIDORO,1012,8,2255,2,1460,2315,375,1171,0,3111,11709,8598,375,1171
27898.0,MARAGOGI,1626,12,536,1,2412,2471,611,1162,0,2449,11280,8831,611,1162
27910.0,MARAVILHA,514,7,864,0,663,2226,189,779,0,2174,7416,5242,189,779
27936.0,MARECHAL DEODORO,3042,36,2468,2,3532,4236,858,1931,0,3812,19917,16105,858,1931
27952.0,MARIBONDO,1371,25,1323,2,1570,2041,454,903,0,2364,10053,7689,454,903
27979.0,MAR VERMELHO,354,3,264,0,220,965,89,289,0,207,2391,2184,89,289
27995.0,MATA GRANDE,2260,1,1879,3,782,3450,912,1969,0,3329,14585,11256,912,1969
28010.0,MATRIZ DE CAMARAGIBE,1622,6,644,2,3857,2340,369,1091,0,3599,13530,9931,369,1091
28037.0,MESSIAS,972,23,588,1,2207,1392,244,969,0,1891,8287,6396,244,969
28053.0,MINADOR DO NEGRAO,414,11,491,0,319,1059,112,468,0,869,3743,2874,112,468
28070.0,MONTEIROPOLIS,735,5,891,2,511,651,163,442,0,952,4352,3400,163,442
28096.0,MURICI,1963,12,1532,1,2690,3098,347,1717,0,1343,12703,11360,347,1717
28118.0,NOVO LINO,540,4,831,0,1512,1185,194,627,0,582,5475,4893,194,627
28134.0,OLHO D AGUA DAS FLORES,1911,18,1118,4,1068,3105,298,1093,0,2596,11211,8615,298,1093
28150.0,OLHO D AGUA DO CASADO,999,5,305,0,392,1403,100,607,0,1105,4916,3811,100,607
28177.0,OLHO D AGUA GRANDE,286,0,490,0,285,966,79,409,0,830,3345,2515,79,409
28193.0,OLIVENCA,656,5,498,2,556,2672,100,848,0,1556,6893,5337,100,848
28215.0,OURO BRANCO,462,3,487,0,478,2468,142,684,0,1608,6332,4724,142,684
28231.0,PALESTINA,676,9,592,0,252,385,55,363,0,202,2534,2332,55,363
28258.0,PALMEIRA DOS INDIOS,6995,88,4840,8,6090,8460,1144,3417,0,9107,40149,31042,1144,3417
28274.0,PAO DE ACUCAR,3381,19,982,2,1561,3501,285,1679,0,3271,14681,11410,285,1679
28290.0,PASSO DE CAMARAGIBE,793,3,545,1,2588,1311,394,772,0,1836,8243,6407,394,772
28312.0,PAULO JACINTO,670,9,469,2,742,1237,173,471,0,288,4061,3773,173,471
28339.0,PENEDO,7632,58,3092,3,3857,5171,811,2239,0,6957,29820,22863,811,2239
28355.0,PIACABUCU,1939,37,881,2,1626,1748,338,994,0,2936,10501,7565,338,994
28371.0,PILAR,2809,26,2714,8,3001,4245,829,1889,0,4818,20339,15521,829,1889
28398.0,PINDOBA,136,1,58,1,254,864,22,125,0,108,1569,1461,22,125
28410.0,PIRANHAS,2445,9,723,4,704,3022,255,1488,0,3118,11768,8650,255,1488
28436.0,POCO DAS TRINCHEIRAS,1093,6,1305,2,687,1916,109,837,0,1980,7935,5955,109,837
28452.0,PORTO CALVO,2020,13,1186,4,3147,3525,552,1564,0,4057,16068,12011,552,1564
28479.0,PORTO DE PEDRAS,457,5,529,2,1513,803,226,359,0,1228,5122,3894,226,359
28495.0,PORTO REAL DO COLEGIO,1539,32,1233,4,1541,2520,792,1103,0,2854,11618,8764,792,1103
28517.0,QUEBRANGULO,1123,8,1063,2,867,2011,385,797,0,641,6897,6256,385,797
28533.0,RIO LARGO,7484,73,3864,8,9866,5338,1088,2530,0,7218,37469,30251,1088,2530
28550.0,ROTEIRO,359,3,92,0,721,960,121,525,0,1374,4155,2781,121,525
28576.0,SANTA LUZIA DO NORTE,844,10,399,1,943,834,143,377,0,939,4490,3551,143,377
28592.0,SANTANA DO IPANEMA,3865,25,2959,2,3211,6587,652,2385,0,5112,24798,19686,652,2385
28614.0,SANTANA DO MUNDAU,623,4,307,2,822,2105,170,852,0,830,5715,4885,170,852
28630.0,SAO BRAS,821,9,197,3,651,909,298,476,0,378,3742,3364,298,476
28657.0,SAO JOSE DA LAJE,1481,23,1177,5,1992,2796,375,1411,0,848,10108,9260,375,1411
28673.0,SAO JOSE DA TAPERA,1579,24,1395,2,1338,4341,460,1843,0,4319,15301,10982,460,1843
28690.0,SAO LUIS DO QUITUNDE,2601,8,1021,1,4140,2657,941,2106,0,4227,17702,13475,941,2106
28711.0,SAO MIGUEL DOS CAMPOS,5926,66,1758,9,6064,4935,681,2659,0,2213,24311,22098,681,2659
28738.0,SAO MIGUEL DOS MILAGRES,529,4,247,0,845,963,241,353,0,368,3550,3182,241,353
28754.0,SAO SEBASTIAO,2233,23,967,9,1480,5888,965,1939,0,5160,18664,13504,965,1939
28770.0,SATUBA,1538,37,983,6,1644,751,291,515,0,1294,7059,5765,291,515
28797.0,TANQUE D ARCA,332,6,292,0,753,1093,223,409,0,1471,4579,3108,223,409
28819.0,TAQUARANA,718,9,1962,2,1254,2092,233,1218,0,2360,9848,7488,233,1218
28835.0,TRAIPU,1733,12,647,3,2249,5223,300,1671,0,3765,15603,11838,300,1671
28851.0,UNIAO DOS PALMARES,5973,79,2328,6,5434,5123,1077,3127,0,8904,32051,23147,1077,3127
28878.0,VICOSA,3644,29,1515,1,2293,2881,652,1903,0,3687,16605,12918,652,1903
28894.0,CRAIBAS,1467,15,1885,1,1446,2849,399,1332,0,3272,12666,9394,399,1332
28916.0,SENADOR RUI PALMEIRA,664,4,1812,2,397,476,106,683,0,1247,5391,4144,106,683
28932.0,SENADOR TEOTONIO VILELA,2358,33,1410,5,4447,4140,649,2114,0,6952,22108,15156,649,2114
30007.0,LUIS EDUARDO MAGALHAES,5045,25,2551,3,1130,1784,227,1007,0,3070,14842,11772,227,1007
30015.0,FERNANDO DE NORONHA,599,0,37,1,58,133,23,39,0,285,1175,890,23,39
30031.0,BARAUNA,2538,5,2000,2,967,2606,552,1795,0,3158,13623,10465,552,1795
30058.0,EUNAPOLIS,13442,56,3121,18,6968,5254,797,4261,0,13386,47303,33917,797,4261
30660.0,IUIU,2154,4,469,0,133,1030,164,929,0,2125,7008,4883,164,929
30678.0,JABORANDI,1283,6,230,0,156,2131,417,968,0,1799,6990,5191,417,968
30694.0,JUSSARI,1165,5,656,1,497,403,71,697,0,1972,5467,3495,71,697
30716.0,AMERICA DOURADA,2720,19,990,3,800,1483,353,1806,0,2964,11138,8174,353,1806
30732.0,ARATACA,992,4,431,4,866,1125,145,891,0,3511,7969,4458,145,891
30759.0,BARRO ALTO,2139,12,854,2,399,1579,230,1133,0,2327,8675,6348,230,1133
30775.0,BARROCAS,2750,10,2347,2,534,608,196,1171,0,2322,9940,7618,196,1171
30791.0,BURITIRAMA,1879,2,2379,2,307,1788,117,2386,0,2750,11610,8860,117,2386
30813.0,CAPELA DO ALTO ALEGRE,1900,12,670,6,856,1426,332,1350,0,2634,9186,6552,332,1350
30830.0,CAPIM GROSSO,5014,23,2051,11,1376,2334,592,2322,0,5251,18974,13723,592,2322
30856.0,CANUDOS,2475,10,1085,3,277,2407,150,1247,0,2183,9837,7654,150,1247
30872.0,DIAS D AVILA,14654,50,2354,10,2829,1182,568,2190,0,7691,31528,23837,568,2190
30899.0,FATIMA,2719,20,1491,3,364,1931,445,1752,0,2645,11370,8725,445,1752
30910.0,FILADELFIA,2475,6,1636,3,858,1354,324,1657,0,2589,10902,8313,324,1657
30937.0,GAVIAO,967,6,561,2,301,421,281,553,0,642,3734,3092,281,553
30953.0,GUAJERU,800,4,819,3,188,1095,170,1259,0,1991,6329,4338,170,1259
30970.0,HELIOPOLIS,2294,14,600,1,337,1576,301,1625,0,2398,9146,6748,301,1625
30996.0,JOAO DOURADO,2652,18,953,6,1670,2412,311,1383,0,1897,11302,9405,311,1383
31003.0,SANTANA DO SAO FRANCISCO,588,16,665,1,765,621,142,503,0,421,3722,3301,142,503
31011.0,AMPARO DO SAO FRANCISCO,438,3,147,0,161,483,31,162,0,261,1686,1425,31,162
31038.0,AQUIDABA,2805,27,2353,2,1635,1289,519,1666,0,3144,13440,10296,519,1666
31054.0,ARACAJU,135078,2157,31724,134,49094,22302,6085,14723,0,50243,311540,261297,6085,14723
31070.0,ARAUA,1654,11,894,0,1045,1367,333,876,0,1608,7788,6180,333,876
31097.0,AREIA BRANCA,1636,24,1627,1,1123,1523,316,1079,0,1014,8343,7329,316,1079
31119.0,BARRA DOS COQUEIROS,4443,45,872,5,1537,1576,348,766,0,1667,11259,9592,348,766
31135.0,BREJO GRANDE,1222,6,592,1,473,392,199,565,0,1308,4758,3450,199,565
31151.0,BOQUIM,6486,34,1247,5,2594,1713,732,1753,0,3188,17752,14564,732,1753
31194.0,CAMPO DO BRITO,2726,29,1879,2,834,1779,427,1162,0,1836,10674,8838,427,1162
31216.0,CANHOBA,666,1,346,1,378,586,125,422,0,419,2944,2525,125,422
31232.0,CANINDE DO SAO FRANCISCO,3942,11,1551,3,1275,1122,283,1548,0,2084,11819,9735,283,1548
31259.0,CAPELA,3359,71,1455,9,1935,3462,786,1857,0,3653,16587,12934,786,1857
31275.0,CARIRA,2007,18,2092,2,974,2561,339,1869,0,3242,13104,9862,339,1869
31291.0,CARMOPOLIS,2406,11,754,2,974,487,303,603,0,1173,6713,5540,303,603
31313.0,CEDRO DE SAO JOAO,1197,13,576,1,818,440,193,315,0,710,4263,3553,193,315
31330.0,CRISTINAPOLIS,2517,16,1068,0,543,1916,276,1142,0,2431,9909,7478,276,1142
31356.0,NOSSA SENHORA APARECIDA,636,18,1057,0,333,1541,247,679,0,687,5198,4511,247,679
31372.0,CUMBE,534,5,665,0,267,660,95,363,0,532,3121,2589,95,363
31399.0,DIVINA PASTORA,705,7,403,1,237,248,77,271,0,165,2114,1949,77,271
31410.0,ESTANCIA,13868,101,2463,13,4569,3515,1355,2876,0,4297,33057,28760,1355,2876
31437.0,FEIRA NOVA,555,8,711,2,493,681,88,438,0,358,3334,2976,88,438
31453.0,FREI PAULO,1210,17,1760,2,694,2185,370,1028,0,1253,8519,7266,370,1028
31470.0,GENERAL MAYNARD,676,8,286,0,246,202,70,179,0,343,2010,1667,70,179
31496.0,GARARU,1892,16,925,2,547,2030,268,1045,0,1444,8169,6725,268,1045
31518.0,GRACCHO CARDOSO,1471,6,438,2,495,519,199,564,0,761,4455,3694,199,564
31534.0,ILHA DAS FLORES,855,13,891,4,793,1054,256,643,0,1339,5848,4509,256,643
31550.0,INDIAROBA,1712,10,955,0,1541,748,231,1005,0,968,7170,6202,231,1005
31577.0,ITABAIANA,11902,134,8388,13,3548,10683,1291,4798,0,6928,47685,40757,1291,4798
31593.0,ITABAIANINHA,3744,46,2476,4,1775,6040,1031,2584,0,5330,23030,17700,1031,2584
31615.0,ITABI,800,6,551,0,253,883,106,544,0,470,3613,3143,106,544
31631.0,ITAPORANGA D AJUDA,4005,37,2757,4,2781,2003,448,2180,0,1793,16008,14215,448,2180
31658.0,JAPARATUBA,2658,34,1516,4,993,997,479,1014,0,2100,9795,7695,479,1014
31674.0,JAPOATA,2068,12,746,1,619,2070,369,1085,0,1117,8087,6970,369,1085
31690.0,LAGARTO,14762,126,5347,7,5166,10919,1890,6069,0,11040,55326,44286,1890,6069
31712.0,LARANJEIRAS,5459,39,1454,2,1837,1639,719,1483,0,1214,13846,12632,719,1483
31739.0,MACAMBIRA,704,6,726,1,236,1777,124,498,0,806,4878,4072,124,498
31755.0,MALHADA DOS BOIS,967,5,127,1,194,328,90,232,0,357,2301,1944,90,232
31771.0,MALHADOR,1324,15,1132,1,741,1897,215,822,0,795,6942,6147,215,822
31798.0,MARUIM,3230,29,1123,1,1371,1257,421,985,0,1201,9618,8417,421,985
31810.0,MOITA BONITA,649,14,427,0,209,3413,304,815,0,852,6683,5831,304,815
31836.0,MONTE ALEGRE DE SERGIPE,956,10,996,3,1653,1424,232,964,0,1832,8070,6238,232,964
31852.0,MURIBECA,843,10,774,0,834,894,242,659,0,1141,5397,4256,242,659
31879.0,NEOPOLIS,3356,37,1027,3,1610,1764,487,1248,0,1240,10772,9532,487,1248
31895.0,NOSSA SENHORA DA GLORIA,5194,25,2145,6,1761,2658,531,1871,0,3126,17317,14191,531,1871
31917.0,NOSSA SENHORA DAS DORES,3008,36,2275,5,1432,2466,952,1857,0,2879,14910,12031,952,1857
31933.0,NOSSA SENHORA DE LOURDES,1398,15,265,1,503,611,134,444,0,321,3692,3371,134,444
31950.0,NOSSA SENHORA DO SOCORRO,19146,314,5513,26,11813,4969,1802,3525,0,11760,58868,47108,1802,3525
31976.0,PACATUBA,1929,14,598,0,779,1626,533,971,0,1999,8449,6450,533,971
31992.0,PEDRA MOLE,534,9,602,1,146,180,45,262,0,266,2045,1779,45,262
32018.0,PEDRINHAS,1220,2,694,1,931,907,213,736,0,1169,5873,4704,213,736
32034.0,PINHAO,917,4,1273,3,283,424,111,557,0,804,4376,3572,111,557
32050.0,PIRAMBU,1312,10,1161,2,762,326,248,519,0,987,5327,4340,248,519
32077.0,POCO REDONDO,3331,24,1522,2,1008,2423,344,1741,0,3052,13447,10395,344,1741
32093.0,POCO VERDE,3090,45,2142,4,1133,2765,468,1725,0,3779,15151,11372,468,1725
32115.0,PORTO DA FOLHA,4737,52,1304,4,1837,2783,522,1861,0,3152,16252,13100,522,1861
32131.0,PROPRIA,6590,40,2437,0,2338,799,503,1306,0,3652,17665,14013,503,1306
32158.0,RIACHAO DO DANTAS,3003,29,1193,1,1235,3424,595,1624,0,2737,13841,11104,595,1624
32174.0,RIACHUELO,2478,6,368,3,705,1024,255,667,0,1099,6605,5506,255,667
32190.0,RIBEIROPOLIS,1883,6,3044,0,637,1764,246,1348,0,1130,10058,8928,246,1348
32212.0,ROSARIO DO CATETE,1596,13,1250,0,782,371,154,535,0,809,5510,4701,154,535
32239.0,SALGADO,3415,26,779,3,1669,1822,513,1261,0,1038,10526,9488,513,1261
32255.0,SANTA LUZIA DO ITANHY,1592,18,247,4,940,1691,448,850,0,1838,7628,5790,448,850
32298.0,SANTA ROSA DE LIMA,572,5,369,4,543,210,156,335,0,375,2569,2194,156,335
32310.0,SANTO AMARO DAS BROTAS,1672,14,940,5,862,1013,221,842,0,1100,6669,5569,221,842
32336.0,SAO CRISTOVAO,13918,162,2699,20,7031,3363,1213,2804,0,5939,37149,31210,1213,2804
32352.0,SAO DOMINGOS,1354,14,1139,0,439,626,226,898,0,1409,6105,4696,226,898
32379.0,SAO FRANCISCO,363,3,509,0,337,355,49,254,0,324,2194,1870,49,254
32395.0,SAO MIGUEL DO ALEIXO,171,1,790,1,158,512,50,404,0,346,2433,2087,50,404
32417.0,SIMAO DIAS,6881,74,1661,8,3676,4837,1064,2988,0,2826,24015,21189,1064,2988
32433.0,SIRIRI,1277,16,789,3,569,673,235,517,0,807,4886,4079,235,517
32450.0,TELHA,760,3,327,0,247,155,50,199,0,333,2074,1741,50,199
32476.0,TOBIAS BARRETO,6316,48,2751,10,4199,6484,1099,3124,0,7139,31170,24031,1099,3124
32492.0,TOMAR DO GERU,923,10,1297,2,567,2352,203,1278,0,2189,8821,6632,203,1278
32514.0,UMBAUBA,2266,24,1841,1,1640,1745,679,1170,0,1595,10961,9366,679,1170
33014.0,ABAIRA,794,13,247,2,248,2423,192,1013,0,1800,6732,4932,192,1013
33030.0,ABARE,2453,17,1189,0,767,1417,255,1942,0,1942,9982,8040,255,1942
33057.0,ACAJUTIBA,3106,13,1709,3,578,541,225,1222,0,2743,10140,7397,225,1222
33065.0,ADUSTINA,1824,21,1848,4,347,1200,227,1614,0,2357,9442,7085,227,1614
33073.0,AGUA FRIA,2632,15,1625,3,733,643,322,1815,0,3741,11529,7788,322,1815
33090.0,ERICO CARDOSO,1155,4,342,4,281,1740,282,1550,0,2631,7989,5358,282,1550
33111.0,AIQUARA,1126,8,142,2,657,248,156,666,0,1798,4803,3005,156,666
33138.0,ALAGOINHAS,33398,515,6222,39,12202,4949,1751,6100,0,18126,83302,65176,1751,6100
33154.0,ALCOBACA,3772,26,643,7,926,1102,333,1712,0,4427,12948,8521,333,1712
33170.0,ALMADINA,1970,2,448,0,292,319,46,500,0,2231,5808,3577,46,500
33197.0,AMARGOSA,7427,22,1367,4,2130,1774,501,2954,0,7638,23817,16179,501,2954
33219.0,AMELIA RODRIGUES,6022,60,1760,7,1848,1105,679,1812,0,4442,17735,13293,679,1812
33235.0,ANAGE,4235,18,1863,4,847,4245,533,3150,0,7481,22376,14895,533,3150
33251.0,ANDARAI,2565,5,653,6,314,973,222,1697,0,2275,8710,6435,222,1697
33260.0,ANDORINHA,4518,7,569,4,255,689,296,1168,0,2283,9789,7506,296,1168
33278.0,ANGICAL,3208,10,604,0,236,2599,205,1369,0,2452,10683,8231,205,1369
33294.0,ANGUERA,2646,15,463,2,804,597,480,1051,0,1383,7441,6058,480,1051
33316.0,ANTAS,2104,20,971,3,415,1795,393,1237,0,1537,8475,6938,393,1237
33332.0,ANTONIO CARDOSO,3869,13,1214,3,407,470,333,1386,0,1289,8984,7695,333,1386
33359.0,ANTONIO GONCALVES,2079,9,754,3,523,986,145,1212,0,2206,7917,5711,145,1212
33375.0,APORA,2100,16,1307,6,290,1599,351,1778,0,3417,10864,7447,351,1778
33383.0,ARACAS,2503,15,746,5,329,470,206,987,0,1981,7242,5261,206,987
33391.0,ARACATU,1257,8,1087,3,407,2207,267,1758,0,2936,9930,6994,267,1758
33405.0,APUAREMA,922,6,110,2,773,1022,131,927,0,2075,5968,3893,131,927
33413.0,ARACI,6817,39,3258,9,1010,3879,1814,5433,0,8373,30632,22259,1814,5433
33430.0,ARAMARI,2549,24,709,3,637,471,195,1207,0,1783,7578,5795,195,1207
33456.0,ARATUIPE,1234,9,210,3,705,995,145,1062,0,1793,6156,4363,145,1062
33472.0,AURELINO LEAL,1932,12,703,3,1061,862,188,1216,0,4084,10061,5977,188,1216
33499.0,BAIANOPOLIS,1691,8,569,4,506,2036,568,1372,0,2216,8970,6754,568,1372
33510.0,BAIXA GRANDE,3233,36,913,8,787,2528,553,2083,0,4606,14747,10141,553,2083
33529.0,BANZAE,2128,10,1209,2,324,1448,253,1637,0,2576,9587,7011,253,1637
33537.0,BARRA,5962,29,4151,8,1160,3829,571,3646,0,6858,26214,19356,571,3646
33553.0,BARRA DA ESTIVA,2596,4,420,2,442,4337,380,2154,0,2952,13287,10335,380,2154
33570.0,BARRA DO CHOCA,4172,13,814,12,1213,3575,437,3043,0,5724,19003,13279,437,3043
33596.0,BARRA DO MENDES,4014,28,1012,7,219,1182,371,1171,0,4042,12046,8004,371,1171
33618.0,BARRA DO ROCHA,1228,4,192,1,766,361,190,594,0,2743,6079,3336,190,594
33634.0,BARREIRAS,29948,97,6981,11,5518,4765,1192,5234,0,14565,68311,53746,1192,5234
33650.0,GOVERNADOR LOMANTO JUNIOR,1289,14,507,3,485,549,113,749,0,1989,5698,3709,113,749
33677.0,BELMONTE,2523,19,1187,6,1824,1194,310,1612,0,6041,14716,8675,310,1612
33693.0,BELO CAMPO,2302,6,1456,7,750,1427,334,1917,0,3038,11237,8199,334,1917
33715.0,BIRITINGA,2323,17,1292,2,574,1031,461,2009,0,2762,10471,7709,461,2009
33731.0,BOA NOVA,1762,8,617,6,258,2219,620,1643,0,3733,10866,7133,620,1643
33758.0,BOA VISTA DO TUPIM,2423,11,1653,3,346,2364,194,2047,0,3640,12681,9041,194,2047
33774.0,BOM JESUS DA LAPA,9430,47,1952,13,1843,6244,869,3446,0,11002,34846,23844,869,3446
33782.0,BOM JESUS DA SERRA,978,7,946,2,173,1162,83,1050,0,1758,6159,4401,83,1050
33790.0,BONINAL,1755,18,398,3,273,2131,253,1525,0,2403,8759,6356,253,1525
33804.0,BONITO,1752,8,383,2,294,1806,177,1283,0,2045,7750,5705,177,1283
33812.0,BOQUIRA,3917,10,1018,3,387,2683,399,2607,0,4603,15627,11024,399,2607
33839.0,BOTUPORA,1934,13,1218,2,188,518,202,1393,0,2179,7647,5468,202,1393
33855.0,BREJOES,2337,7,255,3,640,1710,241,1465,0,2697,9355,6658,241,1465
33871.0,BREJOLANDIA,1449,5,975,1,241,1382,235,983,0,1866,7137,5271,235,983
33898.0,BROTAS DE MACAUBAS,2586,14,1958,4,183,546,136,1142,0,2762,9331,6569,136,1142
33910.0,BRUMADO,14630,56,2012,11,1929,7632,1117,4785,0,9448,41620,32172,1117,4785
33936.0,BUERAREMA,3630,30,1908,3,1330,1521,269,1815,0,5099,15605,10506,269,1815
33952.0,CAATIBA,1118,3,501,2,320,953,195,1133,0,2177,6402,4225,195,1133
33960.0,CABACEIRAS DO PARAGUACU,1555,6,923,5,438,2107,280,1857,0,2466,9637,7171,280,1857
33979.0,CACHOEIRA,8201,50,1494,9,2273,1324,599,2476,0,5542,21968,16426,599,2476
33995.0,CACULE,3804,22,743,8,259,3220,354,1963,0,3954,14327,10373,354,1963
34010.0,CAEM,2800,14,835,4,435,809,244,1707,0,3192,10040,6848,244,1707
34029.0,CAETANOS,704,6,133,2,85,2421,164,1208,0,1992,6715,4723,164,1208
34037.0,CAETITE,7620,51,2953,12,1082,6796,775,4533,0,8371,32193,23822,775,4533
34053.0,CAFARNAUM,1630,9,969,3,773,2312,224,1474,0,2761,10155,7394,224,1474
34070.0,CAIRU,1580,6,568,2,1241,830,241,933,0,1259,6660,5401,241,933
34096.0,CALDEIRAO GRANDE,1438,5,451,0,121,1261,222,1232,0,2137,6867,4730,222,1232
34118.0,CAMACAN,5684,43,1367,5,2320,1464,534,2300,0,8203,21920,13717,534,2300
34134.0,CAMACARI,56220,261,10122,36,12074,3780,2597,8083,0,22645,115818,93173,2597,8083
34150.0,CAMAMU,3200,22,1241,13,1794,2555,494,2610,0,6972,18901,11929,494,2610
34177.0,CAMPO ALEGRE DE LOURDES,5106,16,2485,4,743,1427,386,2383,0,5283,17833,12550,386,2383
34193.0,CAMPO FORMOSO,10252,45,3689,19,2469,6629,2132,7377,0,10731,43343,32612,2132,7377
34215.0,CANAPOLIS,1715,4,636,2,210,1232,225,1388,0,1806,7218,5412,225,1388
34231.0,CANARANA,3765,35,959,4,774,2900,445,1879,0,4068,14829,10761,445,1879
34258.0,CANAVIEIRAS,5828,27,1474,7,3173,1700,481,2432,0,9146,24268,15122,481,2432
34274.0,CANDEAL,2575,6,1035,0,480,683,290,1139,0,1664,7872,6208,290,1139
34290.0,CANDEIAS,27970,115,1558,12,5303,1468,1012,3104,0,10876,51418,40542,1012,3104
34312.0,CANDIBA,2568,14,599,5,447,1543,563,1426,0,2410,9575,7165,563,1426
34339.0,CANDIDO SALES,3322,17,2385,12,1542,1804,656,2726,0,5785,18249,12464,656,2726
34355.0,CANSANCAO,5210,23,1613,9,1342,3334,996,3002,0,5922,21451,15529,996,3002
34363.0,CARAIBAS,1381,2,933,4,247,1246,135,1246,0,4262,9456,5194,135,1246
34371.0,CARAVELAS,4149,34,519,0,1028,1146,382,1838,0,4770,13866,9096,382,1838
34398.0,CARDEAL DA SILVA,1903,6,441,2,153,300,109,736,0,1616,5266,3650,109,736
34410.0,CARINHANHA,5702,17,2102,3,582,1086,237,2082,0,4474,16285,11811,237,2082
34436.0,CASA NOVA,11663,48,4696,12,2356,3271,1341,5987,0,9495,38869,29374,1341,5987
34452.0,CASTRO ALVES,5609,22,1618,10,1261,2822,630,2767,0,5814,20553,14739,630,2767
34479.0,CATOLANDIA,626,1,579,0,59,245,138,340,0,364,2352,1988,138,340
34495.0,CATU,16886,100,1794,8,4570,1548,1099,3007,0,6725,35737,29012,1099,3007
34509.0,CATURAMA,1265,11,602,2,225,1205,276,1067,0,1968,6621,4653,276,1067
34517.0,CENTRAL,4422,11,1139,5,863,1131,322,1580,0,1759,11232,9473,322,1580
34533.0,CHORROCHO,1968,3,893,1,325,1181,130,1278,0,1637,7416,5779,130,1278
34550.0,CICERO DANTAS,5964,47,2636,4,1101,2723,1143,3637,0,6163,23418,17255,1143,3637
34576.0,CIPO,2657,11,1017,2,816,1476,304,1538,0,3323,11144,7821,304,1538
34592.0,COARACI,4270,17,1416,2,1726,1946,271,2033,0,6354,18035,11681,271,2033
34614.0,COCOS,1526,7,422,2,1046,2277,866,1866,0,3308,11320,8012,866,1866
34630.0,CONCEICAO DA FEIRA,5113,17,702,4,1280,594,559,1213,0,2468,11950,9482,559,1213
34657.0,CONCEICAO DO ALMEIDA,4448,13,1459,5,736,907,380,1678,0,2575,12201,9626,380,1678
34673.0,CONCEICAO DO COITE,12973,38,2671,8,3015,6774,1385,5080,0,8414,40358,31944,1385,5080
34690.0,CONCEICAO DO JACUIPE,7118,42,1787,12,1658,1579,518,2121,0,4283,19118,14835,518,2121
34711.0,CONDE,3082,6,1766,7,586,958,334,1749,0,2989,11477,8488,334,1749
34738.0,CONDEUBA,2500,16,726,3,456,3382,358,2449,0,4515,14405,9890,358,2449
34754.0,CONTENDAS DO SINCORA,769,5,217,1,110,859,125,481,0,1164,3731,2567,125,481
34770.0,CORACAO DE MARIA,5677,27,1513,3,698,1886,776,2316,0,4388,17284,12896,776,2316
34797.0,CORDEIROS,761,12,776,1,256,1184,108,1009,0,2116,6223,4107,108,1009
34819.0,CORIBE,3104,12,857,3,470,1137,632,1439,0,2559,10213,7654,632,1439
34835.0,CORONEL JOAO SA,1595,7,1867,6,231,1434,256,2126,0,2602,10124,7522,256,2126
34851.0,CORRENTINA,3662,21,2222,4,733,4533,427,2994,0,5923,20519,14596,427,2994
34878.0,COTEGIPE,2167,5,490,2,249,973,566,1966,0,2310,8728,6418,566,1966
34894.0,CRAVOLANDIA,860,3,200,0,212,720,324,873,0,659,3851,3192,324,873
34916.0,CRISOPOLIS,2146,4,2644,2,356,1103,263,2364,0,4174,13056,8882,263,2364
34932.0,CRISTOPOLIS,1576,9,2169,4,386,1424,238,1445,0,2383,9634,7251,238,1445
34959.0,CRUZ DAS ALMAS,15942,54,3309,14,2973,2286,894,2994,0,7428,35894,28466,894,2994
34975.0,CURACA,6712,25,2435,8,816,1868,598,2210,0,4208,18880,14672,598,2210
34991.0,DARIO MEIRA,1241,5,317,2,782,884,260,1582,0,2302,7375,5073,260,1582
35017.0,DOM BASILIO,1020,15,1067,3,93,2414,191,1305,0,2072,8180,6108,191,1305
35033.0,DOM MACEDO COSTA,1055,1,545,1,214,220,74,500,0,523,3133,2610,74,500
35050.0,ELISIO MEDRADO,1967,9,719,0,570,674,196,1086,0,1561,6782,5221,196,1086
35076.0,ENCRUZILHADA,2482,13,1180,15,891,1999,363,2658,0,5210,14811,9601,363,2658
35092.0,ENTRE RIOS,7824,48,1239,10,1437,2498,956,3110,0,7516,24638,17122,956,3110
35114.0,ESPLANADA,5890,50,2021,8,1101,1945,694,2518,0,5529,19756,14227,694,2518
35130.0,EUCLIDES DA CUNHA,8806,46,5142,12,1731,5819,1186,5261,0,10216,38219,28003,1186,5261
35149.0,FEIRA DA MATA,916,1,342,0,293,788,73,518,0,1066,3997,2931,73,518
35157.0,FEIRA DE SANTANA,118987,700,32956,109,42290,20730,6335,19736,0,53464,295307,241843,6335,19736
35173.0,FIRMINO ALVES,762,7,225,1,200,596,130,529,0,1335,3785,2450,130,529
35190.0,FLORESTA AZUL,1444,7,1050,0,422,1514,207,987,0,1495,7126,5631,207,987
35211.0,FORMOSA DO RIO PRETO,2753,7,1745,3,303,1707,373,2081,0,3906,12878,8972,373,2081
35238.0,GANDU,3746,29,1182,7,3110,2586,472,2699,0,6391,20222,13831,472,2699
35254.0,GENTIO DO OURO,1497,2,848,4,334,1744,238,1069,0,1963,7699,5736,238,1069
35270.0,GLORIA,3763,16,1515,1,208,462,263,1402,0,1536,9166,7630,263,1402
35297.0,GONGOGI,1064,5,360,3,560,662,107,663,0,2829,6253,3424,107,663
35319.0,GOVERNADOR MANGABEIRA,4363,33,1243,5,853,1277,405,1905,0,4211,14295,10084,405,1905
35335.0,GUANAMBI,15153,94,2388,7,2648,9962,1006,4279,0,9812,45349,35537,1006,4279
35351.0,GUARATINGA,4064,10,630,5,1686,807,311,1893,0,5817,15223,9406,311,1893
35378.0,IACU,5125,20,1059,5,943,2620,564,2878,0,6374,19588,13214,564,2878
35394.0,IBIASSUCE,1370,5,416,3,157,2121,139,1147,0,2101,7459,5358,139,1147
35416.0,IBICARAI,4664,42,1640,14,1090,3241,462,2032,0,7918,21103,13185,462,2032
35432.0,IBICOARA,1542,6,1523,3,459,957,192,1483,0,1578,7743,6165,192,1483
35459.0,IBICUI,2250,8,602,6,892,1338,429,1247,0,3827,10599,6772,429,1247
35475.0,IBIPEBA,4856,6,1192,2,683,952,459,962,0,3424,12536,9112,459,962
35491.0,SANTA RITA DE CASSIA,4076,23,1341,9,756,3829,873,1951,0,4156,17014,12858,873,1951
35513.0,IBIPITANGA,1177,4,566,4,708,2488,231,1503,0,4261,10942,6681,231,1503
35530.0,IBIQUERA,1081,2,366,0,89,163,74,657,0,1149,3581,2432,74,657
35556.0,IBIRAPITANGA,3281,13,443,2,1745,1604,254,1559,0,6890,15791,8901,254,1559
35572.0,IBIRAPUA,1295,5,122,2,559,788,131,798,0,1871,5571,3700,131,798
35599.0,IBIRATAIA,2790,14,629,6,1775,1298,396,2250,0,5834,14992,9158,396,2250
35610.0,IBITIARA,1350,10,2853,11,290,1350,147,1572,0,3190,10773,7583,147,1572
35637.0,IBITITA,5720,24,1245,3,773,972,282,841,0,3527,13387,9860,282,841
35653.0,IBOTIRAMA,5105,11,2093,6,753,2036,314,1868,0,5389,17575,12186,314,1868
35670.0,ICHU,2413,15,426,0,295,600,144,546,0,963,5402,4439,144,546
35696.0,IGAPORA,2181,16,575,3,345,3054,356,1846,0,2709,11085,8376,356,1846
35700.0,IGRAPIUNA,1120,7,351,2,892,1028,263,1044,0,2505,7212,4707,263,1044
35718.0,IGUAI,3428,11,1260,6,1511,2054,563,2544,0,5863,17240,11377,563,2544
35734.0,ILHEUS,40678,295,8493,23,15746,5980,2229,7276,0,28677,109397,80720,2229,7276
35750.0,INHAMBUPE,6567,35,3074,10,694,1588,591,3910,0,5950,22419,16469,591,3910
35777.0,IPECAETA,2525,9,2056,5,863,1633,479,1774,0,4237,13581,9344,479,1774
35793.0,IPIAU,8330,108,2066,10,2483,2523,709,2680,0,10156,29065,18909,709,2680
35815.0,IPIRA,13059,24,3377,9,2855,4148,1094,5007,0,13693,43266,29573,1094,5007
35831.0,IPUPIARA,1891,21,808,5,401,1045,132,795,0,1918,7016,5098,132,795
35858.0,IRAJUBA,1324,8,688,7,246,604,231,955,0,946,5009,4063,231,955
35874.0,IRAMAIA,1847,6,1229,2,234,1093,145,1270,0,3101,8927,5826,145,1270
35890.0,IRAQUARA,3195,19,1328,4,288,2249,388,1905,0,3584,12960,9376,388,1905
35912.0,IRARA,5469,31,2168,4,957,2292,526,2907,0,4759,19113,14354,526,2907
35939.0,IRECE,13380,46,4157,12,2650,2881,829,3018,0,9274,36247,26973,829,3018
35947.0,ITABELA,4080,20,732,3,1805,1927,532,1876,0,5595,16570,10975,532,1876
35955.0,ITABERABA,13937,42,2858,9,2562,4557,880,4921,0,11174,40940,29766,880,4921
35971.0,ITABUNA,34827,283,23195,42,21439,10226,1781,9044,0,33489,134326,100837,1781,9044
35998.0,ITACARE,2102,15,698,3,675,769,207,1233,0,3794,9496,5702,207,1233
36013.0,ITAETE,1478,4,226,1,258,2525,237,1284,0,2904,8917,6013,237,1284
36030.0,ITAGI,3054,15,778,2,472,464,239,1845,0,2514,9383,6869,239,1845
36056.0,ITAGIBA,3215,17,524,2,954,663,225,1600,0,4596,11796,7200,225,1600
36072.0,ITAGIMIRIM,999,4,516,1,670,657,137,959,0,1353,5296,3943,137,959
36080.0,ITAGUACU DA BAHIA,2994,6,914,1,229,532,212,1394,0,2228,8510,6282,212,1394
36099.0,ITAJU DO COLONIA,1270,17,580,1,546,398,143,694,0,2341,5990,3649,143,694
36110.0,ITAJUIPE,3733,30,1748,12,2181,1468,551,1815,0,5791,17329,11538,551,1815
36137.0,ITAMARAJU,14532,42,1558,10,4654,4114,866,4236,0,15359,45371,30012,866,4236
36153.0,ITAMARI,1538,7,267,2,598,935,251,695,0,1849,6142,4293,251,695
36170.0,ITAMBE,2973,22,1007,9,998,3275,483,2289,0,5291,16347,11056,483,2289
36196.0,ITANAGRA,1067,7,684,2,187,259,83,644,0,1496,4429,2933,83,644
36218.0,ITANHEM,4965,22,289,3,932,1711,403,2020,0,6273,16618,10345,403,2020
36234.0,ITAPARICA,4697,35,679,7,1495,493,250,846,0,2713,11215,8502,250,846
36250.0,ITAPE,1874,12,1266,2,533,494,142,1114,0,1810,7247,5437,142,1114
36277.0,ITAPEBI,1233,4,534,2,587,1010,205,1037,0,2585,7197,4612,205,1037
36293.0,ITAPETINGA,12115,30,3547,13,4995,4733,639,4628,0,10729,41429,30700,639,4628
36315.0,ITAPICURU,3574,14,1417,10,794,2675,732,3217,0,5994,18427,12433,732,3217
36331.0,ITAPITANGA,1555,11,809,1,693,439,151,729,0,2520,6908,4388,151,729
36358.0,ITAQUARA,999,4,253,2,267,1504,129,1059,0,1581,5798,4217,129,1059
36374.0,ITARANTIM,3461,13,278,0,1312,835,385,2172,0,4160,12616,8456,385,2172
36382.0,ITATIM,1007,3,510,0,558,3071,225,1719,0,2480,9573,7093,225,1719
36390.0,ITIRUCU,2569,9,365,4,427,2276,275,1374,0,2731,10030,7299,275,1374
36412.0,ITIUBA,7119,22,2364,11,1036,3137,953,3317,0,5986,23945,17959,953,3317
36439.0,ITORORO,3505,12,887,6,1122,1934,301,1980,0,2614,12361,9747,301,1980
36455.0,ITUACU,1372,12,1932,7,257,4118,313,2091,0,2774,12876,10102,313,2091
36471.0,ITUBERA,3337,22,861,2,1984,2148,657,1990,0,4479,15480,11001,657,1990
36498.0,JACARACI,2162,14,983,2,197,1823,341,1584,0,4132,11238,7106,341,1584
36510.0,JACOBINA,19026,66,4603,19,3844,4888,1151,5878,0,14974,54449,39475,1151,5878
36536.0,JAGUAQUARA,8770,21,843,7,2531,3834,640,3169,0,7436,27251,19815,640,3169
36552.0,JAGUARARI,7636,26,2440,2,602,1935,689,2779,0,5106,21215,16109,689,2779
36579.0,JAGUARIPE,2474,14,804,3,763,718,438,1591,0,2926,9731,6805,438,1591
36595.0,JANDAIRA,1284,3,657,2,378,546,173,850,0,2456,6349,3893,173,850
36617.0,JEQUIE,34061,168,4647,24,15349,4650,1685,7788,0,26527,94899,68372,1685,7788
36633.0,JEREMOABO,3786,31,3636,7,786,4837,541,3641,0,6076,23341,17265,541,3641
36650.0,JIQUIRICA,1729,8,751,2,407,1776,251,1718,0,2461,9103,6642,251,1718
36676.0,JITAUNA,1917,17,443,4,952,1777,314,1613,0,4998,12035,7037,314,1613
36692.0,JUAZEIRO,37854,234,19762,22,9956,5482,1828,6975,0,21991,104104,82113,1828,6975
36706.0,JUCURUCU,2034,4,708,2,376,737,147,1145,0,4222,9375,5153,147,1145
36714.0,JUSSARA,3687,18,1014,0,308,752,248,1345,0,3408,10780,7372,248,1345
36730.0,JUSSIAPE,680,5,1094,1,214,1741,176,1078,0,2151,7140,4989,176,1078
36757.0,LAFAIETE COUTINHO,1388,4,217,0,211,353,123,599,0,1169,4064,2895,123,599
36765.0,LAGOA REAL,1233,11,923,7,187,1873,101,1369,0,1865,7569,5704,101,1369
36773.0,LAJE,3786,10,1654,2,1238,1410,434,2897,0,3782,15213,11431,434,2897
36790.0,LAJEDAO,874,5,922,2,165,309,40,252,0,591,3160,2569,40,252
36811.0,LAJEDINHO,337,1,1223,0,72,113,27,364,0,377,2514,2137,27,364
36820.0,LAJEDO DO TABOCAL,1095,11,125,4,338,1546,134,936,0,1530,5719,4189,134,936
36838.0,LAMARAO,1029,3,823,2,274,702,302,1065,0,2002,6202,4200,302,1065
36854.0,LAURO DE FREITAS,34308,178,3336,19,8949,2706,1650,3855,0,13694,68695,55001,1650,3855
36870.0,LENCOIS,1602,8,206,2,109,861,79,672,0,1360,4899,3539,79,672
36897.0,LICINIO DE ALMEIDA,2567,9,972,3,284,1312,172,1183,0,2578,9080,6502,172,1183
36919.0,LIVRAMENTO DE NOSSA SENHORA,6153,25,3873,5,561,5207,528,3617,0,6946,26915,19969,528,3617
36935.0,MACAJUBA,1068,9,266,2,189,1923,256,1718,0,2026,7457,5431,256,1718
36951.0,MACARANI,2038,15,1001,6,755,1287,293,2191,0,3571,11157,7586,293,2191
36978.0,MACAUBAS,7664,31,2503,3,484,4964,479,4312,0,7155,27595,20440,479,4312
36994.0,MACURURE,1373,11,895,0,221,915,139,1023,0,1131,5708,4577,139,1023
37010.0,MAIQUINIQUE,1514,4,306,5,665,479,127,833,0,1820,5753,3933,127,833
37036.0,MAIRI,2244,12,1535,10,550,2836,332,2089,0,4932,14540,9608,332,2089
37052.0,MALHADA,3415,7,887,0,240,947,198,1131,0,2783,9608,6825,198,1131
37079.0,MALHADA DE PEDRAS,936,4,1428,2,472,610,100,1194,0,1505,6251,4746,100,1194
37095.0,MANOEL VITORINO,1738,7,674,0,582,2305,360,1572,0,4115,11353,7238,360,1572
37117.0,MARACAS,3211,27,743,8,496,3880,575,2090,0,5179,16209,11030,575,2090
37133.0,MARAGOGIPE,7822,38,3181,6,1342,3229,1226,4550,0,8289,29683,21394,1226,4550
37150.0,MARAU,1720,16,524,5,681,1699,345,1540,0,3719,10249,6530,345,1540
37176.0,MARCIONILIO SOUZA,2202,12,555,3,241,645,190,1124,0,2759,7731,4972,190,1124
37192.0,MASCOTE,2161,9,926,2,1008,869,179,1198,0,4389,10741,6352,179,1198
37214.0,MATA DE SAO JOAO,10518,40,1837,5,1605,1118,735,2528,0,5567,23953,18386,735,2528
37222.0,MATINA,1001,5,351,0,190,2059,286,1497,0,1597,6986,5389,286,1497
37230.0,MEDEIROS NETO,5397,27,731,5,1622,1367,393,2272,0,5190,17004,11814,393,2272
37257.0,MIGUEL CALMON,5570,20,3150,10,1419,1235,261,2845,0,4536,19046,14510,261,2845
37273.0,MILAGRES,1544,2,3931,1,277,344,70,558,0,1816,8543,6727,70,558
37290.0,MIRANGABA,1784,9,728,0,404,2011,396,1778,0,2520,9630,7110,396,1778
37303.0,MIRANTE,466,2,674,2,155,1918,73,926,0,1467,5683,4216,73,926
37311.0,MONTE SANTO,6889,36,3023,13,1189,5208,2079,5215,0,9520,33172,23652,2079,5215
37338.0,MORPARA,1909,5,781,2,228,674,138,1095,0,1877,6709,4832,138,1095
37354.0,MORRO DO CHAPEU,6097,49,2092,6,1189,3574,546,3430,0,5901,22884,16983,546,3430
37370.0,MORTUGABA,1432,11,479,2,169,1959,207,1506,0,4235,10000,5765,207,1506
37397.0,MUCUGE,770,9,1110,7,188,1547,155,1322,0,1184,6292,5108,155,1322
37419.0,MUCURI,5541,31,1761,8,1897,1701,351,1660,0,5912,18862,12950,351,1660
37427.0,MULUNGU DO MORRO,941,14,708,6,280,1891,168,1217,0,2014,7239,5225,168,1217
37435.0,MUNDO NOVO,3543,20,2115,7,656,1520,305,2193,0,3002,13361,10359,305,2193
37451.0,MUNIZ FERREIRA,1917,4,637,3,774,443,201,1167,0,978,6124,5146,201,1167
37460.0,MUQUEM DO SAO FRANCISCO,1545,5,322,0,146,1231,54,483,0,1521,5307,3786,54,483
37478.0,MURITIBA,5731,41,1501,18,1493,1692,527,2042,0,4247,17292,13045,527,2042
37494.0,MUTUIPE,4766,10,993,3,971,2055,268,2039,0,3954,15059,11105,268,2039
37516.0,NAZARE,6460,51,1742,8,2632,1312,743,2455,0,5443,20846,15403,743,2455
37532.0,NILO PECANHA,1525,6,221,3,678,1293,321,1118,0,2130,7295,5165,321,1118
37559.0,NOVA CANAA,2593,9,698,5,703,824,344,1816,0,3503,10495,6992,344,1816
37567.0,NOVA FATIMA,1548,6,674,2,511,796,241,823,0,818,5419,4601,241,823
37575.0,NOVA ITARANA,548,3,645,3,76,1029,288,882,0,1518,4992,3474,288,882
37583.0,NOVA REDENCAO,1923,3,446,4,425,382,123,1033,0,1750,6089,4339,123,1033
37591.0,NOVA SOURE,5114,22,1672,6,485,1710,722,2979,0,5679,18389,12710,722,2979
37613.0,NOVA VICOSA,5770,34,1315,7,1947,1878,418,1843,0,6504,19716,13212,418,1843
37621.0,NOVO TRIUNFO,580,3,1299,3,92,1555,117,1107,0,1516,6272,4756,117,1107
37630.0,OLINDINA,4106,7,2483,10,1002,1748,700,2971,0,4893,17920,13027,700,2971
37656.0,OLIVEIRA DOS BREJINHOS,4535,21,1615,7,537,1941,575,2287,0,4532,16050,11518,575,2287
37672.0,OURICANGAS,1592,9,1295,5,147,198,141,1212,0,1591,6190,4599,141,1212
37680.0,OUROLANDIA,2015,4,656,4,668,2202,178,1974,0,3015,10716,7701,178,1974
37699.0,PALMAS DE MONTE ALTO,4759,22,860,4,286,1970,442,2538,0,3721,14602,10881,442,2538
37710.0,PALMEIRAS,1581,8,474,2,131,962,121,894,0,1537,5710,4173,121,894
37737.0,PARAMIRIM,3306,15,1274,3,351,2560,542,2157,0,4296,14504,10208,542,2157
37753.0,PARATINGA,8086,17,2220,6,298,1332,350,2163,0,5835,20307,14472,350,2163
37770.0,PARIPIRANGA,2744,42,2616,9,554,4266,552,3188,0,5036,19007,13971,552,3188
37796.0,PAU BRASIL,1380,3,681,1,1224,580,173,1078,0,3927,9047,5120,173,1078
37818.0,PAULO AFONSO,28315,82,5067,12,3179,3538,1154,5605,0,9345,56297,46952,1154,5605
37834.0,PEDRAO,1712,14,316,1,285,629,156,995,0,1217,5325,4108,156,995
37850.0,PEDRO ALEXANDRE,707,3,1408,2,262,1061,162,1758,0,2039,7402,5363,162,1758
37877.0,PIATA,1039,22,979,2,734,4018,347,2907,0,4116,14164,10048,347,2907
37893.0,PILAO ARCADO,4579,14,6233,9,765,455,235,2701,0,6909,21900,14991,235,2701
37915.0,PINDAI,1581,9,670,3,478,3202,384,1704,0,3215,11246,8031,384,1704
37931.0,PINDOBACU,3004,16,881,3,1023,2993,543,2170,0,3403,14036,10633,543,2170
37940.0,PIRAI DO NORTE,553,7,262,2,412,1486,161,709,0,2330,5922,3592,161,709
37958.0,PIRIPA,1475,6,937,4,204,645,86,1232,0,2843,7432,4589,86,1232
37974.0,PIRITIBA,3408,18,1236,7,955,1550,213,1970,0,3086,12443,9357,213,1970
37990.0,PLANALTINO,734,4,599,3,127,1376,429,1043,0,1861,6176,4315,429,1043
38016.0,PLANALTO,2367,15,1642,8,662,3708,525,2545,0,4341,15813,11472,525,2545
38032.0,POCOES,6685,37,3133,15,1316,4298,907,4307,0,8643,29341,20698,907,4307
38059.0,POJUCA,9176,47,1794,6,1370,1092,845,2488,0,3820,20638,16818,845,2488
38067.0,PONTO NOVO,2689,10,894,0,180,968,298,1550,0,2338,8927,6589,298,1550
38075.0,PORTO SEGURO,16962,65,2420,21,5612,4076,865,4130,0,13353,47504,34151,865,4130
38091.0,POTIRAGUA,1474,5,787,0,828,336,181,1136,0,2739,7486,4747,181,1136
38113.0,PRADO,3900,31,913,7,1466,1927,427,1678,0,5269,15618,10349,427,1678
38130.0,PRESIDENTE DUTRA,3717,17,972,3,421,934,211,1140,0,2685,10100,7415,211,1140
38156.0,PRESIDENTE JANIO QUADROS,1527,4,1585,4,247,756,175,1962,0,3627,9887,6260,175,1962
38164.0,PRESIDENTE TANCREDO NEVES,1103,9,133,3,864,3398,385,2503,0,3262,11660,8398,385,2503
38172.0,QUEIMADAS,5163,22,2175,7,928,1957,567,2377,0,5427,18623,13196,567,2377
38199.0,QUIJINGUE,4500,13,2875,4,1002,2879,411,3028,0,4251,18963,14712,411,3028
38210.0,REMANSO,6493,18,4119,7,1111,1786,488,4101,0,8557,26680,18123,488,4101
38237.0,RETIROLANDIA,3927,15,470,1,716,1172,462,1279,0,1861,9903,8042,462,1279
38253.0,RIACHAO DAS NEVES,3367,6,2559,6,751,1324,692,3577,0,4623,16905,12282,692,3577
38270.0,RIACHAO DO JACUIPE,8727,28,3588,8,1223,2977,682,2561,0,5259,25053,19794,682,2561
38296.0,RIACHO DE SANTANA,5153,42,664,11,519,4670,908,3383,0,5524,20874,15350,908,3383
38318.0,RIBEIRA DO AMPARO,2310,8,1332,4,363,708,220,1491,0,1440,7876,6436,220,1491
38334.0,RIBEIRA DO POMBAL,8627,32,3778,7,807,3570,1244,3941,0,8123,30129,22006,1244,3941
38342.0,RIBEIRAO DO LARGO,1549,4,693,1,425,713,145,1398,0,2171,7099,4928,145,1398
38350.0,RIO DE CONTAS,1965,22,585,8,298,3292,281,1503,0,1581,9535,7954,281,1503
38377.0,RIO DO ANTONIO,1895,15,1005,6,315,1651,251,1678,0,3010,9826,6816,251,1678
38393.0,RIO DO PIRES,890,14,514,3,113,3082,205,1275,0,1556,7652,6096,205,1275
38415.0,RIO REAL,5504,27,2306,5,975,3145,561,2853,0,6083,21459,15376,561,2853
38431.0,RODELAS,2018,2,657,0,189,162,42,459,0,580,4109,3529,42,459
38458.0,RUY BARBOSA,5767,26,2032,7,707,2058,445,3191,0,5915,20148,14233,445,3191
38474.0,SALINAS DA MARGARIDA,2544,19,609,2,754,275,147,771,0,2086,7207,5121,147,771
38490.0,SALVADOR,825187,4980,78487,652,158973,51600,30376,67760,0,290155,1508170,1218015,30376,67760
38512.0,SANTA BARBARA,5184,14,2358,3,598,1028,333,2318,0,2057,13893,11836,333,2318
38539.0,SANTA BRIGIDA,1218,9,1435,4,294,1626,368,1934,0,1488,8376,6888,368,1934
38555.0,SANTA CRUZ CABRALIA,3441,20,680,2,1203,1135,228,900,0,3024,10633,7609,228,900
38571.0,SANTA CRUZ DA VITORIA,883,2,289,2,263,292,153,582,0,1640,4106,2466,153,582
38598.0,SANTA INES,2363,11,307,1,579,815,375,1646,0,2483,8580,6097,375,1646
38610.0,SANTALUZ,7130,23,2260,4,998,4120,548,3214,0,6593,24890,18297,548,3214
38636.0,SANTA MARIA DA VITORIA,6178,24,2503,4,1335,3946,670,3651,0,7366,25677,18311,670,3651
38652.0,SANTANA,3900,29,1446,3,354,4642,360,2299,0,4762,17795,13033,360,2299
38679.0,SANTANOPOLIS,2014,12,1184,3,405,717,349,1400,0,2251,8335,6084,349,1400
38695.0,SANTA TERESINHA,1330,7,780,3,245,1182,226,1289,0,2020,7082,5062,226,1289
38717.0,SANTO AMARO,19210,179,1793,20,3029,3045,1315,3191,0,9336,41118,31782,1315,3191
38733.0,SANTO ANTONIO DE JESUS,18338,114,3504,16,6673,5982,1234,4661,0,9768,50290,40522,1234,4661
38750.0,SANTO ESTEVAO,7158,29,2602,24,1789,3487,1009,4176,0,7851,28125,20274,1009,4176
38776.0,SAO DESIDERIO,3249,11,3984,3,506,983,233,1635,0,3816,14420,10604,233,1635
38792.0,SAO FELIX,3577,18,546,3,783,898,224,1497,0,2060,9606,7546,224,1497
38806.0,SAO DOMINGOS,2848,17,326,3,326,1119,249,713,0,892,6493,5601,249,713
38814.0,SAO FELIPE,3664,24,1564,5,802,2714,685,2401,0,5030,16889,11859,685,2401
38822.0,SAO FELIX DO CORIBE,2451,9,659,7,557,1524,181,1085,0,2376,8849,6473,181,1085
38830.0,SAO FRANCISCO DO CONDE,11875,27,1412,5,1487,329,424,1822,0,2654,20035,17381,424,1822
38857.0,SAO GONCALO DOS CAMPOS,8265,44,1171,12,1325,1606,960,2230,0,2932,18545,15613,960,2230
38865.0,SAO JOSE DO JACUIPE,1543,6,803,3,595,958,344,1129,0,2296,7677,5381,344,1129
38873.0,SAO MIGUEL DAS MATAS,2176,3,1167,3,363,396,138,1105,0,1850,7201,5351,138,1105
38890.0,SAO SEBASTIAO DO PASSE,14162,65,1357,9,1756,1771,754,2587,0,5608,28069,22461,754,2587
38911.0,SAPEACU,4227,12,1358,7,882,1112,480,1941,0,3324,13343,10019,480,1941
38938.0,SATIRO DIAS,2918,16,1597,4,406,716,210,2090,0,3183,11140,7957,210,2090
38946.0,SAUBARA,3056,14,481,1,850,341,264,745,0,1815,7567,5752,264,745
38954.0,SAUDE,2626,13,1146,3,432,765,221,1685,0,1243,8134,6891,221,1685
38970.0,SEABRA,7621,55,1406,6,776,4383,669,3638,0,6893,25447,18554,669,3638
38997.0,SEBASTIAO LARANJEIRAS,1562,1,252,1,299,1508,143,747,0,1838,6351,4513,143,747
39012.0,SENHOR DO BONFIM,14744,91,5401,15,2752,5535,1109,4425,0,10975,45047,34072,1109,4425
39039.0,SENTO SE,2926,27,3435,9,2142,4403,481,3036,0,6175,22634,16459,481,3036
39047.0,SERRA DO RAMALHO,4312,27,2643,5,1024,2275,347,2685,0,6448,19766,13318,347,2685
39055.0,SERRA DOURADA,1859,10,2094,1,320,2328,352,1714,0,3250,11928,8678,352,1714
39071.0,SERRA PRETA,3874,21,1797,5,865,1300,537,2529,0,3087,14015,10928,537,2529
39098.0,SERRINHA,17911,110,3959,13,3137,3882,1281,6374,0,11013,47680,36667,1281,6374
39110.0,SERROLANDIA,1809,10,778,0,743,1041,203,1432,0,2427,8443,6016,203,1432
39136.0,SIMOES FILHO,25565,159,4018,21,11001,1766,1252,3439,0,11285,58506,47221,1252,3439
39144.0,SITIO DO MATO,1643,4,638,0,552,1147,194,893,0,1808,6879,5071,194,893
39152.0,SOUTO SOARES,1336,13,865,1,279,2833,324,1350,0,3917,10918,7001,324,1350
39179.0,TABOCAS DO BREJO VELHO,1250,6,1246,0,178,1755,163,1676,0,2186,8460,6274,163,1676
39195.0,TANHACU,1499,7,2472,7,261,4185,204,2438,0,3393,14466,11073,204,2438
39217.0,TANQUINHO,2278,4,844,2,240,271,160,747,0,845,5391,4546,160,747
39233.0,TAPEROA,2523,8,701,0,859,1652,512,1764,0,3623,11642,8019,512,1764
39250.0,TAPIRAMUTA,1632,6,638,2,218,2173,128,1478,0,2161,8436,6275,128,1478
39276.0,TEODORO SAMPAIO,2675,13,491,4,504,234,204,909,0,1841,6875,5034,204,909
39292.0,TEOFILANDIA,4617,19,1650,7,665,1708,743,2607,0,4253,16269,12016,743,2607
39314.0,TEOLANDIA,1104,11,327,2,662,2160,377,1499,0,2908,9050,6142,377,1499
39330.0,TERRA NOVA,4394,20,313,3,711,480,216,1133,0,2077,9347,7270,216,1133
39357.0,TREMEDAL,1373,12,2144,3,540,2061,229,2539,0,8525,17426,8901,229,2539
39373.0,TUCANO,7707,30,3047,18,1318,4470,1198,5660,0,7846,31294,23448,1198,5660
39390.0,UAUA,4347,34,2128,2,833,4291,608,2490,0,4831,19564,14733,608,2490
39411.0,UBAIRA,2235,10,1530,2,737,2897,320,2055,0,4301,14087,9786,320,2055
39438.0,UBAITABA,3054,21,1113,6,1299,1781,265,1527,0,4630,13696,9066,265,1527
39454.0,UBATA,4164,31,745,5,2301,1135,446,1847,0,7239,17913,10674,446,1847
39470.0,UIBAI,4126,7,898,2,295,908,186,1011,0,2798,10231,7433,186,1011
39489.0,UMBURANAS,828,8,559,3,541,2580,247,1552,0,1946,8264,6318,247,1552
39497.0,UNA,3834,18,1043,3,1983,1260,344,2334,0,7235,18054,10819,344,2334
39519.0,URANDI,2709,11,455,2,291,2717,552,1747,0,3632,12116,8484,552,1747
39535.0,URUCUCA,4051,12,1231,1,1861,1169,297,2090,0,6378,17090,10712,297,2090
39551.0,UTINGA,2695,14,1703,5,618,1156,191,1734,0,3072,11188,8116,191,1734
39578.0,VALENCA,11909,70,3457,17,7348,3859,1760,5643,0,10760,44823,34063,1760,5643
39594.0,VALENTE,6075,30,1120,7,874,2310,566,1607,0,2684,15273,12589,566,1607
39616.0,VARZEA DO POCO,1434,10,485,1,374,1311,248,889,0,1813,6565,4752,248,889
39624.0,VARZEDO,1595,3,464,3,408,891,198,1207,0,1737,6506,4769,198,1207
39632.0,VERA CRUZ,8743,62,1348,9,2542,865,706,1277,0,4883,20435,15552,706,1277
39640.0,VEREDA,1350,2,182,1,390,829,198,757,0,2281,5990,3709,198,757
39659.0,VITORIA DA CONQUISTA,51613,385,9160,51,20378,27052,3172,13252,0,38878,163941,125063,3172,13252
39675.0,WAGNER,1420,8,755,2,435,635,208,1061,0,1700,6224,4524,208,1061
39691.0,WENCESLAU GUIMARAES,2197,7,440,1,1259,1649,290,1870,0,3697,11410,7713,290,1870
39713.0,XIQUE XIQUE,10094,30,3124,11,1473,1785,735,5600,0,9211,32063,22852,735,5600
39730.0,LAPAO,6079,36,899,6,1279,2342,485,1942,0,3939,17007,13068,485,1942
39748.0,MADRE DE DEUS,6459,20,834,2,1038,242,148,556,0,1782,11081,9299,148,556
39756.0,MAETINGA,871,6,813,4,289,426,106,1005,0,2486,6006,3520,106,1005
39772.0,MANSIDAO,1667,1,861,0,293,1809,222,778,0,1832,7463,5631,222,778
39799.0,NORDESTINA,1424,3,1552,1,174,419,105,1283,0,1934,6895,4961,105,1283
39810.0,PE DE SERRA,2069,11,1910,4,676,1336,310,1718,0,2530,10564,8034,310,1718
39837.0,PINTADAS,2818,6,264,0,351,1025,89,1028,0,2503,8084,5581,89,1028
39845.0,QUIXABEIRA,2038,13,421,2,238,955,259,891,0,2190,7007,4817,259,891
39853.0,RAFAEL JAMBEIRO,3184,12,2128,8,446,1610,460,3029,0,4920,15797,10877,460,3029
39870.0,SANTA LUZIA,1334,10,436,3,1138,874,159,1108,0,3680,8742,5062,159,1108
39896.0,SAO GABRIEL,4499,22,2636,3,355,682,205,1729,0,3180,13311,10131,205,1729
39900.0,SITIO DO QUINTO,956,11,1348,4,173,1623,233,1176,0,2023,7547,5524,233,1176
39918.0,TANQUE NOVO,2296,9,1762,4,116,1090,313,1764,0,2220,9574,7354,313,1764
39926.0,SAO JOSE DA VITORIA,1095,5,390,1,831,294,82,807,0,2128,5633,3505,82,807
39934.0,TEIXEIRA DE FREITAS,27116,82,2240,11,8695,4158,983,5226,0,18980,67491,48511,983,5226
39942.0,NOVO HORIZONTE,516,7,504,6,674,1916,150,1010,0,1646,6429,4783,150,1010
39950.0,VARZEA NOVA,2678,10,504,1,395,1099,220,1462,0,1398,7767,6369,220,1462
39969.0,NOVA IBIA,741,4,470,1,774,656,291,1003,0,1762,5702,3940,291,1003
39977.0,VARZEA DA ROCA,1238,6,1327,2,576,1165,312,1719,0,2978,9323,6345,312,1719
39985.0,SOBRADINHO,5406,13,2352,9,1763,887,259,1317,0,3996,16002,12006,259,1317
39993.0,WANDERLEY,1872,4,792,6,332,2033,251,1384,0,2361,9035,6674,251,1384
40002.0,ALFREDO VASCONCELOS,1582,23,258,1,159,1001,147,302,0,426,3899,3473,147,302
40010.0,ABADIA DOS DOURADOS,1584,27,348,1,402,1427,258,436,0,1059,5542,4483,258,436
40029.0,ARAPORA,1965,16,462,2,440,845,96,370,0,1060,5256,4196,96,370
40037.0,ABAETE,4003,28,1761,7,1281,4760,665,834,0,2838,16177,13339,665,834
40045.0,BRASILANDIA DE MINAS,2368,10,433,4,728,1681,255,558,0,1782,7819,6037,255,558
40053.0,ABRE CAMPO,2883,22,343,1,541,2548,414,961,0,1666,9379,7713,414,961
40061.0,CAPITAO ANDRADE,978,3,113,0,285,655,103,418,0,1169,3724,2555,103,418
40070.0,ACAIACA,966,4,177,4,152,644,77,292,0,710,3026,2316,77,292
40088.0,CARNEIRINHO,2438,7,531,0,284,1607,119,463,0,1352,6801,5449,119,463
40096.0,ACUCENA,2670,21,632,2,775,701,343,1049,0,2608,8801,6193,343,1049
40100.0,CATUJI,1655,5,120,0,196,1926,184,552,0,1022,5660,4638,184,552
40118.0,AGUA BOA,1598,12,424,2,789,2714,425,1226,0,3319,10509,7190,425,1226
40126.0,DIVISA ALEGRE,735,13,55,1,199,1059,47,606,0,918,3633,2715,47,606
40134.0,AGUA COMPRIDA,805,3,142,0,54,685,47,137,0,618,2491,1873,47,137
40142.0,DIVISOPOLIS,535,5,88,0,380,2178,59,498,0,1424,5167,3743,59,498
40150.0,AGUANIL,1014,7,161,0,255,625,194,195,0,518,2969,2451,194,195
40169.0,DURANDE,1387,30,88,1,837,997,104,445,0,1158,5047,3889,104,445
40177.0,AGUAS FORMOSAS,3731,18,515,15,1264,1519,286,1496,0,3628,12472,8844,286,1496
40185.0,ENTRE FOLHAS,1465,8,114,1,647,808,89,513,0,1014,4659,3645,89,513
40193.0,AGUAS VERMELHAS,986,11,198,1,479,2254,528,1398,0,2406,8261,5855,528,1398
40207.0,FERVEDOURO,1847,11,189,0,845,1274,227,616,0,1438,6447,5009,227,616
40215.0,AIMORES,4770,48,956,4,3878,3481,438,1133,0,4388,19096,14708,438,1133
40223.0,FRANCISCOPOLIS,448,3,195,0,224,994,72,565,0,1431,3932,2501,72,565
40231.0,AIURUOCA,1475,27,173,0,177,1323,170,423,0,881,4649,3768,170,423
40240.0,ICARAI DE MINAS,1321,8,306,1,190,2141,112,609,0,2230,6918,4688,112,609
40258.0,ALAGOA,433,11,63,1,258,791,63,187,0,376,2183,1807,63,187
40266.0,IPABA,3502,17,358,5,2494,860,159,532,0,1902,9829,7927,159,532
40274.0,ALBERTINA,603,1,147,0,129,638,56,169,0,376,2119,1743,56,169
40282.0,JAIBA,3773,17,716,2,857,4400,435,1463,0,3916,15579,11663,435,1463
40290.0,ALEM PARAIBA,10454,118,2125,8,5539,2054,541,1031,0,4362,26232,21870,541,1031
40304.0,JAMPRUCA,1142,5,73,2,447,434,113,395,0,932,3543,2611,113,395
40312.0,ALFENAS,19385,180,2604,14,3142,10563,1361,1719,0,7065,46033,38968,1361,1719
40320.0,JUATUBA,4800,26,596,8,1148,1251,429,776,0,1442,10476,9034,429,776
40339.0,ALMENARA,6519,24,954,10,2023,5276,462,2337,0,6943,24548,17605,462,2337
40347.0,LAGOA GRANDE,1886,7,394,1,143,1060,163,374,0,1196,5224,4028,163,374
40355.0,ALPERCATA,1920,9,149,3,973,847,129,446,0,1430,5906,4476,129,446
40363.0,LIMEIRA DO OESTE,2076,4,261,1,219,797,89,298,0,969,4714,3745,89,298
40371.0,ALPINOPOLIS,4849,50,755,2,742,2880,505,697,0,1844,12324,10480,505,697
40380.0,LONTRA,1030,3,292,1,271,1864,168,615,0,1785,6029,4244,168,615
40398.0,ALTEROSA,2237,10,640,7,693,3343,357,675,0,1405,9367,7962,357,675
40401.0,MAMONAS,482,2,90,0,53,2528,110,395,0,1379,5039,3660,110,395
40410.0,ALTO RIO DOCE,2065,23,272,1,457,3288,450,1055,0,3205,10816,7611,450,1055
40428.0,MATA VERDE,724,7,99,3,422,1631,67,487,0,1622,5062,3440,67,487
40436.0,ALVARENGA,1583,3,61,2,378,795,108,319,0,1161,4410,3249,108,319
40444.0,MATIAS CARDOSO,712,7,361,1,186,1718,136,632,0,1647,5400,3753,136,632
40452.0,ALVINOPOLIS,5885,31,623,6,437,1254,340,1184,0,2027,11787,9760,340,1184
40460.0,MONTEZUMA,324,4,116,1,104,1837,92,606,0,1477,4561,3084,92,606
40479.0,ALVORADA DE MINAS,655,3,275,2,53,362,156,342,0,833,2681,1848,156,342
40487.0,NAQUE,1699,4,247,11,612,221,83,402,0,852,4131,3279,83,402
40495.0,AMPARO DO SERRA,1225,4,101,0,227,921,203,450,0,478,3609,3131,203,450
40509.0,NOVO ORIENTE DE MINAS,1889,4,123,4,337,1472,201,819,0,2847,7696,4849,201,819
40517.0,ANDRADAS,7551,98,1589,9,2030,6443,1137,1513,0,2553,22923,20370,1137,1513
40525.0,PALMOPOLIS,1084,2,81,0,180,907,235,918,0,2152,5559,3407,235,918
40533.0,CACHOEIRA DE PAJEU,1520,2,200,4,201,1446,387,963,0,1539,6262,4723,387,963
40541.0,PEDRAS DE MARIA DA CRUZ,1160,3,320,0,286,1345,189,511,0,1637,5451,3814,189,511
40550.0,ANDRELANDIA,2994,39,326,3,543,2735,310,735,0,2451,10136,7685,310,735
40568.0,PERIQUITO,1971,9,190,4,727,425,120,553,0,1422,5421,3999,120,553
40576.0,ANTONIO CARLOS,3944,35,626,10,566,1273,339,628,0,1264,8685,7421,339,628
40584.0,PONTO DOS VOLANTES,1618,5,170,15,312,1440,121,716,0,1648,6045,4397,121,716
40592.0,ANTONIO DIAS,2681,35,217,4,1081,909,409,582,0,1397,7315,5918,409,582
40606.0,RIACHINHO,1598,9,259,0,255,1140,168,334,0,1028,4791,3763,168,334
40614.0,ANTONIO PRADO DE MINAS,494,3,62,0,476,173,34,97,0,164,1503,1339,34,97
40622.0,ROSARIO DA LIMEIRA,1291,9,139,1,493,575,121,390,0,930,3949,3019,121,390
40630.0,ARACAI,813,8,173,0,66,247,43,164,0,324,1838,1514,43,164
40649.0,SANTA BARBARA DO LESTE,1660,20,137,0,787,1505,197,438,0,1097,5841,4744,197,438
40657.0,ARACITABA,507,7,70,0,89,436,78,243,0,116,1546,1430,78,243
40665.0,SANTA RITA DE MINAS,1362,20,168,1,620,562,151,291,0,530,3705,3175,151,291
40673.0,ARACUAI,6509,50,725,12,1055,6162,502,1603,0,7697,24315,16618,502,1603
40681.0,SANTANA DO PARAISO,3705,17,250,1,2636,875,227,977,0,1940,10628,8688,227,977
40690.0,ARAGUARI,25548,282,9113,22,9298,15162,1504,1887,0,10753,73569,62816,1504,1887
40703.0,SAO JOAO DA LAGOA,1078,3,369,3,139,387,91,461,0,664,3195,2531,91,461
40711.0,ARANTINA,1237,9,80,3,264,230,52,190,0,489,2554,2065,52,190
40720.0,SAO JOAO DO MANHUACU,1544,23,187,0,1526,1013,242,496,0,1186,6217,5031,242,496
40738.0,ARAPONGA,1567,28,74,3,406,849,188,957,0,1356,5428,4072,188,957
40746.0,SAO JOAO DO MANTENINHA,866,4,67,0,748,605,132,483,0,811,3716,2905,132,483
40754.0,ARAPUA,412,8,171,0,163,1043,75,228,0,300,2400,2100,75,228
40762.0,SAO JOAO DO PACUI,1048,1,119,2,129,409,65,308,0,754,2835,2081,65,308
40770.0,ARAUJOS,1481,5,232,0,171,1578,223,265,0,599,4554,3955,223,265
40789.0,SAO JOSE DA LAPA,5663,30,482,9,1686,947,289,485,0,1024,10615,9591,289,485
40797.0,ARAXA,20721,187,8122,23,4928,13068,1513,2649,0,7368,58579,51211,1513,2649
40800.0,SARZEDO,4052,24,321,3,2024,812,331,493,0,889,8949,8060,331,493
40819.0,ARCEBURGO,1743,18,332,3,419,1912,319,488,0,1129,6363,5234,319,488
40827.0,SEM-PEIXE,1039,9,157,2,197,432,196,289,0,699,3020,2321,196,289
40835.0,ARCOS,10348,91,2050,13,1501,5018,1294,1246,0,2896,24457,21561,1294,1246
40843.0,SENADOR AMARAL,1569,30,289,1,232,743,95,183,0,874,4016,3142,95,183
40851.0,AREADO,2508,18,532,2,801,3386,256,584,0,1434,9521,8087,256,584
40860.0,UBAPORANGA,2434,23,273,1,1209,1658,178,594,0,1923,8293,6370,178,594
40878.0,ARGIRITA,1311,4,188,1,220,327,68,122,0,242,2483,2241,68,122
40886.0,URUCUIA,1189,4,119,0,196,1508,100,564,0,1346,5026,3680,100,564
40894.0,ARINOS,2771,23,993,4,1216,1892,235,1433,0,2970,11537,8567,235,1433
40908.0,VARGEM ALEGRE,1458,11,102,0,1161,658,125,475,0,1363,5353,3990,125,475
40916.0,ASTOLFO DUTRA,3452,27,478,4,732,2294,200,493,0,1320,9000,7680,200,493
40924.0,JOSENOPOLIS,646,0,16,0,101,797,42,408,0,1002,3012,2010,42,408
40932.0,ATALEIA,3795,9,323,1,919,1584,258,957,0,3914,11760,7846,258,957
40940.0,JUVENILIA,612,1,191,1,349,1480,108,482,0,1069,4293,3224,108,482
40959.0,AUGUSTO DE LIMA,1143,12,292,1,307,754,188,271,0,686,3654,2968,188,271
40967.0,LEME DO PRADO,640,4,106,2,46,858,100,379,0,1097,3232,2135,100,379
40975.0,BAEPENDI,4665,42,1082,9,1725,2680,412,797,0,1782,13194,11412,412,797
40983.0,LUISBURGO,825,8,73,0,469,1434,201,324,0,867,4201,3334,201,324
40991.0,BALDIM,2457,18,438,0,585,895,243,380,0,1455,6471,5016,243,380
41009.0,LUISLANDIA,1188,1,104,2,56,1078,72,614,0,1338,4453,3115,72,614
41017.0,BAMBUI,4933,58,1766,7,937,4072,709,1455,0,3063,17000,13937,709,1455
41025.0,MARIO CAMPOS,2241,16,197,2,1318,498,174,324,0,759,5529,4770,174,324
41033.0,BANDEIRA,753,3,116,1,107,1127,216,347,0,543,3213,2670,216,347
41041.0,MARTINS SOARES,1773,18,76,1,613,491,122,317,0,729,4140,3411,122,317
41050.0,BANDEIRA DO SUL,1123,8,449,1,295,1087,192,290,0,596,4041,3445,192,290
41068.0,MIRAVANIA,364,0,321,0,74,1036,55,385,0,861,3096,2235,55,385
41076.0,BARAO DE COCAIS,10695,41,560,5,890,1312,385,838,0,2293,17019,14726,385,838
41084.0,MONTE FORMOSO,1045,2,315,3,176,365,23,357,0,905,3191,2286,23,357
41092.0,BARAO DE MONTE ALTO,1382,15,265,1,642,1106,135,439,0,873,4858,3985,135,439
41106.0,NATALANDIA,1093,7,129,0,139,522,37,116,0,889,2932,2043,37,116
41114.0,BARBACENA,40227,678,6428,52,5104,12934,2339,3952,0,10049,81763,71714,2339,3952
41122.0,NINHEIRA,569,1,86,2,154,2199,191,876,0,2083,6161,4078,191,876
41130.0,BARRA LONGA,1494,7,295,1,202,1438,361,841,0,1548,6187,4639,361,841
41149.0,NOVA BELEM,644,6,84,1,577,545,113,389,0,935,3294,2359,113,389
41157.0,TRES MARIAS,6311,116,1111,9,1796,3147,633,1245,0,3813,18181,14368,633,1245
41165.0,NOVA PORTEIRINHA,1645,12,176,0,225,1287,149,437,0,1007,4938,3931,149,437
41173.0,BARROSO,5619,49,675,6,956,3647,625,915,0,1923,14415,12492,625,915
41181.0,NOVORIZONTE,696,3,85,0,155,1155,47,465,0,1091,3697,2606,47,465
41190.0,BELA VISTA DE MINAS,4156,20,267,6,980,478,184,381,0,1319,7791,6472,184,381
41203.0,OLHOS DAGUA,849,8,251,0,146,608,88,411,0,837,3198,2361,88,411
41211.0,BELMIRO BRAGA,1159,7,383,1,311,429,69,229,0,438,3026,2588,69,229
41220.0,ORATORIOS,1206,13,92,2,250,593,109,421,0,710,3396,2686,109,421
41238.0,BELO HORIZONTE,780522,6333,131869,1333,236833,179060,35065,50420,0,224606,1646041,1421435,35065,50420
41246.0,ORIZANIA,1470,18,63,1,801,715,124,418,0,1021,4631,3610,124,418
41254.0,BELO ORIENTE,5693,35,321,7,3206,913,438,1099,0,2774,14486,11712,438,1099
41262.0,PADRE CARVALHO,973,0,22,0,47,701,62,522,0,1121,3448,2327,62,522
41270.0,BELO VALE,2396,24,251,1,284,1607,231,430,0,652,5876,5224,231,430
41289.0,PAI PEDRO,604,4,413,2,217,1050,120,705,0,1157,4272,3115,120,705
41297.0,BERILO,1132,6,212,3,243,2739,292,1087,0,2855,8569,5714,292,1087
41300.0,PATIS,1035,1,177,1,91,1030,68,189,0,1305,3897,2592,68,189
41319.0,BERTOPOLIS,1098,3,35,0,208,534,65,337,0,1208,3488,2280,65,337
41327.0,PEDRA BONITA,751,7,54,0,966,1156,115,493,0,690,4232,3542,115,493
41335.0,BETIM,82928,595,8328,131,34547,18336,4144,7055,0,22056,178120,156064,4144,7055
41343.0,PIEDADE DE CARATINGA,819,8,260,0,522,808,102,311,0,982,3812,2830,102,311
41351.0,BIAS FORTES,1450,11,331,1,200,614,105,397,0,598,3707,3109,105,397
41360.0,PINGO DAGUA,1094,11,51,0,521,381,82,256,0,801,3197,2396,82,256
41378.0,BICAS,4633,68,836,8,1391,1188,225,587,0,1372,10308,8936,225,587
41386.0,PINTOPOLIS,971,3,280,0,131,1265,107,367,0,1386,4510,3124,107,367
41394.0,BIQUINHAS,719,6,116,0,116,613,100,158,0,502,2330,1828,100,158
41408.0,PONTO CHIQUE,678,4,239,1,75,685,54,305,0,795,2836,2041,54,305
41416.0,BOA ESPERANCA,9037,119,2598,8,1529,5364,1044,1098,0,4661,25458,20797,1044,1098
41424.0,REDUTO,1303,7,120,3,664,469,144,289,0,673,3672,2999,144,289
41432.0,BOCAINA DE MINAS,899,17,166,0,678,922,145,409,0,826,4062,3236,145,409
41440.0,SANTA BARBARA DO MONTE VERDE,774,10,228,1,449,439,73,209,0,376,2559,2183,73,209
41459.0,BOCAIUVA,12502,50,1147,16,2148,3436,677,2499,0,6614,29089,22475,677,2499
41467.0,SANTA CRUZ DE MINAS,2279,36,204,2,318,1150,127,254,0,551,4921,4370,127,254
41475.0,BOM DESPACHO,12228,104,2424,5,1880,6101,1080,1636,0,4345,29803,25458,1080,1636
41483.0,SANTA CRUZ DE SALINAS,589,1,72,0,67,1197,101,589,0,884,3500,2616,101,589
41491.0,BOM JARDIM DE MINAS,1814,35,333,0,677,928,168,393,0,1074,5422,4348,168,393
41505.0,SANTA HELENA DE MINAS,1158,6,42,0,169,1039,95,489,0,1217,4215,2998,95,489
41513.0,BOM JESUS DA PENHA,623,1,92,2,146,1087,109,191,0,348,2599,2251,109,191
41521.0,SANTO ANTONIO DO RETIRO,174,3,397,0,175,1682,136,621,0,1010,4198,3188,136,621
41530.0,BOM JESUS DO AMPARO,1623,7,280,5,227,649,152,390,0,628,3961,3333,152,390
41548.0,SAO DOMINGOS DAS DORES,1393,33,99,0,161,793,91,286,0,837,3693,2856,91,286
41556.0,BOM JESUS DO GALHO,3643,23,492,5,1662,1983,529,1251,0,2930,12518,9588,529,1251
41564.0,SAO FELIX DE MINAS,586,2,27,0,532,446,62,319,0,807,2781,1974,62,319
41572.0,BOM REPOUSO,2667,35,667,4,398,1135,199,530,0,1099,6734,5635,199,530
41580.0,SAO GERALDO DO BAIXIO,668,0,33,0,447,296,46,232,0,731,2453,1722,46,232
41599.0,BOM SUCESSO,3963,43,940,4,497,3567,713,976,0,2280,12983,10703,713,976
41602.0,SAO JOAO DAS MISSOES,1005,2,917,1,155,883,186,792,0,1496,5437,3941,186,792
41610.0,BONFIM,2089,37,342,4,340,1395,462,506,0,936,6111,5175,462,506
41629.0,SAO JOAQUIM DE BICAS,4995,30,482,4,1295,1233,380,673,0,1700,10792,9092,380,673
41637.0,BONFINOPOLIS DE MINAS,2036,6,597,2,221,436,60,233,0,1185,4776,3591,60,233
41645.0,SAO JOSE DA BARRA,2070,17,238,0,275,809,135,204,0,730,4478,3748,135,204
41653.0,BORDA DA MATA,3674,41,895,1,831,2789,425,628,0,1510,10794,9284,425,628
41661.0,ALTO CAPARAO,556,5,103,1,1426,550,43,126,0,612,3422,2810,43,126
41670.0,BOTELHOS,4125,33,571,4,752,2601,339,708,0,2104,11237,9133,339,708
41688.0,ANGELANDIA,640,5,129,0,539,1585,130,557,0,1436,5021,3585,130,557
41696.0,BOTUMIRIM,940,5,547,0,114,737,91,727,0,1359,4520,3161,91,727
41700.0,ARICANDUVA,615,3,251,0,118,993,178,387,0,720,3265,2545,178,387
41718.0,BRASILIA DE MINAS,6750,34,1120,3,732,5128,634,1400,0,6122,21923,15801,634,1400
41726.0,BERIZAL,487,3,250,0,111,992,30,397,0,753,3023,2270,30,397
41734.0,BRAS PIRES,988,11,391,1,140,805,127,419,0,1305,4187,2882,127,419
41742.0,BONITO DE MINAS,1185,6,575,0,174,928,131,516,0,1490,5005,3515,131,516
41750.0,BRAUNAS,1185,2,106,0,248,812,214,495,0,1340,4402,3062,214,495
41769.0,BUGRE,954,9,367,0,595,473,144,370,0,778,3690,2912,144,370
41777.0,BRAZOPOLIS,2946,82,1486,4,542,3171,319,852,0,1969,11371,9402,319,852
41785.0,CABECEIRA GRANDE,1408,13,350,1,391,1060,169,383,0,1477,5252,3775,169,383
41793.0,BRUMADINHO,9250,65,1527,8,1536,2462,693,993,0,2134,18668,16534,693,993
41807.0,CAMPO AZUL,525,2,331,1,79,891,95,363,0,937,3224,2287,95,363
41815.0,BUENO BRANDAO,1731,39,776,2,532,2216,570,486,0,1189,7541,6352,570,486
41823.0,CANTAGALO,520,10,119,0,168,782,154,377,0,768,2898,2130,154,377
41831.0,BUENOPOLIS,1638,21,361,1,291,1727,543,516,0,2265,7363,5098,543,516
41840.0,CATAS ALTAS,1531,11,142,1,192,539,85,291,0,476,3268,2792,85,291
41858.0,BURITIS,4083,61,1076,2,989,3018,344,1095,0,3659,14327,10668,344,1095
41866.0,CATUTI,719,4,576,3,86,881,74,669,0,957,3969,3012,74,669
41874.0,BURITIZEIRO,5694,42,811,7,1800,2437,561,968,0,4552,16872,12320,561,968
41882.0,CHAPADA GAUCHA,1029,1,395,0,402,1316,79,710,0,1451,5383,3932,79,710
41890.0,CABO VERDE,2652,19,402,2,709,2959,308,485,0,1463,8999,7536,308,485
41904.0,CONEGO MARINHO,1011,7,182,2,126,1437,110,606,0,1505,4986,3481,110,606
41912.0,CACHOEIRA DA PRATA,1652,18,303,4,186,348,83,192,0,509,3295,2786,83,192
41920.0,CONFINS,2307,10,220,3,351,402,96,233,0,503,4125,3622,96,233
41939.0,CACHOEIRA DE MINAS,2260,102,1271,7,512,1997,266,381,0,1011,7807,6796,266,381
41947.0,CORREGO FUNDO,1901,29,142,7,129,711,180,341,0,411,3851,3440,180,341
41955.0,CACHOEIRA DOURADA,571,1,92,0,116,589,30,137,0,509,2045,1536,30,137
41963.0,CRISOLITA,990,3,96,1,208,744,43,708,0,1258,4051,2793,43,708
41971.0,CAETANOPOLIS,3007,16,392,0,426,842,227,300,0,814,6024,5210,227,300
41980.0,CUPARAQUE,491,6,38,0,709,741,72,380,0,1204,3641,2437,72,380
41998.0,CAETE,14072,129,1778,28,1712,3915,1050,1425,0,3969,28078,24109,1050,1425
42005.0,CURRAL DE DENTRO,419,6,90,0,310,1731,182,753,0,1193,4684,3491,182,753
42013.0,CAIANA,1066,18,133,3,597,564,87,291,0,492,3251,2759,87,291
42021.0,DELTA,1727,5,132,0,201,438,111,194,0,222,3030,2808,111,194
42030.0,CAJURI,1324,10,104,2,220,597,154,471,0,414,3296,2882,154,471
42048.0,DOM BOSCO,1335,9,147,0,208,336,74,195,0,955,3259,2304,74,195
42056.0,CALDAS,2473,41,941,3,867,3510,339,584,0,1600,10358,8758,339,584
42064.0,FREI LAGONEGRO,479,5,81,0,118,737,178,580,0,790,2968,2178,178,580
42072.0,CAMACHO,709,6,82,0,60,1010,162,303,0,305,2637,2332,162,303
42080.0,FRUTA DE LEITE,667,3,60,0,206,875,29,1132,0,1604,4576,2972,29,1132
42099.0,CAMANDUCAIA,3574,52,829,1,935,3928,699,1045,0,2092,13155,11063,699,1045
42102.0,GAMELEIRAS,557,5,100,2,46,1717,72,505,0,1092,4096,3004,72,505
42110.0,CAMBUI,6492,96,995,10,985,3752,399,893,0,2253,15875,13622,399,893
42129.0,GLAUCILANDIA,1081,1,262,1,256,410,90,288,0,571,2960,2389,90,288
42137.0,CAMBUQUIRA,3056,39,701,4,647,2096,230,610,0,1406,8789,7383,230,610
42145.0,GOIABEIRA,519,1,24,0,533,536,143,302,0,877,2935,2058,143,302
42153.0,CAMPANARIO,929,9,120,0,177,536,69,286,0,814,2940,2126,69,286
42161.0,GOIANA,1144,17,196,1,403,383,92,217,0,535,2988,2453,92,217
42170.0,CAMPANHA,3394,65,566,5,629,2593,408,648,0,1567,9875,8308,408,648
42188.0,GUARACIAMA,1745,5,87,2,224,783,75,415,0,883,4219,3336,75,415
42196.0,CAMPESTRE,4059,45,748,6,1568,4265,621,881,0,2208,14401,12193,621,881
42200.0,IBIRACATU,1089,4,96,0,73,1144,102,541,0,1369,4418,3049,102,541
42218.0,CAMPINA VERDE,4760,60,1204,3,443,3964,319,577,0,2820,14150,11330,319,577
42226.0,IMBE DE MINAS,1538,6,432,1,293,645,84,419,0,1179,4597,3418,84,419
42234.0,CAMPO BELO,10150,136,2167,11,4233,9257,1604,2217,0,5552,35327,29775,1604,2217
42242.0,INDAIABIRA,575,4,149,3,326,1511,166,715,0,1394,4843,3449,166,715
42250.0,CAMPO DO MEIO,2774,29,311,11,362,2548,398,557,0,1685,8675,6990,398,557
42269.0,JAPONVAR,725,4,271,2,182,2041,140,564,0,1597,5526,3929,140,564
42277.0,CAMPO FLORIDO,1316,10,335,0,163,1187,160,123,0,1155,4449,3294,160,123
42285.0,JENIPAPO DE MINAS,464,6,112,0,82,1224,80,533,0,1734,4235,2501,80,533
42293.0,CAMPOS ALTOS,1930,23,714,0,843,2442,368,550,0,1610,8480,6870,368,550
42307.0,JOSE GONCALVES DE MINAS,351,0,53,0,36,1183,57,439,0,807,2926,2119,57,439
42315.0,CAMPOS GERAIS,6336,48,1043,14,713,4482,716,1389,0,3031,17772,14741,716,1389
42323.0,JOSE RAYDAN,617,1,86,0,104,695,78,494,0,778,2853,2075,78,494
42331.0,CANAA,1296,9,253,5,132,743,225,510,0,777,3950,3173,225,510
42340.0,SAO SEBASTIAO DA VARGEM ALEGRE,570,8,75,0,375,602,102,235,0,446,2413,1967,102,235
42358.0,CANAPOLIS,3343,16,732,2,367,1501,210,627,0,1885,8683,6798,210,627
42366.0,SAO SEBASTIAO DO ANTA,1259,2,119,1,460,386,74,338,0,791,3430,2639,74,338
42374.0,CANA VERDE,1050,27,117,3,557,1187,171,436,0,802,4350,3548,171,436
42382.0,SERRANOPOLIS DE MINAS,320,3,81,0,151,1477,105,537,0,879,3553,2674,105,537
42390.0,CANDEIAS,2584,46,596,3,445,3806,817,782,0,1488,10567,9079,817,782
42404.0,SETUBINHA,692,9,54,1,131,2112,101,1018,0,1872,5990,4118,101,1018
42412.0,CAPARAO,679,13,149,1,701,659,64,216,0,572,3054,2482,64,216
42420.0,TAPARUBA,910,4,274,2,347,486,113,256,0,540,2932,2392,113,256
42439.0,CAPELA NOVA,1046,17,122,0,158,1325,264,341,0,572,3845,3273,264,341
42447.0,UNIAO DE MINAS,1331,3,244,0,155,693,56,202,0,966,3650,2684,56,202
42455.0,CAPELINHA,4291,19,473,8,947,6367,664,2089,0,5482,20340,14858,664,2089
42463.0,URUANA DE MINAS,905,6,130,2,154,498,39,312,0,840,2886,2046,39,312
42471.0,CAPETINGA,1209,31,265,3,354,1711,261,388,0,1207,5429,4222,261,388
42480.0,VARGEM GRANDE DO RIO PARDO,338,4,52,1,20,1530,44,438,0,729,3156,2427,44,438
42498.0,CAPIM BRANCO,2332,8,324,5,605,861,296,352,0,676,5459,4783,296,352
42501.0,VARJAO DE MINAS,799,5,210,3,175,1496,109,210,0,869,3876,3007,109,210
42510.0,CAPINOPOLIS,4282,43,965,2,847,2414,291,573,0,2442,11859,9417,291,573
42528.0,VERDELANDIA,1287,4,106,0,79,924,96,556,0,1135,4187,3052,96,556
42536.0,CAPITAO ENEAS,3247,11,602,5,562,1704,261,839,0,2341,9572,7231,261,839
42544.0,VEREDINHA,1063,3,34,1,113,954,78,487,0,947,3680,2733,78,487
42552.0,CAPITOLIO,2885,12,313,2,352,1154,142,235,0,1017,6112,5095,142,235
42560.0,VERMELHO NOVO,1451,15,106,1,276,678,163,309,0,850,3849,2999,163,309
42579.0,CAPUTIRA,2265,12,219,0,621,1045,337,624,0,1019,6142,5123,337,624
42587.0,TOCOS DO MOJI,1034,4,86,1,66,1278,120,172,0,362,3123,2761,120,172
42595.0,CARAI,3132,19,180,3,559,2341,232,1473,0,3472,11411,7939,232,1473
42617.0,CARANAIBA,720,13,222,6,170,1038,153,247,0,379,2948,2569,153,247
42633.0,CARANDAI,6528,101,947,11,1630,3069,1001,1230,0,1597,16114,14517,1001,1230
42650.0,CARANGOLA,6301,119,1575,6,4206,4201,662,1616,0,4308,22994,18686,662,1616
42676.0,CARATINGA,18520,180,3198,31,9359,8569,1631,2660,0,10803,54951,44148,1631,2660
42692.0,CARBONITA,2898,8,105,3,130,988,277,259,0,1992,6660,4668,277,259
42714.0,CAREACU,1371,7,361,1,278,1296,94,238,0,877,4523,3646,94,238
42730.0,CARLOS CHAGAS,5237,24,830,6,623,2921,390,1195,0,4592,15818,11226,390,1195
42757.0,CARMESIA,644,1,72,0,100,284,60,168,0,489,1818,1329,60,168
42773.0,CARMO DA CACHOEIRA,2936,59,635,3,386,1548,346,598,0,1917,8428,6511,346,598
42790.0,CARMO DA MATA,2779,45,821,4,357,2156,401,684,0,1145,8392,7247,401,684
42811.0,CARMO DE MINAS,2486,24,725,0,871,1580,300,598,0,1209,7793,6584,300,598
42838.0,CARMO DO CAJURU,5737,80,1167,9,730,2257,690,887,0,1477,13034,11557,690,887
42854.0,CARMO DO PARANAIBA,4922,56,2007,2,1372,5008,1125,1532,0,3019,19043,16024,1125,1532
42870.0,CARMO DO RIO CLARO,5281,62,983,4,491,3276,427,670,0,2184,13378,11194,427,670
42897.0,CARMOPOLIS DE MINAS,3479,28,500,3,416,3318,333,801,0,1399,10277,8878,333,801
42919.0,CARRANCAS,1016,22,323,0,91,741,78,300,0,677,3248,2571,78,300
42935.0,CARVALHOPOLIS,880,6,104,3,137,716,69,159,0,361,2435,2074,69,159
42951.0,CARVALHOS,1082,11,140,2,226,1275,147,388,0,795,4066,3271,147,388
42978.0,CASA GRANDE,731,8,106,3,238,489,75,129,0,195,1974,1779,75,129
42994.0,CASCALHO RICO,577,4,215,0,337,606,61,108,0,322,2230,1908,61,108
43010.0,CASSIA,3612,34,638,0,988,3485,408,894,0,2237,12296,10059,408,894
43036.0,CONCEICAO DA BARRA DE MINAS,798,10,187,1,126,1224,118,179,0,438,3081,2643,118,179
43052.0,CATAGUASES,21820,170,4324,18,6997,4274,1327,2004,0,6395,47329,40934,1327,2004
43079.0,CATAS ALTAS DA NORUEGA,906,12,118,0,92,653,203,385,0,617,2986,2369,203,385
43095.0,CAXAMBU,6596,67,1257,14,2153,2279,382,711,0,2525,15984,13459,382,711
43117.0,CEDRO DO ABAETE,211,2,105,0,40,357,57,123,0,195,1090,895,57,123
43133.0,CENTRAL DE MINAS,934,9,82,0,1159,1025,372,464,0,1414,5459,4045,372,464
43150.0,CENTRALINA,2914,22,685,0,333,1173,174,400,0,1613,7314,5701,174,400
43176.0,CHACARA,800,6,335,0,187,248,69,137,0,273,2055,1782,69,137
43192.0,CHALE,1220,6,49,2,790,833,91,325,0,855,4171,3316,91,325
43214.0,CHAPADA DO NORTE,1472,3,96,5,114,2359,289,1017,0,3706,9061,5355,289,1017
43230.0,CHIADOR,518,5,93,1,1010,240,61,186,0,430,2544,2114,61,186
43257.0,CIPOTANEA,961,11,405,1,207,1048,482,589,0,1496,5200,3704,482,589
43273.0,CLARAVAL,695,5,174,0,162,1436,51,130,0,437,3090,2653,51,130
43290.0,CLARO DOS POCOES,2161,5,333,2,346,1372,185,542,0,985,5931,4946,185,542
43311.0,CLAUDIO,5336,42,1183,3,432,4981,860,931,0,1546,15314,13768,860,931
43338.0,COIMBRA,1630,17,184,1,298,1464,191,561,0,682,5028,4346,191,561
43354.0,COLUNA,1683,27,208,3,207,1264,211,739,0,1628,5970,4342,211,739
43370.0,COMENDADOR GOMES,455,3,151,0,49,918,39,73,0,103,1791,1688,39,73
43397.0,COMERCINHO,1834,7,129,1,119,1581,177,661,0,1994,6503,4509,177,661
43419.0,CONCEICAO DA APARECIDA,2206,14,303,4,374,1780,307,397,0,1391,6776,5385,307,397
43435.0,CONCEICAO DA PEDRA,673,7,113,0,94,756,95,133,0,238,2109,1871,95,133
43451.0,CONCEICAO DAS ALAGOAS,4998,15,885,2,853,2951,318,700,0,2636,13358,10722,318,700
43478.0,CONCEICAO DE IPANEMA,1129,4,41,0,346,973,54,282,0,416,3245,2829,54,282
43494.0,CONCEICAO DO MATO DENTRO,4262,24,1130,8,352,1379,386,1958,0,3652,13151,9499,386,1958
43516.0,CONCEICAO DO PARA,1537,18,311,2,166,853,190,273,0,653,4003,3350,190,273
43532.0,CONCEICAO DO RIO VERDE,2916,16,432,6,581,2245,321,625,0,1737,8879,7142,321,625
43559.0,CONCEICAO DOS OUROS,1903,40,756,0,517,1837,182,315,0,923,6473,5550,182,315
43575.0,CONGONHAL,1894,32,376,4,344,2082,206,225,0,422,5585,5163,206,225
43591.0,CONGONHAS,18000,98,1733,26,2251,2461,991,1567,0,3088,30215,27127,991,1567
43613.0,CONGONHAS DO NORTE,1023,4,117,2,101,495,133,656,0,958,3489,2531,133,656
43630.0,CONQUISTA,1569,17,380,3,137,1732,145,238,0,1024,5245,4221,145,238
43656.0,CONSELHEIRO LAFAIETE,41826,455,4455,54,4953,8881,2017,2942,0,7784,73367,65583,2017,2942
43672.0,CONSELHEIRO PENA,4533,27,620,2,3023,2467,526,880,0,5185,17263,12078,526,880
43699.0,CONSOLACAO,424,16,64,0,76,504,57,100,0,212,1453,1241,57,100
43710.0,CONTAGEM,188700,1350,16290,266,67798,27545,7983,13335,0,45438,368705,323267,7983,13335
43737.0,COQUEIRAL,2611,19,232,3,257,1806,186,268,0,1302,6684,5382,186,268
43753.0,CORACAO DE JESUS,5677,38,1543,5,919,3226,593,1746,0,4386,18133,13747,593,1746
43770.0,CORDISBURGO,2278,16,428,2,372,1070,271,528,0,1256,6221,4965,271,528
43796.0,CORDISLANDIA,878,7,278,0,168,639,91,218,0,449,2728,2279,91,218
43818.0,CORINTO,7143,40,1359,10,1554,2187,516,1171,0,4307,18287,13980,516,1171
43834.0,COROACI,1722,22,327,2,563,1656,406,1031,0,2136,7865,5729,406,1031
43850.0,COROMANDEL,6103,51,1998,7,1836,4368,784,1284,0,3821,20252,16431,784,1284
43877.0,CORONEL FABRICIANO,31814,132,3693,31,13946,4312,1296,2005,0,11418,68647,57229,1296,2005
43893.0,CORONEL MURTA,1610,8,155,0,219,2005,178,712,0,1947,6834,4887,178,712
43915.0,CORONEL PACHECO,1132,16,161,1,243,365,70,186,0,163,2337,2174,70,186
43931.0,CORONEL XAVIER CHAVES,954,24,93,2,93,755,67,124,0,291,2403,2112,67,124
43958.0,CORREGO DANTA,886,3,334,1,165,637,67,259,0,489,2841,2352,67,259
43974.0,CORREGO DO BOM JESUS,1133,19,297,3,193,843,95,262,0,552,3397,2845,95,262
43990.0,CORREGO NOVO,961,9,73,0,237,649,121,197,0,416,2663,2247,121,197
44016.0,COUTO DE MAGALHAES DE MINAS,1393,6,105,0,141,398,70,338,0,883,3334,2451,70,338
44032.0,CRISTAIS,2465,16,380,0,319,1495,330,614,0,963,6582,5619,330,614
44059.0,CRISTALIA,705,3,47,0,311,773,21,903,0,853,3616,2763,21,903
44075.0,CRISTIANO OTONI,1392,33,282,6,435,767,147,259,0,391,3712,3321,147,259
44091.0,CRISTINA,2056,34,644,1,574,1973,238,474,0,1288,7282,5994,238,474
44113.0,CRUCILANDIA,1039,11,112,4,153,1196,277,267,0,392,3451,3059,277,267
44130.0,CRUZEIRO DA FORTALEZA,1007,4,328,0,67,846,73,108,0,399,2832,2433,73,108
44156.0,CRUZILIA,3799,20,514,3,186,2768,263,674,0,1569,9796,8227,263,674
44172.0,CURVELO,18851,173,4351,14,2964,7525,1358,2264,0,8529,46029,37500,1358,2264
44199.0,DATAS,1479,15,90,5,122,773,96,340,0,801,3721,2920,96,340
44210.0,DELFIM MOREIRA,1646,52,274,3,520,1918,248,288,0,981,5930,4949,248,288
44237.0,DELFINOPOLIS,1440,13,430,3,231,1313,157,291,0,1379,5257,3878,157,291
44253.0,DESCOBERTO,1507,13,233,3,432,640,113,251,0,387,3579,3192,113,251
44270.0,DESTERRO DE ENTRE RIOS,1160,23,179,0,309,1791,387,435,0,998,5282,4284,387,435
44296.0,DESTERRO DO MELO,695,5,177,3,123,942,84,364,0,303,2696,2393,84,364
44318.0,DIAMANTINA,11785,86,1750,18,1458,4933,694,2033,0,6381,29138,22757,694,2033
44334.0,DIOGO DE VASCONCELOS,874,5,138,1,128,629,106,582,0,457,2920,2463,106,582
44350.0,DIONISIO,3334,8,281,4,636,632,213,579,0,1890,7577,5687,213,579
44377.0,DIVINESIA,1239,3,229,0,125,421,59,241,0,418,2735,2317,59,241
44393.0,DIVINO,4009,26,479,6,1941,2150,441,1094,0,2641,12787,10146,441,1094
44415.0,DIVINO DAS LARANJEIRAS,768,11,89,1,949,939,143,384,0,1089,4373,3284,143,384
44431.0,DIVINOLANDIA DE MINAS,1447,22,79,0,178,899,117,741,0,946,4429,3483,117,741
44458.0,DIVINOPOLIS,71589,478,10546,39,9249,16917,3439,4058,0,12286,128601,116315,3439,4058
44474.0,DIVISA NOVA,1805,14,190,1,193,622,76,292,0,653,3846,3193,76,292
44490.0,DOM CAVATI,1251,9,108,2,730,907,96,308,0,929,4340,3411,96,308
44512.0,DOM JOAQUIM,1117,6,240,0,138,373,202,754,0,1071,3901,2830,202,754
44539.0,DOM SILVERIO,1983,9,261,3,131,702,188,418,0,593,4288,3695,188,418
44555.0,DOM VICOSO,484,6,125,1,130,975,121,216,0,493,2551,2058,121,216
44571.0,DONA EUSEBIA,1220,18,304,2,724,1068,155,231,0,526,4248,3722,155,231
44598.0,DORES DE CAMPOS,2511,39,574,3,310,1288,542,554,0,654,6475,5821,542,554
44610.0,DORES DE GUANHAES,1593,12,99,1,329,695,152,450,0,1167,4498,3331,152,450
44636.0,DORES DO INDAIA,3187,18,1017,2,797,2808,471,713,0,2708,11721,9013,471,713
44652.0,DORES DO TURVO,1278,5,131,3,121,948,154,427,0,621,3688,3067,154,427
44679.0,DORESOPOLIS,320,0,40,1,49,519,36,115,0,250,1330,1080,36,115
44695.0,DOURADOQUARA,482,3,94,0,121,398,42,94,0,197,1431,1234,42,94
44717.0,ELOI MENDES,5427,31,994,8,854,4463,477,876,0,1953,15083,13130,477,876
44733.0,ENGENHEIRO CALDAS,1642,3,204,2,532,1086,222,586,0,525,4802,4277,222,586
44750.0,ENGENHEIRO NAVARRO,2318,5,171,6,384,875,109,487,0,1495,5850,4355,109,487
44776.0,ENTRE RIOS DE MINAS,3816,33,772,6,503,2324,471,707,0,1693,10325,8632,471,707
44792.0,ERVALIA,3906,35,865,5,466,3045,697,1800,0,2884,13703,10819,697,1800
44814.0,ESMERALDAS,10744,75,1577,14,2895,4803,998,1614,0,4163,26883,22720,998,1614
44830.0,ESPERA FELIZ,5033,61,753,5,2358,2603,469,983,0,2723,14988,12265,469,983
44857.0,ESPINOSA,3327,19,697,0,605,9292,548,1598,0,6623,22709,16086,548,1598
44873.0,ESPIRITO SANTO DO DOURADO,1232,9,220,0,191,883,179,310,0,403,3427,3024,179,310
44890.0,ESTIVA,2159,47,797,1,478,1780,318,411,0,1033,7024,5991,318,411
44911.0,ESTRELA DALVA,682,5,157,1,407,143,44,262,0,408,2109,1701,44,262
44938.0,ESTRELA DO INDAIA,764,4,210,1,198,897,176,201,0,705,3156,2451,176,201
44954.0,ESTRELA DO SUL,1629,14,316,1,409,1523,181,336,0,1133,5542,4409,181,336
44970.0,EUGENOPOLIS,2599,29,435,3,1814,944,249,455,0,1527,8055,6528,249,455
44997.0,EWBANK DA CAMARA,1290,11,260,0,402,262,73,235,0,360,2893,2533,73,235
45012.0,EXTREMA,5602,53,648,2,875,3717,453,831,0,1936,14117,12181,453,831
45039.0,FAMA,775,18,181,0,75,400,84,122,0,296,1951,1655,84,122
45055.0,FARIA LEMOS,992,9,128,0,514,552,48,243,0,508,2994,2486,48,243
45071.0,FELICIO DOS SANTOS,776,7,128,0,148,1083,144,453,0,1326,4065,2739,144,453
45098.0,SAO GONCALO DO RIO PRETO,790,1,95,2,63,465,97,329,0,745,2587,1842,97,329
45110.0,FELISBURGO,1476,2,82,13,134,835,63,412,0,1472,4489,3017,63,412
45136.0,FELIXLANDIA,3215,26,523,2,460,2006,543,695,0,1902,9372,7470,543,695
45152.0,FERNANDES TOURINHO,617,3,139,0,183,626,38,341,0,513,2460,1947,38,341
45179.0,FERROS,2354,19,792,1,387,1619,322,1326,0,2522,9342,6820,322,1326
45195.0,FLORESTAL,2168,7,339,2,284,499,120,217,0,532,4168,3636,120,217
45217.0,FORMIGA,17819,234,3619,29,3902,10998,2189,2106,0,5588,46484,40896,2189,2106
45233.0,FORMOSO,1499,2,287,0,218,899,90,385,0,1507,4887,3380,90,385
45250.0,FORTALEZA DE MINAS,1079,14,153,0,137,804,197,351,0,689,3424,2735,197,351
45276.0,FORTUNA DE MINAS,692,10,123,1,111,376,95,105,0,224,1737,1513,95,105
45292.0,FRANCISCO BADARO,736,3,80,1,132,2885,148,618,0,2185,6788,4603,148,618
45314.0,FRANCISCO DUMONT,739,3,196,0,731,390,78,337,0,861,3335,2474,78,337
45330.0,FRANCISCO SA,6124,13,649,6,916,2752,545,1712,0,4367,17084,12717,545,1712
45357.0,FREI GASPAR,1285,2,74,0,240,691,63,561,0,869,3785,2916,63,561
45373.0,FREI INOCENCIO,2387,34,181,1,599,790,130,506,0,1393,6021,4628,130,506
45390.0,FRONTEIRA,2211,17,670,0,430,1316,152,376,0,459,5631,5172,152,376
45411.0,FRUTAL,10921,65,2418,6,3224,8344,1081,1411,0,5616,33086,27470,1081,1411
45438.0,FUNILANDIA,990,9,242,2,351,460,79,180,0,583,2896,2313,79,180
45454.0,GALILEIA,1510,13,205,1,975,808,161,526,0,1716,5915,4199,161,526
45470.0,GONCALVES,864,19,236,0,92,818,129,256,0,552,2966,2414,129,256
45497.0,GONZAGA,569,2,69,1,465,958,151,797,0,1292,4304,3012,151,797
45519.0,GOUVEA,3428,14,213,0,430,1196,291,761,0,1994,8327,6333,291,761
45535.0,GOVERNADOR VALADARES,46639,499,14212,53,39909,23619,3484,6255,0,36357,171027,134670,3484,6255
45551.0,GRAO MOGOL,1442,8,236,1,307,2933,170,1262,0,2835,9194,6359,170,1262
45578.0,GRUPIARA,387,1,290,0,126,218,43,65,0,185,1315,1130,43,65
45594.0,GUANHAES,4332,95,1743,23,1791,3825,950,2329,0,5097,20185,15088,950,2329
45616.0,GUAPE,3240,12,562,8,258,2451,396,692,0,1516,9135,7619,396,692
45632.0,GUARACIABA,2049,24,253,4,199,1987,237,1094,0,940,6787,5847,237,1094
45659.0,GUARANESIA,5201,54,307,4,856,2891,499,897,0,1937,12646,10709,499,897
45675.0,GUARANI,3062,18,272,3,515,1131,175,567,0,1037,6780,5743,175,567
45691.0,GUARARA,1329,10,193,3,590,287,85,223,0,402,3122,2720,85,223
45713.0,GUARDA-MOR,1360,8,319,1,347,1094,117,311,0,985,4542,3557,117,311
45730.0,GUAXUPE,15715,95,1380,8,2299,5995,929,1854,0,4983,33258,28275,929,1854
45756.0,GUIDOVAL,2129,24,407,2,437,1270,285,432,0,930,5916,4986,285,432
45772.0,GUIMARANIA,1632,22,837,3,172,1038,139,253,0,837,4933,4096,139,253
45799.0,GUIRICEMA,3029,16,233,4,524,1206,318,633,0,1150,7113,5963,318,633
45810.0,GURINHATA,1819,12,415,1,434,1436,110,255,0,1286,5768,4482,110,255
45837.0,HELIODORA,1372,20,234,1,141,1223,155,350,0,630,4126,3496,155,350
45853.0,IAPU,2481,26,173,1,743,1504,214,521,0,1471,7134,5663,214,521
45870.0,IBERTIOGA,1602,8,284,1,173,914,109,345,0,365,3801,3436,109,345
45896.0,IBIA,5443,57,1360,9,1387,2814,516,891,0,2696,15173,12477,516,891
45918.0,IBIAI,1145,3,304,0,360,1152,198,376,0,1273,4811,3538,198,376
45934.0,IBIRACI,2490,17,456,3,482,2127,164,426,0,1277,7442,6165,164,426
45950.0,IBIRITE,33779,203,1819,41,13593,4183,1868,2870,0,7619,65975,58356,1868,2870
45977.0,IBITIURA DE MINAS,779,6,254,0,219,682,143,227,0,437,2747,2310,143,227
45993.0,IBITURUNA,566,6,77,0,94,801,46,164,0,261,2015,1754,46,164
46019.0,IGARAPE,7153,59,1049,8,2295,2289,700,836,0,2390,16779,14389,700,836
46035.0,IGARATINGA,2052,40,265,18,329,986,356,246,0,654,4946,4292,356,246
46051.0,IGUATAMA,2735,23,517,10,315,1222,176,449,0,1114,6561,5447,176,449
46078.0,IJACI,1266,13,277,3,321,1115,262,347,0,429,4033,3604,262,347
46094.0,ILICINEA,3225,9,377,0,333,1563,248,197,0,1327,7279,5952,248,197
46116.0,INCONFIDENTES,1736,30,346,1,292,1654,209,253,0,794,5315,4521,209,253
46132.0,INDIANOPOLIS,1458,10,272,1,218,666,92,131,0,362,3210,2848,92,131
46159.0,INGAI,611,7,128,1,61,600,84,161,0,334,1987,1653,84,161
46175.0,INHAPIM,6667,37,1182,9,1725,3150,667,1655,0,5069,20161,15092,667,1655
46191.0,INHAUMA,1512,20,207,1,288,698,104,293,0,641,3764,3123,104,293
46213.0,INIMUTABA,1511,18,271,2,230,1021,132,367,0,810,4362,3552,132,367
46230.0,IPANEMA,3364,23,608,4,1533,3500,317,949,0,2764,13062,10298,317,949
46256.0,IPATINGA,62442,441,6626,78,37097,11387,2594,4393,0,21739,146797,125058,2594,4393
46272.0,IPIACU,1286,6,256,2,285,693,62,241,0,608,3439,2831,62,241
46299.0,IPUIUNA,2162,26,573,1,1006,1561,286,365,0,977,6957,5980,286,365
46310.0,IRAI DE MINAS,1357,15,266,1,326,1116,102,345,0,582,4110,3528,102,345
46337.0,ITABIRA,37262,255,5789,37,7577,7103,2106,3861,0,9336,73326,63990,2106,3861
46353.0,ITABIRINHA,1262,21,114,1,1050,1397,212,730,0,630,5417,4787,212,730
46370.0,ITABIRITO,15974,87,1808,12,2027,3334,882,1137,0,2723,27984,25261,882,1137
46396.0,ITACAMBIRA,873,7,179,1,100,974,117,422,0,774,3447,2673,117,422
46418.0,ITACARAMBI,3408,7,1268,2,657,1185,225,1180,0,3041,10973,7932,225,1180
46434.0,ITAGUARA,2944,26,325,6,338,2574,500,638,0,1051,8402,7351,500,638
46450.0,ITAIPE,1411,4,337,0,433,1425,156,832,0,1952,6550,4598,156,832
46477.0,ITAJUBA,26351,367,4247,26,8065,9502,1198,1759,0,7997,59512,51515,1198,1759
46493.0,ITAMARANDIBA,4732,46,604,7,1044,5339,1187,1345,0,4779,19083,14304,1187,1345
46515.0,ITAMARATI DE MINAS,1343,13,196,0,391,386,134,232,0,379,3074,2695,134,232
46531.0,ITAMBACURI,4475,24,602,3,693,3610,504,1922,0,5095,16928,11833,504,1922
46558.0,ITAMBE DO MATO DENTRO,489,2,204,0,130,331,73,291,0,266,1786,1520,73,291
46574.0,ITAMOGI,2831,35,438,2,275,2038,345,679,0,1574,8217,6643,345,679
46590.0,ITAMONTE,2537,49,977,8,949,2360,373,451,0,1198,8902,7704,373,451
46612.0,ITANHANDU,3794,41,671,4,1165,1986,282,466,0,1305,9714,8409,282,466
46639.0,ITANHOMI,3101,31,310,3,805,1465,236,792,0,2902,9645,6743,236,792
46655.0,ITAOBIM,4449,28,423,4,1012,3091,388,1336,0,4467,15198,10731,388,1336
46671.0,ITAPAGIPE,2544,17,829,2,323,2895,211,385,0,1585,8791,7206,211,385
46698.0,ITAPECERICA,6630,57,863,8,595,4030,722,1587,0,2987,17479,14492,722,1587
46710.0,ITAPEVA,1256,30,518,1,423,1543,171,446,0,911,5299,4388,171,446
46736.0,ITATIAIUCU,2930,15,238,3,368,984,257,421,0,939,6155,5216,257,421
46752.0,ITAUNA,30266,262,4279,21,4425,6995,1428,1679,0,4997,54352,49355,1428,1679
46779.0,ITAVERAVA,1634,15,337,3,211,1228,424,399,0,768,5019,4251,424,399
46795.0,ITINGA,2419,5,183,8,364,2522,181,808,0,2876,9366,6490,181,808
46817.0,ITUETA,1286,3,209,0,641,1132,126,259,0,1082,4738,3656,126,259
46833.0,ITUIUTABA,28078,161,5843,16,4145,12444,1264,1916,0,13048,66915,53867,1264,1916
46850.0,ITUMIRIM,1437,44,543,3,172,1440,229,349,0,720,4937,4217,229,349
46876.0,ITURAMA,9661,20,1401,11,960,3933,451,1113,0,4019,21569,17550,451,1113
46892.0,ITUTINGA,1186,17,250,1,120,765,130,135,0,543,3147,2604,130,135
46914.0,JABOTICATUBAS,3748,33,1173,5,845,1674,415,1056,0,1956,10905,8949,415,1056
46930.0,JACINTO,1458,8,285,1,548,2788,245,932,0,2951,9216,6265,245,932
46957.0,JACUI,1186,17,321,6,388,1909,345,342,0,789,5303,4514,345,342
46973.0,JACUTINGA,4286,51,1411,5,1547,3037,499,713,0,2137,13686,11549,499,713
46990.0,JAGUARACU,1215,7,88,4,272,250,61,127,0,358,2382,2024,61,127
47015.0,JANAUBA,14045,57,2346,10,2192,8675,1510,3006,0,9119,40960,31841,1510,3006
47031.0,JANUARIA,12832,43,2756,11,2410,8276,897,3488,0,11422,42135,30713,897,3488
47058.0,JAPARAIBA,1013,7,127,0,273,589,105,163,0,293,2570,2277,105,163
47074.0,JECEABA,2014,9,266,1,252,827,242,325,0,752,4688,3936,242,325
47090.0,JEQUERI,2784,16,297,4,565,1896,523,1407,0,2818,10310,7492,523,1407
47112.0,JEQUITAI,2269,2,297,1,295,851,180,606,0,1805,6306,4501,180,606
47139.0,JEQUITIBA,1247,8,283,1,278,1333,157,248,0,909,4464,3555,157,248
47155.0,JEQUITINHONHA,5622,22,495,9,697,2144,417,1559,0,4752,15717,10965,417,1559
47171.0,JESUANIA,1520,13,212,2,221,730,109,320,0,654,3781,3127,109,320
47198.0,JOAIMA,3330,7,966,18,385,774,170,986,0,2751,9387,6636,170,986
47210.0,JOANESIA,1464,15,276,0,565,509,223,626,0,1688,5366,3678,223,626
47236.0,JOAO MONLEVADE,27041,225,3144,34,5279,5186,952,1380,0,7445,50686,43241,952,1380
47252.0,JOAO PINHEIRO,8596,68,2841,11,1832,7357,870,1858,0,6774,30207,23433,870,1858
47279.0,JOAQUIM FELICIO,936,2,160,1,154,597,210,188,0,316,2564,2248,210,188
47295.0,JORDANIA,1591,0,215,1,483,1692,375,575,0,2147,7079,4932,375,575
47317.0,NOVA UNIAO,1689,18,258,1,340,703,233,323,0,786,4351,3565,233,323
47333.0,JUIZ DE FORA,174699,2220,26318,214,45438,24565,6364,11272,0,38667,329757,291090,6364,11272
47350.0,JURAMENTO,1067,8,582,1,170,310,61,463,0,805,3467,2662,61,463
47376.0,JURUAIA,1405,16,304,2,650,1743,141,413,0,1068,5742,4674,141,413
47392.0,LADAINHA,1899,17,213,6,349,3063,199,1234,0,3340,10320,6980,199,1234
47414.0,LAGAMAR,1648,3,614,2,605,1635,211,372,0,1342,6432,5090,211,372
47430.0,LAGOA DA PRATA,8351,83,2259,5,2388,6867,1014,1475,0,3573,26015,22442,1014,1475
47457.0,LAGOA DOS PATOS,861,3,528,0,208,498,87,363,0,884,3432,2548,87,363
47473.0,LAGOA DOURADA,2421,36,440,6,274,2751,512,584,0,887,7911,7024,512,584
47490.0,LAGOA FORMOSA,2887,31,1286,6,629,4070,894,675,0,2397,12875,10478,894,675
47511.0,LAGOA SANTA,11256,62,2574,17,3754,3191,938,1442,0,4025,27259,23234,938,1442
47538.0,LAJINHA,3696,22,296,5,1791,3149,314,1159,0,3160,13592,10432,314,1159
47554.0,LAMBARI,4949,61,689,6,1266,3427,398,845,0,2041,13682,11641,398,845
47570.0,LAMIM,1002,13,85,2,70,781,146,366,0,418,2883,2465,146,366
47597.0,LARANJAL,1735,13,891,2,702,582,155,295,0,597,4972,4375,155,295
47619.0,LASSANCE,1460,7,392,1,174,811,101,372,0,1114,4432,3318,101,372
47635.0,LAVRAS,24724,458,5139,42,4501,9349,1934,2797,0,7164,56108,48944,1934,2797
47651.0,LEANDRO FERREIRA,1114,4,224,3,128,498,134,173,0,467,2745,2278,134,173
47678.0,LEOPOLDINA,16797,108,3204,11,4660,3223,988,1370,0,5849,36210,30361,988,1370
47694.0,LIBERDADE,1454,31,348,1,473,870,139,408,0,905,4629,3724,139,408
47716.0,LIMA DUARTE,5559,70,845,15,703,1785,466,804,0,2151,12398,10247,466,804
47732.0,LUMINARIAS,1102,9,346,3,139,975,257,400,0,603,3834,3231,257,400
47759.0,LUZ,3967,47,1372,6,640,2894,650,802,0,2463,12841,10378,650,802
47775.0,MACHACALIS,1731,13,114,2,329,778,136,557,0,1799,5459,3660,136,557
47791.0,MACHADO,8856,73,1549,6,2356,5663,966,1271,0,3252,23992,20740,966,1271
47813.0,MADRE DE DEUS DE MINAS,1601,11,130,1,94,1030,120,245,0,646,3878,3232,120,245
47830.0,MALACACHETA,2615,19,520,1,499,3631,325,2065,0,5036,14711,9675,325,2065
47856.0,MANGA,3177,15,1037,5,851,2878,486,1450,0,3936,13835,9899,486,1450
47872.0,MANHUACU,15463,146,2152,14,8316,7204,1701,2273,0,7712,44981,37269,1701,2273
47899.0,MANHUMIRIM,4754,48,993,4,2135,2438,366,1089,0,2608,14435,11827,366,1089
47910.0,MANTENA,4648,31,736,2,5459,1702,488,1256,0,5451,19773,14322,488,1256
47937.0,MARAVILHAS,1364,14,424,3,238,1450,175,236,0,612,4516,3904,175,236
47953.0,MAR DE ESPANHA,2297,23,640,3,1476,1678,225,608,0,1254,8204,6950,225,608
47970.0,MARIA DA FE,3040,87,672,4,654,3757,270,435,0,1332,10251,8919,270,435
47996.0,MARIANA,15814,161,2180,12,2631,3872,1636,2705,0,4463,33474,29011,1636,2705
48011.0,MARILAC,1079,12,86,0,109,669,128,350,0,1179,3612,2433,128,350
48038.0,MARIPA DE MINAS,677,10,311,1,287,451,61,217,0,280,2295,2015,61,217
48054.0,MARLIERIA,1736,9,102,1,321,260,126,200,0,567,3322,2755,126,200
48070.0,MARMELOPOLIS,880,11,47,0,293,635,81,170,0,571,2688,2117,81,170
48097.0,MARTINHO CAMPOS,2329,49,924,4,696,1984,562,516,0,1810,8874,7064,562,516
48119.0,MATERLANDIA,764,9,277,2,101,479,246,487,0,1121,3486,2365,246,487
48135.0,MATEUS LEME,6773,56,851,10,1499,2114,815,1233,0,2214,15565,13351,815,1233
48151.0,MATIAS BARBOSA,4909,46,621,7,1203,655,196,487,0,1111,9235,8124,196,487
48178.0,MATIPO,2870,16,327,0,1881,2322,593,1337,0,2084,11430,9346,593,1337
48194.0,MATO VERDE,1903,20,558,2,367,3838,331,1094,0,2482,10595,8113,331,1094
48216.0,MATOZINHOS,10579,63,1549,12,2840,2309,884,1248,0,2738,22222,19484,884,1248
48232.0,MATUTINA,600,3,334,0,126,794,157,398,0,814,3226,2412,157,398
48259.0,MEDEIROS,548,3,190,1,73,795,83,184,0,375,2252,1877,83,184
48275.0,MEDINA,4754,18,471,17,855,3125,696,1530,0,5385,16851,11466,696,1530
48291.0,MENDES PIMENTEL,1074,12,69,0,1188,719,173,606,0,1525,5366,3841,173,606
48313.0,MERCES,2657,33,519,4,363,1500,408,717,0,1642,7843,6201,408,717
48330.0,MESQUITA,1400,14,123,1,411,947,176,709,0,905,4686,3781,176,709
48356.0,MINAS NOVAS,2872,27,326,9,386,5177,643,2288,0,6851,18579,11728,643,2288
48372.0,MINDURI,1405,13,111,4,195,445,60,249,0,674,3156,2482,60,249
48399.0,MIRABELA,3071,15,640,4,360,1705,206,423,0,2644,9068,6424,206,423
48410.0,MIRADOURO,3199,14,591,0,884,770,285,668,0,1056,7467,6411,285,668
48437.0,MIRAI,2757,22,368,8,1664,1867,394,890,0,2040,10010,7970,394,890
48453.0,MOEDA,1462,16,276,0,278,680,168,212,0,462,3554,3092,168,212
48470.0,MOEMA,1129,13,588,2,116,1638,127,472,0,1064,5149,4085,127,472
48496.0,MONJOLOS,532,6,174,0,86,515,62,181,0,717,2273,1556,62,181
48518.0,MONSENHOR PAULO,2149,11,295,0,344,978,164,479,0,533,4953,4420,164,479
48534.0,MONTALVANIA,1381,2,606,2,365,3703,197,1177,0,3056,10489,7433,197,1177
48550.0,MONTE ALEGRE DE MINAS,3686,42,1664,6,1607,2563,498,798,0,2794,13658,10864,498,798
48577.0,MONTE AZUL,3524,6,441,2,278,7035,365,1914,0,4721,18286,13565,365,1914
48593.0,MONTE BELO,2357,17,465,2,457,3575,613,563,0,1494,9543,8049,613,563
48615.0,MONTE CARMELO,12468,127,2357,7,2369,5808,959,1826,0,4987,30908,25921,959,1826
48631.0,MONTE SANTO DE MINAS,3597,39,709,3,738,4990,615,1348,0,2576,14615,12039,615,1348
48658.0,MONTES CLAROS,89991,471,16131,54,25653,16784,3898,8038,0,30934,191954,161020,3898,8038
48674.0,MONTE SIAO,3241,35,831,3,859,4061,628,887,0,1988,12533,10545,628,887
48690.0,MORADA NOVA DE MINAS,1233,16,310,3,264,2114,182,411,0,841,5374,4533,182,411
48712.0,MORRO DA GARCA,502,1,371,0,106,596,51,201,0,564,2392,1828,51,201
48739.0,MORRO DO PILAR,1095,8,63,2,105,629,90,345,0,671,3008,2337,90,345
48755.0,MUNHOZ,1363,36,312,2,557,1268,231,367,0,859,4995,4136,231,367
48771.0,MURIAE,19862,288,5208,31,16202,6964,1833,3187,0,10915,64490,53575,1833,3187
48798.0,MUTUM,5931,18,631,5,3151,3512,654,1445,0,4595,19942,15347,654,1445
48810.0,MUZAMBINHO,4542,90,942,2,921,4698,643,595,0,2195,14628,12433,643,595
48836.0,NACIP RAYDAN,458,7,71,0,91,722,76,256,0,838,2519,1681,76,256
48852.0,NANUQUE,7725,45,1761,7,3858,6374,777,1896,0,8621,31064,22443,777,1896
48879.0,NATERCIA,915,14,237,2,72,1426,238,177,0,553,3634,3081,238,177
48895.0,NAZARENO,1847,22,475,0,270,1465,172,346,0,1004,5601,4597,172,346
48917.0,NEPOMUCENO,5728,94,832,8,1156,4773,669,1492,0,2879,17631,14752,669,1492
48933.0,NOVA ERA,6813,42,607,4,1259,1322,256,815,0,2150,13268,11118,256,815
48950.0,NOVA LIMA,26484,138,3225,32,4632,3688,915,1371,0,5082,45567,40485,915,1371
48976.0,NOVA MODICA,673,2,75,0,247,815,35,502,0,1059,3408,2349,35,502
48992.0,NOVA PONTE,2242,19,542,2,508,1727,137,515,0,898,6590,5692,137,515
49018.0,NOVA RESENDE,2843,52,177,6,726,3266,565,486,0,1211,9332,8121,565,486
49034.0,NOVA SERRANA,6390,63,1931,10,3260,5629,1428,1659,0,3196,23566,20370,1428,1659
49050.0,NOVO CRUZEIRO,3568,12,321,4,444,4681,456,2435,0,7100,19021,11921,456,2435
49077.0,OLARIA,716,7,80,1,76,529,52,237,0,204,1902,1698,52,237
49093.0,OLIMPIO NORONHA,717,11,48,1,81,622,44,161,0,315,2000,1685,44,161
49115.0,OLIVEIRA,11058,96,2020,12,1717,6217,1030,1542,0,3435,27127,23692,1030,1542
49131.0,OLIVEIRA FORTES,658,10,128,1,127,332,59,230,0,231,1776,1545,59,230
49158.0,ONCA DE PITANGUI,957,8,182,1,133,450,84,162,0,341,2318,1977,84,162
49174.0,OURO BRANCO,12100,59,1039,7,2009,1973,471,866,0,2696,21220,18524,471,866
49190.0,OURO FINO,5990,67,1329,10,1945,6711,793,1049,0,2916,20810,17894,793,1049
49212.0,OURO PRETO,25274,332,3716,32,3079,6653,1419,2175,0,6260,48940,42680,1419,2175
49239.0,OURO VERDE DE MINAS,1280,10,131,1,655,1156,140,555,0,1968,5896,3928,140,555
49255.0,PADRE PARAISO,3551,15,749,0,894,2142,243,1168,0,4194,12956,8762,243,1168
49271.0,PAINEIRAS,912,4,360,1,317,1228,154,236,0,643,3855,3212,154,236
49298.0,PAINS,2572,10,693,2,294,1124,170,430,0,949,6244,5295,170,430
49310.0,PAIVA,591,12,105,3,101,187,50,136,0,198,1383,1185,50,136
49336.0,PALMA,2034,20,438,1,857,526,120,469,0,1184,5649,4465,120,469
49352.0,FRONTEIRA DOS VALES,1094,7,138,3,165,743,49,551,0,962,3712,2750,49,551
49379.0,PAPAGAIOS,2849,26,716,1,515,2179,497,579,0,1406,8768,7362,497,579
49395.0,PARACATU,18420,108,5208,9,6794,6495,1736,1474,0,7406,47650,40244,1736,1474
49417.0,PARA DE MINAS,23498,238,5029,48,2956,7847,1817,2503,0,5165,49101,43936,1817,2503
49433.0,PARAGUACU,5603,29,918,5,963,3210,369,532,0,1753,13382,11629,369,532
49450.0,PARAISOPOLIS,5022,122,1448,5,601,2813,418,731,0,1952,13112,11160,418,731
49476.0,PARAOPEBA,5963,48,1132,3,1235,2613,467,674,0,1818,13953,12135,467,674
49492.0,PASSABEM,331,7,64,0,130,427,74,250,0,361,1644,1283,74,250
49514.0,PASSA QUATRO,4738,93,938,2,687,2119,346,594,0,1341,10858,9517,346,594
49530.0,PASSA TEMPO,2118,26,376,2,256,1744,327,503,0,1236,6588,5352,327,503
49557.0,PASSA VINTE,350,8,42,0,803,151,49,137,0,225,1765,1540,49,137
49573.0,PASSOS,33398,149,3973,36,4384,11266,1498,2617,0,9543,66864,57321,1498,2617
49590.0,PATOS DE MINAS,28500,269,13519,47,7134,20266,2509,3018,0,13306,88568,75262,2509,3018
49611.0,PATROCINIO,19206,150,5819,20,4069,8382,1555,1829,0,7372,48402,41030,1555,1829
49638.0,PATROCINIO DO MURIAE,1143,15,191,0,799,743,114,278,0,430,3713,3283,114,278
49654.0,PAULA CANDIDO,2779,37,204,1,320,949,192,1013,0,1285,6780,5495,192,1013
49670.0,PAULISTAS,1031,10,63,1,84,998,117,393,0,1381,4078,2697,117,393
49697.0,PAVAO,1877,9,144,0,220,1861,96,489,0,2130,6826,4696,96,489
49719.0,PECANHA,1991,28,890,9,776,2947,413,1483,0,3635,12172,8537,413,1483
49735.0,PEDRA AZUL,4479,15,667,2,946,4246,295,2183,0,4760,17593,12833,295,2183
49751.0,PEDRA DO ANTA,901,12,41,0,187,827,121,427,0,497,3013,2516,121,427
49778.0,PEDRA DO INDAIA,673,8,88,0,140,1437,104,193,0,195,2838,2643,104,193
49794.0,PEDRA DOURADA,524,3,35,1,163,217,26,184,0,91,1244,1153,26,184
49816.0,PEDRALVA,2483,36,619,4,302,2826,285,612,0,1259,8426,7167,285,612
49832.0,PEDRINOPOLIS,825,10,386,0,162,697,94,178,0,522,2874,2352,94,178
49859.0,PEDRO LEOPOLDO,18521,107,2495,14,4442,4132,1094,2005,0,3704,36514,32810,1094,2005
49875.0,PEDRO TEIXEIRA,654,2,273,0,129,196,41,125,0,223,1643,1420,41,125
49891.0,PEQUERI,877,13,183,0,515,357,53,142,0,395,2535,2140,53,142
49913.0,PEQUI,1199,1,212,0,189,816,84,235,0,515,3251,2736,84,235
49930.0,PERDIGAO,1180,25,457,4,293,1389,266,372,0,592,4578,3986,266,372
49956.0,PERDIZES,2393,10,976,1,386,2598,230,461,0,2117,9172,7055,230,461
49972.0,PERDOES,3301,65,1098,2,1157,4592,710,973,0,1721,13619,11898,710,973
49999.0,PESCADOR,923,3,77,0,176,633,53,379,0,1226,3470,2244,53,379
50016.0,PIAU,956,4,170,1,282,587,97,222,0,354,2673,2319,97,222
50032.0,PIEDADE DE PONTE NOVA,1132,3,99,1,228,689,145,355,0,779,3431,2652,145,355
50059.0,PIEDADE DO RIO GRANDE,1042,12,252,2,115,1197,151,389,0,848,4008,3160,151,389
50075.0,PIEDADE DOS GERAIS,1097,8,93,2,173,948,279,374,0,682,3656,2974,279,374
50091.0,PIMENTA,1601,17,278,3,368,1649,394,446,0,916,5672,4756,394,446
50113.0,PIRACEMA,1592,15,228,11,188,1572,317,544,0,852,5319,4467,317,544
50130.0,PIRAJUBA,859,7,134,1,78,641,73,143,0,349,2285,1936,73,143
50156.0,PIRANGA,2507,31,419,8,518,3352,624,1649,0,3014,12122,9108,624,1649
50172.0,PIRANGUCU,946,20,246,3,162,1368,129,304,0,647,3825,3178,129,304
50199.0,PIRANGUINHO,2394,37,363,3,348,980,198,288,0,795,5406,4611,198,288
50210.0,PIRAPETINGA,2028,21,412,3,2718,924,211,666,0,1209,8192,6983,211,666
50237.0,PIRAPORA,14508,104,1853,10,4053,3499,844,1610,0,7400,33881,26481,844,1610
50253.0,PIRAUBA,3218,22,548,4,681,1408,319,520,0,1306,8026,6720,319,520
50270.0,PITANGUI,7844,66,1327,8,1309,2496,630,1002,0,2412,17094,14682,630,1002
50296.0,PIUMHI,7407,66,1202,4,1707,5179,836,1247,0,3689,21337,17648,836,1247
50318.0,PLANURA,1983,4,448,5,663,1564,221,227,0,1318,6433,5115,221,227
50334.0,POCO FUNDO,4422,76,734,2,465,2780,471,437,0,1414,10801,9387,471,437
50350.0,POCOS DE CALDAS,31586,551,11044,56,10506,20891,1870,3277,0,12741,92522,79781,1870,3277
50377.0,POCRANE,1869,8,126,2,955,2138,169,627,0,2088,7982,5894,169,627
50393.0,POMPEU,7067,51,1574,3,1218,2703,905,1428,0,3202,18151,14949,905,1428
50415.0,PONTE NOVA,18503,149,2463,17,3852,5341,1107,2003,0,7225,40660,33435,1107,2003
50431.0,PORTEIRINHA,4818,43,1549,5,1819,7876,1114,2712,0,6463,26399,19936,1114,2712
50458.0,PORTO FIRME,2379,24,195,0,583,1204,291,750,0,2274,7700,5426,291,750
50474.0,POTE,2006,21,409,1,381,3023,249,1040,0,2803,9933,7130,249,1040
50490.0,POUSO ALEGRE,29814,356,8606,30,7018,12975,1599,2530,0,9192,72120,62928,1599,2530
50512.0,POUSO ALTO,1337,19,356,0,537,1464,161,352,0,752,4978,4226,161,352
50539.0,PRADOS,2145,46,237,6,167,1721,361,541,0,631,5855,5224,361,541
50555.0,PRATA,6043,43,1760,4,981,3931,525,764,0,3535,17586,14051,525,764
50571.0,PRATAPOLIS,2170,29,435,5,385,2446,240,493,0,1466,7669,6203,240,493
50598.0,PRATINHA,417,11,175,2,126,868,104,213,0,400,2316,1916,104,213
50610.0,PRESIDENTE BERNARDES,1344,18,82,2,159,1391,135,508,0,658,4297,3639,135,508
50636.0,PRESIDENTE JUSCELINO,915,9,579,0,139,436,123,352,0,890,3443,2553,123,352
50652.0,PRESIDENTE KUBITSCHEK,436,3,661,4,68,300,35,305,0,305,2117,1812,35,305
50679.0,PRESIDENTE OLEGARIO,3743,19,1449,8,572,3001,454,1108,0,2863,13217,10354,454,1108
50695.0,ALTO JEQUITIBA,966,8,420,0,1729,1204,116,352,0,1049,5844,4795,116,352
50717.0,PRUDENTE DE MORAIS,2463,16,367,4,605,920,265,447,0,818,5905,5087,265,447
50733.0,QUARTEL GERAL,649,7,219,0,200,887,209,171,0,592,2934,2342,209,171
50750.0,QUELUZITO,764,6,94,1,78,541,68,170,0,150,1872,1722,68,170
50776.0,RAPOSOS,6332,54,453,2,1471,691,259,381,0,1303,10946,9643,259,381
50792.0,RAUL SOARES,6237,78,610,12,1097,3733,970,1478,0,4559,18774,14215,970,1478
50814.0,RECREIO,3182,22,484,2,1100,1151,207,432,0,1680,8260,6580,207,432
50830.0,RESENDE COSTA,2653,57,363,4,296,2411,262,397,0,1044,7487,6443,262,397
50857.0,RESPLENDOR,2656,15,646,1,3296,2606,322,410,0,3957,13909,9952,322,410
50873.0,RESSAQUINHA,1418,18,232,0,167,1037,126,269,0,276,3543,3267,126,269
50890.0,RIACHO DOS MACHADOS,1285,9,489,1,366,2034,233,725,0,1840,6982,5142,233,725
50911.0,RIBEIRAO DAS NEVES,55615,378,4111,105,27319,11119,4014,5612,0,17900,126173,108273,4014,5612
50938.0,RIBEIRAO VERMELHO,1615,24,186,1,153,336,82,153,0,329,2879,2550,82,153
50954.0,RIO ACIMA,3155,23,253,4,679,590,158,218,0,789,5869,5080,158,218
50970.0,RIO CASCA,4468,29,794,2,815,1485,480,1133,0,3326,12532,9206,480,1133
50997.0,RIO DOCE,793,3,214,1,92,256,42,152,0,363,1916,1553,42,152
51012.0,RIO DO PRADO,1232,7,51,0,108,958,87,305,0,1192,3940,2748,87,305
51039.0,RIO ESPERA,1300,20,223,3,177,1748,328,421,0,1226,5446,4220,328,421
51055.0,RIO MANSO,1206,2,157,0,268,780,122,254,0,250,3039,2789,122,254
51071.0,RIO NOVO,2189,24,771,2,734,1286,289,531,0,1076,6902,5826,289,531
51098.0,RIO PARANAIBA,2562,14,485,3,578,1932,449,618,0,1355,7996,6641,449,618
51110.0,RIO PARDO DE MINAS,2192,19,441,8,649,6390,443,2048,0,4020,16210,12190,443,2048
51136.0,RIO PIRACICABA,5265,44,826,9,913,1029,347,711,0,1929,11073,9144,347,711
51152.0,RIO POMBA,5543,62,951,8,1046,1557,534,889,0,2053,12643,10590,534,889
51179.0,RIO PRETO,1615,10,450,2,576,597,96,231,0,385,3962,3577,96,231
51195.0,RIO VERMELHO,1951,25,412,6,404,1848,782,1315,0,3406,10149,6743,782,1315
51217.0,RITAPOLIS,1302,19,171,4,195,1573,143,263,0,968,4638,3670,143,263
51233.0,ROCHEDO DE MINAS,672,7,93,0,199,285,28,135,0,246,1665,1419,28,135
51250.0,RODEIRO,1650,17,181,6,308,800,140,295,0,409,3806,3397,140,295
51276.0,ROMARIA,1054,8,224,0,183,659,57,152,0,466,2803,2337,57,152
51292.0,RUBELITA,1313,6,118,0,138,2313,123,953,0,1985,6949,4964,123,953
51314.0,RUBIM,1307,5,195,2,217,2053,129,899,0,2360,7167,4807,129,899
51330.0,SABARA,35642,261,3350,46,12005,5536,2274,2702,0,8524,70340,61816,2274,2702
51357.0,SABINOPOLIS,3523,33,379,4,432,1725,704,1071,0,3061,10932,7871,704,1071
51373.0,SACRAMENTO,4079,44,1724,7,532,5801,239,408,0,2740,15574,12834,239,408
51390.0,SALINAS,7583,22,1944,3,1747,4620,773,3002,0,6077,25771,19694,773,3002
51411.0,SALTO DA DIVISA,1406,4,94,0,161,776,83,600,0,1647,4771,3124,83,600
51438.0,SANTA BARBARA,9782,57,1517,8,1113,1655,454,939,0,2785,18310,15525,454,939
51454.0,SANTA BARBARA DO TUGURIO,1248,20,169,0,181,1247,131,443,0,606,4045,3439,131,443
51470.0,SANTA CRUZ DO ESCALVADO,1144,3,84,0,162,916,80,499,0,441,3329,2888,80,499
51497.0,SANTA EFIGENIA DE MINAS,624,18,34,1,418,661,208,542,0,1099,3605,2506,208,542
51519.0,SANTA FE DE MINAS,902,2,104,1,175,751,67,86,0,823,2911,2088,67,86
51535.0,SANTA JULIANA,1791,17,715,2,202,1751,268,318,0,1057,6121,5064,268,318
51551.0,SANTA LUZIA,54875,346,5118,94,22685,10957,3422,4055,0,15228,116780,101552,3422,4055
51578.0,SANTA MARGARIDA,2306,12,166,1,1660,2338,411,1097,0,1646,9637,7991,411,1097
51594.0,SANTA MARIA DE ITABIRA,2470,27,422,6,438,1237,371,816,0,1336,7123,5787,371,816
51616.0,SANTA MARIA DO SALTO,512,1,32,0,517,845,456,510,0,762,3635,2873,456,510
51632.0,SANTA MARIA DO SUACUI,2350,16,713,3,401,2063,310,1518,0,3571,10945,7374,310,1518
51659.0,SANTANA DA VARGEM,2506,9,315,4,265,1131,170,336,0,1012,5748,4736,170,336
51675.0,SANTANA DE CATAGUASES,769,3,214,1,330,763,94,275,0,254,2703,2449,94,275
51691.0,SANTANA DE PIRAPAMA,1951,14,544,0,393,1314,316,552,0,1802,6886,5084,316,552
51713.0,SANTANA DO DESERTO,908,24,199,1,614,260,57,191,0,221,2475,2254,57,191
51730.0,SANTANA DO GARAMBEU,371,7,225,0,53,529,70,171,0,339,1765,1426,70,171
51756.0,SANTANA DO JACARE,1089,9,134,3,273,776,396,327,0,666,3673,3007,396,327
51772.0,SANTANA DO MANHUACU,1765,5,116,0,679,1142,295,414,0,1618,6034,4416,295,414
51799.0,SANTANA DO RIACHO,1012,2,142,0,240,709,135,345,0,766,3351,2585,135,345
51810.0,SANTANA DOS MONTES,762,4,345,1,187,944,118,424,0,461,3246,2785,118,424
51837.0,SANTA RITA DE CALDAS,2242,33,503,1,274,1977,182,348,0,877,6437,5560,182,348
51853.0,SANTA RITA DE JACUTINGA,1252,11,124,3,1171,682,144,223,0,816,4426,3610,144,223
51870.0,SANTA RITA DO IBITIPOCA,900,7,270,1,168,636,99,297,0,343,2721,2378,99,297
51896.0,SANTA RITA DO ITUETO,1195,7,146,0,759,1123,68,192,0,1117,4607,3490,68,192
51918.0,SANTA RITA DO SAPUCAI,6634,79,2414,9,1558,6984,830,1117,0,3114,22739,19625,830,1117
51934.0,SANTA ROSA DA SERRA,625,1,97,0,329,669,108,223,0,514,2566,2052,108,223
51950.0,SANTA VITORIA,4841,27,948,5,864,2730,347,457,0,2919,13138,10219,347,457
51977.0,SANTO ANTONIO DO AMPARO,3145,42,562,3,549,2947,670,1080,0,1477,10475,8998,670,1080
51993.0,SANTO ANTONIO DO AVENTUREIRO,981,21,435,1,236,560,123,273,0,452,3082,2630,123,273
52019.0,SANTO ANTONIO DO GRAMA,1145,1,60,0,76,949,81,358,0,735,3405,2670,81,358
52035.0,SANTO ANTONIO DO ITAMBE,959,8,62,0,96,384,134,390,0,964,2997,2033,134,390
52051.0,SANTO ANTONIO DO JACINTO,1759,8,79,0,425,2318,358,1134,0,3365,9446,6081,358,1134
52078.0,SANTO ANTONIO DO MONTE,4029,30,1156,4,720,5596,662,701,0,1812,14710,12898,662,701
52094.0,SANTO ANTONIO DO RIO ABAIXO,603,4,143,1,35,189,59,203,0,463,1700,1237,59,203
52116.0,SANTO HIPOLITO,727,5,281,2,192,356,137,199,0,808,2707,1899,137,199
52132.0,SANTOS DUMONT,17268,212,2140,19,4499,3845,838,2038,0,4563,35422,30859,838,2038
52159.0,SAO BENTO ABADE,805,8,165,3,171,1001,151,300,0,417,3021,2604,151,300
52175.0,SAO BRAS DO SUACUI,1349,8,142,0,130,320,164,225,0,363,2701,2338,164,225
52191.0,SAO DOMINGOS DO PRATA,5900,43,740,8,1064,1820,403,1135,0,2686,13799,11113,403,1135
52213.0,SAO FRANCISCO,8126,25,1892,9,1058,8532,761,2188,0,9280,31871,22591,761,2188
52230.0,SAO FRANCISCO DE PAULA,1417,12,220,3,320,1597,172,370,0,731,4842,4111,172,370
52256.0,SAO FRANCISCO DE SALES,1569,7,284,0,124,980,114,242,0,869,4189,3320,114,242
52272.0,SAO FRANCISCO DO GLORIA,1466,21,244,1,507,528,163,323,0,781,4034,3253,163,323
52299.0,SAO GERALDO,2271,25,271,2,354,873,216,621,0,954,5587,4633,216,621
52310.0,SAO GERALDO DA PIEDADE,1184,9,175,1,220,427,118,547,0,1482,4163,2681,118,547
52337.0,SAO GONCALO DO ABAETE,877,5,426,1,291,858,161,194,0,698,3511,2813,161,194
52353.0,SAO GONCALO DO PARA,2418,21,461,4,337,1216,311,393,0,816,5977,5161,311,393
52370.0,SAO GONCALO DO RIO ABAIXO,3041,13,271,8,421,951,272,487,0,961,6425,5464,272,487
52396.0,SAO GONCALO DO SAPUCAI,5981,23,992,1,894,4222,479,843,0,2393,15828,13435,479,843
52418.0,SAO GOTARDO,4517,42,1482,7,1804,5360,1176,1492,0,3681,19561,15880,1176,1492
52434.0,SAO JOAO BATISTA DO GLORIA,1941,5,404,2,332,911,117,293,0,682,4687,4005,117,293
52450.0,SAO JOAO DA MATA,920,12,176,0,246,471,89,187,0,375,2476,2101,89,187
52477.0,SAO JOAO DA PONTE,2686,12,403,5,379,6387,372,2184,0,5997,18425,12428,372,2184
52493.0,SAO JOAO DEL REI,28793,396,3761,30,3043,12298,1298,1775,0,7779,59173,51394,1298,1775
52515.0,SAO JOAO DO ORIENTE,2129,13,233,1,952,753,208,695,0,1502,6486,4984,208,695
52531.0,SAO JOAO DO PARAISO,1830,23,362,1,684,4441,782,1706,0,4184,14013,9829,782,1706
52558.0,SAO JOAO EVANGELISTA,3018,25,578,3,596,2485,225,1230,0,3686,11846,8160,225,1230
52574.0,SAO JOAO NEPOMUCENO,9396,59,1165,7,1765,1734,411,876,0,2499,17912,15413,411,876
52590.0,SAO JOSE DA SAFIRA,621,5,175,1,238,639,109,404,0,805,2997,2192,109,404
52612.0,SAO JOSE DA VARGINHA,1035,7,181,1,166,442,117,184,0,356,2489,2133,117,184
52639.0,SAO JOSE DO ALEGRE,868,12,289,0,221,737,122,238,0,395,2882,2487,122,238
52655.0,SAO JOSE DO DIVINO,558,1,66,0,282,757,87,362,0,937,3050,2113,87,362
52671.0,SAO JOSE DO GOIABAL,2400,8,142,2,191,430,111,393,0,1159,4836,3677,111,393
52698.0,SAO JOSE DO JACURI,831,21,227,2,247,934,299,736,0,1461,4758,3297,299,736
52710.0,SAO JOSE DO MANTIMENTO,638,6,32,0,526,218,59,152,0,370,2001,1631,59,152
52736.0,SAO LOURENCO,8363,110,3314,12,3665,5930,605,1038,0,3475,26512,23037,605,1038
52752.0,SAO MIGUEL DO ANTA,1230,30,93,4,283,1055,197,890,0,250,4032,3782,197,890
52779.0,SAO PEDRO DA UNIAO,874,16,144,0,127,1524,248,332,0,708,3973,3265,248,332
52795.0,SAO PEDRO DOS FERROS,2225,16,239,4,254,1352,172,751,0,792,5805,5013,172,751
52817.0,SAO PEDRO DO SUACUI,934,7,371,1,329,725,76,760,0,1415,4618,3203,76,760
52833.0,SAO ROMAO,1836,8,387,1,311,929,102,384,0,1558,5516,3958,102,384
52850.0,SAO ROQUE DE MINAS,932,15,292,1,336,1599,222,329,0,973,4699,3726,222,329
52876.0,SAO SEBASTIAO DA BELA VISTA,939,7,227,2,420,1012,126,205,0,623,3561,2938,126,205
52892.0,SAO SEBASTIAO DO MARANHAO,932,18,346,1,405,1987,398,1017,0,2794,7898,5104,398,1017
52914.0,SAO SEBASTIAO DO OESTE,1448,8,202,2,119,1040,193,431,0,521,3964,3443,193,431
52930.0,SAO SEBASTIAO DO PARAISO,15131,186,2974,19,2898,9260,1335,2317,0,5698,39818,34120,1335,2317
52957.0,SAO SEBASTIAO DO RIO PRETO,512,2,105,0,80,194,85,158,0,288,1424,1136,85,158
52973.0,SAO SEBASTIAO DO RIO VERDE,597,7,216,0,89,373,58,111,0,203,1654,1451,58,111
52990.0,SAO TIAGO,2303,63,568,3,292,2647,437,406,0,1007,7726,6719,437,406
53015.0,SAO TOMAS DE AQUINO,1239,29,315,5,214,1658,147,455,0,884,4946,4062,147,455
53031.0,SAO TOME DAS LETRAS,1627,9,285,0,134,1110,169,318,0,797,4449,3652,169,318
53058.0,SAO VICENTE DE MINAS,2152,21,275,2,142,865,94,315,0,973,4839,3866,94,315
53074.0,SAPUCAI MIRIM,1380,18,175,3,193,948,76,264,0,665,3722,3057,76,264
53090.0,SARDOA,801,29,89,0,338,537,371,490,0,888,3543,2655,371,490
53112.0,SENADOR CORTES,577,4,171,1,250,186,55,204,0,170,1618,1448,55,204
53139.0,SENADOR FIRMINO,2428,20,145,4,157,1129,146,608,0,1320,5957,4637,146,608
53155.0,SENADOR JOSE BENTO,450,11,138,0,150,433,51,146,0,269,1648,1379,51,146
53171.0,SENADOR MODESTINO GONCALVES,1108,1,244,0,131,1073,131,503,0,1320,4511,3191,131,503
53198.0,SENHORA DE OLIVEIRA,1237,9,226,4,176,1187,173,551,0,606,4169,3563,173,551
53210.0,SENHORA DO PORTO,466,8,292,2,133,731,169,617,0,830,3248,2418,169,617
53236.0,SENHORA DOS REMEDIOS,1592,54,277,2,211,2666,202,668,0,1591,7263,5672,202,668
53252.0,SERICITA,1216,4,153,0,609,1927,187,514,0,1089,5699,4610,187,514
53279.0,SERITINGA,463,6,67,0,86,394,42,135,0,240,1433,1193,42,135
53295.0,SERRA AZUL DE MINAS,751,9,32,0,163,470,82,453,0,943,2903,1960,82,453
53317.0,SERRA DA SAUDADE,342,0,67,0,67,165,13,47,0,168,869,701,13,47
53333.0,SERRA DOS AIMORES,1926,12,264,1,488,954,113,521,0,1967,6246,4279,113,521
53350.0,SERRA DO SALITRE,1799,9,444,0,578,1677,230,206,0,1148,6091,4943,230,206
53376.0,SERRANIA,1818,10,249,3,295,1382,128,331,0,988,5204,4216,128,331
53392.0,SERRANOS,652,6,143,0,57,428,39,153,0,341,1819,1478,39,153
53414.0,SERRO,3028,20,420,4,346,3665,499,1696,0,3574,13252,9678,499,1696
53430.0,SETE LAGOAS,64403,573,9094,95,12001,15765,3939,5119,0,16109,127098,110989,3939,5119
53457.0,SILVEIRANIA,871,6,131,0,74,275,42,139,0,206,1744,1538,42,139
53473.0,SILVIANOPOLIS,1360,20,350,2,214,1341,127,317,0,784,4515,3731,127,317
53490.0,SIMAO PEREIRA,924,5,109,1,434,230,39,134,0,231,2107,1876,39,134
53511.0,SIMONESIA,3349,53,183,2,845,3330,465,876,0,2556,11659,9103,465,876
53538.0,SOBRALIA,1138,7,87,2,826,716,110,670,0,1580,5136,3556,110,670
53554.0,SOLEDADE DE MINAS,1306,19,400,1,440,892,123,235,0,592,4008,3416,123,235
53570.0,TABULEIRO,1153,11,227,2,218,716,193,335,0,620,3475,2855,193,335
53597.0,TAIOBEIRAS,4205,24,550,5,963,6965,628,2394,0,5093,20827,15734,628,2394
53619.0,TAPIRA,998,5,374,2,265,694,87,246,0,595,3266,2671,87,246
53635.0,TAPIRAI,489,3,166,0,124,523,52,111,0,268,1736,1468,52,111
53651.0,TAQUARACU DE MINAS,951,7,277,1,273,783,153,283,0,595,3323,2728,153,283
53678.0,TARUMIRIM,3991,21,173,3,689,2598,228,958,0,2315,10976,8661,228,958
53694.0,TEIXEIRAS,3489,28,607,7,554,1530,264,1032,0,1602,9113,7511,264,1032
53716.0,TEOFILO OTONI,32074,168,5112,32,10568,13026,2040,5263,0,22847,91130,68283,2040,5263
53732.0,TIMOTEO,27120,139,1588,21,9694,2965,845,1575,0,6870,50817,43947,845,1575
53759.0,TIRADENTES,1924,13,234,0,275,1177,141,236,0,563,4563,4000,141,236
53775.0,TIROS,830,6,318,1,221,1626,274,543,0,1742,5561,3819,274,543
53791.0,TOCANTINS,3558,51,782,7,1303,2715,410,784,0,1652,11262,9610,410,784
53813.0,TOLEDO,739,15,109,0,120,1589,154,305,0,813,3844,3031,154,305
53830.0,TOMBOS,2430,64,348,1,970,1220,138,459,0,1365,6995,5630,138,459
53856.0,TRES CORACOES,18172,277,4090,30,4261,8773,1564,2140,0,6268,45575,39307,1564,2140
53872.0,TRES PONTAS,15641,134,2790,24,2440,6289,1316,1667,0,5093,35394,30301,1316,1667
53899.0,TUMIRITINGA,993,7,192,1,833,650,164,245,0,765,3850,3085,164,245
53910.0,TUPACIGUARA,6020,36,1306,5,1331,4401,600,806,0,1996,16501,14505,600,806
53937.0,TURMALINA,3347,15,373,3,560,2215,309,1030,0,2763,10615,7852,309,1030
53953.0,TURVOLANDIA,771,21,193,0,259,635,204,284,0,472,2839,2367,204,284
53970.0,UBA,27185,262,3910,45,5231,7076,1737,2511,0,7388,55345,47957,1737,2511
53996.0,UBAI,1122,6,979,5,375,1903,248,1025,0,2458,8121,5663,248,1025
54011.0,UBERABA,93857,765,18846,62,9534,27701,3561,5896,0,28033,188255,160222,3561,5896
54038.0,UBERLANDIA,150926,1630,32107,168,37516,48773,7437,11130,0,44767,334454,289687,7437,11130
54054.0,UMBURATIBA,566,2,73,0,171,498,53,314,0,752,2429,1677,53,314
54070.0,UNAI,18980,129,4461,14,3211,8859,1269,2271,0,10196,49390,39194,1269,2271
54097.0,URUCANIA,1942,24,316,0,1028,1440,221,825,0,1628,7424,5796,221,825
54119.0,VARGEM BONITA,614,12,232,0,234,363,57,132,0,350,1994,1644,57,132
54135.0,VARGINHA,34447,504,6206,52,6784,13858,1936,2294,0,9383,75464,66081,1936,2294
54151.0,VARZEA DA PALMA,7791,65,1810,7,1988,3383,683,1720,0,4578,22025,17447,683,1720
54178.0,VARZELANDIA,2817,13,1026,6,404,1988,303,1225,0,4076,11858,7782,303,1225
54194.0,VAZANTE,6089,50,1632,6,1159,1612,591,671,0,3206,15016,11810,591,671
54216.0,WENCESLAU BRAZ,1009,26,130,2,124,379,54,131,0,267,2122,1855,54,131
54232.0,VERISSIMO,1070,4,285,0,116,573,95,160,0,838,3141,2303,95,160
54259.0,VESPASIANO,22426,139,2035,39,9393,4121,1418,2456,0,7184,49211,42027,1418,2456
54275.0,VICOSA,23712,218,2012,57,2551,5527,1279,2917,0,6252,44525,38273,1279,2917
54291.0,VIEIRAS,1468,11,141,4,318,382,78,233,0,864,3499,2635,78,233
54313.0,MATHIAS LOBATO,833,7,91,0,515,376,71,268,0,793,2954,2161,71,268
54330.0,VIRGEM DA LAPA,1912,8,135,3,315,2559,218,967,0,3043,9160,6117,218,967
54356.0,VIRGINIA,1600,25,332,3,257,2156,210,457,0,1149,6189,5040,210,457
54372.0,VIRGINOPOLIS,2351,48,473,6,266,1040,308,1203,0,2173,7868,5695,308,1203
54399.0,VIRGOLANDIA,1463,3,114,3,159,723,155,466,0,1531,4617,3086,155,466
54410.0,VISCONDE DO RIO BRANCO,11844,84,1394,10,2227,3398,1005,1753,0,3112,24827,21715,1005,1753
54437.0,VOLTA GRANDE,1219,13,248,1,645,395,82,280,0,749,3632,2883,82,280
54453.0,ITAU DE MINAS,4127,41,799,4,1138,1824,306,617,0,1435,10291,8856,306,617
55000.0,NOVA ALVORADA DO SUL,2143,7,613,2,507,1449,95,356,0,1178,6350,5172,95,356
55018.0,ALCINOPOLIS,516,4,411,0,155,713,47,167,0,673,2686,2013,47,167
55026.0,LAGUNA CARAPA,1108,5,160,0,280,973,29,229,0,426,3210,2784,29,229
55034.0,JAPORA,1612,6,188,0,158,549,57,271,0,1109,3950,2841,57,271
55042.0,NOVO HORIZONTE DO SUL,1303,8,161,1,637,506,81,380,0,951,4028,3077,81,380
56006.0,SAO DOMINGOS,2446,19,325,0,758,1108,141,501,0,1299,6597,5298,141,501
56014.0,AFONSO CLAUDIO,5932,70,1088,12,3031,5879,596,1305,0,4242,22155,17913,596,1305
56022.0,AGUA DOCE DO NORTE,2351,25,198,4,2772,1066,289,1052,0,3687,11444,7757,289,1052
56030.0,ALEGRE,5151,116,1139,11,5173,4447,563,2057,0,4784,23441,18657,563,2057
56049.0,IRUPI,992,9,166,2,2102,1631,174,405,0,1465,6946,5481,174,405
56057.0,ALFREDO CHAVES,3180,60,511,6,1116,2947,387,597,0,1681,10485,8804,387,597
56065.0,ALTO RIO NOVO,985,8,235,3,1307,1133,149,517,0,1908,6245,4337,149,517
56073.0,ANCHIETA,5158,51,797,5,2972,2507,516,803,0,3074,15883,12809,516,803
56081.0,VILA PAVAO,2361,33,196,3,1071,954,137,330,0,1137,6222,5085,137,330
56090.0,APIACA,825,14,442,3,1992,656,79,483,0,1348,5842,4494,79,483
56103.0,MARECHAL FLORIANO,3122,42,739,8,1263,2777,485,553,0,1972,10961,8989,485,553
56111.0,ARACRUZ,17903,106,2254,17,8539,6990,906,2382,0,8089,47186,39097,906,2382
56120.0,MARATAIZES,3438,53,751,7,8543,1715,469,1159,0,4416,20551,16135,469,1159
56138.0,ATILIO VIVACQUA,2076,21,333,7,2124,964,139,469,0,1015,7148,6133,139,469
56146.0,BREJETUBA,1920,16,89,1,1250,1387,175,639,0,2088,7565,5477,175,639
56154.0,BAIXO GUANDU,6446,113,1211,8,4025,3569,600,1889,0,4598,22459,17861,600,1889
56162.0,SAO ROQUE DO CANAA,2357,47,406,3,574,2183,234,432,0,998,7234,6236,234,432
56170.0,BARRA DE SAO FRANCISCO,7013,72,896,14,6926,2947,711,2340,0,6945,27864,20919,711,2340
56189.0,SOORETAMA,4043,29,298,1,2061,2150,433,856,0,2357,12228,9871,433,856
56197.0,BOA ESPERANCA,3642,26,421,5,1336,1663,259,727,0,2444,10523,8079,259,727
56200.0,PONTO BELO,1876,13,175,2,663,988,170,549,0,1748,6184,4436,170,549
56219.0,BOM JESUS DO NORTE,1289,19,396,3,2778,886,122,396,0,1719,7608,5889,122,396
56227.0,VILA VALERIO,4458,11,213,4,796,1235,138,671,0,1628,9154,7526,138,671
56235.0,CACHOEIRO DE ITAPEMIRIM,39977,498,7047,68,25349,12790,2896,3611,0,16213,108449,92236,2896,3611
56251.0,CARIACICA,68305,833,8155,151,49272,22334,3599,7588,0,25110,185347,160237,3599,7588
56278.0,CASTELO,9265,154,1843,15,2393,4485,881,1377,0,3599,24012,20413,881,1377
56294.0,COLATINA,25356,411,5519,42,11398,15511,1910,2882,0,12263,75292,63029,1910,2882
56308.0,GOVERNADOR LINDENBERG,3103,19,228,1,439,1536,211,382,0,1320,7239,5919,211,382
56316.0,CONCEICAO DA BARRA,5047,52,433,5,2409,2722,564,1559,0,4915,17706,12791,564,1559
56332.0,CONCEICAO DO CASTELO,1995,13,457,4,1112,2172,340,890,0,1665,8648,6983,340,890
56359.0,DIVINO DE SAO LOURENCO,538,25,137,1,969,766,95,303,0,928,3762,2834,95,303
56375.0,DOMINGOS MARTINS,5497,72,1926,9,2433,6464,792,1030,0,3149,21372,18223,792,1030
56391.0,DORES DO RIO PRETO,847,19,272,0,1082,952,131,405,0,1053,4761,3708,131,405
56413.0,ECOPORANGA,5130,44,500,5,2373,3282,408,1282,0,5108,18132,13024,408,1282
56430.0,FUNDAO,3925,19,546,0,1585,1331,295,598,0,977,9276,8299,295,598
56456.0,GUACUI,4483,58,1186,11,4139,3184,542,1248,0,3555,18406,14851,542,1248
56472.0,GUARAPARI,16482,362,4894,30,14369,10499,1533,2642,0,12667,63478,50811,1533,2642
56499.0,IBIRACU,3886,28,553,2,1087,1247,294,535,0,1483,9115,7632,294,535
56502.0,IBITIRAMA,929,19,238,4,1841,1085,187,598,0,1628,6529,4901,187,598
56510.0,ICONHA,3508,34,497,2,942,2033,251,441,0,1076,8784,7708,251,441
56537.0,ITAGUACU,3445,82,755,2,1330,2578,355,741,0,2181,11469,9288,355,741
56553.0,ITAPEMIRIM,4360,31,562,3,8056,1856,522,1182,0,4196,20768,16572,522,1182
56570.0,ITARANA,2936,54,968,5,774,1708,272,607,0,1308,8632,7324,272,607
56596.0,IUNA,3255,38,888,5,5317,4206,493,1360,0,4114,19676,15562,493,1360
56618.0,JERONIMO MONTEIRO,1530,35,418,4,1894,1410,228,544,0,1031,7094,6063,228,544
56626.0,JOAO NEIVA,5302,33,668,5,1398,1880,329,563,0,1800,11978,10178,329,563
56634.0,LINHARES,23740,252,3930,35,12723,16281,2407,4486,0,13569,77423,63854,2407,4486
56650.0,MANTENOPOLIS,1486,5,242,3,2844,1448,371,849,0,3535,10783,7248,371,849
56677.0,MIMOSO DO SUL,3648,63,888,7,5748,2874,753,1476,0,4301,19758,15457,753,1476
56693.0,MONTANHA,4248,21,339,4,1822,1592,314,1150,0,3790,13280,9490,314,1150
56715.0,MUCURICI,1563,5,129,2,349,949,87,345,0,1515,4944,3429,87,345
56731.0,MUNIZ FREIRE,3702,44,472,5,2046,2919,305,943,0,2747,13183,10436,305,943
56758.0,MUQUI,3324,52,663,4,2850,1509,337,674,0,1957,11370,9413,337,674
56774.0,NOVA VENECIA,11670,89,1237,14,4118,4349,828,1604,0,5968,29877,23909,828,1604
56790.0,PANCAS,4303,46,617,4,2884,2314,284,998,0,3840,15290,11450,284,998
56812.0,PINHEIROS,5752,14,535,2,2291,1828,341,1219,0,4333,16315,11982,341,1219
56839.0,PIUMA,2554,22,447,4,2166,2004,304,529,0,2232,10262,8030,304,529
56855.0,PRESIDENTE KENNEDY,998,10,221,1,2868,496,133,439,0,1314,6480,5166,133,439
56871.0,RIO NOVO DO SUL,2631,19,310,3,1878,1818,371,566,0,1374,8970,7596,371,566
56898.0,SANTA LEOPOLDINA,2262,28,508,7,1177,2353,291,625,0,1208,8459,7251,291,625
56910.0,SANTA TERESA,3994,140,1088,5,1597,5571,527,1183,0,2895,17000,14105,527,1183
56936.0,SAO GABRIEL DA PALHA,7273,40,944,3,2470,3161,425,1183,0,3518,19017,15499,425,1183
56952.0,SAO JOSE DO CALCADO,1699,37,428,5,2605,1007,265,816,0,1934,8796,6862,265,816
56979.0,SAO MATEUS,22647,108,2658,27,9982,6431,1019,2778,0,12558,58208,45650,1019,2778
56995.0,SERRA,80470,701,7989,138,45694,16501,3611,7997,0,31661,194762,163101,3611,7997
57010.0,VIANA,14548,175,1548,21,10117,5036,966,1549,0,7002,40962,33960,966,1549
57037.0,VILA VELHA,84800,1094,15370,179,55254,30472,4153,7093,0,34816,233231,198415,4153,7093
57053.0,VITORIA,83795,863,16801,158,42091,37143,3595,5495,0,33631,223572,189941,3595,5495
57070.0,MARILANDIA,3081,35,353,2,619,2124,327,525,0,1150,8216,7066,327,525
57096.0,IBATIBA,2073,30,408,3,3405,3651,291,816,0,2854,13531,10677,291,816
57118.0,RIO BANANAL,4863,49,328,0,1208,2927,411,773,0,2283,12842,10559,411,773
57134.0,JAGUARE,5998,22,304,8,1109,2218,446,914,0,2336,13355,11019,446,914
57150.0,PEDRO CANARIO,5335,17,477,6,2522,1972,504,1588,0,6161,18582,12421,504,1588
57916.0,LARANJA DA TERRA,2029,46,471,3,845,2930,303,564,0,1251,8442,7191,303,564
57932.0,SANTA MARIA DO JETIBA,5784,53,1398,3,2491,4966,531,1107,0,1914,18247,16333,531,1107
57959.0,VARGEM ALTA,3886,61,494,8,1677,2839,357,455,0,1878,11655,9777,357,455
57975.0,VENDA NOVA DO IMIGRANTE,3056,79,508,8,736,3876,352,920,0,1525,11060,9535,352,920
57991.0,AGUIA BRANCA,2369,14,234,2,709,1325,189,516,0,1345,6703,5358,189,516
58009.0,QUISSAMA,2523,13,267,3,5067,601,220,433,0,1729,10856,9127,220,433
58017.0,ANGRA DOS REIS,20415,233,3672,14,37092,4820,1394,2825,0,12021,82486,70465,1394,2825
58025.0,QUATIS,2616,32,328,2,2287,567,163,492,0,917,7404,6487,163,492
58033.0,ARARUAMA,11387,245,3268,19,27260,4135,997,2462,0,10315,60088,49773,997,2462
58041.0,BELFORD ROXO,58067,1089,7493,71,127549,7072,3452,9075,0,34517,248385,213868,3452,9075
58050.0,BARRA DO PIRAI,23447,423,2928,17,22560,3857,869,2175,0,7671,63947,56276,869,2175
58068.0,CARDOSO MOREIRA,1283,16,264,3,5172,1049,173,571,0,2286,10817,8531,173,571
58076.0,BARRA MANSA,45154,877,5428,40,37013,7575,1754,4561,0,14086,116488,102402,1754,4561
58084.0,VARRE E SAI,661,47,170,2,3105,1038,155,317,0,1077,6572,5495,155,317
58092.0,BOM JARDIM,5480,142,1119,7,3331,2811,601,1479,0,2740,17710,14970,601,1479
58106.0,GUAPIMIRIM,6183,65,1156,4,11940,1190,369,1244,0,4227,26378,22151,369,1244
58114.0,BOM JESUS DO ITABAPOANA,2771,86,1000,6,13385,3590,452,1679,0,5168,28137,22969,452,1679
58122.0,QUEIMADOS,11901,235,1620,18,45021,1372,799,2720,0,11534,75220,63686,799,2720
58130.0,CABO FRIO,18435,301,4227,11,35155,5156,1118,2309,0,12835,79547,66712,1118,2309
58149.0,JAPERI,6969,116,889,9,31067,1023,685,2357,0,7513,50628,43115,685,2357
58157.0,CACHOEIRAS DE MACACU,8390,156,1683,8,13203,2107,740,1625,0,5083,32995,27912,740,1625
58165.0,COMENDADOR LEVY GASPARIAN,2154,28,292,1,2624,268,106,271,0,815,6559,5744,106,271
58173.0,CAMBUCI,1178,16,307,2,6264,630,208,825,0,1478,10908,9430,208,825
58181.0,APERIBE,996,15,263,2,3678,571,155,398,0,1072,7150,6078,155,398
58190.0,CAMPOS,81003,931,8592,89,111433,18231,6030,10723,0,46832,283864,237032,6030,10723
58203.0,RIO DAS OSTRAS,5438,88,1177,5,8373,1784,379,790,0,3438,21472,18034,379,790
58211.0,CANTAGALO,3842,52,1121,7,5375,1981,407,904,0,1520,15209,13689,407,904
58220.0,AREAL,2190,43,825,4,2553,1255,169,475,0,1063,8577,7514,169,475
58238.0,CARMO,3924,64,782,5,3687,1266,226,719,0,1918,12591,10673,226,719
58246.0,PINHEIRAL,4422,76,846,1,4112,739,160,425,0,1409,12190,10781,160,425
58254.0,CASIMIRO DE ABREU,4239,37,854,2,7944,1279,249,655,0,3072,18331,15259,249,655
58262.0,IGUABA GRANDE,2669,47,812,2,6023,934,140,439,0,2532,13598,11066,140,439
58270.0,CONCEICAO DE MACABU,3307,36,473,3,6399,937,294,757,0,2521,14727,12206,294,757
58289.0,SAO FRANCISCO DE ITABAPOANA,2750,49,983,6,14957,2238,763,1968,0,7538,31252,23714,763,1968
58297.0,CORDEIRO,3996,53,768,2,4355,1209,270,652,0,1847,13152,11305,270,652
58300.0,CARAPEBUS,2141,20,221,2,2535,904,213,314,0,1330,7680,6350,213,314
58319.0,DUAS BARRAS,1863,44,384,0,2311,1319,192,643,0,1448,8204,6756,192,643
58327.0,PORTO REAL,2863,37,291,0,2585,569,155,389,0,841,7730,6889,155,389
58335.0,DUQUE DE CAXIAS,151662,2559,22869,184,214189,19415,7429,17927,0,70652,506886,436234,7429,17927
58343.0,SAO JOSE DE UBA,426,5,139,0,2939,717,84,427,0,803,5540,4737,84,427
58351.0,ENGENHEIRO PAULO DE FRONTIN,2915,45,367,2,5424,521,170,494,0,1726,11664,9938,170,494
58360.0,TANGUA,2882,38,547,2,9994,685,242,854,0,2306,17550,15244,242,854
58378.0,ITABORAI,22194,487,4431,42,58205,4752,1879,4427,0,14426,110843,96417,1879,4427
58386.0,MACUCO,2023,11,224,0,1534,972,80,288,0,948,6080,5132,80,288
58394.0,ITAGUAI,13185,270,2953,16,30608,3393,907,2135,0,8628,62095,53467,907,2135
58408.0,ARMACAO DE BUZIOS,2721,29,940,1,6888,1033,147,430,0,2205,14394,12189,147,430
58416.0,ITAOCARA,2106,44,739,4,9155,1617,402,1073,0,3347,18487,15140,402,1073
58424.0,SEROPEDICA,8677,178,1221,8,18564,1683,473,1423,0,5081,37308,32227,473,1423
58432.0,ITAPERUNA,12743,279,3155,14,28091,6131,1267,3046,0,10796,65522,54726,1267,3046
58440.0,ITATIAIA,7480,140,1371,1,3672,1746,349,752,0,2514,18025,15511,349,752
58459.0,LAJE DO MURIAE,1246,23,233,2,2427,594,196,506,0,1064,6291,5227,196,506
58467.0,MESQUITA,29516,527,4569,55,52571,3460,1407,3565,0,13907,109577,95670,1407,3565
58475.0,MACAE,31972,310,3806,20,22298,8933,2066,3232,0,13171,85808,72637,2066,3232
58491.0,MAGE,32801,460,4704,37,61632,4727,1809,4925,0,17439,128534,111095,1809,4925
58513.0,MANGARATIBA,5961,94,1519,6,7070,1441,265,752,0,2031,19139,17108,265,752
58530.0,MARICA,11770,206,2812,19,23025,2567,680,1968,0,8298,51345,43047,680,1968
58556.0,MENDES,4745,73,636,3,5219,863,206,661,0,2080,14486,12406,206,661
58572.0,MIGUEL PEREIRA,3860,84,981,4,7961,1246,263,670,0,1326,16395,15069,263,670
58599.0,MIRACEMA,4245,83,1085,5,6943,1976,516,1295,0,4193,20341,16148,516,1295
58610.0,NATIVIDADE,1538,33,455,3,5504,1014,191,780,0,2178,11696,9518,191,780
58637.0,NILOPOLIS,44486,984,7866,80,59392,5755,2025,4601,0,18890,144079,125189,2025,4601
58653.0,NITEROI,153401,2391,37578,178,90733,30278,4943,11831,0,51661,382994,331333,4943,11831
58670.0,NOVA FRIBURGO,47342,727,7724,45,30349,13178,3236,5625,0,16346,124572,108226,3236,5625
58696.0,NOVA IGUACU,98012,2185,17303,150,233936,16540,6291,15275,0,63802,453494,389692,6291,15275
58718.0,PARACAMBI,6375,129,1063,13,15443,1298,429,1145,0,3628,29523,25895,429,1145
58734.0,PARAIBA DO SUL,8181,161,1433,15,11903,1511,427,1221,0,4154,29006,24852,427,1221
58750.0,PARATI,4469,77,645,5,6349,2442,441,932,0,3066,18426,15360,441,932
58777.0,PETROPOLIS,74644,1775,14516,85,59069,24344,3688,6161,0,23595,207877,184282,3688,6161
58793.0,PIRAI,4875,65,510,5,9304,824,192,646,0,2798,19219,16421,192,646
58815.0,PORCIUNCULA,2245,25,344,0,4913,931,210,864,0,2635,12167,9532,210,864
58831.0,RESENDE,25337,434,6691,25,15537,6886,1514,2866,0,11974,71264,59290,1514,2866
58858.0,RIO BONITO,7067,145,2293,11,17262,3342,544,1786,0,5074,37524,32450,544,1786
58874.0,RIO CLARO,2792,44,365,2,5794,645,264,729,0,1748,12383,10635,264,729
58890.0,RIO DAS FLORES,1136,16,217,1,2760,190,87,326,0,360,5093,4733,87,326
58912.0,SANTA MARIA MADALENA,1169,14,222,2,4592,376,133,533,0,1999,9040,7041,133,533
58939.0,SANTO ANTONIO DE PADUA,5262,53,870,3,13429,1851,448,1288,0,4685,27889,23204,448,1288
58955.0,SAO FIDELIS,3426,73,827,7,14670,2659,515,1519,0,5644,29340,23696,515,1519
58971.0,SAO GONCALO,160165,3588,30877,256,236597,22579,8840,20940,0,77563,561405,483842,8840,20940
58998.0,SAO JOAO DA BARRA,4936,69,863,4,9003,3055,660,1315,0,5091,24996,19905,660,1315
59013.0,SAO JOAO DE MERITI,91348,1681,13612,118,144470,11118,4676,10663,0,42664,320350,277686,4676,10663
59030.0,SAO PEDRO DA ALDEIA,7690,164,2377,11,22024,1967,547,1370,0,6772,42922,36150,547,1370
59056.0,SAO SEBASTIAO DO ALTO,1067,19,256,2,2104,1485,175,525,0,753,6386,5633,175,525
59072.0,SAPUCAIA,3441,63,755,1,5206,1230,274,901,0,1306,13177,11871,274,901
59099.0,SAQUAREMA,7882,114,2834,7,17015,2627,663,1997,0,7091,40230,33139,663,1997
59110.0,SILVA JARDIM,1743,33,420,6,7424,685,203,814,0,2429,13757,11328,203,814
59137.0,SUMIDOURO,1510,20,512,0,4638,1857,298,748,0,1719,11302,9583,298,748
59153.0,TERESOPOLIS,30020,709,6255,34,29098,16266,2503,4588,0,13813,103286,89473,2503,4588
59170.0,TRAJANO DE MORAIS,1202,19,221,1,4253,487,167,717,0,1710,8777,7067,167,717
59196.0,TRES RIOS,16221,329,2775,15,20467,2874,809,2041,0,6588,52119,45531,809,2041
59218.0,VALENCA,20933,298,3173,16,13319,3495,1094,2558,0,6780,51666,44886,1094,2558
59234.0,VASSOURAS,5505,127,1141,18,10441,2227,364,1114,0,3667,24604,20937,364,1114
59250.0,VOLTA REDONDA,91904,1124,8080,64,47452,10077,2077,4823,0,22025,187626,165601,2077,4823
59277.0,ARRAIAL DO CABO,5866,65,1449,0,7495,1074,294,420,0,3258,19921,16663,294,420
59293.0,ITALVA,1395,27,483,0,5184,842,198,398,0,2410,10937,8527,198,398
59315.0,PATI DO ALFERES,2559,75,712,6,10129,730,199,845,0,2764,18019,15255,199,845
59331.0,SAO JOSE DO VALE DO RIO PRETO,1994,48,648,4,5380,1801,198,376,0,1360,11809,10449,198,376
60011.0,RIO DE JANEIRO,1625333,29684,365556,2711,1052539,367992,66134,153131,0,664401,4327481,3663080,66134,153131
61000.0,EUCLIDES DA CUNHA PAULISTA,2359,11,343,0,435,1650,151,477,0,2010,7436,5426,151,477
61018.0,ADAMANTINA,6720,59,3168,2,1218,6527,1225,1137,0,5194,25250,20056,1225,1137
61026.0,BOREBI,369,2,59,1,187,608,22,54,0,236,1538,1302,22,54
61034.0,ADOLFO,947,5,77,0,210,731,127,156,0,355,2608,2253,127,156
61042.0,TARUMA,3141,11,353,0,903,1610,226,366,0,1356,7966,6610,226,366
61050.0,AGUAI,6898,52,1253,7,2314,3725,704,1341,0,3496,19790,16294,704,1341
61069.0,MOTUCA,1195,7,101,0,222,685,89,139,0,586,3024,2438,89,139
61077.0,AGUAS DA PRATA,1789,20,406,2,361,1489,157,252,0,1037,5513,4476,157,252
61085.0,IARAS,552,7,84,0,99,655,37,119,0,503,2056,1553,37,119
61093.0,AGUAS DE LINDOIA,2713,31,791,4,742,3018,369,695,0,2323,10686,8363,369,695
61107.0,GUATAPARA,947,9,229,0,344,1178,146,176,0,1065,4094,3029,146,176
61115.0,AGUAS DE SAO PEDRO,504,8,254,1,79,797,41,52,0,284,2020,1736,41,52
61123.0,DIRCE REIS,457,5,41,0,76,450,91,73,0,189,1382,1193,91,73
61131.0,AGUDOS,7445,75,1428,10,4894,3467,703,1468,0,4034,23524,19490,703,1468
61140.0,ESPIRITO SANTO DO TURVO,806,2,113,0,122,812,98,114,0,781,2848,2067,98,114
61158.0,ALFREDO MARCONDES,897,7,246,0,223,866,144,194,0,287,2864,2577,144,194
61166.0,ROSANA,6191,35,998,1,1603,2442,319,870,0,4616,17075,12459,319,870
61174.0,ALTAIR,788,13,269,1,237,520,117,152,0,738,2835,2097,117,152
61182.0,EMBAUBA,857,6,103,2,241,366,142,113,0,519,2349,1830,142,113
61190.0,ALTINOPOLIS,4552,40,634,0,829,2546,450,582,0,1971,11604,9633,450,582
61204.0,ILHA SOLTEIRA,6023,57,1649,1,2803,2733,535,948,0,3865,18614,14749,535,948
61212.0,ALTO ALEGRE,963,9,194,0,330,952,178,235,0,321,3182,2861,178,235
61220.0,ALUMINIO,5538,105,646,3,1207,2118,313,490,0,2052,12472,10420,313,490
61239.0,ALVARES FLORENCE,990,3,275,1,191,1189,210,248,0,810,3917,3107,210,248
61247.0,PEDRINHAS PAULISTA,718,7,138,0,90,737,42,121,0,418,2271,1853,42,121
61255.0,ALVARES MACHADO,5070,32,820,0,911,3104,507,710,0,2477,13631,11154,507,710
61263.0,ARACARIGUAMA,1998,18,842,1,1286,1857,266,585,0,1958,8811,6853,266,585
61271.0,ALVARO DE CARVALHO,550,1,113,0,161,832,124,262,0,390,2433,2043,124,262
61280.0,BERTIOGA,6632,88,2536,3,2373,4665,428,1044,0,5116,22885,17769,428,1044
61298.0,ALVINLANDIA,582,2,93,2,318,540,52,143,0,350,2082,1732,52,143
61301.0,SUZANOPOLIS,697,3,56,0,116,529,174,173,0,503,2251,1748,174,173
61310.0,AMERICANA,61410,483,8362,64,16088,27151,3402,3932,0,16629,137521,120892,3402,3932
61328.0,SANTO ANTONIO DO ARACANGUA,1934,2,167,1,483,1245,105,220,0,1032,5189,4157,105,220
61336.0,AMERICO BRASILIENSE,9291,66,758,1,1779,2773,677,1026,0,3425,19796,16371,677,1026
61344.0,CANITAR,836,6,120,0,314,559,123,238,0,535,2731,2196,123,238
61352.0,AMERICO DE CAMPOS,1051,10,375,1,340,1566,191,205,0,541,4280,3739,191,205
61360.0,BARRA DO CHAPEU,684,2,42,0,126,1723,188,243,0,837,3845,3008,188,243
61379.0,AMPARO,12711,267,3203,21,3357,12688,1517,2244,0,5970,41978,36008,1517,2244
61387.0,EMILIANOPOLIS,913,4,136,0,211,367,86,167,0,270,2154,1884,86,167
61395.0,ANALANDIA,768,2,177,0,341,1064,82,129,0,778,3341,2563,82,129
61409.0,NOVAIS,757,3,115,0,197,1064,66,169,0,385,2756,2371,66,169
61417.0,ANDRADINA,12338,139,2338,9,4127,9703,1612,1775,0,8169,40210,32041,1612,1775
61425.0,NOVA CANAA PAULISTA,459,3,52,0,112,659,88,100,0,222,1695,1473,88,100
61433.0,ANGATUBA,5027,43,470,2,754,3245,336,718,0,2603,13198,10595,336,718
61441.0,SALTINHO,1323,8,645,3,313,1570,196,185,0,260,4503,4243,196,185
61450.0,ANHEMBI,961,5,166,0,208,1053,109,189,0,910,3601,2691,109,189
61468.0,UBARANA,1276,11,97,0,220,726,132,166,0,817,3445,2628,132,166
61476.0,ANHUMAS,993,2,158,0,165,497,79,99,0,262,2255,1993,79,99
61484.0,CAJATI,4633,48,427,4,3592,3867,425,1168,0,4192,18356,14164,425,1168
61492.0,APARECIDA,8660,171,2026,5,1604,5348,587,702,0,1460,20563,19103,587,702
61506.0,CAMPINA DO MONTE ALEGRE,1142,10,175,2,235,1019,102,151,0,664,3500,2836,102,151
61514.0,APARECIDA D OESTE,938,12,138,0,209,1394,188,136,0,549,3564,3015,188,136
61522.0,ASPASIA,514,2,61,0,82,496,81,113,0,439,1788,1349,81,113
61530.0,APIAI,4153,37,544,1,1459,5833,786,1186,0,4613,18612,13999,786,1186
61549.0,VARGEM,1466,14,226,4,489,1231,209,418,0,1238,5295,4057,209,418
61557.0,ARACATUBA,33288,261,5904,33,14800,37324,2958,4470,0,20724,119762,99038,2958,4470
61565.0,POTIM,3584,59,461,1,817,1810,156,425,0,1345,8658,7313,156,425
61573.0,ARACOIABA DA SERRA,4970,47,1179,3,1313,5157,522,692,0,2971,16854,13883,522,692
61581.0,ALAMBARI,552,9,164,0,160,1124,100,119,0,532,2760,2228,100,119
61590.0,ARAMINA,1328,6,325,1,170,685,161,209,0,382,3267,2885,161,209
61603.0,ITAOCA,643,2,35,0,116,782,170,172,0,968,2888,1920,170,172
61611.0,ARANDU,1073,10,328,0,341,837,148,269,0,368,3374,3006,148,269
61620.0,TUIUTI,1106,12,241,1,299,1101,227,237,0,784,4008,3224,227,237
61638.0,ARARAQUARA,48422,804,8242,30,9158,30922,4083,5250,0,18070,124981,106911,4083,5250
61646.0,ARAPEI,613,6,119,0,331,392,39,172,0,298,1970,1672,39,172
61654.0,ARARAS,27909,345,4890,16,9775,15910,2520,2927,0,8762,73054,64292,2520,2927
61662.0,ESTIVA GERBI,2842,14,461,0,689,933,211,215,0,812,6177,5365,211,215
61670.0,AREALVA,1324,11,261,1,324,1681,376,266,0,553,4797,4244,376,266
61689.0,ENGENHEIRO COELHO,1882,8,282,2,975,1581,158,342,0,1347,6577,5230,158,342
61697.0,AREIAS,780,49,155,4,302,708,61,199,0,601,2859,2258,61,199
61700.0,RIBEIRAO GRANDE,2189,15,138,3,354,1054,314,403,0,761,5231,4470,314,403
61719.0,AREIOPOLIS,2323,12,291,2,965,1156,325,514,0,1347,6935,5588,325,514
61727.0,HORTOLANDIA,40000,319,3571,24,10964,10048,1854,2911,0,13674,83365,69691,1854,2911
61735.0,ARIRANHA,2549,20,518,2,430,686,321,413,0,916,5855,4939,321,413
61743.0,HOLAMBRA,2520,15,185,2,508,2247,202,278,0,1039,6996,5957,202,278
61751.0,ARTUR NOGUEIRA,8826,48,1192,3,2777,3801,778,906,0,3586,21917,18331,778,906
61760.0,ELISIARIO,533,5,98,0,228,658,61,101,0,137,1821,1684,61,101
61778.0,ARUJA,13891,268,3959,10,5643,8449,1183,1931,0,7728,43062,35334,1183,1931
61786.0,BOM SUCESSO DE ITARARE,707,2,52,1,151,688,41,124,0,599,2365,1766,41,124
61794.0,ASSIS,22402,195,3646,11,7371,11624,1674,2358,0,11285,60566,49281,1674,2358
61808.0,PONTALINDA,904,9,93,1,144,656,124,113,0,607,2651,2044,124,113
61816.0,ATIBAIA,16712,347,6048,14,8238,23247,2567,3729,0,12455,73357,60902,2567,3729
61824.0,PARISI,529,4,104,0,91,451,46,80,0,198,1503,1305,46,80
61832.0,AURIFLAMA,3829,20,454,2,1157,2355,332,533,0,2359,11041,8682,332,533
61840.0,TAQUARIVAI,793,6,166,1,303,928,100,141,0,777,3215,2438,100,141
61859.0,AVAI,1197,3,243,1,596,682,118,112,0,688,3640,2952,118,112
61867.0,MARAPOAMA,487,7,148,1,136,647,96,124,0,374,2020,1646,96,124
61875.0,AVANHANDAVA,1882,9,529,1,917,1318,202,313,0,1265,6436,5171,202,313
61883.0,SAO JOAO DE IRACEMA,467,0,273,0,58,219,58,74,0,237,1386,1149,58,74
61891.0,AVARE,15227,187,4586,10,5501,11254,1437,2470,0,8062,48734,40672,1437,2470
61905.0,SAO LOURENCO DA SERRA,1819,24,409,1,510,2559,241,437,0,1497,7497,6000,241,437
61913.0,BADY BASSIT,2596,26,738,2,572,2153,382,363,0,1444,8276,6832,382,363
61921.0,ZACARIAS,642,5,72,0,102,368,51,113,0,438,1791,1353,51,113
61930.0,BALBINOS,247,2,108,0,100,345,73,67,0,132,1074,942,73,67
61948.0,ITAPIRAPUA PAULISTA,626,2,36,1,196,937,143,250,0,726,2917,2191,143,250
61956.0,BALSAMO,1704,12,392,4,416,1625,316,307,0,1206,5982,4776,316,307
61964.0,MESOPOLIS,338,0,145,0,189,372,104,50,0,218,1416,1198,104,50
61972.0,BANANAL,2113,32,381,0,1212,1406,186,556,0,780,6666,5886,186,556
61980.0,NOVA CAMPINA,1063,7,240,1,1069,1172,161,383,0,850,4946,4096,161,383
61999.0,BARBOSA,1244,8,295,0,644,919,129,317,0,1078,4634,3556,129,317
62006.0,ILHA COMPRIDA,1224,15,424,3,397,1891,108,181,0,1181,5424,4243,108,181
62014.0,BARAO DE ANTONINA,510,15,72,0,235,587,86,158,0,423,2086,1663,86,158
62022.0,LOURDES,361,0,102,0,107,638,51,109,0,317,1685,1368,51,109
62030.0,BARIRI,7177,71,916,8,1528,5025,1296,1153,0,3420,20594,17174,1296,1153
62049.0,TORRE DE PEDRA,492,6,87,1,334,421,73,96,0,392,1902,1510,73,96
62057.0,BARRA BONITA,11167,128,1944,9,1941,5056,1034,1347,0,3906,26532,22626,1034,1347
62065.0,ARCO IRIS,570,4,126,3,187,734,68,114,0,554,2360,1806,68,114
62073.0,BARRA DO TURVO,1335,6,212,0,716,1240,95,562,0,2173,6339,4166,95,562
62081.0,BREJO ALEGRE,792,2,48,0,132,383,63,120,0,362,1902,1540,63,120
62090.0,BARRETOS,23833,240,5507,11,5752,19758,1687,2666,0,12006,71460,59454,1687,2666
62103.0,CANAS,762,8,149,1,254,713,70,105,0,384,2446,2062,70,105
62111.0,BARRINHA,6464,60,696,0,1538,2619,676,964,0,3901,16918,13017,676,964
62120.0,PRACINHA,293,0,40,1,81,426,37,87,0,321,1286,965,37,87
62138.0,BARUERI,59296,690,17875,72,24046,24303,4817,7438,0,25884,164421,138537,4817,7438
62146.0,PRATANIA,798,4,113,0,224,920,103,217,0,630,3009,2379,103,217
62154.0,BASTOS,3685,28,619,0,1820,4969,664,698,0,3567,16050,12483,664,698
62162.0,QUADRA,601,6,180,0,192,633,78,114,0,606,2410,1804,78,114
62170.0,BATATAIS,9153,157,3898,11,2985,10743,1409,1794,0,5463,35613,30150,1409,1794
62189.0,SANTA CRUZ DA ESPERANCA,412,7,109,0,101,484,45,89,0,347,1594,1247,45,89
62197.0,BAURU,83630,951,16511,101,26704,35691,5393,7589,0,31364,207934,176570,5393,7589
62200.0,SANTA SALETE,467,3,66,0,72,411,65,62,0,280,1426,1146,65,62
62219.0,BEBEDOURO,13707,195,4060,7,6622,13180,1634,1949,0,9928,51282,41354,1634,1949
62227.0,VITORIA BRASIL,542,3,69,1,46,451,100,87,0,332,1631,1299,100,87
62235.0,BENTO DE ABREU,581,2,49,0,114,784,49,90,0,409,2078,1669,49,90
62243.0,IPIGUA,911,3,320,0,161,777,113,88,0,591,2964,2373,113,88
62251.0,BERNADINO DE CAMPOS,2722,16,255,1,790,1953,184,312,0,1450,7683,6233,184,312
62260.0,TAQUARAL,855,10,150,0,67,284,75,112,0,342,1895,1553,75,112
62278.0,BILAC,1218,6,172,0,321,1805,203,300,0,494,4519,4025,203,300
62286.0,FERNAO,402,2,62,1,94,315,30,85,0,290,1281,991,30,85
62294.0,BIRIGUI,21097,188,4053,22,6666,16617,2967,3300,0,8536,63446,54910,2967,3300
62308.0,GAVIAO PEIXOTO,1032,5,143,0,260,684,72,127,0,500,2823,2323,72,127
62316.0,BIRITIBA MIRIM,4231,71,1221,3,1931,4653,673,988,0,3440,17211,13771,673,988
62324.0,JUMIRIM,396,2,80,1,103,675,40,50,0,222,1569,1347,40,50
62332.0,BOA ESPERANCA DO SUL,3510,28,433,2,650,1636,451,583,0,1756,9049,7293,451,583
62340.0,NANTES,397,3,89,0,123,559,44,139,0,475,1829,1354,44,139
62359.0,BOCAINA,2816,23,377,1,367,1606,299,287,0,1068,6844,5776,299,287
62367.0,NOVA CASTILHO,315,2,103,0,94,346,24,50,0,275,1209,934,24,50
62375.0,BOFETE,1410,9,281,0,592,1406,217,426,0,1758,6099,4341,217,426
62383.0,OUROESTE,1641,10,235,0,242,1301,263,289,0,1327,5308,3981,263,289
62391.0,BOITUVA,6365,88,1421,4,2688,7337,954,1334,0,4115,24306,20191,954,1334
62405.0,PAULISTANIA,336,2,59,0,100,528,44,94,0,354,1517,1163,44,94
62413.0,BOM JESUS DOS PERDOES,2302,39,911,4,866,3020,354,649,0,1736,9881,8145,354,649
62421.0,RIBEIRAO DOS INDIOS,641,4,105,1,64,446,112,159,0,361,1893,1532,112,159
62430.0,BORA,242,1,46,0,167,252,46,76,0,247,1077,830,46,76
62448.0,TRABIJU,527,2,50,0,62,263,34,83,0,297,1318,1021,34,83
62456.0,BORACEIA,1360,9,339,0,233,458,183,120,0,673,3375,2702,183,120
62472.0,BORBOREMA,3233,68,770,2,811,1695,661,739,0,1861,9840,7979,661,739
62499.0,BOTUCATU,25478,312,5436,21,8503,16597,2321,3584,0,11032,73284,62252,2321,3584
62510.0,BRAGANCA PAULISTA,27779,377,5619,16,10832,22383,2849,4188,0,12268,86311,74043,2849,4188
62553.0,BRAUNA,706,5,359,1,268,1095,202,170,0,308,3114,2806,202,170
62570.0,BRODOWSKI,3441,74,1333,1,970,3403,466,637,0,2019,12344,10325,466,637
62596.0,BROTAS,3880,43,755,6,917,4003,599,861,0,2310,13374,11064,599,861
62618.0,BURI,3155,18,488,0,1162,3040,404,556,0,2316,11139,8823,404,556
62634.0,BURITAMA,2857,20,531,3,889,2782,448,754,0,2211,10495,8284,448,754
62650.0,BURITIZAL,692,11,121,1,309,717,88,182,0,384,2505,2121,88,182
62677.0,CABRALIA PAULISTA,1301,12,152,2,430,400,162,231,0,701,3391,2690,162,231
62693.0,CABREUVA,7080,53,1299,3,2116,4741,595,983,0,3554,20424,16870,595,983
62715.0,CACAPAVA,20472,434,4634,24,5945,12028,1484,2161,0,6098,53280,47182,1484,2161
62731.0,CACHOEIRA PAULISTA,8318,139,1227,8,2451,2929,518,895,0,3162,19647,16485,518,895
62758.0,CACONDE,2685,32,487,0,489,4759,392,789,0,2481,12114,9633,392,789
62774.0,CAFELANDIA,3318,48,821,5,854,3348,457,521,0,2378,11750,9372,457,521
62790.0,CAIABU,1026,12,265,1,248,656,188,234,0,418,3048,2630,188,234
62812.0,CAIEIRAS,16097,303,3333,7,6740,8141,1378,2138,0,5277,43414,38137,1378,2138
62839.0,CAIUA,883,6,105,1,179,972,44,162,0,340,2692,2352,44,162
62855.0,CAJAMAR,14258,137,3422,5,4604,4307,848,1513,0,3734,32828,29094,848,1513
62871.0,CAJOBI,2364,13,527,0,826,1239,383,441,0,1544,7337,5793,383,441
62898.0,CAJURU,4754,77,825,3,1111,3634,548,969,0,3080,15001,11921,548,969
62910.0,CAMPINAS,274766,3345,42197,244,66566,130802,13228,21452,0,103996,656596,552600,13228,21452
62936.0,CAMPO LIMPO PAULISTA,18827,244,2361,11,5891,7954,960,1995,0,6592,44835,38243,960,1995
62952.0,CAMPOS DO JORDAO,7233,229,1960,13,3961,9583,1308,1394,0,5921,31602,25681,1308,1394
62979.0,CAMPOS NOVOS PAULISTA,721,4,318,0,295,828,168,206,0,876,3416,2540,168,206
62995.0,CANANEIA,1912,16,447,0,1018,2411,174,401,0,1915,8294,6379,174,401
63010.0,CANDIDO MOTA,6756,77,1371,0,2035,4841,1092,1203,0,4245,21620,17375,1092,1203
63037.0,CANDIDO RODRIGUES,756,3,215,3,135,383,168,135,0,264,2062,1798,168,135
63053.0,CAPAO BONITO,9952,74,1699,6,2778,7690,1288,2164,0,6628,32279,25651,1288,2164
63070.0,CAPELA DO ALTO,2293,17,598,1,605,3393,411,410,0,1653,9381,7728,411,410
63096.0,CAPIVARI,7389,107,1939,6,3175,7196,985,1395,0,4542,26734,22192,985,1395
63118.0,CARAGUATATUBA,15308,219,3614,7,7001,11967,1413,2375,0,10664,52568,41904,1413,2375
63134.0,CARAPICUIBA,93481,1048,13914,72,25389,37565,5499,7058,0,32963,216989,184026,5499,7058
63150.0,CARDOSO,2886,18,969,1,655,1530,440,486,0,2773,9758,6985,440,486
63177.0,CASA BRANCA,5540,74,1484,9,1363,4254,690,1185,0,3237,17836,14599,690,1185
63193.0,CASSIA DOS COQUEIROS,611,8,111,1,128,1088,81,176,0,718,2922,2204,81,176
63215.0,CASTILHO,4136,23,820,1,903,1885,430,718,0,2995,11911,8916,430,718
63231.0,CATANDUVA,22820,367,6976,16,7240,16768,2460,3306,0,8980,68933,59953,2460,3306
63258.0,CATIGUA,1967,15,324,1,653,1002,299,459,0,757,5477,4720,299,459
63274.0,CEDRAL,1715,15,364,1,335,1350,254,272,0,913,5219,4306,254,272
63290.0,CERQUEIRA CESAR,2764,51,1009,2,944,2838,493,676,0,2105,10882,8777,493,676
63312.0,CERQUILHO,6845,99,1417,3,1663,6224,702,1088,0,2723,20764,18041,702,1088
63339.0,CESARIO LANGE,2089,22,574,0,888,2713,655,612,0,1614,9167,7553,655,612
63355.0,CHARQUEADA,3264,29,654,0,1201,2824,356,423,0,1536,10287,8751,356,423
63371.0,CHAVANTES,3257,30,510,3,1105,1576,320,436,0,1574,8811,7237,320,436
63398.0,CLEMENTINA,1229,9,663,0,268,868,145,248,0,904,4334,3430,145,248
63410.0,COLINA,3884,23,654,3,603,3441,456,547,0,2815,12426,9611,456,547
63436.0,COLOMBIA,1388,13,334,1,343,1132,141,304,0,1596,5252,3656,141,304
63452.0,CONCHAL,4076,55,882,1,1785,4489,1003,960,0,3091,16342,13251,1003,960
63479.0,CONCHAS,2982,28,612,5,640,3266,398,543,0,2144,10618,8474,398,543
63495.0,CORDEIROPOLIS,5129,77,1013,3,1192,2140,401,471,0,1494,11920,10426,401,471
63517.0,COROADOS,950,11,106,0,368,895,114,156,0,533,3133,2600,114,156
63533.0,CORONEL MACEDO,1476,7,128,0,182,1233,114,282,0,652,4074,3422,114,282
63550.0,CORUMBATAI,745,23,257,0,262,843,143,156,0,616,3045,2429,143,156
63576.0,COSMOPOLIS,13598,108,1485,6,5164,4456,1000,1202,0,4432,31451,27019,1000,1202
63592.0,COSMORAMA,1335,11,425,0,422,2096,330,222,0,1179,6020,4841,330,222
63614.0,COTIA,35552,514,7737,40,9460,19376,2487,3804,0,14423,93393,78970,2487,3804
63630.0,CRAVINHOS,5260,97,1313,4,1305,6238,742,1189,0,2878,19026,16148,742,1189
63657.0,CRISTAIS PAULISTA,1096,10,367,0,269,1661,95,184,0,995,4677,3682,95,184
63673.0,CRUZALIA,762,6,130,1,271,605,58,111,0,321,2265,1944,58,111
63690.0,CRUZEIRO,22090,356,3520,18,6879,8262,1167,2274,0,7171,51737,44566,1167,2274
63711.0,CUBATAO,36372,530,6872,39,12451,8937,1758,2982,0,11609,81550,69941,1758,2982
63738.0,CUNHA,2957,35,729,3,2848,4025,699,1235,0,4339,16870,12531,699,1235
63754.0,DESCALVADO,7149,94,1453,7,1473,5433,1145,1246,0,3285,21285,18000,1145,1246
63770.0,DIADEMA,124498,1349,13703,77,31904,27540,5299,9484,0,37106,250960,213854,5299,9484
63797.0,DIVINOLANDIA,1868,22,377,5,237,3349,510,642,0,2034,9044,7010,510,642
63819.0,DOBRADA,2063,13,310,2,542,760,188,336,0,1105,5319,4214,188,336
63835.0,DOIS CORREGOS,5519,52,1049,3,1305,3414,899,717,0,2489,15447,12958,899,717
63851.0,DOLCINOPOLIS,464,4,85,0,78,631,76,160,0,267,1765,1498,76,160
63878.0,DOURADO,2371,22,301,0,423,1489,449,351,0,1027,6433,5406,449,351
63894.0,DRACENA,7816,64,2263,2,2212,9417,1173,1564,0,6801,31312,24511,1173,1564
63916.0,DUARTINA,3692,38,676,2,946,1459,297,587,0,1979,9676,7697,297,587
63932.0,DUMONT,1593,16,289,3,334,1121,271,217,0,623,4467,3844,271,217
63959.0,ECHAPORA,1464,23,201,2,537,1127,146,317,0,1202,5019,3817,146,317
63975.0,ELDORADO,1651,11,581,0,1628,2495,206,879,0,2908,10359,7451,206,879
63991.0,ELIAS FAUSTO,2677,21,500,3,1048,2390,358,634,0,2318,9949,7631,358,634
64017.0,EMBU,45526,765,9933,37,18671,26235,4163,5937,0,19470,130737,111267,4163,5937
64033.0,EMBU GUACU,10552,167,3854,6,4621,8677,1298,1820,0,7966,38961,30995,1298,1820
64050.0,ESTRELA D OESTE,1963,14,452,3,452,1715,351,497,0,1215,6662,5447,351,497
64076.0,ESTRELA DO NORTE,477,4,178,1,173,524,57,140,0,311,1865,1554,57,140
64092.0,FARTURA,3331,32,564,7,443,3488,334,486,0,2471,11156,8685,334,486
64114.0,FERNANDOPOLIS,14194,112,2725,7,3029,12070,1669,1635,0,8390,43831,35441,1669,1635
64130.0,FERNANDO PRESTES,1552,13,319,3,183,882,360,250,0,554,4116,3562,360,250
64157.0,FERRAZ DE VASCONCELOS,31021,546,6159,24,13643,11507,2168,3415,0,14325,82808,68483,2168,3415
64173.0,FLORA RICA,621,4,132,1,130,335,43,115,0,318,1699,1381,43,115
64190.0,FLOREAL,912,11,198,1,81,648,176,139,0,351,2517,2166,176,139
64211.0,FLORIDA PAULISTA,1906,11,611,1,771,2339,461,443,0,1837,8380,6543,461,443
64238.0,FLORINEA,906,9,116,0,299,380,79,139,0,313,2241,1928,79,139
64254.0,FRANCA,57387,839,17629,31,19784,53411,4212,6184,0,23013,182490,159477,4212,6184
64270.0,FRANCISCO MORATO,24251,490,4116,36,12100,12893,2211,3090,0,12540,71727,59187,2211,3090
64297.0,FRANCO DA ROCHA,25234,787,5916,39,9860,10890,2240,3614,0,8888,67468,58580,2240,3614
64319.0,GABRIEL MONTEIRO,627,6,105,0,59,766,88,175,0,236,2062,1826,88,175
64335.0,GALIA,1510,3,302,1,398,1360,188,337,0,1224,5323,4099,188,337
64351.0,GARCA,7517,67,1497,4,2715,9201,1433,1482,0,6339,30255,23916,1433,1482
64378.0,GASTAO VIDIGAL,898,5,142,0,87,801,210,182,0,427,2752,2325,210,182
64394.0,GENERAL SALGADO,2667,20,482,0,513,2355,403,371,0,1707,8518,6811,403,371
64416.0,GETULINA,2453,17,431,0,642,1752,267,486,0,1890,7938,6048,267,486
64432.0,GLICERIO,1314,7,203,1,237,1197,118,188,0,862,4127,3265,118,188
64459.0,GUAICARA,2258,7,397,2,495,1045,246,341,0,1254,6045,4791,246,341
64475.0,GUAIMBE,940,11,210,0,339,942,121,290,0,497,3350,2853,121,290
64491.0,GUAIRA,7831,44,1306,4,1103,8277,823,790,0,5132,25310,20178,823,790
64513.0,GUAPIACU,3628,18,769,2,813,2952,526,526,0,2029,11263,9234,526,526
64530.0,GUAPIARA,3725,25,358,6,715,3448,441,1006,0,3427,13151,9724,441,1006
64556.0,GUARA,3900,27,1224,4,1408,2622,469,893,0,3067,13614,10547,469,893
64572.0,GUARACAI,1944,10,630,4,401,1551,362,467,0,1367,6736,5369,362,467
64599.0,GUARACI,1966,16,496,1,293,1946,145,283,0,1996,7142,5146,145,283
64610.0,GUARANI D OESTE,568,1,72,0,71,326,64,137,0,439,1678,1239,64,137
64637.0,GUARANTA,1069,12,248,0,492,1122,294,277,0,1014,4528,3514,294,277
64653.0,GUARARAPES,5236,40,1386,1,1959,6134,799,1139,0,4325,21019,16694,799,1139
64670.0,GUARAREMA,4210,59,1021,1,2018,4250,431,1022,0,3361,16373,13012,431,1022
64696.0,GUARATINGUETA,29598,458,6200,25,8103,15126,1800,2325,0,10072,73707,63635,1800,2325
64718.0,GUAREI,1978,23,485,2,639,1639,508,606,0,1409,7289,5880,508,606
64734.0,GUARIBA,9221,57,890,2,2289,4563,710,975,0,3987,22694,18707,710,975
64750.0,GUARUJA,64020,1037,20907,65,29201,22391,4603,7030,0,26784,176038,149254,4603,7030
64777.0,GUARULHOS,192677,5411,71287,319,92173,102587,15306,27415,0,85565,592740,507175,15306,27415
64793.0,GUZOLANDIA,913,4,172,1,204,1145,96,172,0,1053,3760,2707,96,172
64815.0,HERCULANDIA,1533,9,227,2,648,1694,147,432,0,1201,5893,4692,147,432
64831.0,IACANGA,1897,23,564,0,838,1443,283,297,0,1356,6701,5345,283,297
64858.0,IACRI,1521,10,307,0,387,1448,260,284,0,1212,5429,4217,260,284
64874.0,IBATE,6386,104,956,4,2311,2437,867,838,0,2539,16442,13903,867,838
64890.0,IBIRA,1606,17,466,3,453,2448,311,506,0,1259,7069,5810,311,506
64912.0,IBIRAREMA,1230,15,222,0,546,1345,267,275,0,981,4881,3900,267,275
64939.0,IBITINGA,11668,119,2520,4,3200,6715,1436,1901,0,5418,32981,27563,1436,1901
64955.0,IBIUNA,6905,106,1953,19,4010,16327,1307,2931,0,9161,42719,33558,1307,2931
64971.0,ICEM,2168,16,437,0,276,1090,139,371,0,1373,5870,4497,139,371
64998.0,IEPE,1418,15,401,0,486,1560,131,428,0,1431,5870,4439,131,428
65013.0,IGARACU DO TIETE,6607,77,953,3,1538,2329,1061,1112,0,2579,16259,13680,1061,1112
65030.0,IGARAPAVA,6711,58,1667,4,1235,3906,774,1004,0,4134,19493,15359,774,1004
65056.0,IGARATA,1738,42,610,3,623,2065,271,429,0,1476,7257,5781,271,429
65072.0,IGUAPE,4091,60,1451,6,2606,6314,520,1120,0,4402,20570,16168,520,1120
65099.0,ILHABELA,3150,34,755,2,1818,4069,288,523,0,2655,13294,10639,288,523
65110.0,INDAIATUBA,45138,549,6492,33,9559,16448,2753,3775,0,14956,99703,84747,2753,3775
65137.0,INDIANA,1324,5,243,1,269,1059,200,198,0,689,3988,3299,200,198
65153.0,INDIAPORA,767,8,254,2,194,905,98,130,0,485,2843,2358,98,130
65170.0,INUBIA PAULISTA,531,7,177,0,169,1070,85,172,0,507,2718,2211,85,172
65196.0,IPAUCU,3125,21,445,1,689,2222,301,340,0,1637,8781,7144,301,340
65218.0,IPERO,4361,31,652,2,1342,2348,343,509,0,2241,11829,9588,343,509
65234.0,IPEUNA,813,8,296,2,380,796,115,188,0,563,3161,2598,115,188
65250.0,IPORANGA,809,2,101,0,337,513,152,235,0,827,2976,2149,152,235
65277.0,IPUA,3124,13,420,2,366,1862,401,519,0,1547,8254,6707,401,519
65293.0,IRACEMAPOLIS,4092,61,582,1,1557,2884,251,459,0,1111,10998,9887,251,459
65315.0,IRAPUA,1155,18,195,0,481,1609,254,330,0,1188,5230,4042,254,330
65331.0,IRAPURU,1394,10,726,1,404,1316,247,334,0,1734,6166,4432,247,334
65358.0,ITABERA,4568,53,383,1,890,3204,519,598,0,2349,12565,10216,519,598
65374.0,ITAI,5194,35,855,1,814,3139,620,935,0,3209,14802,11593,620,935
65390.0,ITAJOBI,3092,33,940,1,657,3041,831,742,0,1996,11333,9337,831,742
65412.0,ITAJU,567,3,158,1,316,518,115,121,0,245,2044,1799,115,121
65439.0,ITANHAEM,14208,281,5173,18,5332,9902,1256,2159,0,11084,49413,38329,1256,2159
65455.0,ITAPECERICA DA SERRA,24950,376,5617,15,10055,19336,2440,3404,0,12059,78252,66193,2440,3404
65471.0,ITAPETININGA,28784,377,4980,26,7926,18926,3081,3619,0,11695,79414,67719,3081,3619
65498.0,ITAPEVA,19493,124,2549,11,5504,12385,1748,2112,0,9242,53168,43926,1748,2112
65510.0,ITAPEVI,36246,363,5096,22,13004,16223,2793,3809,0,15436,92992,77556,2793,3809
65536.0,ITAPIRA,18154,170,2546,7,4174,8957,2232,2620,0,6441,45301,38860,2232,2620
65552.0,ITAPOLIS,8781,83,2176,11,1808,5675,1675,1902,0,4876,26987,22111,1675,1902
65579.0,ITAPORANGA,2515,32,454,1,549,3665,545,607,0,3019,11387,8368,545,607
65595.0,ITAPUI,2911,17,423,2,472,1212,295,246,0,938,6516,5578,295,246
65617.0,ITAPURA,963,11,192,0,211,562,116,199,0,823,3077,2254,116,199
65633.0,ITAQUAQUECETUBA,46988,889,8338,32,21982,18884,4281,6365,0,24881,132640,107759,4281,6365
65650.0,ITARARE,8434,107,1445,3,4054,8072,1193,1461,0,6031,30800,24769,1193,1461
65676.0,ITARIRI,1479,19,584,1,886,2178,179,508,0,1712,7546,5834,179,508
65692.0,ITATIBA,17549,233,4420,13,5297,13940,2079,2280,0,7077,52888,45811,2079,2280
65714.0,ITATINGA,3361,13,569,1,843,2328,337,749,0,2319,10520,8201,337,749
65730.0,ITIRAPINA,2578,19,412,0,794,1872,330,309,0,1435,7749,6314,330,309
65757.0,ITIRAPUA,1196,8,438,0,240,1019,119,252,0,838,4110,3272,119,252
65773.0,ITOBI,1308,23,403,1,366,1472,263,397,0,955,5188,4233,263,397
65790.0,ITU,34749,377,6048,27,8451,20863,2394,3862,0,13296,90067,76771,2394,3862
65811.0,ITUPEVA,6678,72,830,3,2444,4474,648,741,0,3768,19658,15890,648,741
65838.0,ITUVERAVA,9234,62,1900,2,1770,6597,888,1153,0,4674,26280,21606,888,1153
65854.0,JABORANDI,1666,2,377,0,299,943,231,296,0,1030,4844,3814,231,296
65870.0,JABOTICABAL,13894,167,3368,9,4403,12009,1507,2062,0,8124,45543,37419,1507,2062
65897.0,JACAREI,49500,1268,11242,63,16653,22973,2671,4114,0,20346,128830,108484,2671,4114
65919.0,JACI,860,7,147,0,110,1177,149,146,0,412,3008,2596,149,146
65935.0,JACUPIRANGA,2671,21,514,3,1816,2992,232,690,0,2458,11397,8939,232,690
65951.0,JAGUARIUNA,8420,72,1203,4,1653,4617,782,927,0,3320,20998,17678,782,927
65978.0,JALES,11229,117,1852,3,2879,8663,1482,1377,0,6179,33781,27602,1482,1377
65994.0,JAMBEIRO,881,16,323,1,283,1196,73,210,0,590,3573,2983,73,210
66010.0,JANDIRA,19707,336,5007,22,10691,10918,1795,2350,0,10492,61318,50826,1795,2350
66036.0,JARDINOPOLIS,6207,87,1737,3,1649,4944,1005,1206,0,3720,20558,16838,1005,1206
66052.0,JARINU,2542,39,1289,2,941,3168,370,575,0,2440,11366,8926,370,575
66079.0,JAU,29507,377,4526,13,7499,18423,3509,2957,0,9709,76520,66811,3509,2957
66095.0,JERIQUARA,728,8,166,1,151,722,52,181,0,521,2530,2009,52,181
66117.0,JOANOPOLIS,1439,30,353,3,645,2876,371,492,0,1503,7712,6209,371,492
66133.0,JOAO RAMALHO,692,4,110,0,219,1079,81,171,0,627,2983,2356,81,171
66150.0,JOSE BONIFACIO,6449,57,1387,9,1099,5434,1115,1017,0,2926,19493,16567,1115,1017
66176.0,JULIO MESQUITA,1132,5,123,0,244,895,106,252,0,418,3175,2757,106,252
66192.0,JUNDIAI,107329,1162,13182,74,21294,48220,4666,8590,0,27276,231793,204517,4666,8590
66214.0,JUNQUEIROPOLIS,3231,30,858,4,960,3748,566,510,0,2937,12844,9907,566,510
66230.0,JUQUIA,2445,34,939,3,2760,3724,314,926,0,4138,15283,11145,314,926
66257.0,JUQUITIBA,3369,89,1127,2,2028,5717,610,1210,0,4165,18317,14152,610,1210
66273.0,LAGOINHA,1196,15,261,0,168,1889,197,334,0,771,4831,4060,197,334
66290.0,LARANJAL PAULISTA,4469,57,1065,7,1118,5368,723,846,0,2330,15983,13653,723,846
66311.0,LAVINIA,1370,1,175,1,193,1129,139,245,0,899,4152,3253,139,245
66338.0,LAVRINHAS,1697,16,312,1,438,1183,137,291,0,734,4809,4075,137,291
66354.0,LEME,23946,155,3310,10,4804,10140,1998,2248,0,7533,54144,46611,1998,2248
66370.0,LENCOIS PAULISTA,11891,132,2346,6,4823,8864,1627,1858,0,5084,36631,31547,1627,1858
66397.0,LIMEIRA,67895,439,8464,41,23387,32197,3922,5717,0,22486,164548,142062,3922,5717
66419.0,LINDOIA,1029,21,249,0,262,1576,133,320,0,874,4464,3590,133,320
66435.0,LINS,11520,153,5358,7,5855,12306,1367,1986,0,8437,46989,38552,1367,1986
66451.0,LORENA,21123,317,4074,7,6518,10624,1209,1729,0,9038,54639,45601,1209,1729
66478.0,LOUVEIRA,5360,68,975,4,2264,4810,608,679,0,2653,17421,14768,608,679
66494.0,LUCELIA,4151,53,712,4,569,4055,388,775,0,3185,13892,10707,388,775
66516.0,LUCIANOPOLIS,556,10,92,0,248,355,43,158,0,252,1714,1462,43,158
66532.0,LUIS ANTONIO,1900,13,373,2,468,1177,136,339,0,1196,5604,4408,136,339
66559.0,LUISIANIA,1068,5,249,0,234,705,94,238,0,393,2986,2593,94,238
66575.0,LUPERCIO,992,4,77,0,285,785,89,187,0,664,3083,2419,89,187
66591.0,LUTECIA,661,9,125,0,200,632,89,189,0,747,2652,1905,89,189
66613.0,MACATUBA,4545,34,658,3,1007,2014,491,586,0,2003,11341,9338,491,586
66630.0,MACAUBAL,1328,11,318,0,300,2147,471,222,0,1214,6011,4797,471,222
66656.0,MACEDONIA,1074,3,186,1,193,691,154,164,0,588,3054,2466,154,164
66672.0,MAGDA,917,6,185,0,129,632,163,126,0,331,2489,2158,163,126
66699.0,MAIRINQUE,11259,165,1710,8,3432,5153,718,1371,0,5357,29173,23816,718,1371
66710.0,MAIRIPORA,9925,184,3270,15,5499,9437,1303,2318,0,5489,37440,31951,1303,2318
66737.0,MANDURI,1872,22,425,1,454,1869,287,458,0,1297,6685,5388,287,458
66753.0,MARABA PAULISTA,715,8,309,0,185,935,79,259,0,648,3138,2490,79,259
66770.0,MARACAI,3558,37,567,3,1379,2014,322,539,0,2017,10436,8419,322,539
66796.0,MARIAPOLIS,614,5,295,0,159,815,206,188,0,356,2638,2282,206,188
66818.0,MARILIA,48405,527,9567,30,14472,27849,4705,5201,0,22658,133414,110756,4705,5201
66834.0,MARINOPOLIS,504,4,188,0,150,553,115,100,0,235,1849,1614,115,100
66850.0,MARTINOPOLIS,3721,50,1156,2,1268,4735,571,766,0,3584,15853,12269,571,766
66877.0,MATAO,23397,214,3094,9,3483,9839,1364,2101,0,6787,50288,43501,1364,2101
66893.0,MAUA,115488,1495,13615,96,33866,25535,5019,9776,0,32090,236980,204890,5019,9776
66915.0,MENDONCA,875,7,165,5,160,753,219,205,0,276,2665,2389,219,205
66931.0,MERIDIANO,1004,5,192,0,163,933,97,192,0,445,3031,2586,97,192
66958.0,MIGUELOPOLIS,4044,36,841,4,1093,4043,391,761,0,3278,14491,11213,391,761
66974.0,MINEIROS DO TIETE,3093,35,530,0,566,1514,339,479,0,1350,7906,6556,339,479
66990.0,MIRACATU,2396,43,851,2,2211,3714,327,1003,0,3662,14209,10547,327,1003
67016.0,MIRA ESTRELA,829,3,95,1,118,585,88,157,0,347,2223,1876,88,157
67032.0,MIRANDOPOLIS,5518,21,807,2,1478,4895,841,1050,0,3879,18491,14612,841,1050
67059.0,MIRANTE DO PARANAPANEMA,3270,18,1219,2,812,2490,562,893,0,3247,12513,9266,562,893
67075.0,MIRASSOL,12233,134,2783,8,2520,7125,1265,1584,0,5669,33321,27652,1265,1584
67091.0,MIRASSOLANDIA,704,18,227,2,288,958,97,136,0,291,2721,2430,97,136
67113.0,MOCOCA,15853,134,2341,8,3173,11170,2451,2471,0,7554,45155,37601,2451,2471
67130.0,MOGI DAS CRUZES,78709,1484,17813,95,28446,45153,5887,8277,0,30349,216213,185864,5887,8277
67156.0,MOJI GUACU,36879,294,5480,18,10207,15524,2618,3410,0,11736,86166,74430,2618,3410
67172.0,MOJI MIRIM,18302,181,3820,20,5555,12979,2073,2194,0,7400,52524,45124,2073,2194
67199.0,MOMBUCA,760,8,184,0,286,522,122,208,0,479,2569,2090,122,208
67210.0,MONCOES,400,1,147,0,69,464,193,100,0,239,1613,1374,193,100
67237.0,MONGAGUA,7204,97,2778,8,2111,4988,523,1017,0,5369,24095,18726,523,1017
67253.0,MONTE ALEGRE DO SUL,1403,19,345,2,266,1629,206,335,0,805,5010,4205,206,335
67270.0,MONTE ALTO,10531,88,2109,6,2164,7936,1811,1577,0,5202,31424,26222,1811,1577
67296.0,MONTE APRAZIVEL,4687,25,836,3,876,3715,799,727,0,2819,14487,11668,799,727
67318.0,MONTE AZUL PAULISTA,3969,54,813,2,1167,4280,702,965,0,2244,14196,11952,702,965
67334.0,MONTE CASTELO,989,5,131,0,143,851,136,210,0,424,2889,2465,136,210
67350.0,MONTEIRO LOBATO,801,17,286,0,247,747,116,190,0,378,2782,2404,116,190
67377.0,MONTE MOR,9045,93,1259,4,3670,4399,806,1358,0,5144,25778,20634,806,1358
67393.0,MORRO AGUDO,5363,37,877,1,1632,3356,796,1130,0,3148,16340,13192,796,1130
67415.0,MORUNGABA,2069,28,427,1,874,2704,301,401,0,1438,8243,6805,301,401
67431.0,MURUTINGA DO SUL,914,14,130,0,147,1001,108,172,0,407,2893,2486,108,172
67458.0,NARANDIBA,954,2,174,0,227,761,99,245,0,727,3189,2462,99,245
67474.0,NATIVIDADE DA SERRA,1399,23,441,3,703,1179,240,532,0,814,5334,4520,240,532
67490.0,NAZARE PAULISTA,1782,26,697,3,839,3129,560,766,0,1929,9731,7802,560,766
67512.0,NEVES PAULISTA,2254,14,383,1,300,1870,476,413,0,1245,6956,5711,476,413
67539.0,NHANDEARA,2156,20,632,1,376,2365,614,302,0,985,7451,6466,614,302
67555.0,NIPOA,676,1,138,1,155,877,100,137,0,332,2417,2085,100,137
67571.0,NOVA ALIANCA,1174,14,332,2,229,989,262,228,0,477,3707,3230,262,228
67598.0,NOVA EUROPA,2521,13,248,0,318,1032,188,269,0,1177,5766,4589,188,269
67610.0,NOVA GRANADA,3594,16,1013,4,907,3672,482,764,0,2389,12841,10452,482,764
67636.0,NOVA GUATAPORANGA,445,2,100,0,114,579,58,164,0,247,1709,1462,58,164
67652.0,NOVA INDEPENDENCIA,661,0,67,2,111,589,45,110,0,516,2101,1585,45,110
67679.0,NOVA LUZITANIA,677,1,77,2,87,897,82,107,0,312,2242,1930,82,107
67695.0,NOVA ODESSA,14443,112,1686,9,4694,3733,718,1075,0,4145,30615,26470,718,1075
67717.0,NOVO HORIZONTE,9168,81,1210,5,1875,4551,1141,1049,0,4022,23102,19080,1141,1049
67733.0,NUPORANGA,1528,7,457,2,200,1236,268,272,0,800,4770,3970,268,272
67750.0,OCAUCU,973,7,260,0,356,740,152,323,0,942,3753,2811,152,323
67776.0,OLEO,640,1,115,1,270,618,109,166,0,247,2167,1920,109,166
67792.0,OLIMPIA,9892,85,2521,6,2247,8699,1735,1686,0,6398,33269,26871,1735,1686
67814.0,ONDA VERDE,892,8,152,0,231,752,80,154,0,529,2798,2269,80,154
67830.0,ORIENTE,1652,9,209,0,309,1214,164,305,0,446,4308,3862,164,305
67857.0,ORINDIUVA,861,3,146,1,105,1097,90,190,0,747,3240,2493,90,190
67873.0,ORLANDIA,7646,85,1776,10,1272,8358,923,1200,0,3385,24655,21270,923,1200
67890.0,OSASCO,201501,2067,33410,168,50010,75435,8988,14314,0,67259,453152,385893,8988,14314
67911.0,OSCAR BRESSANE,551,1,202,0,99,598,62,134,0,264,1911,1647,62,134
67938.0,OSVALDO CRUZ,5587,45,1443,3,1339,7465,862,1081,0,4695,22520,17825,862,1081
67954.0,OURINHOS,22653,215,3897,11,5501,14595,1711,2354,0,10768,61705,50937,1711,2354
67970.0,OURO VERDE,1683,12,373,0,378,1231,154,393,0,1399,5623,4224,154,393
67997.0,PACAEMBU,1940,8,426,0,580,2693,396,484,0,1064,7591,6527,396,484
68012.0,PALESTINA,1460,17,447,3,387,2423,407,580,0,983,6707,5724,407,580
68039.0,PALMARES PAULISTA,1716,9,453,3,708,1061,370,548,0,1012,5880,4868,370,548
68055.0,PALMEIRA D OESTE,2188,22,480,3,643,2065,485,385,0,1973,8244,6271,485,385
68071.0,PALMITAL,4544,50,686,1,1070,4826,515,594,0,2853,15139,12286,515,594
68098.0,PANORAMA,2068,20,787,1,820,2105,338,421,0,2082,8642,6560,338,421
68110.0,PARAGUACU PAULISTA,8081,72,1634,6,3150,5891,1136,1419,0,5079,26468,21389,1136,1419
68136.0,PARAIBUNA,3270,79,912,3,739,3384,322,673,0,1605,10987,9382,322,673
68152.0,PARAISO,1203,10,253,0,239,1096,290,261,0,725,4077,3352,290,261
68179.0,PARANAPANEMA,3992,25,341,1,663,3010,241,581,0,2231,11085,8854,241,581
68195.0,PARANAPUA,696,4,151,1,163,957,175,147,0,373,2667,2294,175,147
68217.0,PARAPUA,2084,32,547,1,517,1938,396,581,0,1801,7897,6096,396,581
68233.0,PARDINHO,1112,6,227,3,312,1033,148,254,0,951,4046,3095,148,254
68250.0,PARIQUERA-ACU,2895,32,571,2,1756,3724,327,673,0,2366,12346,9980,327,673
68276.0,PATROCINIO PAULISTA,2512,24,789,1,508,2463,191,395,0,1417,8300,6883,191,395
68292.0,PAULICEIA,1117,7,179,0,459,717,99,197,0,510,3285,2775,99,197
68314.0,PAULINIA,20024,197,2454,16,4278,4975,1127,1400,0,5890,40361,34471,1127,1400
68330.0,PAULO DE FARIA,1344,13,450,0,315,2040,237,443,0,1649,6491,4842,237,443
68357.0,PEDERNEIRAS,8391,105,1474,8,2636,5775,1003,1396,0,4381,25169,20788,1003,1396
68373.0,PEDRA BELA,856,23,145,0,210,1355,175,280,0,888,3932,3044,175,280
68390.0,PEDRANOPOLIS,634,1,124,0,109,638,78,137,0,236,1957,1721,78,137
68411.0,PEDREGULHO,3258,42,845,1,860,3200,554,802,0,2610,12172,9562,554,802
68438.0,PEDREIRA,10257,98,1662,5,2041,5247,1125,1417,0,3311,25163,21852,1125,1417
68454.0,PEDRO DE TOLEDO,1396,15,402,4,985,1240,177,388,0,1637,6244,4607,177,388
68470.0,PENAPOLIS,15827,113,2142,5,2599,8555,1371,1695,0,6491,38798,32307,1371,1695
68497.0,PEREIRA BARRETO,5314,38,1167,4,1938,4007,595,1037,0,4874,18974,14100,595,1037
68519.0,PEREIRAS,1711,11,260,1,290,1248,216,297,0,1053,5087,4034,216,297
68535.0,PERUIBE,8765,156,4137,5,4133,7369,962,1547,0,8186,35260,27074,962,1547
68551.0,PIACATU,1078,6,133,2,162,1240,113,285,0,835,3854,3019,113,285
68578.0,PIEDADE,5376,94,2104,6,3133,11229,1259,1821,0,5365,30387,25022,1259,1821
68594.0,PILAR DO SUL,3999,26,850,3,1476,5332,551,680,0,2125,15042,12917,551,680
68616.0,PINDAMONHANGABA,31143,425,7425,20,7681,18970,1813,2587,0,10420,80484,70064,1813,2587
68632.0,PINDORAMA,3400,33,833,0,803,2314,613,671,0,1407,10074,8667,613,671
68659.0,ESPIRITO SANTO DO PINHAL,10331,101,1720,5,2126,7607,1156,1627,0,4469,29142,24673,1156,1627
68675.0,PINHALZINHO,1788,27,528,1,460,2655,311,605,0,1437,7812,6375,311,605
68691.0,PIQUEROBI,920,0,126,0,148,810,114,175,0,636,2929,2293,114,175
68713.0,PIQUETE,4827,107,855,1,1878,1633,259,407,0,2268,12235,9967,259,407
68730.0,PIRACAIA,3953,94,1243,6,1543,4981,561,893,0,3111,16385,13274,561,893
68756.0,PIRACICABA,76291,889,16867,117,22856,58368,6253,6875,0,29988,218504,188516,6253,6875
68772.0,PIRAJU,6341,77,1566,2,1579,5460,685,998,0,3814,20522,16708,685,998
68799.0,PIRAJUI,3519,55,1396,2,1486,3257,595,703,0,2931,13944,11013,595,703
68810.0,PIRANGI,2015,25,480,4,474,1842,619,359,0,1304,7122,5818,619,359
68837.0,PIRAPORA DO BOM JESUS,1862,7,476,0,1080,2019,152,373,0,1497,7466,5969,152,373
68853.0,PIRAPOZINHO,5608,66,1140,3,1511,3839,475,967,0,3163,16772,13609,475,967
68870.0,PIRACUNUNGA,17043,269,4150,14,3900,9513,1803,1694,0,7629,46015,38386,1803,1694
68896.0,PIRATININGA,2449,18,721,5,1025,1888,350,394,0,1484,8334,6850,350,394
68918.0,PITANGUEIRAS,6789,80,1337,1,1537,3927,943,1371,0,5143,21128,15985,943,1371
68934.0,PLANALTO,700,3,101,1,156,1150,128,157,0,585,2981,2396,128,157
68950.0,PLATINA,561,4,81,0,246,765,73,158,0,517,2405,1888,73,158
68977.0,POA,26095,502,5187,27,10287,10181,1588,2472,0,9720,66059,56339,1588,2472
68993.0,POLONI,1003,11,225,0,159,1369,206,136,0,525,3634,3109,206,136
69019.0,POMPEIA,4290,25,817,2,1045,4366,491,760,0,2445,14241,11796,491,760
69035.0,PONGAI,807,12,337,0,163,961,120,124,0,442,2966,2524,120,124
69051.0,PONTAL,7403,51,915,3,1430,3779,915,1220,0,4974,20690,15716,915,1220
69078.0,PONTES GESTAL,600,0,163,0,234,519,72,172,0,715,2475,1760,72,172
69094.0,POPULINA,1074,6,130,2,171,937,158,276,0,518,3272,2754,158,276
69116.0,PORANGABA,1374,5,307,0,426,1192,175,323,0,641,4443,3802,175,323
69132.0,PORTO FELIZ,9121,118,2380,7,3554,7877,1123,1407,0,4358,29945,25587,1123,1407
69159.0,PORTO FERREIRA,12735,106,3258,16,3004,5820,1478,1383,0,4646,32446,27800,1478,1383
69175.0,POTIRENDABA,2999,26,1066,0,601,2232,895,595,0,1776,10190,8414,895,595
69191.0,PRADOPOLIS,4397,50,700,2,594,1958,343,494,0,1396,9934,8538,343,494
69213.0,PRAIA GRANDE,37664,656,14360,36,16066,19716,2933,4967,0,24521,120919,96398,2933,4967
69230.0,PRESIDENTE ALVES,824,14,610,3,476,471,85,145,0,489,3117,2628,85,145
69256.0,PRESIDENTE BERNARDES,3912,22,601,0,453,2561,388,402,0,2008,10347,8339,388,402
69272.0,PRESIDENTE EPITACIO,7074,66,1911,0,2694,6296,666,1343,0,5435,25485,20050,666,1343
69299.0,PRESIDENTE PRUDENTE,45543,374,15618,26,14156,29284,3661,5639,0,24612,138913,114301,3661,5639
69310.0,PRESIDENTE VENCESLAU,7267,71,2612,4,2539,6763,814,1467,0,5270,26807,21537,814,1467
69337.0,PROMISSAO,8878,55,1368,2,2843,3508,866,1033,0,4242,22795,18553,866,1033
69353.0,QUATA,2483,13,584,3,1228,1681,411,503,0,2153,9059,6906,411,503
69370.0,QUEIROZ,544,0,44,2,104,550,39,129,0,258,1670,1412,39,129
69396.0,QUELUZ,2313,37,357,2,931,1080,178,404,0,1326,6628,5302,178,404
69418.0,QUINTANA,1195,20,220,2,364,1142,185,332,0,905,4365,3460,185,332
69434.0,RAFARD,2373,45,506,1,949,1868,272,401,0,1258,7673,6415,272,401
69450.0,RANCHARIA,6309,51,1052,2,1883,5853,685,987,0,4474,21296,16822,685,987
69477.0,REDENCAO DA SERRA,971,15,283,2,202,1051,114,273,0,450,3361,2911,114,273
69493.0,REGENTE FEIJO,4245,32,1068,3,831,2824,399,585,0,1972,11959,9987,399,585
69515.0,REGINOPOLIS,951,20,415,4,373,1127,185,195,0,592,3862,3270,185,195
69531.0,REGISTRO,9716,63,1660,8,4872,10600,720,1551,0,8518,37708,29190,720,1551
69558.0,RESTINGA,1614,6,251,0,359,834,83,195,0,348,3690,3342,83,195
69574.0,RIBEIRA,655,3,38,0,139,831,95,161,0,344,2266,1922,95,161
69590.0,RIBEIRAO BONITO,2533,55,746,1,1113,1592,380,604,0,2029,9053,7024,380,604
69612.0,RIBEIRAO BRANCO,2634,25,304,0,779,4084,516,729,0,3260,12331,9071,516,729
69639.0,RIBEIRAO CORRENTE,775,5,146,1,325,659,89,154,0,372,2526,2154,89,154
69655.0,RIBEIRAO DO SUL,1575,9,160,0,225,718,115,165,0,748,3715,2967,115,165
69671.0,RIBEIRAO PIRES,29799,662,6011,33,9902,10618,1840,3139,0,10074,72078,62004,1840,3139
69698.0,RIBEIRAO PRETO,108111,3101,31599,127,33395,86634,8800,15217,0,58095,345079,286984,8800,15217
69710.0,RIVERSUL,1512,14,176,3,319,1676,267,428,0,1847,6242,4395,267,428
69736.0,RIFAINA,906,4,234,0,315,720,91,145,0,479,2894,2415,91,145
69752.0,RINCAO,2454,26,384,1,429,1661,350,355,0,1311,6971,5660,350,355
69779.0,RINOPOLIS,1416,15,346,1,525,2752,275,348,0,846,6524,5678,275,348
69795.0,RIO CLARO,41063,617,9810,34,13417,24860,3294,5162,0,15889,114146,98257,3294,5162
69817.0,RIO DAS PEDRAS,5905,58,1184,2,3062,3780,762,836,0,3049,18638,15589,762,836
69833.0,RIO GRANDE DA SERRA,10523,235,1821,16,4709,3592,919,1514,0,5064,28393,23329,919,1514
69850.0,RIOLANDIA,1357,5,290,0,232,1792,327,361,0,1814,6178,4364,327,361
69876.0,ROSEIRA,1993,27,359,1,542,1637,117,146,0,985,5807,4822,117,146
69892.0,RUBIACEA,387,6,68,0,114,613,69,145,0,241,1643,1402,69,145
69914.0,RUBINEIA,820,6,83,0,174,419,76,150,0,424,2152,1728,76,150
69930.0,SABINO,1478,9,247,0,292,819,154,216,0,541,3756,3215,154,216
69957.0,SAGRES,364,5,132,0,96,609,45,146,0,205,1602,1397,45,146
69973.0,SALES,964,2,203,0,221,1115,150,195,0,433,3283,2850,150,195
69990.0,SALES OLIVEIRA,1787,31,497,2,336,2142,291,341,0,945,6372,5427,291,341
70017.0,SALESOPOLIS,2475,56,955,5,896,3925,465,818,0,2154,11749,9595,465,818
70033.0,SALMORAO,653,2,285,1,165,1164,103,200,0,444,3017,2573,103,200
70050.0,SALTO,32119,247,3848,19,4473,10887,1539,2531,0,8552,64215,55663,1539,2531
70076.0,SALTO DE PIRAPORA,7985,64,1122,12,1529,4761,884,1061,0,3490,20908,17418,884,1061
70092.0,SALTO GRANDE,1691,13,617,1,550,1047,225,373,0,1300,5817,4517,225,373
70114.0,SANDOVALINA,1000,5,267,0,138,295,49,116,0,356,2226,1870,49,116
70130.0,SANTA ADELIA,3938,37,868,4,808,1638,436,493,0,1630,9852,8222,436,493
70157.0,SANTA ALBERTINA,869,237,168,0,199,1420,234,216,0,667,4010,3343,234,216
70173.0,SANTA BARBARA D OESTE,49902,546,4545,36,14158,15111,3307,3938,0,13835,105378,91543,3307,3938
70190.0,AGUAS DE SANTA BARBARA,1079,5,293,1,268,941,100,299,0,850,3836,2986,100,299
70211.0,SANTA BRANCA,3233,69,834,3,885,2319,243,560,0,1808,9954,8146,243,560
70238.0,SANTA CLARA D OESTE,473,7,76,0,94,734,79,84,0,407,1954,1547,79,84
70254.0,SANTA CRUZ DA CONCEICAO,992,12,186,2,191,745,100,110,0,588,2926,2338,100,110
70270.0,SANTA CRUZ DAS PALMEIRAS,6770,62,1186,3,1075,4173,797,1114,0,2834,18014,15180,797,1114
70297.0,SANTA CRUZ DO RIO PARDO,8482,101,1995,3,2054,8576,1313,1484,0,4475,28483,24008,1313,1484
70319.0,SANTA ERNESTINA,2089,32,275,0,450,545,102,203,0,944,4640,3696,102,203
70335.0,SANTA FE DO SUL,5936,52,863,2,1448,5943,848,919,0,4189,20200,16011,848,919
70351.0,SANTA GERTRUDES,4681,34,656,2,1732,1826,455,568,0,1651,11605,9954,455,568
70378.0,SANTA ISABEL,9071,139,3098,13,3548,7816,1024,1842,0,4205,30756,26551,1024,1842
70394.0,SANTA LUCIA,3059,22,216,0,521,863,364,334,0,962,6341,5379,364,334
70416.0,SANTA MARIA DA SERRA,968,3,255,0,291,736,131,247,0,870,3501,2631,131,247
70432.0,SANTA MERCEDES,478,3,138,0,147,556,50,152,0,339,1863,1524,50,152
70459.0,SANTANA DA PONTE PENSA,451,1,106,0,125,399,106,107,0,244,1539,1295,106,107
70475.0,SANTANA DE PARNAIBA,12481,128,5234,9,5986,8721,1247,1813,0,7410,43029,35619,1247,1813
70491.0,SANTA RITA D OESTE,762,4,64,0,101,684,156,119,0,303,2193,1890,156,119
70513.0,SANTA RITA DO PASSA QUATRO,6885,54,1592,4,1484,4253,786,882,0,3245,19185,15940,786,882
70530.0,SANTA ROSA DE VITERBO,6705,72,814,7,1291,3335,638,689,0,2666,16217,13551,638,689
70556.0,SANTO ANASTACIO,4707,40,1373,1,1190,3609,760,840,0,3415,15935,12520,760,840
70572.0,SANTO ANDRE,231499,3338,34730,215,50760,79703,9259,19417,0,71399,500320,428921,9259,19417
70599.0,SANTO ANTONIO DA ALEGRIA,1603,9,727,0,215,734,156,264,0,671,4379,3708,156,264
70610.0,SANTO ANTONIO DA POSSE,4009,37,589,1,1195,3223,546,616,0,2137,12353,10216,546,616
70637.0,SANTO ANTONIO DO JARDIM,1564,20,386,2,243,1502,238,285,0,967,5207,4240,238,285
70653.0,SANTO ANTONIO DO PINHAL,1070,12,298,0,307,1685,136,401,0,1095,5004,3909,136,401
70670.0,SANTO EXPEDITO,750,3,329,0,138,424,96,221,0,548,2509,1961,96,221
70696.0,SANTOPOLIS DO AGUAPEI,726,8,152,1,156,774,127,284,0,388,2616,2228,127,284
70718.0,SANTOS,132388,1793,43955,126,29389,63611,5495,9811,0,48455,335023,286568,5495,9811
70734.0,SAO BENTO DO SAPUCAI,1652,38,672,8,421,2291,228,660,0,1610,7580,5970,228,660
70750.0,SAO BERNARDO DO CAMPO,230368,2264,31854,182,45722,72780,7474,16352,0,65852,472848,406996,7474,16352
70777.0,SAO CAETANO DO SUL,40255,652,13864,61,8211,26123,1860,3743,0,9484,104253,94769,1860,3743
70793.0,SAO CARLOS,48153,904,11199,35,10799,32285,4442,5753,0,18583,132153,113570,4442,5753
70815.0,SAO FRANCISCO,824,5,97,1,123,627,170,99,0,728,2674,1946,170,99
70831.0,SAO JOAO DA BOA VISTA,20671,172,4090,10,4255,13453,1666,2283,0,7799,54399,46600,1666,2283
70858.0,SAO JOAO DAS DUAS PONTES,735,6,150,0,81,562,86,265,0,541,2426,1885,86,265
70874.0,SAO JOAO DO PAU D ALHO,495,6,100,0,77,627,58,121,0,204,1688,1484,58,121
70890.0,SAO JOAQUIM DA BARRA,12486,108,2418,11,1563,5423,927,1459,0,4317,28712,24395,927,1459
70912.0,SAO JOSE DA BELA VISTA,1531,10,350,1,478,1152,382,308,0,1249,5461,4212,382,308
70939.0,SAO JOSE DO BARREIRO,948,15,192,0,307,1033,82,237,0,820,3634,2814,82,237
70955.0,SAO JOSE DO RIO PARDO,11972,156,2104,9,1901,9864,1383,1277,0,5482,34148,28666,1383,1277
70971.0,SAO JOSE DO RIO PRETO,81534,1011,22575,75,23190,63026,6539,8248,0,36988,243186,206198,6539,8248
70998.0,SAO JOSE DOS CAMPOS,142879,3633,27446,144,38778,68464,5486,10710,0,56176,353716,297540,5486,10710
71013.0,SAO LUIS DO PARAITINGA,2256,24,610,2,511,3366,403,609,0,1489,9270,7781,403,609
71030.0,SAO MANUEL,9046,103,1873,3,3355,4192,1275,1857,0,4316,26020,21704,1275,1857
71056.0,SAO MIGUEL ARCANJO,5768,72,941,4,2008,5468,812,1020,0,3768,19861,16093,812,1020
71072.0,SAO PAULO,2458748,43609,746875,3359,806294,1795001,184758,321460,0,1171493,7531597,6360104,184758,321460
71099.0,SAO PEDRO,5133,57,1309,11,1686,5754,766,997,0,4039,19752,15713,766,997
71110.0,SAO PEDRO DO TURVO,1269,13,209,0,317,1745,217,285,0,1104,5159,4055,217,285
71137.0,SAO ROQUE,14127,233,3291,11,4197,13282,1269,2184,0,7032,45626,38594,1269,2184
71153.0,SAO SEBASTIAO,10870,111,2752,6,5495,8097,1031,1433,0,7445,37240,29795,1031,1433
71170.0,SAO SEBASTIAO DA GRAMA,2214,16,613,2,460,2237,351,568,0,1786,8247,6461,351,568
71196.0,SAO SIMAO,3320,112,829,4,846,2467,294,496,0,1786,10154,8368,294,496
71218.0,SAO VICENTE,73199,1061,18072,65,41878,25297,4620,6368,0,28587,199147,170560,4620,6368
71234.0,SARAPUI,1642,12,263,2,350,1832,245,281,0,1126,5753,4627,245,281
71250.0,SARUTAIA,856,4,135,3,271,559,83,200,0,346,2457,2111,83,200
71277.0,SEBASTIANOPOLIS DO SUL,573,7,101,0,121,792,136,120,0,301,2151,1850,136,120
71293.0,SERRA AZUL,1702,21,350,0,359,1363,137,377,0,1083,5392,4309,137,377
71315.0,SERRANA,7786,105,1907,2,1735,4849,1186,1481,0,3743,22794,19051,1186,1481
71331.0,SERRA NEGRA,4450,71,1466,7,1789,5287,686,969,0,3638,18363,14725,686,969
71358.0,SERTAOZINHO,28318,229,2952,8,4212,11092,2433,2871,0,10533,62648,52115,2433,2871
71374.0,SETE BARRAS,2080,17,399,4,1184,2218,195,639,0,2824,9560,6736,195,639
71390.0,SEVERINIA,2899,17,537,1,778,2260,522,647,0,2152,9813,7661,522,647
71412.0,SILVEIRAS,1106,11,242,3,504,1231,151,338,0,911,4497,3586,151,338
71439.0,SOCORRO,5320,60,1491,7,2157,7105,922,1714,0,4142,22918,18776,922,1714
71455.0,SOROCABA,142897,1419,19255,117,31139,69978,6835,11028,0,41601,324269,282668,6835,11028
71471.0,SUD MENUCCI,2233,7,231,0,286,1366,292,320,0,1438,6173,4735,292,320
71498.0,SUMARE,52901,461,5735,27,16064,15909,2790,4206,0,18171,116264,98093,2790,4206
71510.0,SUZANO,55630,1046,11488,48,21673,24213,3678,5473,0,21789,145038,123249,3678,5473
71536.0,TABAPUA,2501,17,802,1,286,2002,486,521,0,1008,7624,6616,486,521
71552.0,TABATINGA,3288,21,515,0,593,2126,646,622,0,1856,9667,7811,646,622
71579.0,TABOAO DA SERRA,52460,768,11739,45,16581,32765,4054,5965,0,23901,148278,124377,4054,5965
71595.0,TACIBA,1404,8,515,1,264,927,137,276,0,967,4499,3532,137,276
71617.0,TAGUAI,1731,7,252,0,184,1778,105,275,0,1214,5546,4332,105,275
71633.0,TAIACU,1135,8,270,0,322,949,228,210,0,740,3862,3122,228,210
71650.0,TAIUVA,1419,5,403,0,224,990,151,214,0,775,4181,3406,151,214
71676.0,TAMBAU,5201,52,1038,4,993,4087,612,853,0,1826,14666,12840,612,853
71692.0,TANABI,5257,32,1148,3,1749,4930,630,502,0,2997,17248,14251,630,502
71714.0,TAPIRAI,989,10,308,2,857,1461,123,389,0,1298,5437,4139,123,389
71730.0,TAPIRATIBA,4104,25,414,1,468,1629,204,541,0,1549,8935,7386,204,541
71757.0,TAQUARITINGA,14538,117,2955,4,2889,5417,1562,1855,0,6001,35338,29337,1562,1855
71773.0,TAQUARITUBA,5297,27,497,4,706,4106,698,927,0,3906,16168,12262,698,927
71790.0,TARABAI,1765,11,345,0,325,803,132,337,0,1207,4925,3718,132,337
71811.0,TATUI,18480,174,3780,12,8455,16938,2418,3015,0,10526,63798,53272,2418,3015
71838.0,TAUBATE,68587,826,10784,53,15622,30310,3455,4404,0,27054,161095,134041,3455,4404
71854.0,TEJUPA,1123,7,110,0,231,997,133,279,0,828,3708,2880,133,279
71870.0,TEODORO SAMPAIO,3833,28,1090,0,966,3409,426,812,0,3614,14178,10564,426,812
71897.0,TERRA ROXA,2355,17,255,0,249,1391,187,245,0,1154,5853,4699,187,245
71919.0,TIETE,5328,57,1449,7,2068,7922,741,1005,0,2979,21556,18577,741,1005
71935.0,TIMBURI,706,8,105,1,127,500,79,231,0,293,2050,1757,79,231
71951.0,TORRINHA,2175,52,612,3,425,1214,322,381,0,992,6176,5184,322,381
71978.0,TREMEMBE,6719,120,1600,8,1926,4636,518,936,0,2975,19438,16463,518,936
71994.0,TRES FRONTEIRAS,1206,8,188,0,259,1141,224,224,0,652,3902,3250,224,224
72010.0,TUPA,12141,108,2871,7,4198,13979,1183,1685,0,8513,44685,36172,1183,1685
72036.0,TUPI PAULISTA,3121,17,759,0,556,3417,301,541,0,2267,10979,8712,301,541
72052.0,TURIUBA,466,16,161,1,101,513,52,134,0,368,1812,1444,52,134
72079.0,TURMALINA,597,7,114,1,49,491,142,104,0,302,1807,1505,142,104
72095.0,UBATUBA,11281,200,2677,14,6988,10881,1278,2083,0,8043,43445,35402,1278,2083
72117.0,UBIRAJARA,823,7,164,0,264,840,69,213,0,356,2736,2380,69,213
72133.0,UCHOA,2103,22,351,3,462,2013,344,340,0,1223,6861,5638,344,340
72150.0,UNIAO PAULISTA,318,3,72,0,42,482,64,48,0,202,1231,1029,64,48
72176.0,URANIA,2192,28,330,3,533,1720,387,442,0,1422,7057,5635,387,442
72192.0,URU,309,1,96,0,68,379,56,56,0,351,1316,965,56,56
72214.0,URUPES,2086,21,347,1,478,3502,275,420,0,1678,8808,7130,275,420
72230.0,VALENTIM GENTIL,1796,12,277,0,442,1931,248,276,0,1084,6066,4982,248,276
72257.0,VALINHOS,25118,181,3344,11,6196,12603,1737,2053,0,10480,61723,51243,1737,2053
72273.0,VALPARAIZO,3623,22,528,2,1098,4197,363,647,0,2819,13299,10480,363,647
72311.0,VARGEM GRANDE DO SUL,6990,82,1439,4,1872,7225,1307,1216,0,4287,24422,20135,1307,1216
72338.0,VARZEA PAULISTA,30566,248,2105,14,9422,7136,1246,2371,0,7109,60217,53108,1246,2371
72354.0,VERA CRUZ,3018,20,419,0,586,2039,297,496,0,1613,8488,6875,297,496
72370.0,VINHEDO,12548,158,2324,9,4191,9432,1336,1392,0,5396,36786,31390,1336,1392
72397.0,VIRADOURO,3587,18,892,0,1231,2705,446,538,0,1924,11341,9417,446,538
72419.0,VISTA ALEGRE DO ALTO,1350,12,246,1,257,754,339,212,0,605,3776,3171,339,212
72435.0,VOTORANTIM,33553,230,3283,14,6550,8691,1448,2239,0,7400,63408,56008,1448,2239
72451.0,VOTUPORANGA,16203,104,3624,5,4239,16027,1539,1867,0,8128,51736,43608,1539,1867
72737.0,VARGEM GRANDE PAULISTA,7958,124,1817,14,2606,5464,850,1033,0,4553,24419,19866,850,1033
73008.0,ABREULANDIA,483,1,168,0,134,206,25,215,0,328,1560,1232,25,215
73016.0,PIRAQUE,483,1,55,0,119,562,9,223,0,373,1825,1452,9,223
73024.0,RIACHINHO,720,2,80,1,158,620,58,318,0,482,2439,1957,58,318
73032.0,DARCINOPOLIS,726,3,279,0,276,686,82,464,0,442,2958,2516,82,464
73040.0,PALMEIRAS DO TOCANTINS,532,4,227,1,174,862,61,493,0,551,2905,2354,61,493
73059.0,MAURILANDIA DO TOCANTINS,355,2,68,1,201,705,62,355,0,326,2075,1749,62,355
73067.0,CACHOEIRINHA,301,0,65,0,75,380,12,197,0,235,1265,1030,12,197
73075.0,ANGICO,394,3,98,0,137,765,70,286,0,334,2087,1753,70,286
73083.0,PALMEIRANTE,442,0,64,0,88,925,28,335,0,472,2354,1882,28,335
73091.0,CAMPOS LINDOS,532,0,117,1,333,1039,55,461,0,737,3275,2538,55,461
73105.0,SAO FELIX DO TOCANTINS,171,1,23,0,119,298,3,155,0,353,1123,770,3,155
73113.0,LAGOA DO TOCANTINS,387,1,70,0,152,478,19,292,0,378,1777,1399,19,292
73121.0,BOM JESUS DO TOCANTINS,434,2,40,0,85,476,39,288,0,400,1764,1364,39,288
73130.0,SANTA MARIA DO TOCANTINS,450,1,104,0,114,381,32,294,0,300,1676,1376,32,294
73148.0,NOVO ALEGRE,515,4,129,0,105,259,22,227,0,380,1641,1261,22,227
73156.0,SANDOLANDIA,380,3,124,0,231,653,16,354,0,559,2320,1761,16,354
73164.0,TAIPAS DO TOCANTINS,290,1,88,0,111,237,12,295,0,295,1329,1034,12,295
73172.0,NOVO JARDIM,469,1,34,0,52,375,30,256,0,302,1519,1217,30,256
73180.0,SAO MIGUEL DO TOCANTINS,1163,7,160,1,442,958,68,555,0,747,4101,3354,68,555
73199.0,FORTALEZA DO TABOCAO,536,1,161,0,209,447,61,283,0,366,2064,1698,61,283
73202.0,ITAPIRATINS,251,1,64,0,61,1053,68,362,0,491,2351,1860,68,362
73210.0,CENTENARIO,467,1,64,0,64,279,27,331,0,397,1630,1233,27,331
73229.0,RECURSOLANDIA,283,0,47,0,96,701,14,491,0,506,2138,1632,14,491
73237.0,TUPIRATINS,216,0,25,0,51,340,24,164,0,263,1083,820,24,164
73245.0,BRASILANDIA DO TOCANTINS,332,1,38,1,179,486,19,217,0,333,1606,1273,19,217
73253.0,JUARINA,530,2,42,0,142,302,36,142,0,316,1512,1196,36,142
73261.0,PAU D'ARCO,726,3,45,0,197,723,52,355,0,693,2794,2101,52,355
73270.0,MATEIROS,167,1,68,0,120,156,7,241,0,291,1051,760,7,241
73288.0,SAO BENTO DO TOCANTINS,479,0,81,1,272,899,30,312,0,505,2579,2074,30,312
73296.0,ESPERANTINA,1577,0,62,0,207,813,70,802,0,901,4432,3531,70,802
73300.0,CARIRI DO TOCANTINS,830,1,102,1,223,489,18,257,0,489,2410,1921,18,257
73318.0,ARAGUANA,841,2,88,0,147,876,57,506,0,783,3300,2517,57,506
73326.0,CARMOLANDIA,593,4,127,0,85,487,25,317,0,491,2129,1638,25,317
73334.0,ARAGOMINAS,945,2,99,0,371,1226,55,546,0,969,4213,3244,55,546
73342.0,MURICILANDIA,444,4,89,0,147,599,35,392,0,498,2208,1710,35,392
73350.0,SANTA FE DO ARAGUAIA,1040,3,119,0,304,1134,85,468,0,1083,4236,3153,85,468
73369.0,JAU DO TOCANTINS,528,0,128,1,262,599,33,372,0,582,2505,1923,33,372
73377.0,SUCUPIRA,273,0,73,0,103,326,17,157,0,124,1073,949,17,157
73385.0,LAGOA DA CONFUSAO,1243,4,209,0,285,495,42,522,0,706,3506,2800,42,522
73393.0,SAO SALVADOR DO TOCANTINS,458,0,58,0,92,396,23,285,0,357,1669,1312,23,285
73407.0,LAGEADO,593,2,104,0,183,403,16,269,0,617,2187,1570,16,269
73415.0,RIO DOS BOIS,316,4,193,0,178,265,27,252,0,316,1551,1235,27,252
73423.0,CARRASCO BONITO,532,1,57,1,95,710,49,302,0,589,2336,1747,49,302
73431.0,RIO DA CONCEICAO,361,1,12,0,107,190,8,172,0,193,1044,851,8,172
73440.0,PALMAS,41393,142,7411,18,14177,16087,819,3936,0,17340,101323,83983,819,3936
73458.0,TUPIRAMA,232,0,68,0,54,367,23,156,0,193,1093,900,23,156
73466.0,OLIVEIRA DE FATIMA,244,0,139,0,106,146,19,106,0,195,955,760,19,106
73474.0,CHAPADA DE AREIA,334,0,117,0,223,380,21,157,0,317,1549,1232,21,157
73482.0,CHAPADA DA NATIVIDADE,541,0,70,0,102,544,20,495,0,486,2258,1772,20,495
73504.0,TALISMA,549,1,69,0,215,290,23,221,0,426,1794,1368,23,221
73512.0,AGUIARNOPOLIS,513,8,134,0,141,882,30,323,0,290,2321,2031,30,323
73520.0,LUZINOPOLIS,362,0,66,0,128,485,11,279,0,186,1517,1331,11,279
73539.0,SANTA TEREZINHA DO TOCANTINS,358,1,69,0,52,684,30,207,0,198,1599,1401,30,207
73547.0,SANTA RITA DO TOCANTINS,291,0,51,0,47,339,9,160,0,269,1166,897,9,160
73555.0,CRIXAS DO TOCANTINS,395,2,79,1,51,402,17,135,0,374,1456,1082,17,135
73563.0,MONTE SANTO,459,2,115,1,152,496,21,213,0,268,1727,1459,21,213
73571.0,PUGMIL,404,2,101,3,170,342,27,144,0,266,1459,1193,27,144
73580.0,BANDEIRANTE DO TOCANTINS,506,2,61,0,159,556,25,332,0,419,2060,1641,25,332
73598.0,IPUEIRAS,278,0,48,0,46,395,8,120,0,175,1070,895,8,120
73601.0,LAVANDEIRA,244,2,54,2,149,243,17,168,0,122,1001,879,17,168
73610.0,BARRA DO OURO,329,1,77,1,180,866,25,383,0,528,2390,1862,25,383
74004.0,GODOY MOREIRA,686,7,79,1,398,632,80,346,0,457,2686,2229,80,346
74012.0,ABATIA,996,13,355,3,462,1932,196,342,0,451,4750,4299,196,342
74020.0,IBEMA,2030,16,222,0,218,382,73,375,0,1223,4539,3316,73,375
74039.0,ADRIANOPOLIS,1400,7,77,4,585,669,153,642,0,700,4237,3537,153,642
74047.0,LINDOESTE,2014,4,143,1,269,491,93,332,0,615,3962,3347,93,332
74055.0,AGUDOS DO SUL,1926,13,250,4,598,1218,208,452,0,545,5214,4669,208,452
74063.0,OURO VERDE DO OESTE,1377,22,240,2,229,1200,87,318,0,441,3916,3475,87,318
74071.0,ALMIRANTE TAMANDARE,18486,182,1295,7,5999,5680,1042,2159,0,2045,36895,34850,1042,2159
74080.0,SANTA TEREZA DO OESTE,1897,13,255,0,244,715,87,287,0,219,3717,3498,87,287
74098.0,ALTO PARANA,3085,30,435,0,653,1725,153,944,0,966,7991,7025,153,944
74101.0,ANAHY,784,10,110,1,188,474,43,224,0,278,2112,1834,43,224
74110.0,ALTO PIQUIRI,1788,21,614,3,680,1867,188,736,0,1155,7052,5897,188,736
74128.0,ANGULO,456,0,96,0,222,745,62,281,0,405,2267,1862,62,281
74136.0,ALVORADA DO SUL,1921,11,609,1,529,1837,137,496,0,1642,7183,5541,137,496
74144.0,BOA ESPERANCA DO IGUACU,1120,4,59,0,138,404,37,155,0,240,2157,1917,37,155
74152.0,AMAPORA,1152,10,425,0,236,462,75,405,0,856,3621,2765,75,405
74160.0,BOM SUCESSO DO SUL,1072,4,93,3,136,643,88,113,0,200,2352,2152,88,113
74179.0,AMPERE,5402,10,413,1,718,1375,172,643,0,725,9459,8734,172,643
74187.0,BRASILANDIA DO SUL,656,7,244,0,190,759,61,359,0,599,2875,2276,61,359
74195.0,ANDIRA,4828,64,1021,4,1287,4209,471,1270,0,3415,16569,13154,471,1270
74209.0,CAFEZAL DO SUL,737,9,241,1,305,1032,91,337,0,498,3251,2753,91,337
74217.0,ANTONINA,4608,48,628,4,3180,2029,300,690,0,2721,14208,11487,300,690
74225.0,CANDOI,4053,23,509,2,435,1501,280,910,0,1796,9509,7713,280,910
74233.0,ANTONIO OLINTO,1729,19,183,2,223,1276,201,425,0,304,4362,4058,201,425
74241.0,CRUZEIRO DO IGUACU,1617,7,119,1,215,328,49,190,0,888,3414,2526,49,190
74250.0,APUCARANA,22444,212,4328,26,8448,24357,2050,3277,0,12942,78084,65142,2050,3277
74268.0,DIAMANTE DO SUL,922,6,147,0,329,295,51,330,0,429,2509,2080,51,330
74276.0,ARAPONGAS,19779,272,4112,16,8054,16075,1881,3374,0,11321,64884,53563,1881,3374
74284.0,ENTRE RIOS DO OESTE,1325,8,144,1,94,686,43,101,0,214,2616,2402,43,101
74292.0,ARAPOTI,5180,50,583,5,2190,4480,484,865,0,3297,17134,13837,484,865
74306.0,FAROL,928,3,71,1,219,670,56,207,0,727,2882,2155,56,207
74314.0,ARARUNA,2101,16,945,1,673,3425,159,618,0,1847,9785,7938,159,618
74322.0,FAZENDA RIO GRANDE,18225,117,1740,11,3874,3751,906,1483,0,5405,35512,30107,906,1483
74330.0,MARILANDIA DO SUL,1565,16,253,2,575,2401,189,541,0,683,6225,5542,189,541
74349.0,FLOR DA SERRA DO SUL,1803,3,188,1,388,475,73,260,0,492,3683,3191,73,260
74357.0,ARAUCARIA,35816,290,3329,17,6296,8154,1614,2678,0,7789,65983,58194,1614,2678
74365.0,HONORIO SERPA,2277,6,86,0,354,492,83,254,0,1271,4823,3552,83,254
74373.0,ASSAI,2602,37,872,1,1484,3881,355,1094,0,1984,12310,10326,355,1094
74381.0,IGUATU,557,4,75,0,133,485,31,198,0,253,1736,1483,31,198
74390.0,ASTORGA,4502,36,1054,5,1934,6021,604,1211,0,3301,18668,15367,604,1211
74403.0,IRACEMA DO OESTE,786,2,87,0,177,597,64,232,0,392,2337,1945,64,232
74411.0,ATALAIA,898,6,124,1,251,859,99,162,0,253,2653,2400,99,162
74420.0,NOVO ITACOLOMI,580,2,143,3,162,728,68,233,0,184,2103,1919,68,233
74438.0,BALSA NOVA,3688,27,247,1,642,1219,271,428,0,442,6965,6523,271,428
74446.0,ITAPERUCU,5959,19,334,2,2219,1892,633,1074,0,2128,14260,12132,633,1074
74454.0,BANDEIRANTES,7634,82,1098,6,2857,5573,656,1559,0,2799,22264,19465,656,1559
74462.0,IVATE,1392,10,141,2,362,1635,102,524,0,1236,5404,4168,102,524
74470.0,BARBOSA FERRAZ,2389,30,443,3,979,2241,331,974,0,1657,9047,7390,331,974
74489.0,LIDIANOPOLIS,1023,13,94,1,189,1027,94,331,0,485,3257,2772,94,331
74497.0,BARRACAO,2242,17,230,0,730,1195,105,446,0,1783,6748,4965,105,446
74500.0,MARIPA,1675,10,346,1,503,1215,82,184,0,768,4784,4016,82,184
74519.0,BARRA DO JACARE,931,3,80,0,221,536,65,202,0,453,2491,2038,65,202
74527.0,MATO RICO,932,1,52,0,159,1028,69,311,0,904,3456,2552,69,311
74535.0,BELA VISTA DO PARAISO,2895,42,752,2,1028,3543,305,950,0,2183,11700,9517,305,950
74543.0,MAUA DA SERRA,1058,9,104,0,651,1728,108,437,0,608,4703,4095,108,437
74551.0,BITURUNA,5015,15,668,3,699,1531,252,815,0,1604,10602,8998,252,815
74560.0,MERCEDES,1473,6,226,1,375,833,50,167,0,280,3411,3131,50,167
74578.0,BOA ESPERANCA,1085,17,191,2,208,1092,97,268,0,284,3244,2960,97,268
74586.0,NOVA LARANJEIRAS,2881,17,216,5,417,957,178,731,0,1916,7318,5402,178,731
74594.0,BOCAIUVA DO SUL,2444,17,379,0,812,1212,278,545,0,1133,6820,5687,278,545
74608.0,NOVA SANTA BARBARA,752,3,89,0,331,678,109,365,0,346,2673,2327,109,365
74616.0,BOM SUCESSO,1191,8,152,1,329,1500,136,407,0,558,4282,3724,136,407
74624.0,PATO BRAGADO,1319,14,111,1,207,1027,35,179,0,264,3157,2893,35,179
74632.0,BORRAZOPOLIS,2023,5,175,2,525,2222,196,513,0,772,6433,5661,196,513
74640.0,PINHAL DE SAO BENTO,887,5,26,2,72,287,39,149,0,229,1696,1467,39,149
74659.0,CAFEARA,786,5,30,0,119,526,56,81,0,220,1823,1603,56,81
74667.0,PITANGUEIRAS,485,6,69,0,129,948,40,59,0,224,1960,1736,40,59
74675.0,CALIFORNIA,1742,31,237,3,540,1597,235,483,0,1065,5933,4868,235,483
74683.0,QUATRO PONTES,1173,14,340,2,181,727,58,118,0,403,3016,2613,58,118
74691.0,CAMBARA,7851,81,866,3,1016,2359,320,1081,0,1706,15283,13577,320,1081
74705.0,RAMILANDIA,772,5,225,0,231,546,49,327,0,366,2521,2155,49,327
74713.0,CAMBE,22022,356,4051,18,8220,13125,1744,3167,0,8971,61674,52703,1744,3167
74721.0,RANCHO ALEGRE D'OESTE,743,9,57,2,135,709,33,230,0,449,2367,1918,33,230
74730.0,CAMBIRA,1676,17,374,0,463,1258,131,454,0,462,4835,4373,131,454
74748.0,RIO BONITO DO IGUACU,3991,6,138,2,349,800,128,541,0,1339,7294,5955,128,541
74756.0,CAMPINA DA LAGOA,2912,42,629,4,1347,2386,226,1133,0,1690,10369,8679,226,1133
74764.0,SANTA LUCIA,1463,7,128,3,269,369,73,205,0,457,2974,2517,73,205
74772.0,CAMPINA GRANDE DO SUL,8986,73,851,9,3604,3716,663,1468,0,4082,23452,19370,663,1468
74780.0,CAMPO BONITO,1656,7,131,0,199,338,59,285,0,885,3560,2675,59,285
74799.0,CAMPO DO TENENTE,1357,8,291,3,376,1013,152,348,0,240,3788,3548,152,348
74802.0,SANTA MARIA DO OESTE,3062,8,370,0,531,1347,174,737,0,2627,8856,6229,174,737
74810.0,CAMPO LARGO,28821,382,3475,25,5764,13081,2315,2918,0,8004,64785,56781,2315,2918
74829.0,SANTA MONICA,853,6,103,0,115,615,41,197,0,381,2311,1930,41,197
74837.0,CAMPO MOURAO,20971,148,5179,7,5808,8431,1011,1971,0,12507,56033,43526,1011,1971
74845.0,SAO MANOEL DO PARANA,371,6,173,0,150,451,39,159,0,284,1633,1349,39,159
74853.0,CANDIDO DE ABREU,3639,37,618,1,927,3290,382,1195,0,3501,13590,10089,382,1195
74861.0,SAO PEDRO DO IGUACU,2048,25,226,1,419,1062,119,469,0,695,5064,4369,119,469
74870.0,CAPANEMA,6498,24,479,8,742,2118,190,700,0,3140,13899,10759,190,700
74888.0,TUNAS DO PARANA,656,5,64,1,350,808,48,318,0,723,2973,2250,48,318
74896.0,CAPITAO LEONIDAS MARQUES,5285,38,370,2,864,1177,228,573,0,2923,11460,8537,228,573
74900.0,VENTANIA,1746,13,297,2,383,1278,229,554,0,832,5334,4502,229,554
74918.0,CARLOPOLIS,2172,31,456,5,613,3178,345,759,0,1370,8929,7559,345,759
74926.0,VILA ALTA,1066,6,143,0,236,375,49,269,0,683,2827,2144,49,269
74934.0,CASCAVEL,69262,761,12062,46,16864,24545,3006,6498,0,36361,169405,133044,3006,6498
74942.0,DOUTOR ULYSSES,633,5,92,0,672,1270,222,311,0,699,3904,3205,222,311
74950.0,CASTRO,12601,175,2492,13,3973,11418,1738,3157,0,6530,42097,35567,1738,3157
74969.0,VIRMOND,1271,13,144,4,294,511,75,241,0,483,3036,2553,75,241
74977.0,CATANDUVAS,2365,31,176,1,483,1200,132,642,0,527,5557,5030,132,642
74985.0,LARANJAL,1300,3,141,0,211,777,108,438,0,1259,4237,2978,108,438
74993.0,CENTENARIO DO SUL,2712,40,481,2,914,1727,223,620,0,2757,9476,6719,223,620
75000.0,ITAIPULANDIA,2873,5,273,0,377,503,56,251,0,473,4811,4338,56,251
75019.0,CERRO AZUL,2701,11,238,2,1809,2635,750,902,0,2601,11649,9048,750,902
75027.0,NOVA ESPERANCA DO SUDOESTE,1534,11,103,1,415,810,86,307,0,496,3763,3267,86,307
75035.0,CHOPINZINHO,6530,32,513,5,994,2430,330,829,0,2880,14543,11663,330,829
75043.0,PINHAIS,33410,301,3443,30,9763,9783,1560,2655,0,10943,71888,60945,1560,2655
75051.0,CIANORTE,14368,137,2581,5,4316,10559,1245,2697,0,7552,43460,35908,1245,2697
75060.0,SAUDADE DO IGUACU,1375,4,75,3,182,584,55,225,0,469,2972,2503,55,225
75078.0,CIDADE GAUCHA,3013,17,318,2,342,1525,156,576,0,834,6783,5949,156,576
75086.0,ARIRANHA DO IVAI,690,11,61,0,164,553,39,247,0,953,2718,1765,39,247
75094.0,CLEVELANDIA,5627,30,529,4,791,2052,281,1000,0,3271,13585,10314,281,1000
75108.0,ARAPUA,1033,5,103,4,276,809,55,330,0,1191,3806,2615,55,330
75116.0,MANGUEIRINHA,5273,24,374,1,986,1829,250,1175,0,2717,12629,9912,250,1175
75124.0,BELA VISTA DA CAROBA,1363,3,89,0,254,631,56,228,0,865,3489,2624,56,228
75132.0,COLOMBO,50418,384,4052,22,14789,13821,2672,4282,0,14696,105136,90440,2672,4282
75140.0,BOA VENTURA DE SAO ROQUE,2197,8,84,0,160,878,112,334,0,911,4684,3773,112,334
75159.0,COLORADO,5713,38,1276,4,1529,2961,469,1309,0,3204,16503,13299,469,1309
75167.0,BOM JESUS DO SUL,1203,1,34,0,153,923,56,241,0,1021,3632,2611,56,241
75175.0,CONGONHINHAS,1207,8,133,2,291,2093,151,512,0,649,5046,4397,151,512
75183.0,CAMPINA DO SIMAO,1131,4,87,0,111,544,92,263,0,149,2381,2232,92,263
75191.0,CONSELHEIRO MAYRINCK,899,4,103,2,314,793,59,241,0,381,2796,2415,59,241
75205.0,CAMPO MAGRO,4610,26,323,2,791,2158,273,604,0,541,9328,8787,273,604
75213.0,CONTENDA,4230,36,580,1,631,1750,287,465,0,1155,9135,7980,287,465
75221.0,CARAMBEI,3960,32,763,1,1087,2269,311,718,0,1173,10314,9141,311,718
75230.0,CORBELIA,4252,37,642,2,863,2830,191,631,0,800,10248,9448,191,631
75248.0,CORONEL DOMINGOS SOARES,1586,4,111,1,334,621,128,355,0,976,4116,3140,128,355
75256.0,CORNELIO PROCOPIO,13988,176,2143,7,4084,6045,738,1456,0,6717,35354,28637,738,1456
75264.0,CRUZMALTINA,775,6,73,0,276,809,51,325,0,1095,3410,2315,51,325
75272.0,CORONEL VIVIDA,7065,50,688,3,1365,3007,475,966,0,3781,17400,13619,475,966
75280.0,CORUMBATAI DO SUL,864,14,203,2,538,730,129,440,0,712,3632,2920,129,440
75299.0,CRUZEIRO DO OESTE,4323,67,750,4,2043,2953,344,1165,0,2290,13939,11649,344,1165
75302.0,ESPERANCA NOVA,534,4,118,0,172,424,61,170,0,241,1724,1483,61,170
75310.0,CRUZEIRO DO SUL,1593,5,141,0,231,870,59,209,0,658,3766,3108,59,209
75329.0,ESPIGAO ALTO DO IGUACU,1676,6,102,1,239,611,120,393,0,1292,4440,3148,120,393
75337.0,CRUZ MACHADO,4424,58,1036,10,917,2463,335,811,0,1700,11754,10054,335,811
75345.0,FERNANDES PINHEIRO,1862,17,180,0,343,800,106,385,0,701,4394,3693,106,385
75353.0,CURITIBA,518212,5939,82006,520,120005,214308,20675,35013,0,149782,1146460,996678,20675,35013
75361.0,FOZ DO JORDAO,1511,5,113,0,340,576,80,250,0,493,3368,2875,80,250
75370.0,CURIUVA,2577,30,342,5,856,2057,381,891,0,1977,9116,7139,381,891
75388.0,GOIOXIM,1871,5,96,1,318,711,96,443,0,978,4519,3541,96,443
75396.0,DIAMANTE DO NORTE,1144,5,494,0,637,774,104,440,0,809,4407,3598,104,440
75400.0,DIAMANTE DO OESTE,1326,16,97,0,287,575,62,363,0,429,3155,2726,62,363
75418.0,DOIS VIZINHOS,10479,41,1017,4,1545,3880,469,1162,0,4452,23049,18597,469,1162
75426.0,GUAMIRANGA,2151,20,198,4,555,1002,141,557,0,618,5246,4628,141,557
75434.0,DOUTOR CAMARGO,1149,6,286,1,610,1571,114,369,0,564,4670,4106,114,369
75442.0,IMBAU,1777,7,159,0,728,1189,222,541,0,1172,5795,4623,222,541
75450.0,ENEAS MARQUES,1954,10,210,1,252,1106,87,210,0,547,4377,3830,87,210
75469.0,MANFRINOPOLIS,1126,4,37,0,166,525,52,194,0,639,2743,2104,52,194
75477.0,ENGENHEIRO BELTRAO,2498,33,917,1,1416,2987,205,646,0,2649,11352,8703,205,646
75485.0,MARQUINHO,1165,2,266,0,141,864,100,490,0,1041,4069,3028,100,490
75493.0,FAXINAL,2681,50,728,5,1771,2285,275,1001,0,3029,11825,8796,275,1001
75507.0,PEROBAL,1033,16,125,1,424,1346,85,313,0,797,4140,3343,85,313
75515.0,FENIX,1005,11,143,1,406,877,89,276,0,483,3291,2808,89,276
75523.0,PONTAL DO PARANA,3743,31,663,3,1130,1706,168,413,0,1869,9726,7857,168,413
75531.0,FLORAI,1231,13,110,0,197,1621,139,365,0,428,4104,3676,139,365
75540.0,PORTO BARREIRO,1521,3,67,0,162,354,61,222,0,393,2783,2390,61,222
75558.0,FLORESTA,1076,14,122,0,465,1502,87,252,0,395,3913,3518,87,252
75566.0,PRADO FERREIRA,811,5,56,1,243,691,45,249,0,378,2479,2101,45,249
75574.0,FLORESTOPOLIS,2932,10,569,3,1263,1660,181,869,0,2298,9785,7487,181,869
75582.0,QUARTO CENTENARIO,773,10,366,1,266,947,106,392,0,290,3151,2861,106,392
75590.0,FLORIDA,840,2,88,1,181,323,54,133,0,197,1819,1622,54,133
75604.0,RESERVA DO IGUACU,1896,16,147,4,518,485,69,457,0,995,4587,3592,69,457
75612.0,FORMOSA DO OESTE,2049,16,300,2,468,1709,189,497,0,1069,6299,5230,189,497
75620.0,RIO BRANCO DO IVAI,504,6,66,1,202,781,60,312,0,378,2310,1932,60,312
75639.0,FOZ DO IGUACU,79886,433,9953,13,20474,16708,1741,6917,0,33806,169931,136125,1741,6917
75647.0,SERRANOPOLIS DO IGUACU,1599,14,255,1,304,772,30,157,0,220,3352,3132,30,157
75655.0,FRANCISCO BELTRAO,23596,83,2297,12,3684,8228,863,1779,0,9764,50306,40542,863,1779
75663.0,TAMARANA,1655,22,453,1,608,2022,199,525,0,878,6363,5485,199,525
75671.0,GENERAL CARNEIRO,4063,23,418,2,659,1472,267,576,0,2045,9525,7480,267,576
75698.0,GOIOERE,5059,48,1232,4,2197,5677,589,1603,0,2746,19155,16409,589,1603
75710.0,GUAIRA,9253,42,884,7,2338,2798,363,1152,0,5992,22829,16837,363,1152
75736.0,GUAIRACA,921,11,360,0,331,1417,108,394,0,1145,4687,3542,108,394
75744.0,ROSARIO DO IVAI,719,8,121,1,329,1695,115,646,0,792,4426,3634,115,646
75752.0,GUAPIRAMA,946,5,84,3,188,1051,64,266,0,417,3024,2607,64,266
75760.0,NOVA TEBAS,1930,10,239,0,521,1146,182,809,0,606,5443,4837,182,809
75779.0,GUAPOREMA,554,5,53,0,60,510,41,161,0,190,1574,1384,41,161
75787.0,SULINA,1293,5,129,2,214,541,61,231,0,784,3260,2476,61,231
75795.0,GUARACI,760,4,219,3,315,1247,93,279,0,346,3266,2920,93,279
75809.0,LUISIANIA,1599,11,187,1,314,1302,155,436,0,916,4921,4005,155,436
75817.0,GUARANIACU,5247,53,818,7,820,1571,311,1015,0,3341,13183,9842,311,1015
75833.0,GUARAPUAVA,49026,288,6469,29,8220,13674,1905,5106,0,16654,101371,84717,1905,5106
75850.0,GUARAQUECABA,1098,6,163,0,1312,1199,127,333,0,1495,5733,4238,127,333
75876.0,GUARATUBA,6687,62,1115,5,2481,3593,394,1064,0,4037,19438,15401,394,1064
75892.0,IBAITI,4881,53,833,4,2660,4402,536,1338,0,2645,17352,14707,536,1338
75914.0,IBIPORA,8132,192,1633,5,3653,9151,1248,2391,0,5293,31698,26405,1248,2391
75930.0,ICARAIMA,1597,24,203,2,664,2323,162,689,0,1978,7642,5664,162,689
75957.0,IGUARACU,729,1,147,0,484,712,42,168,0,300,2583,2283,42,168
75973.0,IMBITUVA,6479,58,909,5,1907,3700,497,1233,0,1827,16615,14788,497,1233
75990.0,INACIO MARTINS,2380,14,501,0,583,1648,253,696,0,1467,7542,6075,253,696
76015.0,INAJA,791,3,384,0,84,230,53,289,0,259,2093,1834,53,289
76031.0,IPIRANGA,2278,44,621,5,629,3140,307,729,0,1315,9068,7753,307,729
76058.0,IPORA,3128,32,1002,3,1265,2626,332,1026,0,1933,11347,9414,332,1026
76074.0,IRATI,17595,143,2534,21,2327,6301,1006,2047,0,5360,37334,31974,1006,2047
76090.0,IRETAMA,2682,22,336,0,613,1520,244,912,0,1443,7772,6329,244,912
76112.0,ITAGUAGE,1224,5,193,3,209,701,77,298,0,438,3148,2710,77,298
76139.0,ITAMBARACA,1301,8,227,1,453,1597,152,401,0,619,4759,4140,152,401
76155.0,ITAMBE,1308,20,262,0,321,1254,82,326,0,453,4026,3573,82,326
76171.0,ITAPEJARA DO OESTE,3010,13,250,1,497,1222,131,467,0,542,6133,5591,131,467
76198.0,ITAUNA DO SUL,854,6,178,2,268,479,113,341,0,584,2825,2241,113,341
76210.0,IVAI,2349,21,397,1,624,2983,202,610,0,1319,8506,7187,202,610
76236.0,IVAIPORA,7400,75,984,4,2915,5154,415,1486,0,8432,26865,18433,415,1486
76252.0,IVATUBA,648,4,140,0,154,647,38,123,0,274,2028,1754,38,123
76279.0,JABOTI,1070,11,60,0,234,1040,94,300,0,409,3218,2809,94,300
76295.0,JACAREZINHO,10219,102,1989,11,3012,5745,792,1341,0,6659,29870,23211,792,1341
76317.0,JAGUAPITA,1983,35,469,1,906,2327,281,750,0,1575,8327,6752,281,750
76333.0,JAGUARIAIVA,7077,69,988,7,3480,3830,493,1347,0,3521,20812,17291,493,1347
76350.0,JANDAIA DO SUL,4884,58,959,3,1499,3399,412,902,0,1192,13308,12116,412,902
76376.0,JANIOPOLIS,1711,20,270,1,212,1622,160,543,0,1077,5616,4539,160,543
76392.0,JAPIRA,1282,15,121,0,235,824,65,301,0,447,3290,2843,65,301
76414.0,JAPURA,1426,22,282,0,332,2481,185,512,0,660,5900,5240,185,512
76430.0,JARDIM ALEGRE,2144,27,406,0,872,1933,212,829,0,1286,7709,6423,212,829
76457.0,JARDIM OLINDA,572,3,111,0,39,137,25,92,0,151,1130,979,25,92
76473.0,JATAIZINHO,2254,25,367,0,813,2231,253,679,0,1948,8570,6622,253,679
76490.0,JOAQUIM TAVORA,1933,26,264,3,569,2217,226,476,0,1870,7584,5714,226,476
76511.0,JUNDIAI DO SUL,975,7,117,0,158,423,55,246,0,465,2446,1981,55,246
76538.0,JUSSARA,1568,7,202,0,599,810,144,481,0,546,4357,3811,144,481
76554.0,KALORE,872,3,159,2,197,1443,127,352,0,516,3671,3155,127,352
76570.0,LAPA,14862,151,1621,6,2106,5530,774,1330,0,4277,30657,26380,774,1330
76597.0,LARANJEIRAS DO SUL,8965,52,987,9,1600,2668,300,1579,0,4960,21120,16160,300,1579
76619.0,LEOPOLIS,949,3,90,1,393,671,58,248,0,175,2588,2413,58,248
76635.0,LOANDA,4046,23,1324,0,1060,3228,312,1111,0,3143,14247,11104,312,1111
76651.0,LOBATO,1411,9,129,0,188,596,54,214,0,272,2873,2601,54,214
76678.0,LONDRINA,83949,2541,26640,137,49841,81756,7802,13413,0,49476,315555,266079,7802,13413
76694.0,LUPIONOPOLIS,1029,9,182,1,267,721,73,306,0,421,3009,2588,73,306
76716.0,MALLET,4288,34,461,7,472,1735,282,605,0,1409,9293,7884,282,605
76732.0,MAMBORE,2777,63,537,2,1243,2868,271,936,0,1406,10103,8697,271,936
76759.0,MANDAGUACU,4176,36,770,5,1648,2848,358,892,0,2176,12909,10733,358,892
76775.0,MANDAGUARI,6622,47,1474,4,3477,5972,627,1563,0,4143,23929,19786,627,1563
76791.0,MANDIRITUBA,5730,36,526,2,1067,2038,457,771,0,1945,12572,10627,457,771
76813.0,MANOEL RIBAS,2660,28,315,1,561,2586,178,581,0,687,7597,6910,178,581
76830.0,MARECHAL CANDIDO RONDON,12830,88,1875,11,2839,5802,486,1424,0,1797,27152,25355,486,1424
76856.0,MARIA HELENA,1233,15,151,0,387,1346,75,308,0,608,4123,3515,75,308
76872.0,MARIALVA,6189,75,1470,2,2791,5538,711,1150,0,3361,21287,17926,711,1150
76899.0,MARILUZ,2547,23,315,1,634,1444,177,778,0,1149,7068,5919,177,778
76910.0,MARINGA,62829,896,18898,67,31315,49527,4108,7877,0,32682,208199,175517,4108,7877
76937.0,MARIOPOLIS,2198,15,191,0,269,961,146,309,0,987,5076,4089,146,309
76953.0,MARMELEIRO,4223,18,521,2,838,1088,195,386,0,2163,9434,7271,195,386
76970.0,MARUMBI,939,11,161,0,231,1137,105,279,0,386,3249,2863,105,279
76996.0,MATELANDIA,3819,49,584,1,1280,2445,208,553,0,1856,10795,8939,208,553
77011.0,MEDIANEIRA,11356,89,1508,1,3090,5076,379,1275,0,4853,27627,22774,379,1275
77038.0,MIRADOR,542,1,183,0,132,269,49,136,0,224,1536,1312,49,136
77054.0,MIRASELVA,421,2,100,0,112,705,26,146,0,195,1707,1512,26,146
77070.0,MOREIRA SALLES,1927,29,459,1,752,2669,257,1014,0,1391,8499,7108,257,1014
77097.0,MORRETES,3634,51,797,5,2387,2035,226,662,0,2196,11993,9797,226,662
77119.0,MUNHOZ DE MELLO,587,9,136,0,243,738,65,229,0,291,2298,2007,65,229
77135.0,NOSSA SENHORA DAS GRACAS,978,6,114,1,264,676,69,340,0,388,2836,2448,69,340
77151.0,NOVA ALIANCA DO IVAI,282,1,131,0,106,285,14,110,0,115,1044,929,14,110
77178.0,NOVA AMERICA DA COLINA,464,6,136,0,492,576,79,330,0,250,2333,2083,79,330
77194.0,NOVA CANTU,2230,14,184,2,534,1112,135,353,0,2148,6712,4564,135,353
77216.0,NOVA ESPERANCA,6214,83,1183,4,1815,4751,563,1270,0,4378,20261,15883,563,1270
77232.0,NOVA FATIMA,1297,15,240,2,396,1922,158,511,0,802,5343,4541,158,511
77259.0,NOVA LONDRINA,2019,25,931,1,831,2654,211,825,0,2762,10259,7497,211,825
77275.0,ORTIGUEIRA,3771,28,421,1,2190,4031,668,1867,0,6182,19159,12977,668,1867
77291.0,OURIZONA,985,9,117,0,207,696,97,237,0,494,2842,2348,97,237
77313.0,PAICANDU,7425,54,1016,3,3001,3888,663,1427,0,3335,20812,17477,663,1427
77330.0,PALMAS,8293,44,1229,6,2014,4124,579,1676,0,3899,21864,17965,579,1676
77356.0,PALMEIRA,8983,98,1297,10,2214,4602,533,1017,0,2857,21611,18754,533,1017
77372.0,PALMITAL,3651,29,771,6,985,2085,265,1012,0,3389,12193,8804,265,1012
77399.0,PALOTINA,7836,34,1588,5,1143,4286,348,755,0,3102,19097,15995,348,755
77410.0,PARAISO DO NORTE,2912,12,376,1,361,1943,206,526,0,1386,7723,6337,206,526
77437.0,PARANACITY,2434,12,436,0,513,1362,189,515,0,1510,6971,5461,189,515
77453.0,PARANAGUA,37033,194,4040,10,15176,12122,1365,2380,0,10452,82772,72320,1365,2380
77470.0,PARANAPOEMA,790,3,82,0,100,329,35,152,0,186,1677,1491,35,152
77496.0,PARANAVAI,13618,121,6032,5,6145,15374,1129,2369,0,11628,56421,44793,1129,2369
77518.0,PATO BRANCO,19905,87,2650,13,3813,6846,746,1701,0,7825,43586,35761,746,1701
77534.0,PAULA FREITAS,1484,12,181,1,267,926,130,380,0,621,4002,3381,130,380
77550.0,PAULO FRONTIN,1857,19,197,1,340,1095,167,362,0,732,4770,4038,167,362
77577.0,PEABIRU,3031,41,643,4,934,2258,255,595,0,2508,10269,7761,255,595
77593.0,PEROLA D OESTE,2546,12,309,1,389,792,73,364,0,524,5010,4486,73,364
77615.0,PIEN,2642,20,285,3,451,1438,251,389,0,224,5703,5479,251,389
77631.0,PINHALAO,1189,5,350,4,252,1461,117,419,0,640,4437,3797,117,419
77658.0,PINHAO,7825,66,981,14,1611,2524,482,1538,0,3810,18851,15041,482,1538
77674.0,PIRAI DO SUL,5331,62,733,7,1584,4200,625,1148,0,2807,16497,13690,625,1148
77690.0,PIRAQUARA,18784,153,1475,12,5555,4657,929,1704,0,6413,39682,33269,929,1704
77712.0,PITANGA,8264,67,1018,11,1687,6005,593,1792,0,5517,24954,19437,593,1792
77739.0,PLANALTINA DO PARANA,1164,5,425,1,211,254,67,242,0,334,2703,2369,67,242
77755.0,PLANALTO,5331,17,393,3,347,1206,150,579,0,1091,9117,8026,150,579
77771.0,PONTA GROSSA,64166,1188,16067,85,26509,43054,4412,7345,0,26443,189269,162826,4412,7345
77798.0,PORECATU,2884,24,1282,7,2352,2047,248,915,0,3661,13420,9759,248,915
77810.0,PORTO AMAZONAS,1138,12,146,2,414,570,109,184,0,310,2885,2575,109,184
77836.0,PORTO RICO,530,4,191,0,176,519,46,182,0,326,1974,1648,46,182
77852.0,PORTO VITORIA,1184,11,224,1,258,487,73,161,0,270,2669,2399,73,161
77879.0,PRESIDENTE CASTELO BRANCO,1252,9,202,1,334,763,78,276,0,461,3376,2915,78,276
77895.0,PRIMEIRO DE MAIO,1769,20,233,1,624,2959,196,530,0,498,6830,6332,196,530
77917.0,PRUDENTOPOLIS,11534,118,2736,27,2637,7614,991,2863,0,6468,34988,28520,991,2863
77933.0,QUATIGUA,1396,8,206,0,367,2211,169,342,0,1192,5891,4699,169,342
77950.0,QUATRO BARRAS,4519,34,705,5,1996,2220,328,655,0,1908,12370,10462,328,655
77976.0,QUERENCIA DO NORTE,2889,15,334,0,413,1423,152,769,0,1923,7918,5995,152,769
77992.0,QUINTA DO SOL,890,10,327,1,812,663,132,381,0,512,3728,3216,132,381
78018.0,QUITANDINHA,3404,26,493,2,839,2448,513,819,0,523,9067,8544,513,819
78034.0,RANCHO ALEGRE,794,14,190,3,477,962,102,221,0,340,3103,2763,102,221
78050.0,REALEZA,4746,34,553,4,543,1862,208,633,0,854,9437,8583,208,633
78077.0,REBOUCAS,4461,57,705,3,1128,1476,266,570,0,1670,10336,8666,266,570
78093.0,RENASCENCA,2265,3,277,3,289,1081,108,269,0,1224,5519,4295,108,269
78115.0,RESERVA,6616,24,712,1,1797,2617,547,1495,0,3789,17598,13809,547,1495
78131.0,RIBEIRAO CLARO,2384,18,234,2,508,3232,303,551,0,2161,9393,7232,303,551
78158.0,RIBEIRAO DO PINHAL,3014,23,376,2,874,2777,308,588,0,3198,11160,7962,308,588
78174.0,RIO AZUL,3959,36,610,8,747,1682,259,622,0,1138,9061,7923,259,622
78190.0,RIO BOM,710,9,100,1,241,846,91,270,0,311,2579,2268,91,270
78212.0,RIO BRANCO DO SUL,7680,36,545,4,3380,2946,840,1537,0,1761,18729,16968,840,1537
78239.0,RIO NEGRO,8813,136,1167,7,1910,4024,489,958,0,2895,20399,17504,489,958
78255.0,ROLANDIA,9519,78,2408,9,5368,11136,1128,1252,0,6446,37344,30898,1128,1252
78271.0,RONCADOR,3000,28,408,1,488,2308,168,933,0,1217,8551,7334,168,933
78298.0,RONDON,2376,14,326,1,260,1654,137,539,0,707,6014,5307,137,539
78310.0,SABAUDIA,1471,7,174,1,581,1153,163,289,0,527,4366,3839,163,289
78336.0,SALGADO FILHO,1487,9,146,0,267,700,81,285,0,454,3429,2975,81,285
78352.0,SALTO DO ITARARE,985,13,118,2,314,1624,126,265,0,1074,4521,3447,126,265
78379.0,SALTO DO LONTRA,3727,29,310,3,523,1919,278,625,0,1349,8763,7414,278,625
78395.0,SANTA AMELIA,1129,5,114,0,168,826,169,292,0,435,3138,2703,169,292
78417.0,SANTA CECILIA DO PAVAO,698,4,151,0,457,598,82,406,0,421,2817,2396,82,406
78433.0,SANTA CRUZ DO MONTE CASTELO,1407,4,672,0,411,1310,161,683,0,724,5372,4648,161,683
78450.0,SANTA FE,1784,13,372,0,649,2289,277,431,0,1395,7210,5815,277,431
78476.0,SANTA INES,511,1,91,0,83,487,33,153,0,170,1529,1359,33,153
78492.0,SANTA IZABEL DO IVAI,1606,11,576,1,405,1863,158,648,0,990,6258,5268,158,648
78514.0,SANTA IZABEL DO OESTE,3214,11,291,4,286,1655,230,487,0,571,6749,6178,230,487
78530.0,SANTA MARIANA,3305,28,582,3,786,1884,263,845,0,1264,8960,7696,263,845
78557.0,SANTA ANA DO ITARARE,1218,24,84,1,179,1291,134,311,0,570,3812,3242,134,311
78573.0,SANTO ANTONIO DO SUDOESTE,4146,10,389,4,944,2588,265,670,0,779,9795,9016,265,670
78590.0,SANTO ANTONIO DA PLATINA,8280,65,1825,8,3518,6535,1112,1831,0,7015,30189,23174,1112,1831
78611.0,SANTO ANTONIO DO CAIUA,772,4,298,1,42,349,47,318,0,257,2088,1831,47,318
78638.0,SANTO ANTONIO DO PARAISO,551,5,90,0,262,468,63,127,0,243,1809,1566,63,127
78654.0,SANTO INACIO,1418,4,252,0,268,764,44,328,0,475,3553,3078,44,328
78670.0,SAO CARLOS DO IVAI,937,0,177,1,320,1516,172,350,0,745,4218,3473,172,350
78697.0,SAO JERONIMO DA SERRA,1874,9,279,0,954,2020,147,1088,0,1107,7478,6371,147,1088
78719.0,SAO JOAO,3703,7,339,5,509,1288,164,624,0,927,7566,6639,164,624
78735.0,SAO JOAO DO CAIUA,1235,18,570,0,261,794,102,702,0,1136,4818,3682,102,702
78751.0,SAO JOAO DO IVAI,2477,17,319,1,1455,2294,192,945,0,1518,9218,7700,192,945
78778.0,SAO JOAO DO TRIUNFO,4444,20,413,1,530,1208,333,673,0,1121,8743,7622,333,673
78794.0,SAO JORGE DO IVAI,1446,4,185,0,270,1553,109,272,0,822,4661,3839,109,272
78816.0,SAO JORGE D OESTE,3574,27,242,5,288,977,162,535,0,918,6728,5810,162,535
78832.0,SAO JOSE DA BOA VISTA,978,9,143,0,309,1947,69,255,0,555,4265,3710,69,255
78859.0,SAO JOSE DOS PINHAIS,60354,654,6757,42,13777,21741,3356,4753,0,16335,127769,111434,3356,4753
78875.0,SAO MATEUS DO SUL,11577,59,1399,10,1560,5690,628,1675,0,3229,25827,22598,628,1675
78891.0,SAO MIGUEL DO IGUACU,8536,38,925,6,1631,3157,318,922,0,3473,19006,15533,318,922
78913.0,SAO PEDRO DO IVAI,1850,20,362,1,521,1803,177,578,0,762,6074,5312,177,578
78930.0,SAO PEDRO DO PARANA,493,3,172,5,116,604,49,185,0,251,1878,1627,49,185
78956.0,SAO SEBASTIAO DA AMOREIRA,2007,18,292,3,581,1289,137,643,0,740,5710,4970,137,643
78972.0,SAO TOME,899,9,131,0,289,1336,88,366,0,430,3548,3118,88,366
78999.0,SAPOPEMA,1768,7,139,3,379,847,143,403,0,394,4083,3689,143,403
79014.0,SENGES,3876,28,444,3,1954,2118,400,844,0,2226,11893,9667,400,844
79030.0,SERTANEJA,1258,9,283,5,545,1369,119,319,0,565,4472,3907,119,319
79057.0,SERTANOPOLIS,2925,32,626,1,1271,3590,374,790,0,1813,11422,9609,374,790
79073.0,SIQUEIRA CAMPOS,4205,42,263,2,718,3453,415,612,0,2581,12291,9710,415,612
79090.0,TAMBOARA,767,6,376,2,178,886,127,319,0,346,3007,2661,127,319
79111.0,TAPEJARA,2593,19,411,3,1124,2218,261,689,0,1120,8438,7318,261,689
79138.0,TEIXEIRA SOARES,2114,25,463,1,666,1233,161,412,0,997,6072,5075,161,412
79154.0,TELEMACO BORBA,17091,152,2537,16,7234,5081,854,1559,0,7661,42185,34524,854,1559
79170.0,TERRA BOA,2272,18,432,0,907,4277,284,779,0,1105,10074,8969,284,779
79197.0,TERRA RICA,2587,25,996,1,845,2729,191,797,0,1304,9475,8171,191,797
79219.0,TERRA ROXA,3423,30,725,1,879,3368,271,1046,0,1476,11219,9743,271,1046
79235.0,TIBAGI,3876,40,700,3,1084,2578,356,885,0,2343,11865,9522,356,885
79251.0,TIJUCAS DO SUL,2932,20,379,1,576,2348,283,507,0,1580,8626,7046,283,507
79278.0,TOLEDO,29897,252,4207,23,6173,14103,1269,2824,0,11002,69750,58748,1269,2824
79294.0,TOMAZINA,1221,24,220,0,209,2811,159,513,0,751,5908,5157,159,513
79316.0,TUNEIRAS DO OESTE,1670,20,445,0,994,1136,175,486,0,847,5773,4926,175,486
79332.0,UBIRATA,4242,65,1357,6,1411,3766,423,1042,0,2072,14384,12312,423,1042
79359.0,UMUARAMA,24283,244,3448,5,6986,14426,1189,2997,0,15970,69548,53578,1189,2997
79375.0,UNIAO DA VITORIA,14874,139,2766,11,3229,6292,651,1601,0,6428,35991,29563,651,1601
79391.0,UNIFLOR,951,4,92,0,145,338,49,155,0,472,2206,1734,49,155
79413.0,URAI,2370,42,336,4,839,2582,255,697,0,1129,8254,7125,255,697
79430.0,WENCESLAU BRAZ,3242,61,589,7,1632,3371,381,1114,0,1199,11596,10397,381,1114
79456.0,VERE,3286,14,219,2,318,1312,129,360,0,533,6173,5640,129,360
79472.0,VITORINO,1838,12,188,2,224,876,88,281,0,782,4291,3509,88,281
79499.0,XAMBRE,1605,23,347,0,424,1314,131,242,0,756,4842,4086,131,242
79510.0,ALTONIA,3549,49,587,0,1200,4019,436,1239,0,2213,13292,11079,436,1239
79537.0,ASSIS CHATEAUBRIAND,7988,106,1361,4,1692,6407,738,1422,0,3134,22852,19718,738,1422
79553.0,QUEDAS DO IGUACU,7600,60,743,4,1282,2404,443,1217,0,4801,18554,13753,443,1217
79570.0,CEU AZUL,3471,26,357,0,687,1319,140,417,0,836,7253,6417,140,417
79596.0,GRANDES RIOS,1076,11,198,2,523,1505,94,618,0,796,4823,4027,94,618
79618.0,INDIANOPOLIS,832,4,136,0,193,924,117,372,0,286,2864,2578,117,372
79634.0,MATINHOS,5925,37,1339,3,2618,2811,331,797,0,4126,17987,13861,331,797
79650.0,NOVA AURORA,3301,45,329,3,790,1963,286,671,0,628,8016,7388,286,671
79677.0,NOVA OLIMPIA,1351,15,180,0,277,999,71,399,0,679,3971,3292,71,399
79693.0,PEROLA,2254,40,548,2,534,1654,209,681,0,1913,7835,5922,209,681
79715.0,SANTA HELENA,7721,24,1240,2,1000,2627,223,802,0,1889,15528,13639,223,802
79731.0,TAPIRA,1423,14,285,0,340,909,133,407,0,644,4155,3511,133,407
79758.0,MARILENA,1243,6,274,0,316,1209,125,690,0,1305,5168,3863,125,690
79774.0,FRANCISCO ALVES,1454,40,401,1,558,1168,198,462,0,927,5209,4282,198,462
79790.0,NOVA SANTA ROSA,1346,14,315,1,1602,1050,66,241,0,466,5101,4635,66,241
79812.0,BOA VISTA DA APARECIDA,1624,15,206,1,493,1323,233,404,0,522,4821,4299,233,404
79839.0,BRAGANEY,1631,18,286,1,192,879,122,423,0,503,4055,3552,122,423
79855.0,CAFELANDIA,3144,41,349,2,493,1928,178,496,0,1146,7777,6631,178,496
79871.0,TRES BARRAS DO PARANA,2912,18,207,1,492,1971,170,725,0,1051,7547,6496,170,725
79898.0,VERA CRUZ DO OESTE,1773,21,724,0,697,1541,144,506,0,890,6296,5406,144,506
79910.0,PRANCHITA,1947,8,133,3,311,930,74,268,0,436,4110,3674,74,268
79936.0,TUPASSI,1936,23,307,0,541,1810,235,344,0,669,5865,5196,235,344
79952.0,NOVA PRATA DO IGUACU,3508,12,247,4,381,1210,108,470,0,1333,7273,5940,108,470
79979.0,JESUITAS,2253,24,341,4,517,1815,225,601,0,1109,6889,5780,225,601
79995.0,SAO JORGE DO PATROCINIO,1365,14,232,1,281,1327,140,527,0,734,4621,3887,140,527
80004.0,MONTE CARLO,2792,6,189,2,462,992,206,527,0,1230,6406,5176,206,527
80012.0,ABELARDO LUZ,4916,17,510,4,868,1485,290,769,0,2316,11175,8859,290,769
80020.0,IPORA DO OESTE,3240,14,267,1,286,659,126,285,0,1054,5932,4878,126,285
80039.0,AGROLANDIA,1821,18,416,2,564,1466,189,366,0,689,5531,4842,189,366
80047.0,LINDOIA DO SUL,2389,11,127,4,148,315,79,195,0,500,3768,3268,79,195
80055.0,AGRONOMICA,1127,11,149,1,245,877,64,181,0,172,2827,2655,64,181
80063.0,APIUNA,2633,16,476,4,556,1169,221,361,0,992,6428,5436,221,361
80071.0,AGUA DOCE,2081,23,170,2,355,989,90,361,0,781,4852,4071,90,361
80080.0,DOUTOR PEDRINHO,975,12,89,2,228,680,86,162,0,272,2506,2234,86,162
80098.0,AGUAS DE CHAPECO,2164,12,106,2,683,344,170,245,0,857,4583,3726,170,245
80101.0,JOSE BOITEUX,1058,12,147,3,396,751,93,254,0,540,3254,2714,93,254
80110.0,AGUAS MORNAS,1136,31,257,5,335,1716,178,301,0,206,4165,3959,178,301
80128.0,VITOR MEIRELES,1506,10,173,3,549,691,63,301,0,794,4090,3296,63,301
80136.0,ALFREDO WAGNER,1546,29,216,1,611,2788,185,449,0,992,6817,5825,185,449
80144.0,UNIAO DO OESTE,1315,9,111,0,194,396,78,168,0,492,2763,2271,78,168
80152.0,ANCHIETA,2649,10,146,1,326,772,98,309,0,1502,5813,4311,98,309
80160.0,URUPEMA,691,15,163,0,101,506,45,187,0,182,1890,1708,45,187
80179.0,ANGELINA,1455,27,293,2,472,1426,99,380,0,361,4515,4154,99,380
80187.0,IRACEMINHA,1666,27,250,2,366,478,93,231,0,723,3836,3113,93,231
80195.0,ANITA GARIBALDI,1847,16,356,0,440,1906,227,652,0,2028,7472,5444,227,652
80209.0,TIMBO GRANDE,1006,4,158,1,685,969,95,404,0,916,4238,3322,95,404
80217.0,ANITAPOLIS,822,16,122,2,180,845,96,134,0,273,2490,2217,96,134
80225.0,ABDON BATISTA,765,13,117,0,151,636,62,182,0,233,2159,1926,62,182
80233.0,ANTONIO CARLOS,1795,28,463,2,247,1526,119,274,0,253,4707,4454,119,274
80241.0,SANTA ROSA DO SUL,2507,10,256,2,810,914,169,343,0,889,5900,5011,169,343
80250.0,ARAQUARI,4254,33,290,6,1278,1718,212,520,0,1723,10034,8311,212,520
80268.0,CELSO RAMOS,768,8,132,1,137,413,85,148,0,249,1941,1692,85,148
80276.0,ARARANGUA,18006,124,2096,11,4839,5226,695,1574,0,5570,38141,32571,695,1574
80284.0,SERRA ALTA,1422,5,68,0,64,285,87,137,0,423,2491,2068,87,137
80292.0,ARMAZEM,1950,24,479,1,443,1036,149,337,0,753,5172,4419,149,337
80306.0,COCAL DO SUL,6060,42,309,3,805,868,151,379,0,1251,9868,8617,151,379
80314.0,ARROIO TRINTA,1445,17,185,2,189,386,64,156,0,344,2788,2444,64,156
80322.0,NOVA ITABERABA,1953,13,70,1,339,407,77,171,0,536,3567,3031,77,171
80330.0,ASCURRA,2406,15,268,1,488,911,225,290,0,704,5308,4604,225,290
80349.0,SANTA TEREZINHA,2845,21,441,2,358,775,143,377,0,831,5793,4962,143,377
80357.0,ATALANTA,1122,13,184,7,412,618,61,152,0,349,2918,2569,61,152
80365.0,MIRIM DOCE,918,4,100,0,210,369,28,167,0,217,2013,1796,28,167
80373.0,AURORA,1815,18,175,3,509,789,107,196,0,518,4130,3612,107,196
80381.0,CERRO NEGRO,793,4,182,1,315,639,128,274,0,938,3274,2336,128,274
80390.0,BALNEARIO DE CAMBORIU,19951,234,4479,13,6415,11953,981,1695,0,9485,55206,45721,981,1695
80403.0,PASSO DE TORRES,1229,8,272,0,399,801,75,212,0,562,3558,2996,75,212
80411.0,BARRA VELHA,2813,24,560,5,1873,2216,291,681,0,2171,10634,8463,291,681
80420.0,BRACO DO TROMBUDO,575,9,94,1,222,1119,56,189,0,351,2616,2265,56,189
80438.0,BENEDITO NOVO,2680,25,506,3,583,2004,203,409,0,625,7038,6413,203,409
80446.0,SUL BRASIL,1294,5,132,2,254,103,29,162,0,407,2388,1981,29,162
80454.0,BIGUACU,11528,221,1418,8,3246,6538,977,1695,0,3261,28892,25631,977,1695
80462.0,VARGEM,613,0,117,1,244,819,76,247,0,643,2760,2117,76,247
80470.0,BLUMENAU,67709,1822,15423,83,19774,48959,3859,6842,0,19661,184132,164471,3859,6842
80489.0,ARABUTA,1947,12,160,2,171,461,68,145,0,295,3261,2966,68,145
80497.0,BOM RETIRO,1769,37,311,1,416,1863,191,542,0,1061,6191,5130,191,542
80500.0,AGUAS FRIAS,1308,3,80,0,118,221,33,83,0,334,2180,1846,33,83
80519.0,BOTUVERA,1626,10,145,0,75,520,148,199,0,153,2876,2723,148,199
80527.0,GUATAMBU,1818,4,125,0,313,643,64,322,0,485,3774,3289,64,322
80535.0,BRACO DO NORTE,7626,75,962,9,1052,4462,491,935,0,1729,17341,15612,491,935
80543.0,PLANALTO ALEGRE,1098,6,64,1,212,205,37,106,0,152,1881,1729,37,106
80551.0,BRUSQUE,27731,244,5828,28,4004,9480,871,1575,0,5103,54864,49761,871,1575
80560.0,RIQUEZA,2134,13,64,2,293,348,69,280,0,775,3978,3203,69,280
80578.0,CACADOR,22775,164,1795,14,3545,5475,978,2227,0,6490,43463,36973,978,2227
80586.0,LAGEADO GRANDE,758,6,66,0,46,158,17,110,0,114,1275,1161,17,110
80594.0,CAIBI,2596,7,169,2,365,488,69,363,0,991,5050,4059,69,363
80608.0,RIO RUFINO,580,16,90,0,171,509,56,177,0,314,1913,1599,56,177
80616.0,CAMBORIU,8716,97,1069,0,5434,3668,517,1237,0,3771,24509,20738,517,1237
80624.0,PASSOS MAIA,1282,3,49,2,160,558,63,199,0,586,2902,2316,63,199
80632.0,CAMPO ALEGRE,2483,36,400,6,727,2945,196,533,0,883,8209,7326,196,533
80640.0,SAO JOAO DO OESTE,2917,11,302,8,158,417,60,167,0,753,4793,4040,60,167
80659.0,CAMPO BELO DO SUL,1838,13,475,0,341,1302,182,633,0,1574,6358,4784,182,633
80667.0,CALMON,775,3,551,0,173,173,19,220,0,330,2244,1914,19,220
80675.0,CAMPO ERE,2973,9,360,4,625,894,162,609,0,2284,7920,5636,162,609
80683.0,BALNEARIO DE BARRA DO SUL,1565,15,185,1,870,831,80,239,0,821,4607,3786,80,239
80691.0,CAMPOS NOVOS,8045,70,1162,11,1409,4474,770,1424,0,3691,21056,17365,770,1424
80705.0,PARAISO,1731,6,157,2,226,536,66,205,0,749,3678,2929,66,205
80713.0,CANELINHA,2432,19,425,3,612,1301,240,475,0,970,6477,5507,240,475
80721.0,SANTA HELENA,1080,4,94,1,140,161,42,132,0,233,1887,1654,42,132
80730.0,CANOINHAS,15250,161,1856,18,3295,7468,713,1993,0,5580,36334,30754,713,1993
80748.0,BELMONTE,1088,3,45,1,142,221,23,178,0,240,1941,1701,23,178
80756.0,CAPINZAL,6904,42,711,4,1163,1957,362,949,0,1899,13991,12092,362,949
80764.0,NOVO HORIZONTE,1039,11,153,1,147,465,65,146,0,412,2439,2027,65,146
80772.0,CATANDUVAS,2480,9,197,8,539,1083,125,437,0,745,5623,4878,125,437
80780.0,SAO MIGUEL DA BOA VISTA,630,3,71,5,132,219,52,98,0,239,1449,1210,52,98
80799.0,CAXAMBU DO SUL,2086,14,131,0,464,594,101,301,0,727,4418,3691,101,301
80802.0,ARVOREDO,1092,4,46,2,238,159,26,129,0,139,1835,1696,26,129
80810.0,CHAPECO,40957,321,5629,12,13109,16505,1424,3557,0,13188,94702,81514,1424,3557
80829.0,IPUACU,1617,4,210,0,443,275,52,344,0,588,3533,2945,52,344
80837.0,CONCORDIA,25317,149,1732,20,3118,7188,780,1596,0,6236,46136,39900,780,1596
80845.0,OURO VERDE,819,1,22,0,138,426,53,161,0,330,1950,1620,53,161
80853.0,CORONEL FREITAS,3658,10,287,2,572,1462,224,455,0,977,7647,6670,224,455
80861.0,IRATI,798,5,57,0,277,208,35,117,0,420,1917,1497,35,117
80870.0,CORUPA,4587,42,270,2,498,2304,192,496,0,1058,9449,8391,192,496
80888.0,FORMOSA DO SUL,1096,4,77,1,207,195,30,127,0,361,2098,1737,30,127
80896.0,CRICIUMA,63273,576,6506,20,16478,11475,1751,3956,0,14576,118611,104035,1751,3956
80900.0,MACIEIRA,737,6,67,0,162,153,45,102,0,138,1410,1272,45,102
80918.0,CUNHA PORA,2864,37,675,4,994,1663,179,501,0,1349,8266,6917,179,501
80926.0,PONTE ALTA DO NORTE,807,4,39,0,172,411,26,197,0,366,2022,1656,26,197
80934.0,CURITIBANOS,10475,84,1552,11,2074,5037,676,1932,0,5179,27020,21841,676,1932
80942.0,SAO CRISTOVAO DO SUL,1104,8,115,0,336,448,68,246,0,599,2924,2325,68,246
80950.0,DESCANSO,3833,13,268,2,449,885,154,344,0,1493,7441,5948,154,344
80969.0,VARGEM BONITA,1710,7,114,2,359,454,55,200,0,311,3212,2901,55,200
80977.0,DIONISIO CERQUEIRA,3746,34,614,2,1134,1535,174,844,0,3555,11638,8083,174,844
80985.0,BOMBINHAS,1838,32,662,3,752,1670,145,272,0,1204,6578,5374,145,272
80993.0,DONA EMMA,1072,6,175,3,194,532,59,160,0,440,2641,2201,59,160
81000.0,SANGAO,1845,21,207,1,677,1081,167,357,0,726,5082,4356,167,357
81019.0,ERVAL VELHO,1184,6,157,0,265,907,79,259,0,302,3159,2857,79,259
81027.0,CAPIVARI DE BAIXO,8648,36,373,2,1172,1098,177,633,0,1770,13909,12139,177,633
81035.0,FAXINAL DOS GUEDES,3602,11,282,1,525,1037,118,391,0,1025,6992,5967,118,391
81043.0,CORDILHEIRA ALTA,1336,2,75,0,84,431,47,132,0,108,2215,2107,47,132
81051.0,FLORIANOPOLIS,126343,2021,18790,125,18075,45671,4368,9108,0,31503,256004,224501,4368,9108
81060.0,FORQUILHINHA,7973,40,519,2,1241,1051,211,592,0,1157,12786,11629,211,592
81078.0,FRAIBURGO,11950,62,782,3,1792,2366,484,1343,0,4040,22822,18782,484,1343
81086.0,MORRO GRANDE,1146,18,99,6,246,338,45,135,0,126,2159,2033,45,135
81094.0,GALVAO,1525,13,139,5,158,368,73,191,0,670,3142,2472,73,191
81108.0,CORONEL MARTINS,776,7,86,1,203,348,35,138,0,388,1982,1594,35,138
81116.0,GOVERNADOR CELSO RAMOS,2338,33,680,3,1611,2249,226,582,0,1608,9330,7722,226,582
81124.0,SAO JOAO DO ITAPERIU,842,18,97,0,275,671,62,182,0,506,2653,2147,62,182
81132.0,GAROPABA,3879,32,436,3,611,2742,307,620,0,1561,10191,8630,307,620
81140.0,JARDINOPOLIS,902,5,44,1,141,167,26,112,0,261,1659,1398,26,112
81159.0,GARUVA,2974,33,325,5,1079,1648,158,470,0,1426,8118,6692,158,470
81167.0,ERMO,1131,10,86,2,392,251,51,172,0,297,2392,2095,51,172
81175.0,GASPAR,11850,204,2293,12,3609,7966,764,1300,0,3258,31256,27998,764,1300
81183.0,SAO PEDRO DE ALCANTARA,1287,21,207,1,214,975,106,234,0,324,3369,3045,106,234
81191.0,GRAO PARA,1992,35,429,9,368,1005,137,381,0,429,4785,4356,137,381
81205.0,SANTIAGO DO SUL,688,4,22,0,72,173,33,70,0,329,1391,1062,33,70
81213.0,GRAVATAL,2785,32,534,1,449,1445,161,419,0,511,6337,5826,161,419
81221.0,BELA VISTA DO TOLDO,1591,17,147,1,337,1042,96,296,0,557,4084,3527,96,296
81230.0,GUABIRUBA,4989,40,580,5,478,1603,289,457,0,686,9127,8441,289,457
81248.0,CAPAO ALTO,751,11,370,0,296,630,51,180,0,494,2783,2289,51,180
81256.0,GUARACIABA,3930,33,264,8,726,1309,183,347,0,790,7590,6800,183,347
81264.0,PAINEL,697,4,210,2,211,591,40,177,0,398,2330,1932,40,177
81272.0,GUARAMIRIM,8856,93,752,7,1669,2817,322,654,0,1959,17129,15170,322,654
81280.0,BOCAINA DO SUL,727,8,346,1,254,688,50,270,0,467,2811,2344,50,270
81299.0,GUARUJA DO SUL,1546,13,216,0,268,621,92,173,0,770,3699,2929,92,173
81302.0,ALTO BELA VISTA,1113,3,172,2,40,132,20,76,0,235,1793,1558,20,76
81310.0,HERVAL DO OESTE,6705,44,515,3,973,2639,310,741,0,1928,13858,11930,310,741
81329.0,FREI ROGERIO,918,20,94,5,172,349,35,134,0,350,2077,1727,35,134
81337.0,IBICARE,1383,22,118,5,219,467,95,181,0,271,2761,2490,95,181
81345.0,TREVISO,1722,12,129,1,208,264,32,144,0,238,2750,2512,32,144
81353.0,IBIRAMA,4228,43,625,7,1104,2948,314,694,0,1615,11578,9963,314,694
81361.0,IOMERE,979,17,85,0,112,555,58,110,0,259,2175,1916,58,110
81370.0,ICARA,18690,101,1006,7,4278,2958,652,1413,0,3997,33102,29105,652,1413
81388.0,BOM JESUS,995,3,38,0,167,163,37,140,0,344,1887,1543,37,140
81396.0,ILHOTA,3078,31,463,2,1187,1646,226,533,0,1106,8272,7166,226,533
81400.0,IBIAM,879,4,78,4,79,283,32,97,0,237,1693,1456,32,97
81418.0,IMARUI,3851,29,415,0,907,1895,264,916,0,1739,10016,8277,264,916
81426.0,ENTRE RIOS,735,5,168,2,335,155,62,192,0,447,2101,1654,62,192
81434.0,IMBITUBA,13863,118,1297,8,2277,2702,503,1476,0,4022,26266,22244,503,1476
81442.0,PAIAL,829,4,107,3,174,221,29,70,0,324,1761,1437,29,70
81450.0,IMBUIA,1198,17,84,2,416,1518,108,261,0,446,4050,3604,108,261
81469.0,BOM JESUS DO OESTE,819,6,97,1,116,195,36,120,0,234,1624,1390,36,120
81477.0,INDAIAL,10993,195,1893,16,3026,7344,877,1495,0,3235,29074,25839,877,1495
81485.0,SAO BERNARDINO,1143,7,46,0,205,177,43,138,0,396,2155,1759,43,138
81493.0,IPIRA,1875,8,222,0,208,441,104,196,0,481,3535,3054,104,196
81507.0,SANTA TEREZINHA DO PROGRESSO,1063,7,91,2,274,325,63,185,0,789,2799,2010,63,185
81515.0,IPUMIRIM,2724,12,275,1,437,839,133,275,0,640,5336,4696,133,275
81523.0,SALTINHO,1526,5,85,0,262,207,90,224,0,734,3133,2399,90,224
81531.0,IRANI,3065,13,168,0,584,632,128,364,0,859,5813,4954,128,364
81540.0,JUPIA,858,5,52,0,114,260,30,131,0,308,1758,1450,30,131
81558.0,IRINEOPOLIS,2994,32,445,5,589,1074,118,473,0,1103,6833,5730,118,473
81566.0,PALMEIRA,811,2,165,0,365,303,47,168,0,391,2252,1861,47,168
81574.0,ITA,2594,10,152,3,219,629,74,172,0,882,4735,3853,74,172
81582.0,BANDEIRANTE,1480,6,96,1,118,333,40,136,0,652,2862,2210,40,136
81590.0,ITAIOPOLIS,5411,90,694,8,1076,2919,423,951,0,2107,13679,11572,423,951
81604.0,FLOR DO SERTAO,614,3,27,2,76,229,41,114,0,336,1442,1106,41,114
81612.0,ITAJAI,42733,505,6640,31,13467,17679,2251,3872,0,14152,101330,87178,2251,3872
81620.0,CUNHATAI,659,6,132,2,114,309,36,66,0,177,1501,1324,36,66
81639.0,ITAPEMA,6093,49,1206,4,2703,4271,400,774,0,2724,18224,15500,400,774
81647.0,PRINCESA,1013,8,45,0,107,325,63,107,0,370,2038,1668,63,107
81655.0,ITAPIRANGA,6119,32,414,13,545,1230,108,431,0,1890,10782,8892,108,431
81663.0,ITAPOA,2366,29,405,0,580,1311,119,362,0,1526,6698,5172,119,362
81671.0,ITUPORANGA,6328,52,577,3,1817,3337,313,841,0,1954,15222,13268,313,841
81680.0,TIGRINHOS,826,1,48,0,157,148,40,116,0,318,1654,1336,40,116
81698.0,JABORA,1644,13,100,1,252,672,92,238,0,481,3493,3012,92,238
81701.0,CHAPADAO DO LAGEADO,857,6,84,1,291,490,47,132,0,289,2197,1908,47,132
81710.0,JACINTO MACHADO,3455,39,540,2,1052,940,247,603,0,708,7586,6878,247,603
81728.0,BALNEARIO ARROIO DO SILVA,2320,15,352,2,394,513,62,297,0,938,4893,3955,62,297
81736.0,JAGUARUNA,4365,21,440,1,1298,2067,255,635,0,1511,10593,9082,255,635
81744.0,BALNEARIO GAIVOTA,1981,10,317,1,555,496,83,258,0,724,4425,3701,83,258
81752.0,JARAGUA DO SUL,42691,302,3965,22,5423,13735,1195,2319,0,7674,77326,69652,1195,2319
81760.0,BARRA BONITA,1014,5,34,0,178,234,42,127,0,428,2062,1634,42,127
81779.0,JOACABA,8105,76,977,8,1237,3949,334,817,0,2654,18157,15503,334,817
81787.0,BRUNOPOLIS,916,5,80,2,280,386,75,296,0,537,2577,2040,75,296
81795.0,JOINVILLE,140160,1688,10722,81,38480,54666,3772,9347,0,31523,290439,258916,3772,9347
81809.0,LUZERNA,2138,20,280,3,300,994,65,187,0,483,4470,3987,65,187
81817.0,LACERDOPOLIS,807,14,57,4,83,365,41,136,0,119,1626,1507,41,136
81825.0,ZORTEA,1123,8,49,2,112,297,55,124,0,243,2013,1770,55,124
81833.0,LAGES,37394,470,11188,28,10211,22210,1970,4207,0,16713,104391,87678,1970,4207
81850.0,LAGUNA,15952,172,1760,9,3095,6170,798,1553,0,3331,32840,29509,798,1553
81876.0,LAURENTINO,1487,10,362,4,163,1010,139,252,0,223,3650,3427,139,252
81892.0,LAURO MULLER,6116,27,418,2,796,1172,236,599,0,1305,10671,9366,236,599
81914.0,LEBON REGIS,3400,8,304,2,836,982,226,739,0,1557,8054,6497,226,739
81930.0,LEOBERTO LEAL,926,9,122,4,364,908,64,247,0,449,3093,2644,64,247
81957.0,LONTRAS,2412,20,380,2,465,1584,197,429,0,963,6452,5489,197,429
81973.0,LUIZ ALVES,2517,40,292,0,349,1688,157,316,0,595,5954,5359,157,316
81990.0,MAFRA,16846,291,1727,24,3047,7272,1002,1803,0,4736,36748,32012,1002,1803
82015.0,MAJOR GERCINO,819,14,146,1,230,590,105,165,0,291,2361,2070,105,165
82031.0,MAJOR VIEIRA,2807,25,195,3,260,731,143,325,0,730,5219,4489,143,325
82058.0,MARAVILHA,6784,37,626,8,1354,2243,322,707,0,2831,14912,12081,322,707
82066.0,MAREMA,1150,11,89,0,94,235,60,132,0,318,2089,1771,60,132
82074.0,MASSARANDUBA,4481,48,851,6,757,1937,247,443,0,1092,9862,8770,247,443
82090.0,MATOS COSTA,808,5,156,3,359,312,37,168,0,507,2355,1848,37,168
82112.0,MELEIRO,2556,18,363,2,497,734,142,267,0,377,4956,4579,142,267
82139.0,MODELO,1588,4,100,3,233,339,63,185,0,435,2950,2515,63,185
82155.0,MONDAI,3588,19,275,3,415,871,129,377,0,1148,6825,5677,129,377
82171.0,MONTE CASTELO,2113,10,327,1,741,1200,155,454,0,1430,6431,5001,155,454
82198.0,MORRO DA FUMACA,5676,35,402,1,1352,1163,240,510,0,1067,10446,9379,240,510
82210.0,NAVEGANTES,9584,118,1264,3,3160,5610,494,1174,0,4320,25727,21407,494,1174
82236.0,NOVA ERECHIM,1451,7,104,0,303,354,38,143,0,306,2706,2400,38,143
82252.0,NOVA TRENTO,3073,38,921,7,311,1742,413,391,0,925,7821,6896,413,391
82279.0,NOVA VENEZA,4767,41,536,0,428,1086,218,382,0,637,8095,7458,218,382
82295.0,ORLEANS,6379,89,825,9,1169,3281,511,846,0,1681,14790,13109,511,846
82317.0,OURO,2578,22,347,0,271,1153,127,389,0,648,5535,4887,127,389
82333.0,PALHOCA,28254,554,3017,20,5527,12558,1689,2932,0,5988,60539,54551,1689,2932
82350.0,PALMA SOLA,2689,15,174,2,445,609,108,456,0,1620,6118,4498,108,456
82376.0,PALMITOS,5436,38,488,7,919,2144,237,648,0,2376,12293,9917,237,648
82392.0,PAPANDUVA,5801,47,679,3,919,1596,286,840,0,2025,12196,10171,286,840
82414.0,PAULO LOPES,1446,12,147,0,676,1045,141,315,0,452,4234,3782,141,315
82430.0,PEDRAS GRANDES,1818,20,115,7,314,453,102,254,0,313,3396,3083,102,254
82457.0,PENHA,3334,61,611,2,1620,3065,274,615,0,2484,12066,9582,274,615
82473.0,PERITIBA,1518,4,128,1,124,346,48,134,0,232,2535,2303,48,134
82490.0,PETROLANDIA,1764,17,172,3,960,1030,105,320,0,642,5013,4371,105,320
82511.0,PICARRAS,2881,26,395,2,988,2045,154,448,0,1655,8594,6939,154,448
82538.0,PINHALZINHO,4930,14,470,6,710,1289,164,428,0,1267,9278,8011,164,428
82554.0,PINHEIRO PRETO,1088,7,100,0,88,351,39,152,0,271,2096,1825,39,152
82570.0,PIRATUBA,1627,19,180,5,292,678,99,274,0,384,3558,3174,99,274
82597.0,POMERODE,7407,97,1074,17,1513,4091,488,794,0,1568,17049,15481,488,794
82619.0,PONTE ALTA,1420,5,242,0,593,529,66,360,0,828,4043,3215,66,360
82635.0,PONTE SERRADA,3357,16,246,3,857,1013,166,517,0,1608,7783,6175,166,517
82651.0,PORTO BELO,2229,33,438,6,965,1726,195,441,0,1213,7246,6033,195,441
82678.0,PORTO UNIAO,9484,118,1502,3,1782,3953,439,1027,0,4241,22549,18308,439,1027
82694.0,POUSO REDONDO,3208,28,297,3,715,2233,267,577,0,1505,8833,7328,267,577
82716.0,PRAIA GRANDE,2598,13,252,0,583,811,126,480,0,939,5802,4863,126,480
82732.0,PRESIDENTE CASTELO BRANCO,1005,1,34,0,93,178,29,96,0,120,1556,1436,29,96
82759.0,PRESIDENTE GETULIO,4101,30,401,6,841,1991,253,434,0,1097,9154,8057,253,434
82775.0,PRESIDENTE NEREU,649,8,83,2,142,504,38,149,0,170,1745,1575,38,149
82791.0,QUILOMBO,3885,26,263,5,886,1000,170,365,0,1335,7935,6600,170,365
82813.0,RANCHO QUEIMADO,747,13,97,4,171,608,82,164,0,183,2069,1886,82,164
82830.0,RIO DAS ANTAS,2318,47,229,1,385,763,128,393,0,694,4958,4264,128,393
82856.0,RIO DO CAMPO,1859,15,253,2,567,1225,104,270,0,850,5145,4295,104,270
82872.0,RIO DO OESTE,2330,21,231,4,347,1202,136,260,0,599,5130,4531,136,260
82899.0,RIO DOS CEDROS,3127,40,423,8,453,1780,155,491,0,864,7341,6477,155,491
82910.0,RIO DO SUL,13301,157,2866,6,3273,10550,813,1848,0,5090,37904,32814,813,1848
82937.0,RIO FORTUNA,1413,22,450,0,299,762,97,214,0,182,3439,3257,97,214
82953.0,RIO NEGRINHO,11348,124,1644,8,2359,5381,446,1333,0,3059,25702,22643,446,1333
82970.0,RODEIO,3563,42,313,5,452,2012,296,489,0,902,8074,7172,296,489
82996.0,ROMELANDIA,1836,23,573,6,398,496,90,324,0,1701,5447,3746,90,324
83011.0,SALETE,2048,14,294,3,500,1246,126,307,0,843,5381,4538,126,307
83038.0,SALTO VELOSO,1302,14,380,1,150,445,54,225,0,351,2922,2571,54,225
83054.0,SANTA CECILIA,3870,18,591,1,917,1822,374,802,0,2056,10451,8395,374,802
83070.0,SANTA ROSA DE LIMA,625,17,221,2,162,313,37,95,0,83,1555,1472,37,95
83097.0,SANTO AMARO DA IMPERATRIZ,4684,117,770,3,680,3569,329,814,0,1009,11975,10966,329,814
83119.0,SAO BENTO DO SUL,24225,150,2265,5,3593,9241,600,1709,0,4382,46170,41788,600,1709
83135.0,SAO BONIFACIO,518,15,131,1,136,1157,133,152,0,208,2451,2243,133,152
83151.0,SAO CARLOS,3404,17,433,6,710,995,179,337,0,1128,7209,6081,179,337
83178.0,SAO DOMINGOS,3423,20,422,4,415,1023,222,503,0,1338,7370,6032,222,503
83194.0,SAO FRANCISCO DO SUL,9544,118,1320,6,3019,4521,404,1119,0,3877,23928,20051,404,1119
83216.0,SAO JOAO BATISTA,4529,68,870,3,952,2486,537,673,0,1354,11472,10118,537,673
83232.0,SAO JOAO DO SUL,2387,13,259,0,700,873,103,426,0,777,5538,4761,103,426
83259.0,SAO JOAQUIM,6771,114,863,10,981,4258,526,1181,0,2667,17371,14704,526,1181
83275.0,SAO JOSE,56139,966,6994,43,10390,21070,2610,4704,0,12163,115079,102916,2610,4704
83291.0,SAO JOSE DO CEDRO,5062,23,463,4,684,1438,177,561,0,2246,10658,8412,177,561
83313.0,SAO JOSE DO CERRITO,2151,29,437,1,473,1859,193,444,0,2146,7733,5587,193,444
83330.0,SAO LOURENCO DO OESTE,5680,42,636,5,1200,3113,442,812,0,2970,14900,11930,442,812
83356.0,SAO LUDGERO,3074,22,296,2,447,1204,197,308,0,644,6194,5550,197,308
83372.0,SAO MARTINHO,827,23,263,5,176,903,132,163,0,207,2699,2492,132,163
83399.0,SAO MIGUEL DO OESTE,11523,69,1383,3,1465,2960,346,866,0,4496,23111,18615,346,866
83410.0,SAUDADES,3029,9,381,4,358,1292,116,249,0,700,6138,5438,116,249
83437.0,SCHROEDER,5205,29,313,3,600,1161,144,291,0,802,8548,7746,144,291
83453.0,SEARA,6297,37,414,12,804,2236,207,512,0,1512,12031,10519,207,512
83470.0,SIDEROPOLIS,5671,33,363,1,581,880,137,403,0,1167,9236,8069,137,403
83496.0,SOMBRIO,7844,56,685,2,1980,1968,317,885,0,2268,16005,13737,317,885
83518.0,TAIO,4338,61,803,3,1877,2434,315,840,0,1852,12523,10671,315,840
83534.0,TANGARA,2471,19,273,4,341,1656,166,469,0,448,5847,5399,166,469
83550.0,TIJUCAS,7205,77,1277,7,1796,3717,431,1118,0,2778,18406,15628,431,1118
83577.0,TIMBO,9373,117,1632,5,1839,5641,462,886,0,1984,21939,19955,462,886
83593.0,TRES BARRAS,5422,34,461,4,1698,1258,212,781,0,2092,11962,9870,212,781
83615.0,TREZE DE MAIO,2226,23,222,11,489,726,149,277,0,392,4515,4123,149,277
83631.0,TREZE TILIAS,733,17,232,2,170,1535,68,184,0,547,3488,2941,68,184
83658.0,TROMBUDO CENTRAL,1611,13,350,10,548,1131,122,272,0,678,4735,4057,122,272
83674.0,TUBARAO,33559,278,3248,17,5363,10026,1087,2790,0,7309,63677,56368,1087,2790
83682.0,TUNAPOLIS,2077,8,265,5,173,348,42,121,0,338,3377,3039,42,121
83690.0,TURVO,4369,28,636,2,980,1169,136,548,0,1297,9165,7868,136,548
83712.0,URUBICI,2114,33,435,3,765,2034,135,493,0,1262,7274,6012,135,493
83739.0,URUSSANGA,8668,69,593,3,1004,1715,273,621,0,1809,14755,12946,273,621
83755.0,VARGEAO,1133,10,93,3,208,354,62,144,0,604,2611,2007,62,144
83771.0,VIDAL RAMOS,1753,21,119,5,500,1150,152,291,0,640,4631,3991,152,291
83798.0,VIDEIRA,14083,121,1149,16,2345,4725,914,1462,0,4032,28847,24815,914,1462
83810.0,WITMARSUM,1012,18,121,1,237,610,94,148,0,304,2545,2241,94,148
83836.0,XANXERE,14156,31,1296,5,2607,3124,444,1163,0,4320,27146,22826,444,1163
83852.0,XAVANTINA,1864,9,63,1,214,759,51,146,0,325,3432,3107,51,146
83879.0,XAXIM,8628,47,511,3,1694,2030,412,996,0,2412,16733,14321,412,996
83895.0,BOM JARDIM DA SERRA,816,6,196,3,199,1069,74,280,0,336,2979,2643,74,280
83917.0,MARACAJA,2680,13,222,0,290,446,97,236,0,485,4469,3984,97,236
83933.0,TIMBE DO SUL,1697,11,112,2,642,592,133,373,0,398,3960,3562,133,373
83950.0,CORREIA PINTO,4480,29,656,1,1653,1369,194,581,0,1092,10055,8963,194,581
83976.0,OTACILIO COSTA,4953,31,627,2,1326,1156,167,488,0,1822,10572,8750,167,488
84514.0,CANTAGALO,3599,15,659,2,781,1012,190,736,0,2388,9382,6994,190,736
84530.0,TURVO,4145,8,300,3,789,1377,260,801,0,871,8554,7683,260,801
84557.0,ALTAMIRA DO PARANA,744,3,90,0,291,1215,104,450,0,1630,4527,2897,104,450
84573.0,FIGUEIRA,2056,17,192,1,746,1166,177,551,0,837,5743,4906,177,551
84590.0,LUNARDELLI,951,15,176,3,412,1088,125,469,0,522,3761,3239,125,469
84611.0,SARANDI,13420,160,3033,3,8754,8469,1607,3074,0,8173,46693,38520,1607,3074
84638.0,JURANDA,1837,24,442,2,592,1217,170,451,0,1536,6271,4735,170,451
84654.0,DOURADINA,1718,3,187,0,202,1231,110,311,0,601,4363,3762,110,311
84670.0,SANTA TEREZINHA DE ITAIPU,5946,39,675,4,1545,1972,189,710,0,2045,13125,11080,189,710
84697.0,MISSAL,3857,22,388,2,395,1459,96,357,0,635,7211,6576,96,357
84719.0,SAO JOSE DAS PALMEIRAS,1064,14,149,1,275,469,58,328,0,322,2680,2358,58,328
84735.0,AUREA,1350,3,180,1,155,739,100,144,0,451,3123,2672,100,144
84743.0,TRES ARROIOS,1265,5,157,3,168,586,89,89,0,256,2618,2362,89,89
84751.0,NOVA ROMA DO SUL,781,9,104,1,75,1207,63,176,0,217,2633,2416,63,176
84760.0,PROGRESSO,1504,13,288,1,170,1567,212,270,0,896,4921,4025,212,270
84778.0,PIRAPO,778,2,79,4,203,705,101,182,0,748,2802,2054,101,182
84786.0,JABOTICABA,1159,7,148,1,412,691,64,283,0,580,3345,2765,64,283
84794.0,SAO JORGE,678,3,59,0,89,1016,64,113,0,439,2461,2022,64,113
84808.0,ALTO ALEGRE,634,3,165,0,183,435,54,80,0,260,1814,1554,54,80
84816.0,NOVA HARTZ,5111,20,410,4,1414,1869,234,413,0,1029,10504,9475,234,413
84824.0,DOIS LAJEADOS,956,10,78,2,94,954,152,144,0,269,2659,2390,152,144
84832.0,SAO DOMINGOS DO SUL,769,6,96,1,282,821,104,126,0,347,2552,2205,104,126
84840.0,TUNAS,1053,2,54,1,160,1187,139,265,0,726,3587,2861,139,265
84859.0,SAO JOAO DA URTIGA,1546,3,207,1,205,1139,223,293,0,697,4314,3617,223,293
84867.0,GUABIJU,380,6,61,3,77,530,106,92,0,317,1572,1255,106,92
84875.0,QUINZE DE NOVEMBRO,1095,10,207,2,114,1074,88,58,0,229,2877,2648,88,58
84883.0,DOUTOR MAURICIO CARDOSO,2171,2,157,1,275,1467,45,206,0,750,5074,4324,45,206
84891.0,CAPELA DE SANTANA,2492,10,414,0,877,1526,214,307,0,654,6494,5840,214,307
84905.0,JAQUIRANA,820,2,153,1,430,1065,139,257,0,747,3614,2867,139,257
84913.0,VANINI,447,6,31,0,105,538,100,101,0,202,1530,1328,100,101
84921.0,BOQUEIRAO DO LEAO,1896,9,502,2,333,1574,321,413,0,773,5823,5050,321,413
84930.0,FAGUNDES VARELA,644,15,142,4,66,820,114,94,0,212,2111,1899,114,94
84948.0,AGUA SANTA,863,3,60,0,197,1153,71,170,0,278,2795,2517,71,170
84956.0,SILVEIRA MARTINS,767,3,150,3,179,682,96,126,0,326,2332,2006,96,126
84964.0,IBIRAPUITA,826,5,132,1,170,1279,151,292,0,532,3388,2856,151,292
84972.0,IBARAMA,1436,6,186,0,290,751,151,228,0,421,3469,3048,151,228
84980.0,PANTANO GRANDE,2766,19,633,1,608,2007,287,652,0,1278,8251,6973,287,652
84999.0,IPE,1225,18,241,2,380,1716,197,345,0,596,4720,4124,197,345
85006.0,TRINDADE DO SUL,1442,5,335,3,378,961,126,339,0,1206,4795,3589,126,339
85014.0,AGUDO,4057,32,1123,5,1454,2970,599,627,0,1461,12328,10867,599,627
85022.0,ERNESTINA,1113,10,179,1,217,847,59,142,0,336,2904,2568,59,142
85030.0,AJURICABA,2539,5,462,0,582,1312,77,215,0,707,5899,5192,77,215
85049.0,DEZESSEIS DE NOVEMBRO,725,8,70,1,170,836,71,213,0,757,2851,2094,71,213
85057.0,ALECRIM,2386,11,213,5,373,1958,131,343,0,1215,6635,5420,131,343
85065.0,BROCHIER,1052,7,310,3,193,1422,140,200,0,376,3703,3327,140,200
85073.0,ALEGRETE,18868,121,4928,14,6248,14462,1284,2149,0,10497,58571,48074,1284,2149
85081.0,EREBANGO,863,5,132,0,175,541,45,156,0,360,2277,1917,45,156
85090.0,ALPESTRE,2866,16,204,10,362,1703,213,421,0,2025,7820,5795,213,421
85103.0,ENTRE IJUIS,3091,13,754,3,700,1287,245,430,0,1254,7777,6523,245,430
85111.0,ALVORADA,38561,507,11113,60,14950,27816,3014,3700,0,11486,111207,99721,3014,3700
85120.0,NOVA ESPERANCA DO SUL,834,2,139,2,271,1136,224,263,0,401,3272,2871,224,263
85138.0,ANTA GORDA,1346,16,290,0,269,1794,331,253,0,691,4990,4299,331,253
85146.0,PAVERAMA,1480,13,342,0,407,1873,237,383,0,675,5410,4735,237,383
85154.0,ANTONIO PRADO,3211,22,357,6,526,3328,423,616,0,957,9446,8489,423,616
85162.0,TERRA DE AREIA,1250,18,466,0,648,2055,233,310,0,1111,6091,4980,233,310
85170.0,ARATIBA,2460,10,337,1,351,1373,178,226,0,671,5607,4936,178,226
85189.0,HARMONIA,1052,6,232,4,169,1118,110,117,0,221,3029,2808,110,117
85197.0,ARROIO DO MEIO,5182,27,904,5,892,3635,490,495,0,1291,12921,11630,490,495
85200.0,CAMPOS BORGES,1222,10,112,3,168,706,123,202,0,551,3097,2546,123,202
85219.0,ARROIO DOS RATOS,2623,24,838,1,1010,2714,404,475,0,1453,9542,8089,404,475
85227.0,CERRO GRANDE,857,0,121,1,382,240,37,217,0,688,2543,1855,37,217
85235.0,ARROIO DO TIGRE,3570,18,449,1,652,2674,421,552,0,1082,9419,8337,421,552
85243.0,IPIRANGA DO SUL,439,2,52,1,65,856,42,97,0,259,1813,1554,42,97
85251.0,ARROIO GRANDE,4386,31,1487,8,1615,3600,446,787,0,2080,14440,12360,446,787
85260.0,LAGOAO,679,6,224,2,204,1797,233,466,0,930,4541,3611,233,466
85278.0,ARVOREZINHA,2289,11,371,10,563,1986,590,518,0,1307,7645,6338,590,518
85286.0,ESTACAO,1756,12,203,2,412,1570,135,267,0,582,4939,4357,135,267
85294.0,AUGUSTO PESTANA,2301,10,617,2,529,1552,124,229,0,824,6188,5364,124,229
85308.0,ARROIO DO SAL,1362,16,495,0,399,1057,96,187,0,1041,4653,3612,96,187
85316.0,BAGE,31533,250,7090,21,7735,17834,2008,2615,0,10699,79785,69086,2008,2615
85324.0,SAO JOSE DO HORTENCIO,829,13,214,4,138,963,98,96,0,203,2558,2355,98,96
85332.0,BARAO DE COTEGIPE,2038,5,215,1,317,1363,128,276,0,566,4909,4343,128,276
85340.0,PINHAL,643,4,105,2,151,489,40,166,0,339,1939,1600,40,166
85359.0,BARRACAO,1428,9,171,0,253,1132,201,297,0,986,4477,3491,201,297
85367.0,TRES CACHOEIRAS,2057,33,668,3,720,1996,202,282,0,975,6936,5961,202,282
85375.0,BARRA DO RIBEIRO,2545,24,700,3,1090,2652,291,341,0,1216,8862,7646,291,341
85383.0,SAO VENDELINO,386,2,82,1,83,706,38,62,0,122,1482,1360,38,62
85391.0,BARROS CASSAL,2437,10,589,5,455,2024,357,659,0,1610,8146,6536,357,659
85405.0,PROTASIO ALVES,401,11,167,2,136,774,91,134,0,271,1987,1716,91,134
85413.0,BENTO GONCALVES,26330,202,4551,16,4414,16996,1764,2133,0,5896,62302,56406,1764,2133
85421.0,POUSO NOVO,605,4,138,1,72,464,64,110,0,503,1961,1458,64,110
85430.0,BOA VISTA DO BURICA,2225,3,393,2,273,1235,101,138,0,616,4986,4370,101,138
85448.0,EUGENIO DE CASTRO,942,14,221,0,219,662,74,197,0,583,2912,2329,74,197
85456.0,BOM JESUS,2158,9,382,3,680,3333,311,649,0,2044,9569,7525,311,649
85464.0,CRISTAL,1315,8,471,2,638,1493,287,314,0,865,5393,4528,287,314
85472.0,BOM RETIRO DO SUL,2736,19,596,3,1327,1665,393,418,0,936,8093,7157,393,418
85480.0,SAO MIGUEL DAS MISSOES,2035,5,359,0,616,1178,213,406,0,903,5715,4812,213,406
85499.0,BOSSOROCA,2156,12,290,4,427,1214,294,343,0,1136,5876,4740,294,343
85502.0,GLORINHA,986,5,500,1,307,1690,153,231,0,373,4246,3873,153,231
85510.0,BRAGA,1018,1,116,0,297,720,110,294,0,701,3257,2556,110,294
85529.0,SEGREDO,1830,12,228,3,331,1595,212,389,0,728,5328,4600,212,389
85537.0,BUTIA,5124,33,1173,3,1702,3552,526,784,0,2268,15165,12897,526,784
85545.0,ALEGRIA,1416,7,222,0,342,1118,128,279,0,752,4264,3512,128,279
85553.0,CACAPAVA DO SUL,8122,53,1758,9,2194,7969,1365,1811,0,4398,27679,23281,1365,1811
85561.0,SALDANHA MARINHO,885,3,122,3,191,985,59,97,0,372,2717,2345,59,97
85570.0,CACEQUI,4095,16,785,1,770,2228,261,533,0,2354,11043,8689,261,533
85588.0,SAO JOSE DO HERVAL,545,2,100,2,191,505,76,199,0,464,2084,1620,76,199
85596.0,CACHOEIRA DO SUL,24155,139,5799,23,5741,13957,1785,2095,0,9932,63626,53694,1785,2095
85600.0,VISTA ALEGRE,1101,3,53,0,180,583,59,156,0,392,2527,2135,59,156
85618.0,CACHOEIRINHA,29129,333,7374,23,10948,19008,1924,2385,0,7843,78967,71124,1924,2385
85626.0,IVORA,737,7,60,0,141,645,68,97,0,290,2045,1755,68,97
85634.0,CACIQUE DOBLE,1072,11,240,0,253,1108,152,264,0,709,3809,3100,152,264
85642.0,VILA MARIA,1281,6,86,1,170,1075,129,210,0,439,3397,2958,129,210
85650.0,CAIBATE,1772,9,110,3,362,835,143,168,0,817,4219,3402,143,168
85669.0,TAQUARUCU DO SUL,852,5,52,0,177,799,47,126,0,409,2467,2058,47,126
85677.0,CAICARA,1442,6,229,5,390,1148,87,225,0,674,4206,3532,87,225
85685.0,IMBE,2974,24,1080,4,727,3010,202,301,0,1831,10153,8322,202,301
85693.0,CAMAQUA,12595,59,5298,8,5448,11406,1486,1879,0,5597,43776,38179,1486,1879
85707.0,SEDE NOVA,906,3,63,3,199,753,44,164,0,491,2626,2135,44,164
85715.0,CAMBARA DO SUL,1246,12,197,0,532,1632,228,272,0,1024,5143,4119,228,272
85723.0,TUPANDI,608,3,157,1,141,1206,91,132,0,237,2576,2339,91,132
85731.0,CAMPINA DAS MISSOES,2489,13,476,2,372,1106,167,210,0,1031,5866,4835,167,210
85740.0,RIOZINHO,1118,8,117,0,217,1056,187,173,0,341,3217,2876,187,173
85758.0,CAMPINAS DO SUL,1500,4,173,0,256,1651,79,176,0,584,4423,3839,79,176
85766.0,RELVADO,335,1,97,0,118,887,80,149,0,523,2190,1667,80,149
85774.0,CAMPO BOM,18508,72,1809,8,4036,10097,1032,1258,0,3595,40415,36820,1032,1258
85782.0,IMIGRANTE,855,5,134,2,114,821,143,142,0,303,2519,2216,143,142
85790.0,CAMPO NOVO,1730,4,292,0,504,974,96,372,0,1279,5251,3972,96,372
85804.0,CIDREIRA,2031,11,810,5,597,1704,124,217,0,1782,7281,5499,124,217
85812.0,CANDELARIA,6484,44,3470,15,2504,4500,1211,1110,0,2724,22062,19338,1211,1110
85820.0,MONTAURI,639,7,54,0,78,334,102,69,0,200,1483,1283,102,69
85839.0,CANDIDO GODOI,1793,10,323,2,1001,1657,111,272,0,766,5935,5169,111,272
85847.0,VISTA GAUCHA,713,5,41,5,136,787,31,150,0,359,2227,1868,31,150
85855.0,CANELA,6693,48,1863,9,2028,7864,937,942,0,2257,22641,20384,937,942
85863.0,VISTA ALEGRE DO PRATA,458,2,129,0,62,504,75,58,0,211,1499,1288,75,58
85871.0,CANGUCU,7582,76,4142,14,4697,14946,2363,2327,0,5109,41256,36147,2363,2327
85880.0,CASEIROS,609,4,106,0,211,862,122,163,0,413,2490,2077,122,163
85898.0,CANOAS,89805,780,16442,71,22530,49171,4793,6166,0,20888,210646,189758,4793,6166
85901.0,ITACURUBI,839,5,228,0,287,621,74,186,0,500,2740,2240,74,186
85910.0,CARAZINHO,15282,53,2856,6,4136,10798,709,1415,0,5427,40682,35255,709,1415
85928.0,ENTRE RIOS DO SUL,1177,4,84,0,126,620,69,160,0,621,2861,2240,69,160
85936.0,CARLOS BARBOSA,6553,38,824,7,825,5170,522,583,0,1260,15782,14522,522,583
85944.0,CERRO GRANDE DO SUL,1715,18,624,4,637,1735,364,513,0,922,6532,5610,364,513
85952.0,CASCA,2127,15,219,5,312,2067,429,297,0,819,6290,5471,429,297
85960.0,CAMARGO,720,4,55,1,96,726,94,149,0,289,2134,1845,94,149
85979.0,CATUIPE,2922,11,740,6,936,1887,280,369,0,1545,8696,7151,280,369
85987.0,PARAISO DO SUL,1686,16,595,2,618,1463,153,231,0,537,5301,4764,153,231
85995.0,CAXIAS DO SUL,94155,864,12620,95,20401,84254,5727,9121,0,21129,248366,227237,5727,9121
86010.0,CERRO LARGO,4416,12,475,0,896,1654,182,363,0,1855,9853,7998,182,363
86029.0,FAXINALZINHO,695,3,147,2,222,544,52,162,0,456,2283,1827,52,162
86037.0,CHAPADA,2427,13,507,7,956,2567,166,323,0,925,7891,6966,166,323
86045.0,AMARAL FERRADOR,1049,5,520,1,462,1142,202,355,0,756,4492,3736,202,355
86053.0,CHIAPETA,1179,4,194,1,367,844,93,157,0,452,3291,2839,93,157
86061.0,VILA FLORES,891,9,176,1,149,931,128,140,0,234,2659,2425,128,140
86070.0,CIRIACO,1358,7,200,0,325,1060,329,226,0,748,4253,3505,329,226
86088.0,CERRO BRANCO,1390,17,406,5,370,591,203,226,0,381,3589,3208,203,226
86096.0,COLORADO,1065,6,162,0,212,1194,129,163,0,440,3371,2931,129,163
86100.0,ANDRE DA ROCHA,281,4,73,0,49,469,27,46,0,199,1148,949,27,46
86118.0,CONDOR,1815,2,338,2,638,1266,127,295,0,666,5149,4483,127,295
86126.0,POCO DAS ANTAS,527,4,153,0,60,685,84,66,0,182,1761,1579,84,66
86134.0,CONSTANTINA,2612,12,212,2,482,2184,214,441,0,1712,7871,6159,214,441
86142.0,TRES PALMEIRAS,1415,7,204,1,444,629,120,274,0,849,3943,3094,120,274
86150.0,CORONEL BICACO,2356,7,197,1,493,1308,210,495,0,1610,6677,5067,210,495
86169.0,NOVA ALVORADA,652,3,74,3,75,946,126,187,0,237,2303,2066,126,187
86177.0,CRISSIUMAL,4920,30,605,7,1469,2050,583,472,0,2294,12430,10136,583,472
86185.0,MORRO REDONDO,1055,9,496,0,756,1628,262,231,0,708,5145,4437,262,231
86193.0,CRUZ ALTA,17888,116,3126,2,4661,11163,1117,1707,0,8031,47811,39780,1117,1707
86207.0,SANTA MARIA DO HERVAL,1587,11,272,6,226,1695,181,207,0,224,4409,4185,181,207
86215.0,CRUZEIRO DO SUL,3419,19,712,2,645,1972,305,365,0,914,8353,7439,305,365
86223.0,BARAO,1045,8,245,1,160,1667,149,245,0,391,3911,3520,149,245
86231.0,DAVID CANABARRO,1189,14,183,2,156,1236,231,205,0,514,3730,3216,231,205
86240.0,ELDORADO DO SUL,6096,50,1867,4,2396,4712,453,737,0,2314,18629,16315,453,737
86258.0,DOIS IRMAOS,6955,28,742,8,996,4714,341,491,0,1014,15289,14275,341,491
86274.0,DOM FELICIANO,2667,17,1062,4,655,2375,629,761,0,1499,9669,8170,629,761
86282.0,ALTO FELIZ,539,5,70,0,132,997,107,139,0,212,2201,1989,107,139
86290.0,DOM PEDRITO,9336,68,2534,11,2517,7176,923,1335,0,4965,28865,23900,923,1335
86304.0,AMETISTA DO SUL,1441,6,138,1,401,1611,146,440,0,917,5101,4184,146,440
86312.0,DONA FRANCISCA,987,4,185,1,238,944,118,207,0,480,3164,2684,118,207
86320.0,ARAMBARE,1129,2,322,1,214,791,76,161,0,574,3270,2696,76,161
86339.0,ENCANTADO,5050,29,834,5,1594,3828,473,793,0,1782,14388,12606,473,793
86347.0,BARAO DO TRIUNFO,588,3,483,0,398,1591,201,364,0,559,4187,3628,201,364
86355.0,ENCRUZILHADA DO SUL,4393,34,2186,3,1253,5247,913,1301,0,2988,18318,15330,913,1301
86363.0,BARRA DO GUARITA,689,0,40,0,158,743,55,163,0,482,2330,1848,55,163
86371.0,ERECHIM,29845,149,4284,12,5055,11511,1467,1892,0,7886,62101,54215,1467,1892
86380.0,BARRA DO RIO AZUL,891,2,85,0,57,466,56,101,0,264,1922,1658,56,101
86398.0,HERVAL,1463,8,653,2,519,1376,214,348,0,1088,5671,4583,214,348
86401.0,BARRA FUNDA,907,1,167,0,206,355,41,103,0,273,2053,1780,41,103
86410.0,ERVAL GRANDE,1736,3,319,0,324,899,113,320,0,737,4451,3714,113,320
86428.0,BOA VISTA DAS MISSOES,657,2,147,0,275,347,24,110,0,305,1867,1562,24,110
86436.0,ERVAL SECO,2239,5,436,2,643,1358,147,469,0,1221,6520,5299,147,469
86444.0,BOM PROGRESSO,804,1,114,0,209,494,51,127,0,489,2289,1800,51,127
86452.0,ESMERALDA,400,2,172,0,150,1255,146,149,0,524,2798,2274,146,149
86460.0,CAMPESTRE DA SERRA,603,5,173,0,136,925,146,133,0,427,2548,2121,146,133
86479.0,ESPUMOSO,3634,30,946,4,939,3330,364,668,0,1588,11503,9915,364,668
86487.0,CANDIOTA,2522,12,417,1,458,1164,140,211,0,787,5712,4925,140,211
86495.0,ESTANCIA VELHA,10052,53,1521,7,1940,6894,594,953,0,2138,24152,22014,594,953
86509.0,CAPITAO,839,6,189,0,190,566,118,128,0,256,2292,2036,118,128
86517.0,ESTEIO,26833,218,4570,21,6095,12881,1136,1253,0,5954,58961,53007,1136,1253
86525.0,CARLOS GOMES,786,4,109,1,82,357,44,60,0,298,1741,1443,44,60
86533.0,ESTRELA,7256,44,1701,7,2296,5714,571,702,0,2310,20601,18291,571,702
86541.0,CENTENARIO,1128,6,136,0,125,635,52,109,0,327,2518,2191,52,109
86550.0,FARROUPILHA,14147,108,1891,22,2479,14883,1307,1632,0,3881,40350,36469,1307,1632
86568.0,CHARRUA,784,4,76,1,143,922,44,187,0,335,2496,2161,44,187
86576.0,FAXINAL DO SOTURNO,2246,8,316,1,300,1458,154,225,0,745,5453,4708,154,225
86584.0,COLINAS,645,4,178,2,186,692,85,92,0,256,2140,1884,85,92
86592.0,FELIZ,2418,20,477,9,538,3596,372,435,0,847,8712,7865,372,435
86606.0,COQUEIROS DO SUL,878,6,139,1,163,794,78,100,0,270,2429,2159,78,100
86614.0,FLORES DA CUNHA,5021,90,1201,7,978,6826,732,863,0,1565,17283,15718,732,863
86622.0,CORONEL BARROS,744,2,180,0,270,646,36,91,0,233,2202,1969,36,91
86630.0,FONTOURA XAVIER,2199,11,560,1,431,1983,438,697,0,1933,8253,6320,438,697
86649.0,COXILHA,952,3,150,0,185,796,64,152,0,383,2685,2302,64,152
86657.0,FORMIGUEIRO,1652,6,344,1,471,1995,250,512,0,1046,6277,5231,250,512
86665.0,DERRUBADAS,750,3,66,3,134,1084,56,204,0,552,2852,2300,56,204
86673.0,FREDERICO WESTPHALEN,7393,29,1174,6,1343,5540,339,1005,0,3443,20272,16829,339,1005
86681.0,DOIS IRMAOS DAS MISSOES,666,0,87,0,245,361,44,143,0,445,1991,1546,44,143
86690.0,GARIBALDI,6900,53,1295,8,1091,6910,772,701,0,1851,19581,17730,772,701
86703.0,ENGENHO VELHO,689,2,18,1,87,379,29,91,0,454,1750,1296,29,91
86711.0,GAURAMA,2239,14,395,2,492,1089,166,239,0,689,5325,4636,166,239
86720.0,GARRUCHOS,743,2,288,1,320,474,96,155,0,636,2715,2079,96,155
86738.0,GENERAL CAMARA,2298,16,525,2,520,1848,231,427,0,1210,7077,5867,231,427
86746.0,GENTIL,477,4,59,1,116,526,106,104,0,241,1634,1393,106,104
86754.0,SAO VICENTE DO SUL,1851,13,485,1,433,2014,218,442,0,1146,6603,5457,218,442
86762.0,GRAMADO DOS LOUREIROS,691,1,62,0,168,525,52,164,0,572,2235,1663,52,164
86770.0,GETULIO VARGAS,3356,31,625,6,1094,4454,314,605,0,1657,12142,10485,314,605
86789.0,GRAMADO XAVIER,878,7,472,6,214,559,91,219,0,426,2872,2446,91,219
86797.0,GIRUA,4083,15,1137,6,2233,3112,282,589,0,2732,14189,11457,282,589
86800.0,HULHA NEGRA,1735,15,339,0,412,777,94,177,0,617,4166,3549,94,177
86819.0,GRAMADO,5620,54,1630,9,1727,8687,746,1027,0,2230,21730,19500,746,1027
86827.0,INHACORA,495,2,243,2,255,412,42,131,0,528,2110,1582,42,131
86835.0,GRAVATAI,51624,581,13303,46,17308,36495,3783,4422,0,13243,140805,127562,3783,4422
86843.0,ITAPUCA,497,3,115,3,122,478,122,135,0,352,1827,1475,122,135
86851.0,GUAIBA,19707,208,7335,39,8205,16260,1572,1815,0,6104,61245,55141,1572,1815
86860.0,LAJEADO DO BUGRE,714,2,71,0,378,168,50,157,0,439,1979,1540,50,157
86878.0,GUAPORE,5704,32,906,10,949,4090,670,677,0,1663,14701,13038,670,677
86886.0,LAGOA DOS TRES CANTOS,389,7,102,1,109,544,44,38,0,144,1378,1234,44,38
86894.0,GUARANI DAS MISSOES,3364,8,426,2,542,1084,152,265,0,1296,7139,5843,152,265
86908.0,LINDOLFO COLLOR,1592,4,169,1,297,665,86,137,0,300,3251,2951,86,137
86916.0,HORIZONTINA,6377,14,692,1,1084,3229,205,423,0,1973,13998,12025,205,423
86924.0,LINHA NOVA,301,6,105,3,101,456,60,85,0,152,1269,1117,60,85
86932.0,CHARQUEADAS,7837,51,1505,5,2496,4378,416,659,0,1686,19033,17347,416,659
86940.0,MANOEL VIANA,1514,5,446,3,425,1578,174,273,0,989,5407,4418,174,273
86959.0,HUMAITA,1938,9,201,1,273,1015,99,192,0,774,4502,3728,99,192
86967.0,MAQUINE,1707,12,361,0,274,1830,243,315,0,887,5629,4742,243,315
86975.0,IBIACA,1107,2,242,0,329,1439,174,213,0,534,4040,3506,174,213
86983.0,MARATA,566,6,223,0,123,871,67,113,0,240,2209,1969,67,113
86991.0,IBIRAIARAS,1722,15,149,0,350,2118,170,270,0,686,5480,4794,170,270
87009.0,MARIANA PIMENTEL,620,2,279,0,274,1190,87,193,0,475,3120,2645,87,193
87017.0,IBIRUBA,5363,36,1081,1,949,4359,330,399,0,1782,14300,12518,330,399
87025.0,MATO CASTELHANO,675,1,125,0,151,820,101,177,0,275,2325,2050,101,177
87033.0,IGREJINHA,7550,31,1204,8,2165,4763,597,864,0,1856,19038,17182,597,864
87041.0,MATO LEITAO,1286,4,302,2,202,629,117,145,0,275,2962,2687,117,145
87050.0,IJUI,23916,94,4090,13,6487,9875,705,1483,0,7969,54632,46663,705,1483
87068.0,MINAS DO LEAO,1906,11,494,1,731,1443,234,368,0,988,6176,5188,234,368
87076.0,ILOPOLIS,737,0,317,0,181,1066,135,194,0,406,3036,2630,135,194
87084.0,MONTE BELO DO SUL,902,5,81,1,85,1176,131,139,0,283,2803,2520,131,139
87092.0,INDEPENDENCIA,1965,8,413,1,545,1314,139,314,0,858,5557,4699,139,314
87106.0,MORMACO,497,5,125,0,262,729,111,117,0,302,2148,1846,111,117
87114.0,IRAI,2473,17,372,4,526,1676,171,335,0,1395,6969,5574,171,335
87122.0,MORRINHOS DO SUL,833,7,157,1,378,934,97,140,0,432,2979,2547,97,140
87130.0,ITAQUI,9082,36,2417,5,3828,4827,359,829,0,4525,25908,21383,359,829
87149.0,MORRO REUTER,1232,3,235,0,261,1608,185,193,0,308,4025,3717,185,193
87157.0,ITATIBA DO SUL,1815,7,96,1,214,1014,82,197,0,668,4094,3426,82,197
87165.0,MULITERNO,455,2,29,4,85,450,76,101,0,225,1427,1202,76,101
87173.0,IVOTI,4438,39,1028,7,897,3330,293,383,0,925,11340,10415,293,383
87181.0,NICOLAU VERGUEIRO,393,3,49,0,57,793,73,102,0,269,1739,1470,73,102
87190.0,JACUTINGA,1073,3,116,1,145,882,102,154,0,300,2776,2476,102,154
87203.0,NOVA BOA VISTA,731,4,140,1,208,490,43,45,0,146,1808,1662,43,45
87211.0,JAGUARAO,7945,62,2028,6,1664,4724,497,957,0,3111,20994,17883,497,957
87220.0,NOVA PADUA,500,16,98,2,91,1063,67,115,0,205,2157,1952,67,115
87238.0,JAGUARI,3107,28,686,8,732,2806,467,598,0,1717,10149,8432,467,598
87246.0,NOVA SANTA RITA,3893,29,809,5,1297,2468,258,400,0,1138,10297,9159,258,400
87254.0,JULIO DE CASTILHOS,4410,22,727,1,1250,4639,438,824,0,2531,14842,12311,438,824
87262.0,NOVO BARREIRO,1349,4,56,0,495,605,31,191,0,371,3102,2731,31,191
87270.0,LAGOA VERMELHA,5523,41,1123,6,1704,6017,776,1092,0,3104,19386,16282,776,1092
87289.0,NOVO MACHADO,1131,2,158,1,642,1192,75,190,0,684,4075,3391,75,190
87297.0,LAJEADO,17878,121,3641,19,3574,11850,1394,1622,0,4741,44840,40099,1394,1622
87300.0,NOVO TIRADENTES,683,3,60,0,175,353,51,104,0,445,1874,1429,51,104
87319.0,LAVRAS DO SUL,1805,6,503,2,445,2094,236,489,0,1239,6819,5580,236,489
87327.0,PARECI NOVO,667,1,109,1,128,1111,61,80,0,216,2374,2158,61,80
87335.0,LIBERATO SALZANO,1938,5,72,0,258,1189,143,326,0,1379,5310,3931,143,326
87343.0,PASSO DO SOBRADO,1880,1,620,1,454,615,180,230,0,406,4387,3981,180,230
87351.0,MACHADINHO,1430,4,181,1,225,1469,81,371,0,856,4618,3762,81,371
87360.0,PICADA CAFE,1161,7,292,4,199,1313,95,144,0,281,3496,3215,95,144
87378.0,MARAU,7773,49,896,6,1373,6395,781,1030,0,2288,20591,18303,781,1030
87386.0,PINHAL GRANDE,1330,5,184,0,182,938,127,194,0,531,3491,2960,127,194
87394.0,MARCELINO RAMOS,1892,11,249,3,442,1015,81,200,0,789,4682,3893,81,200
87408.0,PINHEIRINHO DO VALE,928,5,234,2,310,850,96,190,0,553,3168,2615,96,190
87416.0,MARIANO MORO,900,1,81,0,97,451,95,115,0,164,1904,1740,95,115
87424.0,PONTAO,1426,4,164,0,264,811,48,108,0,374,3199,2825,48,108
87432.0,MATA,1037,10,208,1,225,1603,267,338,0,809,4498,3689,267,338
87440.0,PONTE PRETA,683,5,53,0,128,549,47,105,0,215,1785,1570,47,105
87459.0,MAXIMILIANO DE ALMEIDA,1504,7,249,0,389,1042,146,314,0,791,4442,3651,146,314
87467.0,PORTO MAUA,880,3,136,0,194,564,47,111,0,363,2298,1935,47,111
87475.0,MIRAGUAI,1385,10,226,0,284,959,85,283,0,1143,4375,3232,85,283
87483.0,PORTO VERA CRUZ,755,1,100,0,105,561,41,120,0,393,2076,1683,41,120
87491.0,MONTENEGRO,13545,78,2880,13,3299,10475,1152,1761,0,4147,37350,33203,1152,1761
87505.0,PRESIDENTE LUCENA,610,7,178,1,100,631,35,77,0,160,1799,1639,35,77
87513.0,MOSTARDAS,1662,16,630,3,889,2823,307,421,0,1072,7823,6751,307,421
87521.0,QUEVEDOS,400,0,77,1,80,914,100,155,0,334,2061,1727,100,155
87530.0,MUCUM,1238,3,172,1,219,1571,196,236,0,581,4217,3636,196,236
87548.0,RIO DOS INDIOS,1252,7,86,2,325,758,125,269,0,957,3781,2824,125,269
87556.0,NAO ME TOQUE,4316,9,609,5,610,3472,266,368,0,1302,10957,9655,266,368
87564.0,SAGRADA FAMILIA,873,0,149,1,430,169,50,123,0,619,2414,1795,50,123
87572.0,NONOAI,2694,5,694,2,994,1746,234,789,0,2180,9338,7158,234,789
87580.0,SALVADOR DAS MISSOES,1023,6,128,3,195,525,33,51,0,332,2296,1964,33,51
87599.0,NOVA ARACA,832,5,122,2,114,1035,131,175,0,278,2694,2416,131,175
87602.0,SANTA CLARA DO SUL,1399,15,276,1,246,1465,211,205,0,389,4207,3818,211,205
87610.0,NOVA BASSANO,2246,11,299,1,414,1860,283,243,0,741,6098,5357,283,243
87629.0,SANTA TEREZA,685,1,196,1,68,442,94,117,0,207,1811,1604,94,117
87637.0,NOVA BRESCIA,600,6,172,0,132,1122,62,180,0,436,2710,2274,62,180
87645.0,SANTO ANTONIO DO PALMA,779,10,56,1,89,526,74,108,0,247,1890,1643,74,108
87653.0,NOVA PALMA,2143,15,186,1,244,1455,81,241,0,568,4934,4366,81,241
87661.0,SANTO ANTONIO DO PLANALTO,727,1,100,0,174,628,32,81,0,249,1992,1743,32,81
87670.0,NOVA PETROPOLIS,3299,47,1347,8,947,5351,473,574,0,1363,13409,12046,473,574
87688.0,SANTO EXPEDITO DO SUL,692,1,74,2,122,814,82,126,0,390,2303,1913,82,126
87696.0,NOVA PRATA,4603,52,1042,13,1096,4250,482,482,0,1715,13735,12020,482,482
87700.0,SAO JOAO DO POLESINE,919,3,132,2,134,688,49,109,0,365,2401,2036,49,109
87718.0,NOVO HAMBURGO,61892,388,10717,50,18442,40967,3194,4020,0,14971,154641,139670,3194,4020
87726.0,SAO JOSE DOS AUSENTES,470,5,118,0,178,939,69,160,0,566,2505,1939,69,160
87734.0,OSORIO,9201,59,2190,5,2462,8306,915,1201,0,3267,27606,24339,915,1201
87742.0,SAO JOSE DO INHACORA,871,2,45,2,100,604,52,74,0,200,1950,1750,52,74
87750.0,PAIM FILHO,1496,4,115,0,111,1002,60,220,0,609,3617,3008,60,220
87769.0,SAO JOSE DAS MISSOES,1031,0,62,0,469,439,61,236,0,696,2994,2298,61,236
87777.0,PALMEIRA DAS MISSOES,7362,32,1622,3,3454,4590,404,1389,0,4248,23104,18856,404,1389
87785.0,SAO MARTINHO DA SERRA,667,2,249,1,294,1007,128,150,0,485,2983,2498,128,150
87793.0,PALMITINHO,2025,6,167,2,353,1515,99,358,0,893,5418,4525,99,358
87807.0,SAO PEDRO DA SERRA,680,6,180,2,109,967,73,120,0,168,2305,2137,73,120
87815.0,PANAMBI,9113,30,1265,10,4203,4656,512,745,0,3100,23634,20534,512,745
87823.0,SAO PEDRO DO BUTIA,1085,1,165,1,230,519,55,81,0,366,2503,2137,55,81
87831.0,PARAI,1274,25,201,2,280,1700,351,195,0,435,4463,4028,351,195
87840.0,SAO VALENTIM DO SUL,828,10,73,5,92,611,90,92,0,259,2060,1801,90,92
87858.0,PASSO FUNDO,50877,348,7449,59,9767,26646,2118,3539,0,13452,114255,100803,2118,3539
87866.0,SAO VALERIO DO SUL,700,2,28,0,128,393,40,120,0,381,1792,1411,40,120
87874.0,PEDRO OSORIO,2548,13,575,1,697,1073,257,330,0,1158,6652,5494,257,330
87882.0,SENTINELA DO SUL,927,7,352,2,301,1364,170,319,0,653,4095,3442,170,319
87890.0,PEJUCARA,1356,4,290,0,198,903,67,136,0,520,3474,2954,67,136
87904.0,SERIO,627,5,136,1,203,737,155,147,0,251,2262,2011,155,147
87912.0,PELOTAS,67945,1347,21995,113,39901,51510,6253,8288,0,28943,226295,197352,6253,8288
87920.0,SERTAO SANTANA,736,9,473,0,399,1412,123,185,0,517,3854,3337,123,185
87939.0,PINHEIRO MACHADO,3425,25,903,1,760,2628,449,615,0,1593,10399,8806,449,615
87947.0,SINIMBU,2990,20,1512,5,858,750,257,417,0,1019,7828,6809,257,417
87955.0,PIRATINI,3303,34,1318,4,1516,4377,1008,1057,0,2545,15162,12617,1008,1057
87963.0,TIRADENTES DO SUL,2338,8,343,0,343,1308,155,326,0,1150,5971,4821,155,326
87971.0,PLANALTO,2800,25,490,2,438,2137,276,463,0,1805,8436,6631,276,463
87980.0,TRAVESSEIRO,811,0,107,2,51,725,41,100,0,296,2133,1837,41,100
87998.0,PORTAO,6555,34,1066,6,1944,4671,588,705,0,1874,17443,15569,588,705
88005.0,TRES FORQUILHAS,661,3,308,1,306,889,120,136,0,508,2932,2424,120,136
88013.0,PORTO ALEGRE,381836,4750,97973,544,83409,261628,19869,24572,0,117806,992387,874581,19869,24572
88021.0,TUPANCI DO SUL,427,6,66,0,86,524,50,108,0,404,1671,1267,50,108
88030.0,PORTO LUCENA,1793,6,285,1,408,1264,112,221,0,824,4914,4090,112,221
88048.0,UNIAO DA SERRA,621,4,105,0,79,455,103,80,0,268,1715,1447,103,80
88056.0,PORTO XAVIER,2323,9,438,1,796,2468,239,531,0,1852,8657,6805,239,531
88064.0,VALE DO SOL,3112,13,1321,2,1049,738,339,452,0,713,7739,7026,339,452
88072.0,PUTINGA,987,4,268,2,222,1238,165,352,0,1037,4275,3238,165,352
88080.0,VALE REAL,929,5,141,3,139,1475,162,133,0,275,3262,2987,162,133
88099.0,QUARAI,6676,38,2067,2,1890,2947,436,681,0,2714,17451,14737,436,681
88102.0,VILA NOVA DO SUL,1104,7,251,1,402,939,160,264,0,720,3848,3128,160,264
88110.0,REDENTORA,1633,8,97,3,460,1481,120,447,0,1346,5595,4249,120,447
88129.0,VITORIA DAS MISSOES,1464,3,390,0,274,429,92,218,0,738,3608,2870,92,218
88137.0,RESTINGA SECA,4042,29,932,3,992,3577,369,619,0,1870,12433,10563,369,619
88145.0,XANGRI-LA,2015,6,631,1,630,2348,149,225,0,1254,7259,6005,149,225
88153.0,RIO GRANDE,53509,824,8809,58,13094,28232,3174,4248,0,16505,128453,111948,3174,4248
88161.0,BOA VISTA DO SUL,744,3,125,0,103,901,153,108,0,263,2400,2137,153,108
88170.0,RIO PARDO,11609,38,2285,1,1855,6237,858,1537,0,3771,28191,24420,858,1537
88188.0,DILERMANDO DE AGUIAR,712,8,195,0,179,867,76,179,0,507,2723,2216,76,179
88196.0,ROCA SALES,2707,15,411,6,610,1907,384,362,0,1003,7405,6402,384,362
88200.0,CAPIVARI DO SUL,623,1,225,0,203,854,46,90,0,269,2311,2042,46,90
88218.0,RODEIO BONITO,1722,2,156,0,342,1074,93,275,0,855,4519,3664,93,275
88226.0,NOVA CANDELARIA,1030,12,127,1,156,598,98,58,0,287,2367,2080,98,58
88234.0,ROLANTE,4111,25,768,2,978,3814,488,648,0,1244,12078,10834,488,648
88242.0,FLORIANO PEIXOTO,895,2,63,1,121,555,46,98,0,393,2174,1781,46,98
88250.0,RONDA ALTA,3156,9,259,1,439,1889,143,303,0,1286,7485,6199,143,303
88269.0,CHUVISCA,690,5,581,1,486,1356,200,273,0,407,3999,3592,200,273
88277.0,RONDINHA,2026,6,115,4,231,1552,89,193,0,923,5139,4216,89,193
88285.0,ESPERANCA DO SUL,1204,1,203,0,231,763,56,114,0,570,3142,2572,56,114
88293.0,ROQUE GONZALES,2067,6,245,2,572,1680,159,369,0,1439,6539,5100,159,369
88307.0,DOUTOR RICARDO,534,11,81,1,101,608,91,146,0,253,1826,1573,91,146
88315.0,ROSARIO DO SUL,8792,65,3353,9,2620,8121,949,1526,0,5978,31413,25435,949,1526
88323.0,HERVEIRAS,1185,2,174,1,260,132,68,192,0,398,2412,2014,68,192
88331.0,SALVADOR DO SUL,1234,8,450,4,252,1983,151,200,0,393,4675,4282,151,200
88340.0,CARAA,1124,11,348,2,328,2186,285,470,0,876,5630,4754,285,470
88358.0,SANANDUVA,2878,19,506,4,658,4995,411,583,0,1514,11568,10054,411,583
88366.0,FAZENDA VILANOVA,715,2,131,1,221,637,133,156,0,301,2297,1996,133,156
88374.0,SANTA BARBARA DO SUL,2473,4,426,1,837,2033,161,270,0,1179,7384,6205,161,270
88382.0,ITAARA,953,12,278,0,397,1120,100,217,0,534,3611,3077,100,217
88390.0,SANTA CRUZ DO SUL,37484,233,10465,28,8678,10228,2121,2409,0,7746,79392,71646,2121,2409
88404.0,ESTRELA VELHA,1005,7,78,0,119,977,114,145,0,361,2806,2445,114,145
88412.0,SANTA MARIA,59328,646,15814,61,19987,43116,4478,4888,0,23084,171402,148318,4478,4888
88420.0,BENJAMIN CONSTANT DO SUL,784,1,32,1,118,348,61,117,0,392,1854,1462,61,117
88439.0,SANTANA DA BOA VISTA,1292,36,690,2,593,2165,666,681,0,1425,7550,6125,666,681
88447.0,MACAMBARA,874,3,310,1,408,745,63,233,0,596,3233,2637,63,233
88455.0,SANTANA DO LIVRAMENTO,24022,153,8633,23,6586,13317,1265,1669,0,10419,66087,55668,1265,1669
88463.0,DOM PEDRO DE ALCANTARA,1064,11,209,1,193,643,51,113,0,311,2596,2285,51,113
88471.0,SANTA ROSA,17944,57,2751,7,5196,10159,597,1258,0,6773,44742,37969,597,1258
88480.0,UNISTALDA,529,4,184,1,369,792,105,181,0,440,2605,2165,105,181
88498.0,SANTA VITORIA DO PALMAR,9885,76,2648,7,1693,3575,622,980,0,3359,22845,19486,622,980
88501.0,TURUCU,618,1,287,1,327,1284,77,184,0,265,3044,2779,77,184
88510.0,SANTIAGO,11381,65,2645,5,3683,9772,1456,1680,0,5789,36476,30687,1456,1680
88528.0,CRISTAL DO SUL,977,1,63,0,203,492,58,164,0,445,2403,1958,58,164
88536.0,SANTO ANGELO,23204,99,5355,12,5760,8836,1159,1914,0,9956,56295,46339,1159,1914
88544.0,MUITOS CAPOES,374,6,111,0,111,1026,106,134,0,377,2245,1868,106,134
88552.0,SANTO ANTONIO DA PATRULHA,6148,49,2569,9,1629,10429,1399,1857,0,3339,27428,24089,1399,1857
88560.0,NOVA RAMADA,921,3,117,0,258,508,43,132,0,279,2261,1982,43,132
88579.0,SANTO ANTONIO DAS MISSOES,3323,9,695,1,1013,1686,352,471,0,2094,9644,7550,352,471
88587.0,JARI,566,3,122,2,153,1104,171,245,0,357,2723,2366,171,245
88595.0,SANTO AUGUSTO,4311,16,616,1,959,2352,259,607,0,2388,11509,9121,259,607
88609.0,UBIRETAMA,646,6,124,0,463,492,36,97,0,273,2137,1864,36,97
88617.0,SANTO CRISTO,5251,16,344,3,708,3847,174,385,0,1422,12150,10728,174,385
88625.0,BARRA DO QUARAI,1152,1,298,2,204,400,34,93,0,509,2693,2184,34,93
88633.0,SAO BORJA,18310,72,4465,9,3171,8598,999,1585,0,8866,46075,37209,999,1585
88641.0,CERRITO,1525,13,506,4,647,1489,291,356,0,912,5743,4831,291,356
88650.0,SAO FRANCISCO DE ASSIS,4118,17,959,4,995,5293,880,926,0,2907,16099,13192,880,926
88668.0,VALE VERDE,793,1,250,1,163,591,103,144,0,305,2351,2046,103,144
88676.0,SAO FRANCISCO DE PAULA,3880,28,828,5,1098,5483,625,886,0,2378,15211,12833,625,886
88684.0,NOVO CABRAIS,1066,5,424,2,321,776,86,137,0,259,3076,2817,86,137
88692.0,SAO GABRIEL,12554,125,6473,8,4942,7764,1299,1792,0,7492,42449,34957,1299,1792
88706.0,SETE DE SETEMBRO,843,1,48,0,136,549,29,99,0,293,1998,1705,29,99
88714.0,SAO JERONIMO,4420,31,1499,1,1564,4144,441,745,0,2201,15046,12845,441,745
88722.0,TABAI,793,7,192,0,272,1070,158,190,0,489,3171,2682,158,190
88730.0,SAO JOSE DO NORTE,4154,74,1046,3,2037,7266,597,981,0,2110,18268,16158,597,981
88749.0,VILA LANGARO,780,4,42,3,146,718,67,90,0,180,2030,1850,67,90
88757.0,SAO JOSE DO OURO,1558,12,280,3,271,2096,245,330,0,867,5662,4795,245,330
88765.0,SENADOR SALGADO FILHO,555,2,172,0,568,661,32,125,0,329,2444,2115,32,125
88773.0,SAO LEOPOLDO,60740,394,8823,49,13506,26872,2809,3642,0,14901,131736,116835,2809,3642
88781.0,VESPASIANO CORREA,403,7,45,0,54,1071,130,148,0,312,2170,1858,130,148
88790.0,SAO LOURENCO DO SUL,10675,88,3656,19,2752,9249,928,1322,0,4121,32810,28689,928,1322
88803.0,MONTE ALEGRE DOS CAMPOS,607,4,204,1,321,915,170,215,0,709,3146,2437,170,215
88811.0,SAO LUIS GONZAGA,9576,38,1750,4,2831,4970,812,1235,0,5683,26899,21216,812,1235
88820.0,MARQUES DE SOUZA,1349,4,320,2,197,1086,127,146,0,468,3699,3231,127,146
88838.0,SAO MARCOS,3927,59,986,5,1007,5142,704,709,0,1664,14203,12539,704,709
88846.0,CHUI,1568,16,270,0,126,364,57,103,0,639,3143,2504,57,103
88854.0,SAO MARTINHO,1987,7,373,2,382,1063,123,235,0,591,4763,4172,123,235
88862.0,ARARICA,1175,5,133,1,336,777,85,110,0,322,2944,2622,85,110
88870.0,SAO NICOLAU,1425,4,218,1,532,1048,153,384,0,1436,5201,3765,153,384
88889.0,PASSA SETE,1277,8,390,1,263,920,187,194,0,544,3784,3240,187,194
88897.0,SAO PAULO DAS MISSOES,2306,4,235,2,612,1067,131,209,0,991,5557,4566,131,209
88900.0,TOROPI,609,5,237,0,189,1030,125,137,0,369,2701,2332,125,137
88919.0,SAO PEDRO DO SUL,3872,22,1008,8,992,4291,686,714,0,2434,14027,11593,686,714
88927.0,BALNEARIO PINHAL,1460,11,498,1,526,1569,93,264,0,1308,5730,4422,93,264
88935.0,SAO SEBASTIAO DO CAI,6021,26,1041,1,1105,5159,429,661,0,1652,16095,14443,429,661
88943.0,MAMPITUBA,912,5,196,0,211,697,69,134,0,523,2747,2224,69,134
88951.0,SAO SEPE,5847,62,1792,5,1186,5151,793,955,0,2878,18669,15791,793,955
88978.0,SAO VALENTIM,1390,2,135,0,190,1055,71,201,0,592,3636,3044,71,201
88986.0,ACEGUA,887,4,226,0,383,1220,48,116,0,513,3397,2884,48,116
88994.0,SAPIRANGA,20268,80,2278,11,5949,11181,1209,1753,0,4789,47518,42729,1209,1753
89001.0,ALMIRANTE TAMANDARE DO SUL,728,4,110,0,79,594,40,64,0,191,1810,1619,40,64
89010.0,SAPUCAIA DO SUL,44936,306,5430,35,9203,15953,1936,2452,0,8672,88923,80251,1936,2452
89028.0,ARROIO DO PADRE,198,8,283,3,501,882,40,61,0,231,2207,1976,40,61
89036.0,SARANDI,4844,20,984,5,1969,3098,360,616,0,2474,14370,11896,360,616
89044.0,BOA VISTA DO CADEADO,467,0,92,0,169,621,73,73,0,276,1771,1495,73,73
89052.0,SEBERI,2742,11,455,3,720,2464,358,553,0,1770,9076,7306,358,553
89060.0,BOA VISTA DO INCRA,674,2,95,0,151,609,47,38,0,223,1839,1616,47,38
89079.0,SELBACH,1231,11,147,2,238,1431,80,176,0,440,3756,3316,80,176
89087.0,BOZANO,768,2,183,0,128,570,26,56,0,186,1919,1733,26,56
89095.0,SERAFINA CORREA,3307,28,306,4,535,2344,480,436,0,902,8342,7440,480,436
89109.0,CANUDOS DO VALE,519,5,117,0,119,551,69,94,0,238,1712,1474,69,94
89117.0,SERTAO,1646,12,248,0,481,2061,179,328,0,826,5781,4955,179,328
89125.0,CAPAO BONITO DO SUL,460,2,119,0,121,723,50,124,0,367,1966,1599,50,124
89133.0,SEVERIANO DE ALMEIDA,1513,3,159,3,137,819,111,169,0,365,3279,2914,111,169
89141.0,CAPAO DO CIPO,583,1,91,0,113,713,66,122,0,276,1965,1689,66,122
89150.0,CAPAO DA CANOA,6172,28,2091,3,2052,6637,609,848,0,3164,21604,18440,609,848
89168.0,COQUEIRO BAIXO,258,4,95,1,55,573,44,109,0,446,1585,1139,44,109
89176.0,SOBRADINHO,3016,18,692,2,654,3475,298,565,0,1457,10177,8720,298,565
89184.0,CORONEL PILAR,410,3,60,0,85,656,103,83,0,201,1601,1400,103,83
89192.0,SOLEDADE,6829,30,1297,1,1720,5688,817,1145,0,3305,20832,17527,817,1145
89206.0,CRUZALTENSE,848,2,69,3,85,569,70,96,0,320,2062,1742,70,96
89214.0,TAPEJARA,3516,25,482,7,782,3835,336,481,0,968,10432,9464,336,481
89222.0,FORQUETINHA,531,3,170,1,123,823,109,160,0,278,2198,1920,109,160
89230.0,TAPERA,2932,20,479,0,483,2063,237,377,0,947,7538,6591,237,377
89247.0,SANTA CECILIA DO SUL,511,2,59,2,117,390,33,69,0,119,1302,1183,33,69
89249.0,ITATI,531,2,149,1,249,913,114,222,0,634,2815,2181,114,222
89257.0,TAPES,3833,26,1226,1,971,3239,388,625,0,2007,12316,10309,388,625
89265.0,JACUIZINHO,586,3,105,1,171,510,50,141,0,322,1889,1567,50,141
89273.0,TAQUARA,10310,69,2643,13,3712,12008,944,1422,0,4193,35314,31121,944,1422
89281.0,LAGOA BONITA DO SUL,930,3,97,0,135,545,80,130,0,231,2151,1920,80,130
89290.0,TAQUARI,6466,32,1103,5,2748,4805,692,777,0,2131,18759,16628,692,777
89303.0,MATO QUEIMADO,844,1,50,1,92,327,38,83,0,325,1761,1436,38,83
89311.0,TENENTE PORTELA,3487,13,405,2,531,3167,131,632,0,2016,10384,8368,131,632
89320.0,NOVO XINGU,663,0,31,1,106,372,23,75,0,357,1628,1271,23,75
89338.0,TORRES,7567,83,1900,5,1758,5681,629,780,0,2984,21387,18403,629,780
89346.0,PAULO BENTO,854,1,107,1,144,341,53,92,0,187,1780,1593,53,92
89354.0,TRAMANDAI,7242,49,1870,5,2168,6020,510,925,0,3901,22690,18789,510,925
89362.0,PINHAL DA SERRA,497,2,88,0,125,527,97,140,0,421,1897,1476,97,140
89370.0,TRES COROAS,5071,25,841,8,1219,4046,552,802,0,1293,13857,12564,552,802
89389.0,QUATRO IRMAOS,658,4,60,0,58,363,36,85,0,183,1447,1264,36,85
89397.0,TRES DE MAIO,6682,18,1286,8,1656,5005,387,693,0,3089,18824,15735,387,693
89400.0,ROLADOR,810,4,64,1,364,532,105,133,0,507,2520,2013,105,133
89419.0,TRES PASSOS,7848,28,1112,2,1181,4674,364,660,0,3188,19057,15869,364,660
89435.0,TRIUNFO,4854,46,1834,5,2077,5609,772,1197,0,2634,19028,16394,772,1197
89443.0,SANTA MARGARIDA DO SUL,728,7,337,0,269,708,88,155,0,482,2774,2292,88,155
89451.0,TUCUNDUVA,1873,11,259,2,400,1528,88,217,0,793,5171,4378,88,217
89460.0,SAO JOSE DO SUL,509,9,171,1,62,586,64,108,0,150,1660,1510,64,108
89478.0,TUPANCIRETA,5034,18,932,1,1079,4627,511,899,0,2241,15342,13101,511,899
89486.0,SAO PEDRO DAS MISSOES,535,1,58,0,247,318,32,146,0,306,1643,1337,32,146
89494.0,TUPARENDI,3348,10,345,0,566,1663,272,276,0,1075,7555,6480,272,276
89508.0,TIO HUGO,705,2,89,1,72,568,63,81,0,158,1739,1581,63,81
89516.0,URUGUAIANA,24112,224,10653,24,8086,22512,1522,2425,0,12542,82100,69558,1522,2425
89524.0,WESTFALIA,802,4,178,1,131,666,90,62,0,191,2125,1934,90,62
89532.0,VACARIA,10795,86,2193,15,3683,13301,1720,1886,0,5621,39300,33679,1720,1886
89540.0,PINTO BANDEIRA,696,11,125,0,67,723,83,85,0,209,1999,1790,83,85
89559.0,VENANCIO AIRES,20847,96,4225,16,3975,7331,2129,1999,0,4466,45084,40618,2129,1999
89567.0,PEDRAS ALTAS,568,2,108,0,99,580,42,119,0,396,1914,1518,42,119
89575.0,VERA CRUZ,7472,24,2141,4,1753,1519,484,588,0,1350,15335,13985,484,588
89591.0,VERANOPOLIS,4487,51,1287,4,1073,5091,867,737,0,1622,15219,13597,867,737
89613.0,VIADUTOS,1912,21,317,7,471,953,162,195,0,660,4698,4038,162,195
89630.0,VIAMAO,46576,575,12046,59,16549,36093,3855,4913,0,13615,134281,120666,3855,4913
89656.0,VICENTE DUTRA,1287,4,228,2,599,930,104,283,0,963,4400,3437,104,283
89672.0,PALMARES DO SUL,2662,12,1037,2,817,2415,176,388,0,1453,8962,7509,176,388
89699.0,VICTOR GRAEFF,951,15,121,0,164,932,65,74,0,295,2617,2322,65,74
89710.0,TAVARES,760,5,376,1,553,1625,167,246,0,587,4320,3733,167,246
89737.0,CAPAO DO LEAO,5344,83,1260,7,3114,3081,537,711,0,2031,16168,14137,537,711
89753.0,SALTO DO JACUI,3128,6,314,3,587,2106,229,469,0,1233,8075,6842,229,469
89770.0,COTIPORA,1106,16,317,2,142,988,259,189,0,402,3421,3019,259,189
89788.0,COLNIZA,2661,7,807,0,785,2009,243,553,0,2337,9402,7065,243,553
89796.0,COLIDER,3465,16,2026,2,1959,6684,586,1077,0,4497,20312,15815,586,1077
89800.0,CURVELANDIA,757,0,478,0,282,784,51,284,0,899,3535,2636,51,284
89818.0,NOVA BRASILANDIA,513,3,356,0,421,1020,60,212,0,348,2933,2585,60,212
89826.0,NOVA SANTA HELENA,685,2,141,1,162,633,29,155,0,574,2382,1808,29,155
89834.0,PARANATINGA,2215,16,1412,0,1262,2722,172,510,0,2692,11001,8309,172,510
89843.0,SANTO ANTONIO DO LESTE,370,3,89,0,89,532,14,55,0,482,1634,1152,14,55
89850.0,SINOP,15864,78,6135,6,3763,13175,1022,1213,0,10143,51399,41256,1022,1213
89877.0,ALTA FLORESTA,7339,75,4255,4,3635,7774,533,1180,0,2928,27723,24795,533,1180
89893.0,ARAPUTANGA,2414,11,786,5,1418,2312,243,571,0,2592,10352,7760,243,571
89915.0,JAURU,930,7,758,1,1335,2406,175,500,0,2674,8786,6112,175,500
89931.0,QUATRO MARCOS,4064,25,1245,6,1198,3002,531,707,0,3765,14543,10778,531,707
89958.0,RIO BRANCO,1121,15,297,0,450,771,66,246,0,970,3936,2966,66,246
89960.0,RONDOLANDIA,715,3,82,0,257,245,25,179,0,675,2181,1506,25,179
89974.0,SALTO DO CEU,555,0,409,0,634,618,50,285,0,1172,3723,2551,50,285
89990.0,PONTES E LACERDA,4318,20,2268,4,3514,6602,541,1118,0,6622,25007,18385,541,1118
90018.0,ACORIZAL,1382,3,556,0,454,1083,53,240,0,1270,5041,3771,53,240
90026.0,SAO JOSE DO POVO,557,7,194,0,261,989,65,136,0,436,2645,2209,65,136
90034.0,AGUA CLARA,1795,13,429,1,658,1911,113,417,0,1818,7155,5337,113,417
90042.0,ALTO DA BOA VISTA,390,3,250,0,290,615,41,171,0,905,2665,1760,41,171
90050.0,ALTO ARAGUAIA,2095,8,897,2,943,2461,142,399,0,2102,9049,6947,142,399
90069.0,QUERENCIA,1561,5,393,0,423,865,74,199,0,1214,4734,3520,74,199
90077.0,ALTO GARCAS,1505,6,931,1,392,1727,127,373,0,934,5996,5062,127,373
90085.0,CANABRAVA DO NORTE,510,1,186,0,371,1039,75,210,0,986,3378,2392,75,210
90093.0,ALTO PARAGUAI,1593,9,538,0,855,1512,126,323,0,1672,6628,4956,126,323
90107.0,SANTA CARMEM,611,2,537,2,161,497,68,76,0,626,2580,1954,68,76
90115.0,AMAMBAI,6608,22,1301,2,1909,3927,221,835,0,4172,18997,14825,221,835
90123.0,NOVA MARINGA,633,2,217,4,250,811,42,171,0,926,3056,2130,42,171
90131.0,ANASTACIO,6001,36,1451,2,2018,2383,289,661,0,2822,15663,12841,289,661
90140.0,NOVA GUARITA,1285,7,243,2,215,599,82,190,0,839,3462,2623,82,190
90158.0,ANAURILANDIA,1258,8,344,1,367,2024,85,339,0,1066,5492,4426,85,339
90166.0,NOVA MARILANDIA,348,3,336,0,160,371,18,14,0,488,1738,1250,18,14
90174.0,ANTONIO JOAO,2105,5,293,2,345,1268,58,324,0,839,5239,4400,58,324
90182.0,PORTO ESTRELA,974,2,415,1,229,679,61,202,0,843,3406,2563,61,202
90190.0,APARECIDA DO TABUADO,4015,32,755,2,1187,3518,431,676,0,2079,12695,10616,431,676
90204.0,GLORIA D'OESTE,466,1,324,0,118,734,48,149,0,423,2263,1840,48,149
90212.0,AQUIDAUANA,10584,74,2819,12,3705,5030,319,1400,0,6669,30612,23943,319,1400
90220.0,TABAPORA,1042,3,176,0,212,1779,72,140,0,997,4421,3424,72,140
90239.0,ARAGUAINHA,337,1,122,0,101,191,21,60,0,117,950,833,21,60
90247.0,SAO JOSE DO XINGU,587,1,177,0,252,922,56,205,0,1229,3429,2200,56,205
90255.0,ARENAPOLIS,1437,13,788,2,861,2377,143,279,0,2109,8009,5900,143,279
90263.0,APIACAS,885,3,485,1,233,1433,80,235,0,1169,4524,3355,80,235
90271.0,ARIPUANA,2492,5,746,2,817,1457,205,285,0,1997,8006,6009,205,285
90280.0,CONFRESA,2032,5,878,2,1430,2910,229,810,0,3258,11554,8296,229,810
90298.0,BANDEIRANTES,1200,22,513,2,567,1208,70,313,0,1057,4952,3895,70,313
90301.0,LAMBARI D'OESTE,870,8,255,0,356,1078,128,310,0,1096,4101,3005,128,310
90310.0,BARAO DE MELGACO,1050,2,959,1,496,1302,97,260,0,865,5032,4167,97,260
90328.0,SANTO AFONSO,556,1,155,1,192,908,47,97,0,828,2785,1957,47,97
90336.0,BARRA DO BUGRES,6687,16,1921,3,1723,3235,552,1106,0,4733,19976,15243,552,1106
90344.0,PLANALTO DA SERRA,376,1,253,1,303,341,29,97,0,141,1542,1401,29,97
90352.0,BARRA DO GARCAS,13703,111,4557,7,4338,5019,562,1026,0,9635,38958,29323,562,1026
90360.0,NOVA MONTE VERDE,1140,5,688,1,399,1138,116,263,0,1155,4905,3750,116,263
90379.0,BATAGUACU,3293,30,698,2,901,2980,244,579,0,1858,10585,8727,244,579
90387.0,NOVA BANDEIRANTE,1121,8,796,1,407,827,144,244,0,1254,4802,3548,144,244
90395.0,BATAIPORA,2674,29,370,2,436,1923,157,522,0,1513,7626,6113,157,522
90409.0,SAO PEDRO DA CIPA,726,1,252,2,546,659,56,142,0,563,2947,2384,56,142
90417.0,BELA VISTA,4731,16,1291,1,1563,2889,147,512,0,3170,14320,11150,147,512
90425.0,COTRIGUACU,1570,4,498,2,439,1118,144,319,0,1254,5348,4094,144,319
90433.0,BONITO,3700,16,1214,1,1161,3167,197,556,0,2445,12457,10012,197,556
90441.0,RIBEIRAOZINHO,402,4,156,0,159,425,17,67,0,300,1530,1230,17,67
90450.0,BRASILANDIA,2215,24,646,7,932,1920,236,520,0,2451,8951,6500,236,520
90468.0,BRASNORTE,1560,3,815,0,629,1637,135,297,0,1897,6973,5076,135,297
90476.0,CACERES,17728,48,4921,11,5718,9866,656,1810,0,13171,53929,40758,656,1810
90484.0,CAMPO NOVO DO PARECIS,4109,16,1197,1,923,2574,181,357,0,3859,13217,9358,181,357
90492.0,CAMAPUA,3241,21,1472,1,990,3324,193,598,0,2335,12175,9840,193,598
90506.0,CAMPO VERDE,4126,18,1276,2,1466,2844,272,446,0,2501,12951,10450,272,446
90514.0,CAMPO GRANDE,140258,1780,58214,174,66575,90244,6405,12992,0,68704,445346,376642,6405,12992
90522.0,CLAUDIA,1793,20,704,0,565,1607,123,238,0,1254,6304,5050,123,238
90530.0,CARACOL,1143,4,92,0,218,892,43,137,0,527,3056,2529,43,137
90549.0,CASTANHEIRA,1457,2,360,0,414,1473,125,256,0,1495,5582,4087,125,256
90557.0,CAARAPO,4263,25,971,1,1883,3303,355,783,0,3086,14670,11584,355,783
90565.0,JANGADA,1116,5,353,1,583,1520,63,463,0,1110,5214,4104,63,463
90573.0,CASSILANDIA,3163,45,1478,1,2278,4527,401,962,0,2710,15565,12855,401,962
90581.0,JURUENA,1275,7,487,2,328,621,89,260,0,869,3938,3069,89,260
90590.0,CHAPADA DOS GUIMARAES,2622,6,897,2,1148,2055,167,369,0,784,8050,7266,167,369
90603.0,LUCAS DO RIO VERDE,5256,24,2143,4,1015,2664,342,391,0,3241,15080,11839,342,391
90611.0,CORGUINHO,843,6,241,0,264,646,31,166,0,594,2791,2197,31,166
90620.0,MATUPA,2135,3,990,0,785,2125,144,390,0,1871,8443,6572,144,390
90638.0,CORUMBA,21836,177,7520,12,6801,9328,669,1730,0,11301,59374,48073,669,1730
90646.0,NOVA MUTUM,3119,7,1068,2,665,2545,204,176,0,1911,9697,7786,204,176
90654.0,COXIM,4785,35,2999,6,2154,5513,350,1178,0,4805,21825,17020,350,1178
90662.0,RIBEIRAO CASCALHEIRA,1135,6,407,2,530,1596,71,331,0,1558,5636,4078,71,331
90670.0,CUIABA,130846,618,35070,70,43740,53592,3754,7000,0,66199,341257,275058,3754,7000
90689.0,TAPURA,927,6,504,0,301,851,61,122,0,767,3539,2772,61,122
90697.0,DIAMANTINO,3577,23,1191,1,1146,3618,199,436,0,3245,13436,10191,199,436
90700.0,PONTAL DO ARAGUAIA,1274,10,398,1,393,641,65,127,0,708,3617,2909,65,127
90719.0,DOM AQUINO,1316,14,740,0,620,1826,102,413,0,1506,6537,5031,102,413
90727.0,SAPEZAL,1322,1,783,0,428,1180,66,156,0,1570,5506,3936,66,156
90735.0,DOURADOS,36764,385,11277,35,15610,27055,1742,3016,0,19518,115402,95884,1742,3016
90743.0,CAMPOS DE JULIO,559,1,176,0,191,797,22,92,0,545,2383,1838,22,92
90751.0,FATIMA DO SUL,3200,57,1639,5,1873,3517,377,943,0,1619,13230,11611,377,943
90760.0,CARLINDA,2077,11,920,3,741,2375,155,377,0,2048,8707,6659,155,377
90778.0,GENERAL CARNEIRO,1444,1,386,0,204,736,71,183,0,990,4015,3025,71,183
90786.0,FELIZ NATAL,797,3,296,0,190,1413,48,108,0,1225,4080,2855,48,108
90794.0,GLORIA DE DOURADOS,2180,16,720,2,832,1816,230,365,0,1389,7550,6161,230,365
90808.0,NOVO MUNDO,1245,6,207,0,230,853,92,125,0,947,3705,2758,92,125
90816.0,GUIA LOPES DA LAGUNA,2376,13,734,5,719,1778,166,438,0,1360,7589,6229,166,438
90824.0,GAUCHA DO NORTE,551,1,254,1,195,650,53,91,0,600,2396,1796,53,91
90832.0,GUIRATINGA,1805,15,1130,4,1585,2921,170,482,0,2344,10456,8112,170,482
90840.0,UNIAO DO SUL,602,1,298,0,91,463,35,64,0,712,2266,1554,35,64
90859.0,IGUATEMI,2937,20,535,3,597,2000,119,447,0,1664,8322,6658,119,447
90867.0,NOVA LACERDA,659,4,245,0,249,583,39,97,0,884,2760,1876,39,97
90875.0,INOCENCIA,1241,11,314,0,311,2072,85,348,0,1075,5457,4382,85,348
90883.0,NOVA UBIRATA,918,2,314,1,199,540,35,84,0,943,3036,2093,35,84
90891.0,ITAPORA,3399,36,944,2,1171,3070,268,565,0,2014,11469,9455,268,565
90905.0,BOM JESUS DO ARAGUAIA,309,2,107,0,161,619,31,113,0,738,2080,1342,31,113
90913.0,ITIQUIRA,1602,20,939,1,464,1549,112,289,0,1960,6936,4976,112,289
90921.0,SERRA NOVA DOURADA,132,0,78,0,63,181,22,62,0,256,794,538,22,62
90930.0,IVINHEMA,4064,69,1857,2,1980,3637,436,911,0,3558,16514,12956,436,911
90948.0,NOVO SANTO ANTONIO,283,1,131,0,60,279,13,28,0,283,1078,795,13,28
90956.0,JACIARA,4001,25,1208,1,2548,4290,251,604,0,2878,15806,12928,251,604
90964.0,NOVA NAZARE,179,0,93,0,85,303,6,79,0,298,1043,745,6,79
90972.0,JARAGUARI,820,6,600,0,322,660,38,186,0,421,3053,2632,38,186
90980.0,SANTA CRUZ DO XINGU,223,3,82,1,56,361,20,39,0,334,1119,785,20,39
90999.0,JARDIM,5887,28,1308,2,1432,3597,289,606,0,2587,15736,13149,289,606
91006.0,CONQUISTA D'OESTE,303,2,199,0,292,492,25,109,0,487,1909,1422,25,109
91014.0,JATEI,839,5,253,0,358,872,57,161,0,434,2979,2545,57,161
91022.0,VALE DE SAO DOMINGOS,378,6,229,0,410,745,48,132,0,889,2837,1948,48,132
91030.0,LADARIO,3251,30,1120,1,967,986,129,292,0,1711,8487,6776,129,292
91049.0,SANTA RITA DO TRIVELATO,186,0,134,0,89,300,11,16,0,304,1040,736,11,16
91057.0,LUCIARA,388,2,309,0,285,214,21,119,0,306,1644,1338,21,119
91065.0,BOA ESPERANCA DO NORTE,473,2,183,1,105,142,34,39,0,340,1319,979,34,39
91073.0,MARACAJU,6574,25,971,3,1718,4781,252,704,0,3310,18338,15028,252,704
91081.0,IPIRANGA DO NORTE,536,4,154,0,61,283,31,25,0,271,1365,1094,31,25
91090.0,VILA BELA STSSMA TRINDADE,1102,3,1036,0,1052,1692,81,365,0,2115,7446,5331,81,365
91103.0,ITANHANGA,634,1,272,2,120,528,37,64,0,578,2236,1658,37,64
91111.0,MIRANDA,5426,37,1167,3,1728,3085,246,886,0,2633,15211,12578,246,886
91138.0,NAVIRAI,8874,66,1569,3,3486,6020,650,1418,0,4725,26811,22086,650,1418
91154.0,NIOAQUE,3420,10,633,0,1113,1568,149,594,0,1790,9277,7487,149,594
91170.0,NOBRES,2252,12,1434,0,1349,2551,131,517,0,2507,10753,8246,131,517
91197.0,NORTELANDIA,1577,2,595,1,447,1628,66,241,0,1501,6058,4557,66,241
91219.0,NOSSA SENHORA DO LIVRAMENTO,2206,4,1175,0,657,2520,121,574,0,2177,9434,7257,121,574
91235.0,NOVA ANDRADINA,6869,66,2021,2,2659,6144,495,1124,0,4967,24347,19380,495,1124
91251.0,PARANAIBA,7668,77,2640,7,2093,7614,604,1465,0,5315,27483,22168,604,1465
91278.0,PEDRO GOMES,1487,10,882,0,572,1309,116,522,0,1253,6151,4898,116,522
91294.0,POCONE,5186,15,2776,4,1267,4213,261,885,0,1516,16123,14607,261,885
91316.0,PONTA PORA,13624,148,4001,11,3787,9263,674,1804,0,8581,41893,33312,674,1804
91332.0,PONTE BRANCA,493,1,102,1,116,464,14,99,0,188,1478,1290,14,99
91359.0,PORTO DOS GAUCHOS,748,7,246,1,318,1306,53,141,0,778,3598,2820,53,141
91375.0,PORTO MURTINHO,2333,8,489,0,603,1588,56,434,0,1536,7047,5511,56,434
91391.0,POXOREO,3093,27,1252,7,1157,4101,266,885,0,3654,14442,10788,266,885
91413.0,RIBAS DO RIO PARDO,2949,15,759,4,910,2509,127,474,0,2673,10420,7747,127,474
91430.0,RIO BRILHANTE,5005,36,1263,2,1707,2823,265,613,0,2113,13827,11714,265,613
91456.0,RIO NEGRO,1286,8,339,3,348,1143,68,205,0,802,4202,3400,68,205
91472.0,RIO VERDE DE MATO GROSSO,2708,14,1311,2,2324,2717,222,650,0,2329,12277,9948,222,650
91499.0,ROCHEDO,826,4,553,0,275,869,34,222,0,568,3351,2783,34,222
91510.0,RONDONOPOLIS,29702,313,11700,23,11411,22182,1548,3026,0,22475,102264,79789,1548,3026
91537.0,ROSARIO OESTE,2750,8,1762,2,1269,2907,220,792,0,3148,12858,9710,220,792
91553.0,SANTO ANTONIO DO LEVERGER,3343,8,1737,1,925,3161,116,520,0,1366,11177,9811,116,520
91570.0,SIDROLANDIA,6189,21,2021,6,1413,2189,238,673,0,2082,14832,12750,238,673
91596.0,TERENOS,2197,23,1158,3,940,1839,135,349,0,1161,7805,6644,135,349
91618.0,TESOURO,412,0,312,0,167,773,33,180,0,775,2652,1877,33,180
91634.0,TORIXOREU,903,1,438,0,260,926,85,146,0,317,3076,2759,85,146
91650.0,TRES LAGOAS,19642,207,5134,29,6813,9342,1026,1651,0,10379,54223,43844,1026,1651
91677.0,VARZEA GRANDE,52011,269,14257,24,20180,20265,1934,3785,0,26972,139697,112725,1934,3785
91693.0,ANGELICA,1794,17,326,1,588,1268,99,293,0,1040,5426,4386,99,293
91715.0,ARAL MOREIRA,1680,4,221,0,322,1417,65,349,0,759,4817,4058,65,349
91731.0,ELDORADO,2191,16,723,2,544,1943,203,427,0,1495,7544,6049,203,427
91758.0,DEODAPOLIS,1768,18,1168,1,1039,1999,228,573,0,1568,8362,6794,228,573
91774.0,MIRASSOL D'OESTE,2950,13,1406,0,1281,4896,449,1139,0,4269,16403,12134,449,1139
91782.0,CHAPADAO DO SUL,2299,11,504,2,1013,2136,144,239,0,1431,7779,6348,144,239
91790.0,MUNDO NOVO,3480,14,420,1,1000,2826,160,635,0,2323,10859,8536,160,635
91804.0,DOIS IRMAOS DO BURITI,2587,9,464,2,463,987,83,392,0,1671,6658,4987,83,392
91812.0,PEDRA PRETA,3028,25,1300,2,936,2442,277,489,0,2471,10970,8499,277,489
91820.0,JUTY,1226,11,213,1,296,997,63,200,0,632,3639,3007,63,200
91839.0,SAO FELIX DO ARAGUAIA,1448,3,644,3,665,1439,89,435,0,2543,7269,4726,89,435
91847.0,PARANHOS,1784,1,127,1,244,1364,61,378,0,1137,5097,3960,61,378
91855.0,TANGARA DA SERRA,14029,62,5004,7,3958,9097,798,1316,0,9619,43890,34271,798,1316
91863.0,SANTA RITA DO PARDO,1365,4,246,0,510,911,56,306,0,1225,4623,3398,56,306
91880.0,SONORA,1966,7,906,1,533,1737,137,423,0,1385,7095,5710,137,423
91898.0,JUSCIMEIRA,1893,15,960,2,1197,2327,198,487,0,2305,9384,7079,198,487
91901.0,VICENTINA,1081,13,356,2,542,1204,153,345,0,583,4279,3696,153,345
91910.0,AGUA BOA,2699,10,1605,2,1070,2278,166,551,0,2815,11196,8381,166,551
91936.0,CANARANA,2524,8,1171,5,1001,2075,187,545,0,2661,10177,7516,187,545
91952.0,NOVA XAVANTINA,3189,12,1200,3,1178,3364,220,513,0,3233,12912,9679,220,513
91979.0,SANTA TEREZINHA,849,9,362,0,463,777,75,308,0,1596,4439,2843,75,308
91995.0,SAO JOSE DO RIO CLARO,1435,8,766,4,747,2969,230,556,0,2606,9321,6715,230,556
92002.0,BERNARDO SAYAO,521,2,73,3,411,700,47,313,0,503,2573,2070,47,313
92010.0,ABADIANIA,2263,14,684,1,787,1996,228,703,0,1298,7974,6676,228,703
92029.0,BONFINOPOLIS,1501,8,219,0,569,1095,72,314,0,734,4512,3778,72,314
92037.0,AGUA LIMPA,582,3,83,0,225,456,31,124,0,247,1751,1504,31,124
92045.0,BURITI DO TOCANTINS,1270,3,187,2,462,1271,109,728,0,1016,5048,4032,109,728
92053.0,ALEXANIA,3431,40,1416,3,1779,3575,408,1218,0,3062,14932,11870,408,1218
92061.0,CAMPOS VERDES,1123,8,232,0,836,1253,53,617,0,1857,5979,4122,53,617
92070.0,ALMAS,1145,1,98,0,248,1089,54,886,0,1236,4757,3521,54,886
92088.0,CASEARA,669,1,77,0,231,499,20,381,0,538,2416,1878,20,381
92096.0,ALOANDIA,481,1,94,3,327,526,28,151,0,208,1819,1611,28,151
92100.0,CEZARINA,1775,10,344,0,1155,1034,82,269,0,545,5214,4669,82,269
92118.0,ALTO PARAISO,1231,14,174,1,507,727,57,249,0,1093,4053,2960,57,249
92126.0,COLINAS DO SUL,537,1,209,1,276,771,38,255,0,1052,3140,2088,38,255
92134.0,ALVORADA,1590,6,333,0,511,1294,70,520,0,1615,5939,4324,70,520
92142.0,COMBINADO,664,2,229,1,499,612,55,483,0,650,3195,2545,55,483
92150.0,ALVORADA DO NORTE,1301,4,375,1,276,1620,84,583,0,1319,5563,4244,84,583
92169.0,MORRO AGUDO DE GOIAS,483,2,79,0,451,491,47,217,0,290,2060,1770,47,217
92177.0,AMORINOPOLIS,944,5,147,0,763,951,45,162,0,323,3340,3017,45,162
92185.0,DIVINOPOLIS DO TOCANTINS,1153,5,320,0,347,786,58,506,0,715,3890,3175,58,506
92193.0,ANANAS,1457,5,271,0,552,1947,91,795,0,1461,6579,5118,91,795
92207.0,EDEALINA,1002,1,220,0,530,720,59,299,0,396,3227,2831,59,299
92215.0,ANAPOLIS,51678,815,17176,65,34326,44971,4005,6410,0,29021,188467,159446,4005,6410
92223.0,FAINA,1607,8,168,2,901,1278,141,493,0,1196,5794,4598,141,493
92231.0,ANHANGUERA,232,3,106,1,69,163,7,73,0,118,772,654,7,73
92240.0,GOIANORTE,610,2,80,1,544,1060,69,408,0,703,3477,2774,69,408
92258.0,ANICUNS,4630,27,870,4,2282,2729,302,985,0,2213,14042,11829,302,985
92266.0,GOUVELANDIA,1013,1,129,0,432,829,54,297,0,650,3405,2755,54,297
92274.0,APARECIDA DE GOIANIA,64190,551,10071,41,35877,29659,2993,8642,0,29090,181114,152024,2993,8642
92282.0,ITAGUARI,1215,10,110,0,529,990,62,282,0,484,3682,3198,62,282
92290.0,APORE,550,5,197,0,203,612,32,164,0,740,2503,1763,32,164
92304.0,MARIANOPOLIS DO TOCANTINS,565,3,113,0,167,686,66,238,0,420,2258,1838,66,238
92312.0,ARACU,1130,6,177,1,305,1047,61,307,0,391,3425,3034,61,307
92320.0,MATRINCHA,1171,1,135,0,432,758,65,278,0,799,3639,2840,65,278
92339.0,ARAGARCAS,4234,35,693,3,1390,1281,201,628,0,2603,11068,8465,201,628
92347.0,MIMOSO DE GOIAS,403,5,175,1,582,647,39,297,0,358,2507,2149,39,297
92355.0,ARAGOIANIA,1767,8,320,0,569,1168,72,364,0,430,4698,4268,72,364
92363.0,MONTIVIDIU,2011,8,379,1,694,1891,135,440,0,1045,6604,5559,135,440
92371.0,ARAGUACEMA,649,1,112,1,320,1094,40,555,0,885,3657,2772,40,555
92398.0,ARAGUACU,1081,14,317,1,1280,1425,98,880,0,1569,6665,5096,98,880
92401.0,NOVA ROSALANDIA,554,1,167,1,201,563,28,257,0,359,2131,1772,28,257
92410.0,ARAGUAINA,22576,104,5005,9,6843,15015,1097,5030,0,13151,68830,55679,1097,5030
92436.0,ARAGUATINS,2953,11,838,1,1202,4590,205,1996,0,2892,14688,11796,205,1996
92444.0,NOVO PLANALTO,744,7,176,2,449,620,26,247,0,607,2878,2271,26,247
92452.0,ARAPOEMA,1348,5,192,1,648,1081,92,667,0,1351,5385,4034,92,667
92460.0,PALESTINA DE GOIAS,495,2,66,0,552,722,24,250,0,489,2600,2111,24,250
92479.0,ARRAIAS,1750,11,449,1,410,1185,131,1327,0,1982,7246,5264,131,1327
92487.0,PEQUIZEIRO,790,3,153,0,205,806,45,459,0,743,3204,2461,45,459
92495.0,ARUANA,1008,10,153,1,303,1091,37,290,0,974,3867,2893,37,290
92509.0,PORTO ALEGRE DO TOCANTINS,501,0,30,0,105,439,14,291,0,349,1729,1380,14,291
92517.0,AURILANDIA,1463,8,222,1,388,595,58,281,0,670,3686,3016,58,281
92525.0,PRAIA NORTE,1120,1,132,1,263,1091,103,523,0,1020,4254,3234,103,523
92533.0,AURORA DO TOCANTINS,764,1,175,1,145,500,102,384,0,546,2618,2072,102,384
92541.0,SAMPAIO,613,0,39,1,93,549,22,286,0,502,2105,1603,22,286
92550.0,AVELINOPOLIS,565,4,165,0,261,731,79,164,0,286,2255,1969,79,164
92568.0,SANTA FE DE GOIAS,1126,5,76,2,615,572,73,198,0,679,3346,2667,73,198
92576.0,AXIXA DO TOCANTINS,1748,7,232,3,429,2159,121,1314,0,1597,7610,6013,121,1314
92584.0,SANTA ROSA DO TOCANTINS,698,0,47,0,121,807,26,476,0,549,2724,2175,26,476
92592.0,BABACULANDIA,762,1,214,1,272,2323,115,910,0,1153,5751,4598,115,910
92606.0,SANTA TEREZA DO TOCANTINS,478,2,332,0,163,241,24,167,0,277,1684,1407,24,167
92614.0,BALIZA,490,5,58,1,131,298,21,124,0,512,1640,1128,21,124
92622.0,SAO JOAO DA PARAUNA,516,3,102,2,237,365,31,129,0,253,1638,1385,31,129
92630.0,BARRO ALTO,1716,11,320,0,971,823,79,558,0,1507,5985,4478,79,558
92649.0,SAO LUIZ DO NORTE,945,3,115,1,447,803,61,339,0,856,3570,2714,61,339
92657.0,BELA VISTA DE GOIAS,4542,25,780,6,1741,3494,396,941,0,2330,14255,11925,396,941
92665.0,SAO MIGUEL DO PASSA QUATRO,893,4,265,1,297,552,70,194,0,383,2659,2276,70,194
92673.0,BOM JARDIM DE GOIAS,1882,13,209,0,798,1389,101,406,0,1559,6357,4798,101,406
92681.0,SAO VALERIO DA NATIVIDADE,973,5,98,1,129,751,35,519,0,713,3224,2511,35,519
92690.0,BOM JESUS,3301,18,557,4,1060,3628,273,1040,0,1940,11821,9881,273,1040
92703.0,SENADOR CANEDO,11532,89,1584,4,6122,5712,571,1348,0,6260,33222,26962,571,1348
92711.0,BRAZABRANTES,667,4,148,1,283,597,43,101,0,280,2124,1844,43,101
92720.0,SIMOLANDIA,1308,5,235,1,284,1348,143,565,0,1234,5123,3889,143,565
92738.0,BREJINHO DE NAZARE,1023,3,155,1,289,816,57,498,0,614,3456,2842,57,498
92754.0,BRITANIA,1626,4,131,0,299,1009,61,316,0,1040,4486,3446,61,316
92762.0,TERESINA DE GOIAS,557,7,72,0,278,336,14,238,0,404,1906,1502,14,238
92770.0,BURITI ALEGRE,2145,10,430,0,511,1995,133,482,0,957,6663,5706,133,482
92789.0,TROMBAS,889,6,103,0,367,679,48,288,0,656,3036,2380,48,288
92797.0,CABECEIRAS,1810,12,373,1,381,1030,119,361,0,1069,5156,4087,119,361
92800.0,TURVELANDIA,914,2,134,0,226,600,27,263,0,558,2724,2166,27,263
92819.0,CACHOEIRA ALTA,1680,4,484,1,824,1218,141,535,0,1330,6217,4887,141,535
92827.0,RIO QUENTE,770,7,288,0,227,443,38,126,0,351,2250,1899,38,126
92835.0,CACHOEIRA DE GOIAS,313,4,88,0,168,408,19,108,0,217,1325,1108,19,108
92851.0,CACU,2614,15,1020,1,601,1788,143,529,0,1434,8145,6711,143,529
92860.0,GUARINOS,526,2,91,0,177,788,36,285,0,430,2335,1905,36,285
92878.0,CAIAPONIA,3264,20,528,2,1419,2040,157,841,0,1416,9687,8271,157,841
92886.0,COCALZINHO DE GOIAS,1978,22,631,3,1522,2369,246,930,0,1970,9671,7701,246,930
92894.0,CALDAS NOVAS,10846,55,3498,9,5315,6075,722,1815,0,6404,34739,28335,722,1815
92908.0,SANTO ANTONIO DE GOIAS,1235,4,173,1,344,438,60,144,0,403,2802,2399,60,144
92916.0,CAMPESTRE DE GOIAS,690,0,114,1,317,671,29,116,0,214,2152,1938,29,116
92924.0,CHAPADAO DO CEU,1017,4,124,0,231,614,43,135,0,519,2687,2168,43,135
92932.0,CAMPINORTE,1418,13,452,2,730,1868,169,341,0,1658,6651,4993,169,341
92940.0,ALTO HORIZONTE,507,2,69,0,313,696,34,167,0,480,2268,1788,34,167
92959.0,CAMPO ALEGRE DE GOIAS,1039,10,227,1,520,915,53,206,0,656,3627,2971,53,206
92967.0,CASTELANDIA,997,1,250,0,248,762,52,190,0,652,3152,2500,52,190
92975.0,CAMPOS BELOS,3570,21,1129,2,1243,1570,227,1430,0,3127,12319,9192,227,1430
92983.0,JESUPOLIS,611,3,233,0,152,461,46,241,0,266,2013,1747,46,241
92991.0,CARMO DO RIO VERDE,2034,9,302,1,925,1115,132,453,0,896,5867,4971,132,453
93009.0,APARECIDA DO RIO DOCE,731,2,144,1,269,398,26,187,0,537,2295,1758,26,187
93017.0,CATALAO,20683,130,3089,8,5093,8325,1225,2509,0,5697,46759,41062,1225,2509
93025.0,CIDADE OCIDENTAL,9018,110,2522,13,3765,2574,476,1118,0,3778,23374,19596,476,1118
93033.0,CATURAI,1135,5,111,1,334,999,78,242,0,487,3392,2905,78,242
93041.0,PROFESSOR JAMIL,1158,8,143,1,137,559,45,205,0,560,2816,2256,45,205
93050.0,CAVALCANTE,1211,20,253,1,421,1099,72,899,0,2112,6088,3976,72,899
93068.0,PEROLANDIA,751,4,194,0,263,260,30,188,0,441,2131,1690,30,188
93076.0,CERES,4770,13,1201,4,2345,3385,255,766,0,1614,14353,12739,255,766
93084.0,NOVA IGUACU DE GOIAS,451,1,73,0,190,660,32,182,0,394,1983,1589,32,182
93092.0,DIVINOPOLIS DE GOIAS,1284,5,176,0,316,695,75,511,0,1025,4087,3062,75,511
93106.0,BURITI DE GOIAS,795,5,64,1,814,264,28,221,0,427,2619,2192,28,221
93114.0,COLINAS DO TOCANTINS,4845,17,948,2,1507,3909,250,2121,0,3507,17106,13599,250,2121
93122.0,CALDAZINHA,798,4,170,0,307,606,45,149,0,405,2484,2079,45,149
93130.0,CONCEICAO DO TOCANTINS,641,6,73,1,225,525,78,462,0,740,2751,2011,78,462
93149.0,GUARAITA,682,4,26,0,824,332,41,230,0,470,2609,2139,41,230
93157.0,CORREGO DO OURO,682,1,104,0,625,598,50,143,0,538,2741,2203,50,143
93165.0,INACIOLANDIA,1248,6,370,1,552,693,66,417,0,725,4078,3353,66,417
93173.0,CORUMBA DE GOIAS,1376,26,490,5,689,2232,180,656,0,753,6407,5654,180,656
93181.0,MONTIVIDIU DO NORTE,548,2,81,1,296,827,58,253,0,429,2495,2066,58,253
93190.0,CORUMBAIBA,1610,21,454,1,727,1015,99,490,0,943,5360,4417,99,490
93203.0,SANTO ANTONIO DA BARRA,773,5,186,1,293,1146,79,254,0,615,3352,2737,79,254
93211.0,COUTO DE MAGALHAES,777,3,159,0,185,705,49,521,0,861,3260,2399,49,521
93220.0,TEREZOPOLIS DE GOIAS,1194,8,195,2,518,951,99,333,0,512,3812,3300,99,333
93238.0,CRISTALANDIA,1805,22,294,0,313,1139,60,704,0,1126,5463,4337,60,704
93246.0,UIRAPURU,565,1,56,1,347,645,25,232,0,467,2339,1872,25,232
93254.0,CRISTALINA,4592,66,1616,1,2230,6643,617,1686,0,3763,21214,17451,617,1686
93262.0,BURITINOPOLIS,408,4,99,0,179,865,33,332,0,619,2539,1920,33,332
93270.0,CRISTIANOPOLIS,826,4,80,0,631,570,44,196,0,466,2817,2351,44,196
93289.0,VILA BOA,786,5,242,0,170,454,24,244,0,315,2240,1925,24,244
93297.0,CRIXAS,3217,11,634,2,1165,1819,120,842,0,2348,10158,7810,120,842
93300.0,VALPARAISO,15083,167,4665,7,6840,3602,876,1569,0,5857,38666,32809,876,1569
93319.0,CROMINIA,1010,6,248,0,486,851,56,212,0,350,3219,2869,56,212
93327.0,NOVO GAMA,10034,83,2787,10,5096,3653,645,2183,0,5164,29655,24491,645,2183
93335.0,CUMARI,909,10,140,0,300,460,61,151,0,310,2341,2031,61,151
93343.0,AGUAS LINDAS,8620,78,3165,6,6513,3167,1013,1632,0,6356,30550,24194,1013,1632
93351.0,DAMIANOPOLIS,370,5,86,1,206,1159,36,263,0,712,2838,2126,36,263
93360.0,ABADIA DE GOIAS,1178,12,345,0,554,751,59,181,0,487,3567,3080,59,181
93378.0,DAMOLANDIA,751,6,231,1,190,754,70,191,0,255,2449,2194,70,191
93386.0,AMARALINA,350,0,139,0,350,677,43,167,0,429,2155,1726,43,167
93394.0,DAVINOPOLIS,552,2,196,0,263,388,30,140,0,129,1700,1571,30,140
93408.0,BONOPOLIS,471,1,41,0,117,821,21,171,0,534,2177,1643,21,171
93416.0,DIANOPOLIS,3446,14,280,2,516,1996,113,1214,0,2209,9790,7581,113,1214
93424.0,PORTEIRAO,710,0,80,0,305,504,23,212,0,612,2446,1834,23,212
93432.0,DIORAMA,663,5,165,0,389,480,44,87,0,365,2198,1833,44,87
93440.0,SANTA RITA DO NOVO DESTINO,774,3,239,0,722,367,51,258,0,631,3045,2414,51,258
93459.0,DOIS IRMAOS DO TOCANTINS,1247,4,153,0,178,956,112,700,0,864,4214,3350,112,700
93475.0,DUERE,1082,7,190,1,160,627,39,388,0,650,3144,2494,39,388
93483.0,SAO PATRICIO,426,1,44,0,367,443,24,136,0,209,1650,1441,24,136
93491.0,EDEIA,1941,16,431,2,732,2280,129,380,0,1218,7129,5911,129,380
93505.0,VILA PROPICIO,873,9,179,1,524,703,72,409,0,850,3620,2770,72,409
93513.0,ESTRELA DO NORTE,815,6,178,0,322,807,51,208,0,589,2976,2387,51,208
93530.0,FAZENDA NOVA,1529,7,242,0,1016,1050,67,434,0,994,5339,4345,67,434
93548.0,IPIRANGA DE GOIAS,621,1,62,0,429,470,47,219,0,256,2105,1849,47,219
93556.0,FILADELFIA,954,3,227,0,343,1933,93,808,0,1207,5568,4361,93,808
93564.0,GAMELEIRA DE GOIAS,452,9,97,0,173,623,39,114,0,261,1768,1507,39,114
93572.0,FIRMINOPOLIS,2163,16,360,1,1307,1819,123,431,0,758,6978,6220,123,431
93580.0,CAMPO LIMPO DE GOIAS,855,6,276,0,373,1344,75,218,0,521,3668,3147,75,218
93599.0,FLORES DE GOIAS,1012,4,213,3,309,1349,84,401,0,1116,4491,3375,84,401
93602.0,LAGOA SANTA,163,1,61,1,113,260,7,66,0,141,813,672,7,66
93610.0,FORMOSA,18205,209,5045,11,4364,11059,999,2623,0,8150,50665,42515,999,2623
93637.0,FORMOSO,1285,9,253,4,631,863,65,398,0,1101,4609,3508,65,398
93653.0,FORMOSO DO ARAGUAIA,3684,19,1009,0,1227,2799,264,1216,0,3285,13503,10218,264,1216
93670.0,GOIANAPOLIS,1710,12,435,1,1559,2190,205,518,0,1750,8380,6630,205,518
93696.0,GOIANDIRA,1627,11,270,1,426,708,69,278,0,359,3749,3390,69,278
93718.0,GOIANESIA,11377,64,2215,11,5676,5964,712,2816,0,6306,35141,28835,712,2816
93734.0,GOIANIA,260666,2823,71296,252,131145,144915,10196,23657,0,117143,762093,644950,10196,23657
93750.0,GOIANIRA,4710,24,805,5,1816,2118,241,607,0,1802,12128,10326,241,607
93777.0,GOIAS,7803,36,928,3,2848,3717,374,1256,0,3840,20805,16965,374,1256
93793.0,GOIATUBA,6385,27,2265,8,2267,6027,607,1686,0,4447,23719,19272,607,1686
93815.0,GUAPO,2727,17,495,2,1098,2743,213,510,0,1375,9180,7805,213,510
93831.0,GUARANI DE GOIAS,626,1,188,0,215,1245,37,385,0,734,3431,2697,37,385
93858.0,GURUPI,16066,84,3982,8,4487,7474,584,2826,0,9712,45223,35511,584,2826
93874.0,HEITORAI,705,3,64,0,405,819,26,200,0,422,2644,2222,26,200
93890.0,HIDROLANDIA,3475,23,914,2,963,2124,245,520,0,1614,9880,8266,245,520
93912.0,HIDROLINA,1057,2,195,1,340,1064,74,303,0,529,3565,3036,74,303
93939.0,IACIARA,1537,7,322,2,475,2161,135,717,0,1607,6963,5356,135,717
93955.0,INHUMAS,11215,84,2382,5,3560,7878,566,1570,0,4823,32083,27260,566,1570
93971.0,IPAMERI,5693,40,1668,4,1683,3592,435,1124,0,3181,17420,14239,435,1124
93998.0,IPORA,6463,37,1710,2,4465,4574,381,985,0,3904,22521,18617,381,985
94013.0,ISRAELANDIA,601,6,85,0,474,764,37,155,0,444,2566,2122,37,155
94030.0,ITABERAI,5636,23,1042,1,2773,4902,413,1649,0,3290,19729,16439,413,1649
94056.0,ITACAJA,720,2,311,0,291,1535,52,669,0,1146,4726,3580,52,669
94072.0,ITAGUARU,1676,6,168,0,884,808,105,420,0,438,4505,4067,105,420
94099.0,ITAGUATINS,1289,6,146,0,231,1177,52,646,0,867,4414,3547,52,646
94110.0,ITAJA,1158,10,240,0,361,1070,44,318,0,757,3958,3201,44,318
94137.0,ITAPACI,2497,6,576,1,1498,2868,177,838,0,1754,10215,8461,177,838
94153.0,ITAPIRAPUA,2049,12,357,0,980,1209,89,516,0,1499,6711,5212,89,516
94170.0,ITAPORA DO TOCANTINS,455,0,28,0,107,703,39,288,0,450,2070,1620,39,288
94196.0,ITAPURANGA,7600,25,516,5,4390,2992,424,1191,0,3696,20839,17143,424,1191
94218.0,ITARUMA,816,5,361,1,316,1183,39,253,0,923,3897,2974,39,253
94234.0,ITAUCU,2547,18,335,1,523,1729,130,446,0,700,6429,5729,130,446
94250.0,ITUMBIARA,18887,162,6516,8,4949,15821,1183,2827,0,9888,60241,50353,1183,2827
94277.0,IVOLANDIA,626,4,118,2,300,748,29,164,0,369,2360,1991,29,164
94293.0,JANDAIA,1850,5,336,2,995,1186,68,328,0,844,5614,4770,68,328
94315.0,JARAGUA,6124,33,1641,7,3121,6114,477,1742,0,3822,23081,19259,477,1742
94331.0,JATAI,20132,123,6045,13,6079,7993,864,2701,0,8289,52239,43950,864,2701
94358.0,JAUPACI,647,6,112,0,665,379,35,209,0,358,2411,2053,35,209
94374.0,JOVIANIA,1662,15,511,0,426,1339,129,393,0,935,5410,4475,129,393
94390.0,JUSSARA,4492,17,709,3,1771,3590,217,991,0,2986,14776,11790,217,991
94439.0,LEOPOLDO DE BULHOES,1553,20,587,3,937,1190,196,598,0,1252,6336,5084,196,598
94455.0,LUZIANIA,23935,266,7155,21,12365,14486,1998,4176,0,11063,75465,64402,1998,4176
94471.0,MAIRIPOTABA,624,6,195,0,172,596,34,144,0,230,2001,1771,34,144
94498.0,MAMBAI,649,2,113,0,385,1133,57,343,0,875,3557,2682,57,343
94510.0,MARA ROSA,1385,14,470,7,1066,2818,137,617,0,1559,8073,6514,137,617
94536.0,MARZAGAO,440,5,98,1,222,437,17,148,0,267,1635,1368,17,148
94552.0,PARANAIGUARA,2188,16,512,7,504,1445,118,482,0,1382,6654,5272,118,482
94579.0,MAURILANDIA,2391,9,273,1,477,1361,182,585,0,1534,6813,5279,182,585
94595.0,MINEIROS,9503,29,2012,3,2691,6202,512,1658,0,4054,26664,22610,512,1658
94617.0,MIRACEMA DO TOCANTINS,4251,16,790,1,1290,2707,245,1565,0,3043,13908,10865,245,1565
94633.0,MIRANORTE,2216,8,511,1,780,2711,202,1009,0,1824,9262,7438,202,1009
94650.0,MOIPORA,458,6,83,0,244,615,33,97,0,237,1773,1536,33,97
94676.0,MONTE ALEGRE DE GOIAS,1014,7,235,0,363,1246,55,686,0,1351,4957,3606,55,686
94692.0,MONTE DO CARMO,1132,2,206,2,163,850,31,559,0,802,3747,2945,31,559
94714.0,MONTES CLAROS DE GOIAS,1418,12,254,0,916,1432,83,453,0,918,5486,4568,83,453
94730.0,MORRINHOS,10446,40,2490,1,2570,6085,534,1533,0,4053,27752,23699,534,1533
94757.0,MOSSAMEDES,1731,10,254,1,625,649,87,281,0,891,4529,3638,87,281
94773.0,MOZARLANDIA,2141,4,379,2,1128,2366,139,707,0,2057,8923,6866,139,707
94790.0,MUTUNOPOLIS,650,4,121,0,442,1132,60,263,0,689,3361,2672,60,263
94811.0,NATIVIDADE,1256,2,370,2,351,1541,62,937,0,1310,5831,4521,62,937
94838.0,NAZARE,748,3,148,0,180,1341,84,474,0,554,3532,2978,84,474
94854.0,NAZARIO,1584,11,282,2,720,1169,123,391,0,574,4856,4282,123,391
94870.0,NEROPOLIS,4745,41,979,4,1455,3253,365,1085,0,2152,14079,11927,365,1085
94897.0,NIQUELANDIA,7848,38,1221,2,3800,4799,455,2384,0,7345,27892,20547,455,2384
94919.0,NOVA AMERICA,462,4,78,1,189,737,41,153,0,213,1878,1665,41,153
94935.0,NOVA AURORA,517,2,90,0,167,554,28,105,0,124,1587,1463,28,105
94951.0,NOVA ROMA,501,1,94,0,99,1009,39,263,0,874,2880,2006,39,263
94978.0,NOVA VENEZA,1804,9,454,2,446,1275,117,373,0,748,5228,4480,117,373
94994.0,NOVO ACORDO,477,2,200,0,316,563,31,361,0,630,2580,1950,31,361
95010.0,NOVO BRASIL,1146,4,82,1,435,767,41,318,0,600,3394,2794,41,318
95036.0,ORIZONA,3680,33,789,4,878,2139,225,787,0,1318,9853,8535,225,787
95052.0,OURO VERDE DE GOIAS,849,7,269,0,503,926,109,318,0,702,3683,2981,109,318
95079.0,OUVIDOR,1359,13,289,2,593,829,45,252,0,292,3674,3382,45,252
95095.0,PADRE BERNARDO,2359,9,905,2,1851,2052,198,1184,0,2881,11441,8560,198,1184
95117.0,PALMEIRAS DE GOIAS,3162,19,538,1,2859,4783,209,595,0,2081,14247,12166,209,595
95133.0,PALMELO,634,8,238,0,174,447,28,125,0,307,1961,1654,28,125
95150.0,PALMINOPOLIS,623,1,155,1,587,831,33,144,0,342,2717,2375,33,144
95176.0,PANAMA,712,6,98,0,151,821,45,179,0,329,2341,2012,45,179
95192.0,PARAISO DO TOCANTINS,6714,33,2208,1,3779,5489,364,2131,0,3926,24645,20719,364,2131
95214.0,PARANA,853,5,237,1,219,1530,79,1366,0,1481,5771,4290,79,1366
95230.0,PARAUNA,2576,12,546,1,772,1612,106,606,0,1685,7916,6231,106,606
95257.0,PEDRO AFONSO,1610,7,398,1,344,1595,139,644,0,1138,5876,4738,139,644
95273.0,PEIXE,1434,2,274,0,354,1623,76,897,0,1203,5863,4660,76,897
95290.0,COLMEIA,1379,5,276,0,1233,1385,121,929,0,1446,6774,5328,121,929
95311.0,PETROLINA DE GOIAS,1878,23,420,4,515,2676,187,635,0,837,7175,6338,187,635
95338.0,GOIATINS,1028,5,137,4,531,1977,84,1240,0,1550,6556,5006,84,1240
95354.0,PILAR DE GOIAS,600,1,100,0,236,862,48,257,0,582,2686,2104,48,257
95370.0,PINDORAMA DO TOCANTINS,549,1,139,2,196,1012,35,506,0,590,3030,2440,35,506
95397.0,PIRACANJUBA,6975,28,1137,3,1483,3826,321,1024,0,3012,17809,14797,321,1024
95419.0,PIRANHAS,3135,21,455,1,1190,1464,137,742,0,1305,8450,7145,137,742
95435.0,PIRENOPOLIS,4075,38,654,6,1695,5764,439,1198,0,2591,16460,13869,439,1198
95451.0,PIRES DO RIO,5870,64,1631,9,2986,3734,504,1451,0,3001,19250,16249,504,1451
95478.0,PIUM,853,4,448,0,256,997,79,588,0,775,4000,3225,79,588
95494.0,PONTALINA,3907,14,1390,1,1586,2751,322,975,0,2337,13283,10946,322,975
95516.0,PONTE ALTA DO BOM JESUS,386,2,107,2,186,982,75,652,0,780,3172,2392,75,652
95532.0,PONTE ALTA DO TOCANTINS,881,4,238,1,249,1181,65,736,0,803,4158,3355,65,736
95559.0,PORANGATU,8537,26,2234,6,2498,6195,333,1676,0,6293,27798,21505,333,1676
95575.0,PORTELANDIA,1008,4,192,0,324,670,99,290,0,525,3112,2587,99,290
95591.0,PORTO NACIONAL,11666,42,2076,5,2373,3557,328,2813,0,4991,27851,22860,328,2813
95613.0,POSSE,4473,33,1482,3,843,5741,297,1581,0,3872,18325,14453,297,1581
95630.0,QUIRINOPOLIS,10319,54,1731,2,2500,5966,575,1840,0,4389,27376,22987,575,1840
95656.0,RIALMA,1839,9,567,0,1121,1954,133,542,0,1306,7471,6165,133,542
95672.0,RIANAPOLIS,1046,9,274,0,590,666,88,403,0,773,3849,3076,88,403
95699.0,LIZARDA,311,2,58,0,118,956,53,488,0,618,2604,1986,53,488
95710.0,RIO VERDE,22770,126,6504,11,8801,19692,1846,4205,0,11310,75265,63955,1846,4205
95737.0,RUBIATABA,3209,43,765,4,1727,4082,270,955,0,2444,13499,11055,270,955
95753.0,SANCLERLANDIA,2410,9,211,2,1237,994,109,362,0,1178,6512,5334,109,362
95770.0,SANTA BARBARA DE GOIAS,1195,2,220,0,375,883,49,230,0,506,3460,2954,49,230
95796.0,SANTA CRUZ DE GOIAS,780,8,251,0,191,639,46,181,0,317,2413,2096,46,181
95818.0,SANTA HELENA DE GOIAS,7555,47,1336,9,3374,7621,625,1799,0,4565,26931,22366,625,1799
95834.0,SANTA RITA DO ARAGUAIA,889,3,240,0,360,1038,52,313,0,792,3687,2895,52,313
95850.0,SANTA ROSA DE GOIAS,1031,7,246,1,131,703,106,299,0,359,2883,2524,106,299
95877.0,SANTA TEREZA DE GOIAS,884,2,180,2,613,847,65,306,0,973,3872,2899,65,306
95893.0,SANTA TEREZINHA DE GOIAS,1813,5,584,1,984,2296,131,682,0,2068,8564,6496,131,682
95915.0,SAO DOMINGOS,1276,12,543,1,616,1757,110,780,0,1888,6983,5095,110,780
95931.0,SAO FRANCISCO DE GOIAS,1040,5,229,2,418,1415,87,330,0,443,3969,3526,87,330
95958.0,PLANALTINA,13676,150,2890,5,6067,5150,1210,2204,0,6476,37828,31352,1210,2204
95974.0,SAO JOAO D ALIANCA,1330,7,486,5,443,860,96,467,0,1371,5065,3694,96,467
95990.0,SAO LUIS DE MONTES BELOS,5642,38,1044,3,4004,4100,456,1506,0,3685,20478,16793,456,1506
96016.0,SAO MIGUEL DO ARAGUAIA,3568,22,770,2,2247,3706,251,1000,0,3470,15036,11566,251,1000
96032.0,SAO SEBASTIAO DO TOCANTINS,590,5,121,0,248,541,53,398,0,637,2593,1956,53,398
96059.0,SAO SIMAO,4297,17,607,1,889,2013,138,755,0,2699,11416,8717,138,755
96075.0,SERRANOPOLIS,1597,15,325,1,808,584,70,330,0,879,4609,3730,70,330
96091.0,SILVANIA,4401,52,959,4,888,2999,292,688,0,1612,11895,10283,292,688
96113.0,SITIO D ABADIA,605,0,112,1,111,669,37,275,0,565,2375,1810,37,275
96130.0,SITIO NOVO DO TOCANTINS,1912,6,188,1,482,1513,77,986,0,1372,6537,5165,77,986
96156.0,TAGUATINGA,1355,9,719,5,585,2397,155,1706,0,2065,8996,6931,155,1706
96172.0,TAQUARAL DE GOIAS,680,6,203,1,183,988,54,278,0,435,2828,2393,54,278
96199.0,TOCANTINIA,954,4,190,0,228,702,46,573,0,833,3530,2697,46,573
96210.0,TOCANTINOPOLIS,4550,9,797,5,784,2245,278,1615,0,2304,12587,10283,278,1615
96237.0,TRES RANCHOS,810,11,139,0,252,475,47,168,0,231,2133,1902,47,168
96253.0,TRINDADE,19433,155,3845,11,7931,11499,909,2314,0,8507,54604,46097,909,2314
96270.0,GUARAI,3633,25,1155,5,1683,3362,273,1233,0,2879,14248,11369,273,1233
96296.0,PRESIDENTE KENNEDY,836,2,82,0,231,550,104,419,0,647,2871,2224,104,419
96318.0,TURVANIA,1237,6,240,0,679,1134,55,320,0,488,4159,3671,55,320
96334.0,URUACU,6168,27,2012,9,1875,5811,506,1595,0,5788,23791,18003,506,1595
96350.0,URUANA,3512,25,561,0,1895,1887,215,767,0,1795,10657,8862,215,767
96377.0,URUTAI,590,10,255,1,350,480,80,163,0,247,2176,1929,80,163
96393.0,VARJAO,774,0,311,1,549,1055,68,299,0,562,3619,3057,68,299
96415.0,VIANOPOLIS,1741,22,606,2,792,2143,200,682,0,1089,7277,6188,200,682
96431.0,XAMBIOA,2029,9,388,0,621,2074,109,1228,0,2228,8686,6458,109,1228
96458.0,ACREUNA,4615,17,595,2,1427,2540,280,745,0,2225,12446,10221,280,745
96474.0,MINACU,6452,18,831,3,5315,4059,354,1384,0,6344,24760,18416,354,1384
96490.0,PALMEIROPOLIS,792,4,286,2,773,1348,69,589,0,1319,5182,3863,69,589
96512.0,MUNDO NOVO DE GOIAS,1042,2,164,0,411,1195,52,530,0,1091,4487,3396,52,530
96539.0,NOVA CRIXAS,1392,2,160,1,522,2230,70,617,0,1626,6620,4994,70,617
96555.0,NOVA GLORIA,2070,3,293,1,1308,896,142,550,0,1389,6652,5263,142,550
96571.0,VICENTINOPOLIS,1458,3,478,0,371,1120,81,384,0,667,4562,3895,81,384
96598.0,SILVANOPOLIS,989,4,247,0,155,792,57,526,0,733,3503,2770,57,526
96610.0,AMERICANO DO BRASIL,1578,11,137,0,624,840,90,353,0,477,4110,3633,90,353
96636.0,NOVA OLINDA,1497,6,331,2,482,1484,82,978,0,1981,6843,4862,82,978
96652.0,WANDERLANDIA,1704,6,395,1,324,1662,130,860,0,1990,7072,5082,130,860
96679.0,FIGUEIROPOLIS,1222,4,235,2,440,1004,73,421,0,880,4281,3401,73,421
96695.0,ARAGUAPAZ,1281,6,134,1,1173,1085,70,465,0,1179,5394,4215,70,465
96717.0,ARENOPOLIS,1071,2,163,0,544,596,24,274,0,629,3303,2674,24,274
96733.0,CACHOEIRA DOURADA,2307,16,504,3,682,1781,117,327,0,982,6719,5737,117,327
96750.0,DOVERLANDIA,1942,5,254,1,671,1419,96,355,0,1152,5895,4743,96,355
96776.0,SANTO ANTONIO DO DESCOBERTO,7060,86,3339,8,4670,3609,704,1884,0,5818,27178,21360,704,1884
96792.0,RIO SONO,916,1,97,0,204,836,35,521,0,765,3375,2610,35,521
96814.0,INDIARA,2504,18,450,5,980,1569,202,518,0,1394,7640,6246,202,518
96830.0,FATIMA,670,2,165,0,361,685,77,299,0,395,2654,2259,77,299
96857.0,AUGUSTINOPOLIS,2381,5,477,0,563,2181,175,1167,0,2252,9201,6949,175,1167
96873.0,CAMPINACU,663,1,85,0,576,757,80,224,0,814,3200,2386,80,224
96890.0,SANTA ISABEL,649,10,183,0,336,667,66,255,0,319,2485,2166,66,255
96911.0,ADELANDIA,450,4,69,0,634,498,27,151,0,375,2208,1833,27,151
96938.0,AGUA FRIA DE GOIAS,591,2,252,0,365,861,54,289,0,911,3325,2414,54,289
96954.0,ALIANCA DO TOCANTINS,1513,6,237,3,262,916,63,506,0,1040,4546,3506,63,506
96970.0,APARECIDA DO RIO NEGRO,430,0,116,0,271,816,37,337,0,558,2565,2007,37,337
96997.0,BARROLANDIA,1318,4,370,0,343,822,66,543,0,838,4304,3466,66,543
97012.0,BRASILIA,592977,6684,184558,797,220989,202410,17517,56652,1519,234334,1518437,1284103,17517,56652
98019.0,BODOQUENA,2182,10,375,1,857,943,63,311,0,1197,5939,4742,63,311
98035.0,COSTA RICA,3357,26,766,1,861,3638,165,684,0,2374,11872,9498,165,684
98051.0,DOURADINA,1056,7,334,0,636,861,71,243,0,503,3711,3208,71,243
98078.0,ITAQUIRAI,3360,17,363,4,900,2543,222,613,0,2272,10294,8022,222,613
98094.0,SAO GABRIEL DO OESTE,3541,32,1383,0,1044,3090,203,353,0,2223,11869,9646,203,353
98116.0,SELVIRIA,1609,8,258,0,409,834,109,243,0,855,4325,3470,109,243
98132.0,SETE QUEDAS,2381,11,459,0,780,2080,124,486,0,1797,8118,6321,124,486
98159.0,TACURU,1742,3,170,0,243,1237,62,273,0,1044,4774,3730,62,273
98175.0,TAQUARUSSU,801,0,132,1,123,816,54,170,0,389,2486,2097,54,170
98191.0,JUARA,4800,22,1619,3,1319,6336,410,956,0,4082,19547,15465,410,956
98213.0,TEUTONIA,6491,43,1128,5,1612,4545,596,659,0,1539,16618,15079,596,659
98230.0,BOM PRINCIPIO,2092,11,479,8,384,2815,272,267,0,510,6838,6328,272,267
98256.0,PAROBE,13054,36,1825,2,3551,5814,729,1224,0,2823,29058,26235,729,1224
98272.0,FORTALEZA DOS VALOS,1672,3,191,0,219,923,85,145,0,430,3668,3238,85,145
98299.0,JOIA,1911,12,365,2,653,1487,174,287,0,784,5675,4891,174,287
98310.0,JUINA,6407,23,2725,7,2636,5643,422,882,0,5097,23842,18745,422,882
98337.0,DENISE,1183,2,428,1,623,1282,156,207,0,1162,5044,3882,156,207
98353.0,IRANDUBA,4662,37,1310,1,2685,2003,178,959,0,1869,13704,11835,178,959
98370.0,ITAMARATI,235,2,473,0,609,243,35,358,0,1699,3654,1955,35,358
98396.0,MANAQUIRI,1703,2,777,0,1917,781,106,523,0,2079,7888,5809,106,523
98418.0,PRESIDENTE FIGUEIREDO,4688,21,2106,0,1505,705,165,548,0,3344,13082,9738,165,548
98434.0,RIO PRETO DA EVA,2281,17,1352,1,977,828,92,435,0,2229,8212,5983,92,435
98450.0,SAO SEBASTIAO DO UATUMA,729,2,272,0,562,928,43,197,0,1024,3757,2733,43,197
98477.0,TABATINGA,3077,11,1436,2,2189,2980,225,1465,0,4007,15392,11385,225,1465
98493.0,UARINI,502,9,297,1,511,900,53,190,0,1788,4251,2463,53,190
98515.0,TONANTINS,505,6,672,1,402,884,66,519,0,1725,4780,3055,66,519
98531.0,QUIXELO,3544,5,1277,0,375,3299,382,971,0,1682,11535,9853,382,971
98558.0,UMIRIM,2327,5,3718,0,843,886,277,970,0,2674,11700,9026,277,970
98574.0,VARJOTA,921,2,4619,0,452,958,262,914,0,2160,10288,8128,262,914
98590.0,CORONEL SAPUCAIA,2760,4,501,2,700,2096,77,585,0,2429,9154,6725,77,585
98612.0,ALTO TAQUARI,651,1,371,0,490,882,50,107,0,797,3349,2552,50,107
98639.0,ARAGUAIANA,643,2,193,0,116,328,28,112,0,194,1616,1422,28,112
98655.0,CAMPINAPOLIS,1681,7,422,1,967,2026,147,380,0,2386,8017,5631,147,380
98671.0,COCALINHO,825,2,288,1,466,695,46,187,0,2290,4800,2510,46,187
98698.0,ITAUBA,1025,3,468,3,351,870,46,184,0,942,3892,2950,46,184
98710.0,MARCELANDIA,1663,11,842,4,616,3252,175,388,0,2173,9124,6951,175,388
98736.0,NOVA OLIMPIA,3291,7,726,1,1368,1943,351,537,0,2944,11168,8224,351,537
98752.0,NOVA CANAA DO NORTE,1701,10,833,1,593,2206,145,480,0,1755,7724,5969,145,480
98779.0,NOVO SAO JOAQUIM,1282,2,373,0,752,1562,115,253,0,2127,6466,4339,115,253
98795.0,NOVO HORIZONTE DO NORTE,704,2,401,1,269,813,45,151,0,618,3004,2386,45,151
98817.0,PEIXOTO DE AZEVEDO,3325,18,1712,1,2080,4859,295,953,0,5568,18811,13243,295,953
98833.0,PARANAITA,1489,9,798,0,339,2269,115,360,0,1030,6409,5379,115,360
98850.0,PORTO ALEGRE DO NORTE,1004,2,369,1,732,1791,67,338,0,2019,6323,4304,67,338
98876.0,PORTO ESPEREDIAO,1142,7,808,1,446,1579,100,420,0,1081,5584,4503,100,420
98892.0,PRIMAVERA DO LESTE,7083,35,2600,6,2601,5313,520,796,0,4411,23365,18954,520,796
98914.0,RESERVA DO CABACAL,358,1,113,0,291,218,24,158,0,144,1307,1163,24,158
98930.0,SORRISO,9358,24,2698,3,1932,4962,557,659,0,4560,24753,20193,557,659
98957.0,TERRA NOVA DO NORTE,2626,17,664,3,913,2042,160,451,0,2154,9030,6876,160,451
98973.0,VERA,1933,16,867,1,396,1074,126,230,0,1511,6154,4643,126,230
98990.0,VILA RICA,2105,13,470,0,1419,2671,197,473,0,2359,9707,7348,197,473
99015.0,COMODORO,2380,5,701,2,1193,2953,197,519,0,3542,11492,7950,197,519
99031.0,FIGUEIROPOLES D'OESTE,337,1,313,0,244,846,68,235,0,334,2378,2044,68,235
99058.0,GUARANTA DO NORTE,4007,25,1791,0,1551,3983,406,876,0,3566,16205,12639,406,876
99074.0,INDIAVAI,440,1,124,0,203,475,27,138,0,261,1669,1408,27,138
