STATE,CD_MUN,NM_MUN,VOTES_INCUMBENT,VOTES_CHALLENGER,QT_ABST,QT_APT,QT_ATTEND,QT_BLANK,QT_NULL
AC,1007,BUJARI,1682,2099,1227,5140,3913,25,107
AC,1015,CAPIXABA,1350,2037,1508,4983,3475,24,64
AC,1023,PORTO ACRE,2228,3419,1653,7473,5820,32,141
AC,1031,SANTA ROSA,466,346,725,1594,869,5,52
AC,1040,MARECHAL THAUMATURGO,1373,2106,2922,6539,3617,12,126
AC,1058,BRASILÉIA,5310,4682,3413,13674,10261,58,211
AC,1066,PORTO WALTER,1065,946,2527,4612,2085,7,67
AC,1074,CRUZEIRO DO SUL,11228,15380,16433,43781,27348,122,618
AC,1082,RODRIGUES ALVES,2121,1614,3172,7039,3867,12,120
AC,1090,MÂNCIO LIMA,3032,2376,2784,8366,5582,25,149
AC,1104,JORDÃO,1249,497,1428,3231,1803,3,54
AC,1112,EPITACIOLÂNDIA,3588,2373,2011,8148,6137,44,132
AC,1120,ACRELÂNDIA,2422,3039,1945,7548,5603,43,99
AC,1139,FEIJÓ,6353,2718,5453,15049,9596,47,478
AC,1392,RIO BRANCO,81846,68282,39073,193549,154476,1156,3192
AC,1457,SENA MADUREIRA,6293,6419,7221,20416,13195,66,417
AC,1473,TARAUACÁ,5603,4619,8178,18876,10698,62,414
AC,1490,XAPURI,3371,3416,2608,9628,7020,31,202
AC,1511,PLÁCIDO DE CASTRO,3781,3773,3367,11128,7761,42,165
AC,1538,SENADOR GUIOMARD,4498,5044,3808,13641,9833,59,232
AC,1554,MANUEL URBANO,1091,1344,1829,4371,2542,14,93
AC,1570,ASSIS BRASIL,1634,1382,892,4054,3162,10,136
AL,27006,PARIPUEIRA,2849,1958,1541,6560,5019,56,156
AL,27014,ÁGUA BRANCA,7301,2013,3749,13550,9801,83,404
AL,27022,PARICONHA,4399,712,1799,7167,5368,41,216
AL,27030,ANADIA,5812,2193,4314,12769,8455,93,357
AL,27049,ESTRELA DE ALAGOAS,5708,1266,3210,10672,7462,80,408
AL,27057,ARAPIRACA,44646,37880,24469,110124,85655,774,2355
AL,27065,JEQUIÁ DA PRAIA,2582,1281,3359,7376,4017,42,112
AL,27073,ATALAIA,10459,7933,7805,27003,19198,178,628
AL,27081,CAMPESTRE,2282,708,1204,4321,3117,18,109
AL,27090,BARRA DE SANTO ANTÔNIO,3999,1535,1946,7694,5748,54,160
AL,27111,BARRA DE SÃO MIGUEL,2071,1534,978,4716,3738,28,105
AL,27138,BATALHA,6003,1325,2339,9944,7605,44,233
AL,27154,BELÉM,2328,808,1255,4571,3316,50,130
AL,27170,BELO MONTE,1959,599,1272,3965,2693,25,110
AL,27197,BOCA DA MATA,7904,4756,5036,18414,13378,224,494
AL,27219,BRANQUINHA,3516,1212,2030,7048,5018,49,241
AL,27235,CACIMBINHAS,3473,1467,2232,7474,5242,41,261
AL,27251,CAJUEIRO,5583,3927,3368,13389,10021,101,410
AL,27278,CAMPO ALEGRE,10183,3549,6226,20616,14390,149,509
AL,27294,CAMPO GRANDE,3838,1247,1252,6599,5347,43,219
AL,27316,CANAPI,6961,828,3584,11747,8163,55,319
AL,27332,CAPELA,4691,3819,3378,12352,8974,101,363
AL,27359,CARNEIROS,2736,952,981,4838,3857,26,143
AL,27375,CHÃ PRETA,3345,617,1025,5240,4215,32,221
AL,27391,COITÉ DO NÓIA,4078,1205,2086,7715,5629,55,291
AL,27413,COLÔNIA LEOPOLDINA,5008,3938,3757,13215,9458,100,412
AL,27430,COQUEIRO SECO,1812,1052,715,3723,3008,47,97
AL,27456,CORURIPE,13230,10992,9201,34573,25372,289,861
AL,27472,DELMIRO GOUVEIA,18488,3669,8756,31831,23075,192,726
AL,27499,DOIS RIACHOS,3864,1513,2237,7965,5728,47,304
AL,27510,FEIRA GRANDE,8106,1854,2844,13337,10493,87,446
AL,27537,FELIZ DESERTO,1447,611,643,2815,2172,26,88
AL,27553,FLEXEIRAS,3427,1565,1965,7239,5274,46,236
AL,27570,GIRAU DO PONCIANO,12550,2260,5805,21364,15559,117,632
AL,27596,IBATEGUARA,4761,1883,2855,9806,6951,66,241
AL,27618,IGACI,9339,2856,5963,18907,12944,137,612
AL,27634,IGREJA NOVA,7133,3341,4493,15560,11067,137,456
AL,27650,INHAPI,6766,891,3241,11398,8157,61,439
AL,27677,JACARÉ DOS HOMENS,2535,563,932,4152,3220,22,100
AL,27693,JACUÍPE,2624,666,1527,4992,3465,35,140
AL,27715,JAPARATINGA,1791,1405,1674,5001,3327,41,90
AL,27731,JARAMATAIA,2217,702,1199,4286,3087,32,136
AL,27758,JOAQUIM GOMES,5623,2703,5074,13934,8860,103,431
AL,27774,JUNDIÁ,1244,976,1051,3418,2367,29,118
AL,27790,JUNQUEIRO,7418,3611,5487,17109,11622,131,462
AL,27812,LAGOA DA CANOA,6364,1933,2965,11666,8701,85,319
AL,27839,LIMOEIRO DE ANADIA,8152,2282,4287,15294,11007,108,465
AL,27855,MACEIÓ,182236,191748,84687,476691,392004,5377,12643
AL,27871,MAJOR ISIDORO,6635,2505,3862,13436,9574,54,380
AL,27898,MARAGOGI,6768,3447,3705,14463,10758,157,386
AL,27910,MARAVILHA,2941,2023,2871,8097,5226,56,206
AL,27936,MARECHAL DEODORO,10379,8621,6070,25915,19845,254,591
AL,27952,MARIBONDO,4679,2622,3251,10964,7713,85,327
AL,27979,MAR VERMELHO,1544,661,592,2929,2337,23,109
AL,27995,MATA GRANDE,9469,1362,4436,15945,11509,126,552
AL,28010,MATRIZ DE CAMARAGIBE,6440,3971,4635,15526,10891,128,352
AL,28037,MESSIAS,4525,2751,2607,10223,7616,77,263
AL,28053,MINADOR DO NEGRÃO,2249,526,1121,4062,2941,21,145
AL,28070,MONTEIRÓPOLIS,2744,675,1433,4989,3556,24,113
AL,28096,MURICI,8115,4198,4039,17083,13044,161,570
AL,28118,NOVO LINO,2613,2836,1764,7520,5756,46,261
AL,28134,OLHO D'ÁGUA DAS FLORES,6134,3034,3461,13028,9567,91,308
AL,28150,OLHO D'ÁGUA DO CASADO,3590,660,1726,6220,4494,42,202
AL,28177,OLHO D'ÁGUA GRANDE,2063,597,1051,3865,2814,25,129
AL,28193,OLIVENÇA,3927,1391,2155,7783,5628,45,265
AL,28215,OURO BRANCO,4111,1246,1944,7513,5569,27,185
AL,28231,PALESTINA,2242,346,698,3365,2667,13,66
AL,28258,PALMEIRA DOS ÍNDIOS,19284,13266,12544,46607,34063,367,1146
AL,28274,PÃO DE AÇÚCAR,8526,2503,4842,16328,11486,92,365
AL,28290,PASSO DE CAMARAGIBE,4969,1408,3015,9678,6663,63,223
AL,28312,PAULO JACINTO,3324,811,1037,5383,4346,44,167
AL,28339,PENEDO,12415,12359,9269,34998,25729,247,708
AL,28355,PIAÇABUÇU,5076,2417,3859,11693,7834,59,282
AL,28371,PILAR,7029,9567,6676,24036,17360,223,541
AL,28398,PINDOBA,1377,318,404,2211,1807,16,96
AL,28410,PIRANHAS,7824,1862,4130,14303,10173,73,414
AL,28436,POÇO DAS TRINCHEIRAS,4713,1693,2429,9094,6665,49,210
AL,28452,PORTO CALVO,6912,5080,5914,18487,12573,157,424
AL,28479,PORTO DE PEDRAS,2463,1147,2256,6042,3786,39,137
AL,28495,PORTO REAL DO COLÉGIO,4993,4173,3235,12870,9635,123,346
AL,28517,QUEBRÂNGULO,5344,1231,1905,8791,6886,43,268
AL,28533,RIO LARGO,20866,13797,9880,45986,36106,466,977
AL,28550,ROTEIRO,1928,903,1549,4525,2976,18,127
AL,28576,SANTA LUZIA DO NORTE,2380,1350,1172,5055,3883,41,112
AL,28592,SANTANA DO IPANEMA,13102,6684,7257,27851,20594,125,683
AL,28614,SANTANA DO MUNDAÚ,4317,1037,1507,7222,5715,60,301
AL,28630,SÃO BRÁS,1835,1653,1228,4888,3660,56,116
AL,28657,SÃO JOSÉ DA LAJE,7400,3394,2342,13772,11430,113,523
AL,28673,SÃO JOSÉ DA TAPERA,7409,4403,5281,17836,12555,122,621
AL,28690,SÃO LUÍS DO QUITUNDE,10062,3858,6076,20694,14618,200,498
AL,28711,SÃO MIGUEL DOS CAMPOS,10855,14269,5763,32036,26273,297,852
AL,28738,SÃO MIGUEL DOS MILAGRES,2347,964,1463,4945,3482,50,121
AL,28754,SÃO SEBASTIÃO,11583,3443,5839,21598,15759,164,569
AL,28770,SATUBA,3038,3089,1941,8327,6386,96,163
AL,28797,TANQUE D'ARCA,2303,755,1636,4889,3253,43,152
AL,28819,TAQUARANA,6124,2451,2961,12134,9173,101,497
AL,28835,TRAIPÚ,8858,2636,5556,17734,12178,95,589
AL,28851,UNIÃO DOS PALMARES,16649,8489,10245,36702,26457,288,1031
AL,28878,VIÇOSA,9636,3045,5108,18459,13351,139,531
AL,28894,CRAÍBAS,6770,3103,3435,13808,10373,72,428
AL,28916,SENADOR RUI PALMEIRA,4280,893,1640,7066,5426,35,218
AL,28932,SENADOR TEOTÔNIO VILELA,10505,6198,8833,26373,17540,199,638
AM,2003,APUÍ,3527,1611,2231,7532,5301,25,138
AM,2011,NOVO AIRÃO,3511,639,2343,6592,4249,14,85
AM,2020,GUAJARÁ,2192,1350,4021,7698,3677,6,129
AM,2038,ANORI,4051,733,2526,7427,4901,17,100
AM,2046,CAREIRO DA VÁRZEA,7483,660,4359,12667,8308,27,138
AM,2054,ATALAIA DO NORTE,1976,576,1577,4194,2617,6,59
AM,2070,AUTAZES,9559,1077,5544,16443,10899,42,221
AM,2097,BARCELOS,3341,751,2729,6894,4165,4,69
AM,2119,BARREIRINHA,8125,931,4084,13344,9260,35,169
AM,2135,BENJAMIN CONSTANT,9151,716,3646,13966,10320,52,401
AM,2151,BOCA DO ACRE,6275,3706,5138,15584,10446,73,392
AM,2178,BORBA,9038,691,5279,15315,10036,26,281
AM,2194,CANUTAMA,2726,465,2029,5314,3285,10,84
AM,2216,CARAUARI,6405,1235,6070,13939,7869,33,196
AM,2232,CAREIRO,8603,777,5853,15470,9617,45,192
AM,2259,COARI,22140,2342,11519,36711,25192,77,633
AM,2275,CODAJÁS,5907,980,4453,11505,7052,28,137
AM,2291,EIRUNEPÉ,8227,824,6150,15612,9462,52,359
AM,2313,ENVIRA,2880,1509,4049,8621,4572,21,162
AM,2330,FONTE BOA,4410,1634,4610,10839,6229,18,167
AM,2356,HUMAITÁ,11329,3328,5571,20604,15033,75,301
AM,2372,SANTA ISABEL DO RIO NEGRO,2047,848,2330,5318,2988,13,80
AM,2399,IPIXUNA,2347,1324,3823,7738,3915,18,226
AM,2410,ITACOATIARA,32152,4211,14145,51125,36980,114,503
AM,2437,ITAPIRANGA,2926,376,1548,4902,3354,8,44
AM,2453,JAPURÁ,1115,213,1153,2524,1371,8,35
AM,2470,JURUÁ,1703,847,2244,4900,2656,6,100
AM,2496,JUTAÍ,3512,1696,2785,8205,5420,23,189
AM,2518,LÁBREA,9456,898,6400,17173,10773,30,389
AM,2534,MANACAPURU,29414,3012,15242,48544,33302,152,724
AM,2550,MANAUS,721734,104579,149812,995870,846058,6389,13356
AM,2577,MANICORÉ,10361,2601,6606,19894,13288,46,280
AM,2593,MARAÃ,2400,296,3224,6000,2776,8,72
AM,2615,MAUÉS,15071,1447,8207,25107,16900,68,314
AM,2631,NHAMUNDÁ,5776,1235,3552,10701,7149,25,113
AM,2658,NOVA OLINDA DO NORTE,6280,858,4274,11612,7338,30,170
AM,2674,NOVO ARIPUANÃ,5089,693,3553,9494,5941,33,126
AM,2690,PARINTINS,31615,4563,13371,50214,36843,150,515
AM,2712,PAUINI,3463,784,3301,7730,4429,21,161
AM,2739,SANTO ANTONIO DO IÇÁ,4450,1601,2221,8531,6310,19,240
AM,2755,SÃO PAULO DE OLIVENÇA,6871,1049,1862,10068,8206,51,235
AM,2771,SILVES,3324,330,1341,5059,3718,13,51
AM,2798,TAPAUÁ,4543,790,3516,9056,5540,25,182
AM,2810,TEFÉ,17123,1646,10188,29448,19260,79,412
AM,2836,SÃO GABRIEL DA CACHOEIRA,10691,1838,7134,19913,12779,49,201
AM,2852,URUCARÁ,5357,501,2871,8866,5995,17,120
AM,2879,URUCURITUBA,5187,582,3076,8972,5896,21,106
AM,2895,ALVARÃES,4026,514,2144,6804,4660,17,103
AM,2917,AMATURÁ,2364,287,828,3623,2795,13,131
AM,2933,ANAMÃ,2512,576,2267,5434,3167,11,68
AM,2950,BERURI,3075,959,2321,6476,4155,10,111
AM,2976,BOA VISTA DO RAMOS,4481,572,2264,7445,5181,12,116
AM,2992,CAAPIRANGA,2742,198,2651,5683,3032,15,77
AM,98353,IRANDUBA,13536,971,3839,18682,14843,64,272
AM,98370,ITAMARATI,1952,299,2177,4515,2338,5,82
AM,98396,MANAQUIRI,5473,230,2989,8798,5809,13,93
AM,98418,PRESIDENTE FIGUEIREDO,8493,972,4601,14271,9670,56,149
AM,98434,RIO PRETO DA EVA,6632,847,3600,11235,7635,17,139
AM,98450,SÃO SEBASTIÃO DO UATUMÃ,2275,637,1444,4410,2966,13,41
AM,98477,TABATINGA,12446,2175,4589,19747,15158,79,458
AM,98493,UARINI,2397,373,2336,5181,2845,6,69
AM,98515,TONANTINS,2442,1375,1589,5555,3966,23,126
AP,6009,PRACUÚBA,1109,286,559,1974,1415,2,18
AP,6017,AMAPÁ,2926,594,1513,5105,3592,8,64
AP,6025,PORTO GRANDE,4629,1237,1683,7693,6010,23,121
AP,6033,CALÇOENE,2758,776,1719,5340,3621,22,65
AP,6041,ITAUBAL,1427,506,923,2896,1973,9,31
AP,6050,MACAPÁ,111740,53187,42966,212539,169573,1217,3429
AP,6068,CUTIAS,1242,459,1066,2798,1732,7,24
AP,6076,MAZAGÃO,4607,2050,2981,9806,6825,23,145
AP,6084,AMAPARI,1845,429,765,3111,2346,12,60
AP,6092,OIAPOQUE,5808,1523,4897,12481,7584,62,191
AP,6106,SERRA DO NAVIO,1407,467,615,2525,1910,6,30
AP,6114,FERREIRA GOMES,1546,752,888,3238,2350,8,44
AP,6122,VITÓRIA DO JARÍ,4062,1266,2429,7883,5454,20,106
AP,6130,LARANJAL DO JARÍ,12740,3375,6182,22696,16514,85,314
AP,6157,SANTANA,31154,12611,9934,54750,44816,255,796
AP,6173,TARTARUGALZINHO,2698,1083,1900,5779,3879,20,78
BA,30007,LUIS EDUARDO MAGALHÃES,9258,7290,3029,19995,16966,111,307
BA,30058,EUNÁPOLIS,33450,9556,16300,61111,44811,370,1435
BA,30660,IUIU,4063,1202,1920,7453,5533,43,225
BA,30678,JABORANDI,3859,1131,2012,7324,5312,44,278
BA,30694,JUSSARI,2570,742,1878,5356,3478,26,140
BA,30716,AMÉRICA DOURADA,5597,2077,3195,11293,8098,74,350
BA,30732,ARATACA,2842,1126,3208,7368,4160,31,161
BA,30759,BARRO ALTO,4764,2178,2226,9438,7212,54,216
BA,30775,BARROCAS,6173,1359,1927,9777,7850,47,271
BA,30791,BURITIRAMA,6348,2681,2754,12363,9609,53,527
BA,30813,CAPELA DO ALTO ALEGRE,4593,1440,1781,8213,6432,83,316
BA,30830,CAPIM GROSSO,9369,3495,3329,16980,13651,175,612
BA,30856,CANUDOS,5768,1621,2913,10655,7742,65,288
BA,30872,DIAS D'ÁVILA,21548,3402,3853,29760,25907,272,685
BA,30899,FÁTIMA,7556,1913,2878,12843,9965,87,409
BA,30910,FILADÉLFIA,6248,2533,2940,12214,9274,91,402
BA,30937,GAVIÃO,1946,846,820,3772,2952,26,134
BA,30953,GUAJERU,3129,1234,2102,6746,4644,60,221
BA,30970,HELIÓPOLIS,5581,1429,2660,9969,7309,41,258
BA,30996,JOÃO DOURADO,7590,3437,3155,14663,11508,84,397
BA,33014,ABAÍRA,3309,1442,2029,7138,5109,85,273
BA,33030,ABARÉ,7030,1104,2174,10732,8558,37,387
BA,33057,ACAJUTIBA,5541,1687,2862,10463,7601,80,293
BA,33065,ADUSTINA,6058,1790,2305,10567,8262,49,365
BA,33073,ÁGUA FRIA,5847,1637,3574,11720,8146,76,586
BA,33090,ÉRICO CARDOSO,3872,1220,2891,8356,5465,54,319
BA,33111,AIQUARA,2218,419,894,3670,2776,25,114
BA,33138,ALAGOINHAS,50404,17613,19457,90414,70957,887,2053
BA,33154,ALCOBAÇA,7632,1478,4230,13937,9707,109,488
BA,33170,ALMADINA,2178,922,495,3731,3236,18,118
BA,33197,AMARGOSA,11908,4574,7037,24439,17402,206,714
BA,33219,AMÉLIA RODRIGUES,9994,2420,4897,17915,13018,199,405
BA,33235,ANAGÉ,5859,4236,2105,12893,10788,112,581
BA,33251,ANDARAÍ,5205,844,2765,9201,6436,61,326
BA,33260,ANDORINHA,7133,949,2515,10914,8399,51,266
BA,33278,ANGICAL,6048,2354,2594,11297,8703,56,245
BA,33294,ANGUERA,4803,702,1935,7737,5802,40,257
BA,33316,ANTAS,5528,1692,2692,10238,7546,73,253
BA,33332,ANTÔNIO CARDOSO,5473,1156,880,7888,7008,73,306
BA,33359,ANTÔNIO GONÇALVES,3596,1363,1117,6330,5213,36,218
BA,33375,APORÁ,6050,2090,3117,11734,8617,85,392
BA,33383,ARAÇÁS,4823,1121,2159,8434,6275,72,259
BA,33391,ARACATU,3946,3096,3029,10510,7481,56,383
BA,33405,APUAREMA,2583,1258,773,4816,4043,24,178
BA,33413,ARACI,18789,3494,8925,32372,23447,158,1006
BA,33430,ARAMARI,4275,1172,1871,7674,5803,58,298
BA,33456,ARATUÍPE,3929,759,2027,6997,4970,48,234
BA,33472,AURELINO LEAL,5519,755,3826,10392,6566,48,244
BA,33499,BAIANÓPOLIS,5430,1102,1011,7920,6909,61,316
BA,33510,BAIXA GRANDE,6235,3657,4554,15232,10678,181,605
BA,33529,BANZAÊ,5036,1436,1490,8260,6770,50,248
BA,33537,BARRA,14711,5165,7500,28808,21308,150,1282
BA,33553,BARRA DA ESTIVA,8331,2562,2979,14440,11461,113,455
BA,33570,BARRA DO CHOÇA,10805,4096,5675,21649,15974,161,912
BA,33596,BARRA DO MENDES,6220,1362,1880,9796,7916,86,248
BA,33618,BARRA DO ROCHA,2224,562,535,3451,2916,20,110
BA,33634,BARREIRAS,44338,12582,16099,74585,58486,385,1181
BA,33650,GOVERNADOR LOMANTO JÚNIOR,2893,805,1906,5777,3871,41,132
BA,33677,BELMONTE,6811,1406,1584,10325,8741,77,447
BA,33693,BELO CAMPO,4822,3727,3748,12743,8995,76,370
BA,33715,BIRITINGA,6690,907,2861,11094,8233,95,541
BA,33731,BOA NOVA,6152,1096,4151,11954,7803,75,480
BA,33758,BOA VISTA DO TUPIM,6967,2022,4164,13819,9655,103,563
BA,33774,BOM JESUS DA LAPA,21791,5146,10383,38615,28232,289,1006
BA,33782,BOM JESUS DA SERRA,3394,1130,2113,6877,4764,28,212
BA,33790,BONINAL,4981,1495,2843,9712,6869,88,305
BA,33804,BONITO,4504,1995,2064,8880,6816,64,253
BA,33812,BOQUIRA,9519,1408,4599,16027,11428,83,418
BA,33839,BOTUPORÃ,5230,682,2094,8341,6247,40,295
BA,33855,BREJÕES,5827,1345,2921,10514,7593,90,331
BA,33871,BREJOLÂNDIA,4166,995,1426,6853,5427,53,213
BA,33898,BROTAS DE MACAÚBAS,4552,1879,2860,9631,6771,55,285
BA,33910,BRUMADO,26048,6789,9677,44021,34344,304,1203
BA,33936,BUERAREMA,5949,3367,1986,11784,9798,95,387
BA,33952,CAATIBA,3050,1024,2327,6657,4330,24,232
BA,33960,CABACEIRAS DO PARAGUAÇU,6644,1662,2815,11549,8734,52,376
BA,33979,CACHOEIRA,14437,2225,6241,23594,17353,159,532
BA,33995,CACULÉ,7114,3587,4123,15442,11319,154,464
BA,34010,CAEM,4939,1221,1492,8055,6563,50,353
BA,34029,CAETANOS,3637,1338,2402,7689,5287,36,276
BA,34037,CAETITÉ,17345,6823,8854,34409,25555,251,1136
BA,34053,CAFARNAUM,4218,3451,3147,11161,8014,64,281
BA,34070,CAIRU,4802,1075,2440,8564,6124,56,191
BA,34096,CALDEIRÃO GRANDE,3774,1010,2086,7171,5085,50,251
BA,34118,CAMACÃ,9871,3738,7878,22186,14308,140,559
BA,34134,CAMAÇARI,75210,15305,13302,107846,94544,1330,2699
BA,34150,CAMAMU,9535,3445,6653,20533,13880,147,753
BA,34177,CAMPO ALEGRE DE LOURDES,10584,2833,5145,19386,14241,85,739
BA,34193,CAMPO FORMOSO,22142,9481,12962,46246,33284,293,1368
BA,34215,CANÁPOLIS,4540,793,1761,7429,5668,37,298
BA,34231,CANARANA,8606,3131,4205,16407,12202,88,377
BA,34258,CANAVIEIRAS,12854,3334,8368,25227,16859,122,549
BA,34274,CANDEAL,4467,1116,2196,8097,5901,52,266
BA,34290,CANDEIAS,34573,3472,4166,43564,39398,477,876
BA,34312,CANDIBA,5610,1463,2376,9914,7538,100,365
BA,34339,CÂNDIDO SALES,9853,3765,5577,19837,14260,102,540
BA,34355,CANSANÇÃO,12878,3096,6022,22837,16815,147,694
BA,34363,CARAÍBAS,2681,2153,3570,8668,5098,43,221
BA,34371,CARAVELAS,7741,1526,4602,14486,9884,93,524
BA,34398,CARDEAL DA SILVA,3158,564,1875,5863,3988,55,211
BA,34410,CARINHANHA,8073,5079,4481,18302,13821,99,570
BA,34436,CASA NOVA,25126,6054,10060,42966,32906,299,1427
BA,34452,CASTRO ALVES,11470,2409,3671,18181,14510,124,507
BA,34479,CATOLÂNDIA,2149,174,385,2804,2419,12,84
BA,34495,CATU,25632,3463,7554,38121,30567,493,979
BA,34509,CATURAMA,3772,780,2311,7089,4778,53,173
BA,34517,CENTRAL,7164,2142,2503,12194,9691,81,304
BA,34533,CHORROCHÓ,4380,1207,2199,8078,5879,39,253
BA,34550,CÍCERO DANTAS,12963,4059,6769,24778,18009,239,748
BA,34576,CIPÓ,5672,2289,3487,11892,8405,60,384
BA,34592,COARACI,8964,3016,5920,18490,12570,93,497
BA,34614,COCOS,6423,2298,3488,12757,9269,79,469
BA,34630,CONCEIÇÃO DA FEIRA,8215,1643,2684,12982,10298,132,308
BA,34657,CONCEIÇÃO DO ALMEIDA,7944,1351,3188,12945,9757,113,349
BA,34673,CONCEIÇÃO DO COITÉ,24428,9244,9574,44797,35223,380,1171
BA,34690,CONCEIÇÃO DO JACUÍPE,12405,3185,4856,21125,16269,193,486
BA,34711,CONDE,7895,1636,3375,13452,10077,92,454
BA,34738,CONDEÚBA,6412,2622,5055,14777,9722,117,571
BA,34754,CONTENDAS DO SINCORÁ,1678,767,658,3221,2563,20,98
BA,34770,CORAÇÃO DE MARIA,11725,1976,5039,19407,14368,162,505
BA,34797,CORDEIROS,2187,1751,1180,5383,4203,34,231
BA,34819,CORIBE,6458,1555,2912,11411,8499,91,395
BA,34835,CORONEL JOÃO SÁ,5552,2228,2818,11101,8283,75,428
BA,34851,CORRENTINA,11677,3677,5538,22019,16481,190,937
BA,34878,COTEGIPE,5397,1020,2384,9184,6800,48,335
BA,34894,CRAVOLÂNDIA,2713,391,1066,4404,3338,37,197
BA,34916,CRISÓPOLIS,8510,1647,3704,14411,10707,79,471
BA,34932,CRISTÓPOLIS,6249,1180,2543,10367,7824,51,344
BA,34959,CRUZ DAS ALMAS,23801,7211,8389,40440,32051,391,648
BA,34975,CURAÇÁ,12548,3133,5039,21470,16431,111,639
BA,34991,DÁRIO MEIRA,4539,852,2445,8228,5783,52,340
BA,35017,DOM BASÍLIO,4840,1560,1021,7766,6745,55,290
BA,35033,DOM MACEDO COSTA,1908,503,529,3087,2558,30,117
BA,35050,ELÍSIO MEDRADO,3564,1271,1445,6537,5092,54,203
BA,35076,ENCRUZILHADA,7231,2915,5138,16023,10885,89,650
BA,35092,ENTRE RIOS,13350,3809,7347,25612,18265,279,827
BA,35114,ESPLANADA,10837,2587,1920,16076,14156,176,556
BA,35130,EUCLIDES DA CUNHA,21285,5722,11645,40138,28493,251,1235
BA,35149,FEIRA DA MATA,2220,953,1015,4315,3300,22,105
BA,35157,FEIRA DE SANTANA,202515,57896,57689,329582,271893,3009,8473
BA,35173,FIRMINO ALVES,2062,553,437,3183,2746,26,105
BA,35190,FLORESTA AZUL,4278,1537,2087,8165,6078,40,223
BA,35211,FORMOSA DO RIO PRETO,6419,3284,3772,14005,10233,73,457
BA,35238,GANDU,8414,5123,6918,21230,14312,165,610
BA,35254,GENTIO DO OURO,4186,1843,2135,8495,6360,50,281
BA,35270,GLÓRIA,6637,1608,2185,10782,8597,53,299
BA,35297,GONGOGI,2766,770,2794,6543,3749,42,171
BA,35319,GOVERNADOR MANGABEIRA,8731,1786,2362,13336,10974,99,358
BA,35335,GUANAMBI,26444,11344,11095,50840,39745,447,1510
BA,35351,GUARATINGA,7920,1530,6961,16972,10011,76,485
BA,35378,IAÇU,9872,2248,6856,19723,12867,146,601
BA,35394,IBIASSUCÊ,3430,2212,1929,7823,5894,53,199
BA,35416,IBICARAÍ,9365,3418,7021,20364,13343,94,466
BA,35432,IBICOARA,4223,2314,1646,8536,6890,63,290
BA,35459,IBICUÍ,5288,1842,3658,11171,7513,69,314
BA,35475,IBIPEBA,7614,1194,2195,11366,9171,71,292
BA,35491,SANTA RITA DE CÁSSIA,9929,3733,4723,19055,14332,146,524
BA,35513,IBIPITANGA,5031,1656,2254,9343,7089,72,330
BA,35530,IBIQUERA,2022,296,709,3180,2471,18,135
BA,35556,IBIRAPITANGA,7213,1956,6562,16293,9731,78,484
BA,35572,IBIRAPUÃ,2954,934,782,4917,4135,37,210
BA,35599,IBIRATAIA,7090,3128,5627,16429,10802,93,491
BA,35610,IBITIARA,5772,1901,3399,11492,8093,74,346
BA,35637,IBITITÁ,7499,2654,3376,13908,10532,76,303
BA,35653,IBOTIRAMA,9662,3149,5146,18576,13430,145,474
BA,35670,ICHU,3113,768,721,4740,4019,42,96
BA,35696,IGAPORÃ,4947,2883,3071,11339,8268,71,367
BA,35700,IGRAPIÚNA,4205,1032,2629,8261,5632,73,322
BA,35718,IGUAÍ,9094,2259,6232,18352,12120,107,660
BA,35734,ILHÉUS,68434,19198,31172,122076,90904,900,2372
BA,35750,INHAMBUPE,13830,3222,6068,24132,18064,189,823
BA,35777,IPECAETÁ,6371,2343,4692,13897,9205,91,400
BA,35793,IPIAÚ,16855,4458,9073,31426,22353,213,827
BA,35815,IPIRÁ,21925,7246,14550,45589,31039,313,1555
BA,35831,IPUPIARA,3328,1639,1059,6259,5200,50,183
BA,35858,IRAJUBA,3143,613,1503,5463,3960,31,173
BA,35874,IRAMAIA,4490,1415,2779,9005,6226,50,271
BA,35890,IRAQUARA,8757,1534,3369,14136,10767,94,382
BA,35912,IRARÁ,10936,1881,1956,15439,13483,147,519
BA,35939,IRECÊ,20463,7451,9830,39008,29178,304,960
BA,35947,ITABELA,9338,2939,6276,19367,13091,119,695
BA,35955,ITABERABA,23272,5191,12671,42770,30099,451,1185
BA,35971,ITABUNA,60552,45594,33239,142770,109531,913,2472
BA,35998,ITACARÉ,6038,1224,3578,11266,7688,77,349
BA,36013,ITAETÊ,5019,1670,2874,10003,7129,65,375
BA,36030,ITAGI,5287,2112,2806,10549,7743,45,299
BA,36056,ITAGIBÁ,6503,1216,4239,12351,8112,60,333
BA,36072,ITAGIMIRIM,2193,856,692,3957,3265,37,179
BA,36080,ITAGUAÇU DA BAHIA,4935,596,860,6682,5822,53,238
BA,36099,ITAJU DO COLÔNIA,2680,662,2372,5853,3481,25,114
BA,36110,ITAJUÍPE,6815,3386,1335,11944,10609,86,322
BA,36137,ITAMARAJU,20958,9199,17244,48961,31717,309,1251
BA,36153,ITAMARI,3063,974,753,4986,4233,24,172
BA,36170,ITAMBÉ,8015,3510,5889,18055,12166,78,563
BA,36196,ITANAGRA,2067,613,2219,5056,2837,35,122
BA,36218,ITANHÉM,8039,1833,1988,12633,10645,99,674
BA,36234,ITAPARICA,8348,828,3227,12635,9408,55,177
BA,36250,ITAPÉ,3844,1407,2039,7569,5530,64,215
BA,36277,ITAPEBI,3399,1195,3625,8476,4851,41,216
BA,36293,ITAPETINGA,22977,8719,11259,44215,32956,272,988
BA,36315,ITAPICURU,10498,1879,5725,18988,13263,119,767
BA,36331,ITAPITANGA,3508,719,2442,6867,4425,37,161
BA,36358,ITAQUARA,3615,924,1632,6400,4768,30,199
BA,36374,ITARANTIM,6349,2377,4008,13151,9143,64,353
BA,36382,ITATIM,4039,2980,2996,10441,7445,104,322
BA,36390,ITIRUÇU,5008,1877,1504,8743,7239,84,270
BA,36412,ITIÚBA,12845,5048,6571,25572,19001,207,901
BA,36439,ITORORÓ,6815,3104,3737,14160,10423,85,419
BA,36455,ITUAÇU,5648,4872,2843,13940,11097,86,491
BA,36471,ITUBERÁ,8462,3204,4910,17263,12353,164,523
BA,36498,JACARACI,4907,1723,2252,9301,7049,68,351
BA,36510,JACOBINA,29693,8511,15970,56220,40250,368,1678
BA,36536,JAGUAQUARA,17368,4852,7936,31649,23713,310,1183
BA,36552,JAGUARARI,12226,2563,1686,17233,15547,142,616
BA,36579,JAGUARIPE,6060,689,3352,10547,7195,117,329
BA,36595,JANDAÍRA,3507,592,2067,6420,4353,38,216
BA,36617,JEQUIÉ,61304,12371,26421,103514,77093,837,2581
BA,36633,JEREMOABO,13219,3992,6641,24818,18177,139,827
BA,36650,JIQUIRIÇÁ,3374,3583,2545,9949,7404,80,367
BA,36676,JITAÚNA,5298,1863,4924,12547,7623,60,402
BA,36692,JUAZEIRO,63824,23466,23256,113326,90070,665,2115
BA,36706,JUCURUÇU,3790,580,4719,9325,4606,22,214
BA,36714,JUSSARA,6362,1155,3377,11395,8018,70,431
BA,36730,JUSSIAPE,3291,1607,2145,7279,5134,49,187
BA,36757,LAFAIETE COUTINHO,2118,318,504,3095,2591,34,121
BA,36765,LAGOA REAL,4307,1684,2159,8454,6295,41,263
BA,36773,LAJE,10017,1594,3801,16186,12385,115,659
BA,36790,LAJEDÃO,2143,451,725,3442,2717,14,109
BA,36811,LAJEDINHO,1751,359,380,2636,2256,24,122
BA,36820,LAJEDO DO TABOCAL,3856,549,1505,6154,4649,50,194
BA,36838,LAMARÃO,3423,585,2196,6446,4250,51,191
BA,36854,LAURO DE FREITAS,54865,10223,14722,82646,67924,863,1973
BA,36870,LENÇÓIS,3621,576,1503,5926,4423,49,177
BA,36897,LICÍNIO DE ALMEIDA,3707,2217,926,7157,6231,77,230
BA,36919,LIVRAMENTO DE NOSSA SENHORA,15612,5612,7195,29450,22255,234,797
BA,36935,MACAJUBA,4922,921,2336,8600,6264,54,367
BA,36951,MACARANI,6443,1855,1654,10514,8860,86,476
BA,36978,MACAÚBAS,13951,6016,7704,28703,20999,175,857
BA,36994,MACURURÉ,2997,1101,1775,6057,4282,24,160
BA,37010,MAIQUINIQUE,3152,1019,869,5250,4381,32,178
BA,37036,MAIRI,6836,2569,4849,14943,10094,134,555
BA,37052,MALHADA,6142,1615,2852,11004,8152,62,333
BA,37079,MALHADA DE PEDRAS,3983,718,1761,6659,4898,42,155
BA,37095,MANOEL VITORINO,5943,1168,4294,11747,7453,48,294
BA,37117,MARACÁS,8588,3091,5349,17654,12305,128,498
BA,37133,MARAGOGIPE,17718,3992,9528,32410,22882,265,907
BA,37150,MARAÚ,5803,1264,4079,11623,7544,59,418
BA,37176,MARCIONÍLIO SOUZA,3805,723,911,5693,4782,33,221
BA,37192,MASCOTE,3813,1442,1059,6548,5489,31,203
BA,37214,MATA DE SÃO JOÃO,15620,2379,2576,21617,19041,364,678
BA,37222,MATINA,3968,1339,1915,7627,5712,60,345
BA,37230,MEDEIROS NETO,9183,2301,2493,14639,12146,86,576
BA,37257,MIGUEL CALMON,11325,2449,6019,20577,14558,120,664
BA,37273,MILAGRES,3150,2775,2343,8593,6250,40,285
BA,37290,MIRANGABA,4690,2448,3046,10599,7553,55,360
BA,37303,MIRANTE,2812,1385,1858,6301,4443,26,220
BA,37311,MONTE SANTO,17866,6877,10169,36634,26465,266,1456
BA,37338,MORPARÁ,3423,1430,2164,7239,5075,30,192
BA,37354,MORRO DO CHAPÉU,12414,4083,7477,24880,17403,153,753
BA,37370,MORTUGABA,4206,1842,3490,9835,6345,43,254
BA,37397,MUCUGÊ,2938,2303,1455,7038,5583,72,270
BA,37419,MUCURI,11976,3208,7175,22945,15770,100,486
BA,37427,MULUNGU DO MORRO,4160,1523,2263,8207,5944,46,215
BA,37435,MUNDO NOVO,7832,2479,4113,15088,10975,117,547
BA,37451,MUNIZ FERREIRA,3672,878,1130,5888,4758,46,162
BA,37460,MUQUÉM DO SÃO FRANCISCO,3454,868,1467,5984,4517,31,164
BA,37478,MURITIBA,11788,2775,4973,20233,15260,218,479
BA,37494,MUTUÍPE,6701,4999,4049,16410,12361,110,551
BA,37516,NAZARÉ,11853,1703,2177,16366,14189,174,459
BA,37532,NILO PEÇANHA,3784,1429,2324,7924,5600,87,300
BA,37559,NOVA CANAÃ,5732,1694,3476,11426,7950,70,454
BA,37567,NOVA FÁTIMA,3364,879,663,5129,4466,57,166
BA,37575,NOVA ITARANA,2800,743,1647,5407,3760,32,185
BA,37583,NOVA REDENÇÃO,3594,546,1895,6295,4400,38,222
BA,37591,NOVA SOURE,11070,1568,5369,18704,13335,111,586
BA,37613,NOVA VIÇOSA,12150,2958,6366,22223,15857,125,624
BA,37621,NOVO TRIUNFO,3462,1241,2052,7036,4984,25,256
BA,37630,OLINDINA,11428,1394,5307,18793,13486,114,550
BA,37656,OLIVEIRA DOS BREJINHOS,8758,2663,4643,16754,12111,140,550
BA,37672,OURIÇANGAS,3159,1201,930,5622,4692,49,283
BA,37680,OUROLÂNDIA,4436,3003,3804,11646,7842,51,352
BA,37699,PALMAS DO MONTE ALTO,8327,2216,4196,15429,11233,112,578
BA,37710,PALMEIRAS,3398,895,1491,5989,4498,25,180
BA,37737,PARAMIRIM,8048,1844,4351,14692,10341,119,330
BA,37753,PARATINGA,12884,1923,5844,21321,15477,101,569
BA,37770,PARIPIRANGA,9676,5442,4546,20510,15964,150,696
BA,37796,PAU BRASIL,3859,876,805,5767,4962,38,189
BA,37818,PAULO AFONSO,41137,8706,14308,65867,51559,417,1299
BA,37834,PEDRÃO,2800,575,757,4290,3533,28,130
BA,37850,PEDRO ALEXANDRE,3210,2175,2106,7980,5874,64,425
BA,37877,PIATÃ,7865,1933,4460,14957,10497,108,591
BA,37893,PILÃO ARCADO,10572,3961,7272,22753,15481,93,855
BA,37915,PINDAÍ,4644,2963,3550,11690,8140,101,432
BA,37931,PINDOBAÇU,6665,3570,4267,15046,10779,107,437
BA,37940,PIRAÍ DO NORTE,1948,1757,1829,5780,3951,43,203
BA,37958,PIRIPÁ,3081,1730,3005,8142,5137,40,286
BA,37974,PIRITIBA,7460,1731,3620,13332,9712,75,446
BA,37990,PLANALTINO,3369,861,623,5117,4494,56,208
BA,38016,PLANALTO,8401,3023,4334,16476,12142,124,594
BA,38032,POÇÕES,15208,5231,9349,30953,21604,218,947
BA,38059,POJUCA,14282,2495,1666,19478,17812,374,661
BA,38067,PONTO NOVO,5458,1844,2722,10440,7718,63,353
BA,38075,PORTO SEGURO,33540,9428,16225,60950,44725,433,1324
BA,38091,POTIRAGUÁ,4035,891,2873,8054,5181,56,199
BA,38113,PRADO,7711,3321,5956,17698,11742,129,581
BA,38130,PRESIDENTE DUTRA,6979,845,2458,10581,8123,54,245
BA,38156,PRESIDENTE JÂNIO QUADROS,4457,1558,3875,10291,6416,50,351
BA,38164,PRESIDENTE TANCREDO NEVES,4850,5913,3446,14927,11481,97,621
BA,38172,QUEIMADAS,10201,2881,5707,19448,13741,140,519
BA,38199,QUINJINGUE,11147,3236,5023,20234,15211,116,712
BA,38210,REMANSO,16200,2943,8145,28331,20186,130,913
BA,38237,RETIROLÂNDIA,6238,1285,1485,9368,7883,75,285
BA,38253,RIACHÃO DAS NEVES,9455,2095,6241,18565,12324,94,680
BA,38270,RIACHÃO DO JACUÍPE,13848,4435,3598,22672,19074,190,601
BA,38296,RIACHO DE SANTANA,9805,5734,5822,22303,16481,188,754
BA,38318,RIBEIRA DO AMPARO,4892,1730,1987,9054,7067,64,381
BA,38334,RIBEIRA DO POMBAL,17249,6535,8702,33645,24943,239,920
BA,38342,RIBEIRÃO DO LARGO,3716,1182,2408,7704,5296,29,369
BA,38350,RIO DE CONTAS,6004,1784,2268,10459,8191,95,308
BA,38377,RIO DO ANTÔNIO,5488,1498,3026,10497,7471,77,408
BA,38393,RIO DO PIRES,4008,1851,2334,8542,6208,61,288
BA,38415,RIO REAL,14374,3166,5615,24015,18400,146,714
BA,38431,RODELAS,3011,695,901,4740,3839,16,117
BA,38458,RUY BARBOSA,12526,2057,6494,21934,15440,147,710
BA,38474,SALINAS DA MARGARIDA,4637,1044,2112,8007,5895,63,151
BA,38490,SALVADOR,1109289,199347,276098,1657559,1381461,20804,52021
BA,38512,SANTA BÁRBARA,7976,2463,1579,12572,10993,89,465
BA,38539,SANTA BRÍGIDA,5360,1695,2228,9752,7524,79,390
BA,38555,SANTA CRUZ DE CABRÁLIA,6563,2525,3641,13119,9478,88,302
BA,38571,SANTA CRUZ DA VITÓRIA,2130,449,1521,4224,2703,22,102
BA,38598,SANTA INÊS,4796,737,3054,8881,5827,49,245
BA,38610,SANTALUZ,13743,4624,4368,23584,19216,176,673
BA,38636,SANTA MARIA DA VITÓRIA,13827,4818,7310,27003,19693,167,881
BA,38652,SANTANA,10449,3266,4651,19079,14428,109,604
BA,38679,SANTANÓPOLIS,4361,1054,1578,7289,5711,59,237
BA,38695,SANTA TEREZINHA,3692,1026,1595,6671,5076,74,284
BA,38717,SANTO AMARO,29025,2740,10428,43565,33137,457,915
BA,38733,SANTO ANTÔNIO DE JESUS,34784,8213,11176,56299,45123,597,1529
BA,38750,SANTO ESTEVÃO,18629,3239,7720,30689,22969,210,891
BA,38776,SÃO DESIDÉRIO,8699,2303,2006,13775,11769,91,676
BA,38792,SÃO FÉLIX,6107,1381,2338,10105,7767,58,221
BA,38806,SÃO DOMINGOS,3857,1175,743,5979,5236,54,150
BA,38814,SÃO FELIPE,7805,2529,1829,12659,10830,141,355
BA,38822,SÃO FÉLIX DO CORIBE,4058,2224,1435,8017,6582,67,233
BA,38830,SÃO FRANCISCO DO CONDE,15906,3402,3759,23696,19937,192,437
BA,38857,SÃO GONÇALO DOS CAMPOS,14865,2059,3693,21278,17585,172,489
BA,38865,SÃO JOSÉ DO JACUÍPE,3567,1224,1571,6711,5140,89,260
BA,38873,SÃO MIGUEL DAS MATAS,4459,1359,2007,8130,6123,48,257
BA,38890,SÃO SEBASTIÃO DO PASSÉ,20713,2375,6426,30381,23955,246,621
BA,38911,SAPEAÇU,8584,1545,3896,14429,10533,94,310
BA,38938,SÁTIRO DIAS,5372,2114,3474,11490,8016,91,439
BA,38946,SAUBARA,5406,856,2347,8835,6488,71,155
BA,38954,SAÚDE,5021,1269,2258,8952,6694,77,327
BA,38970,SEABRA,17462,2510,6469,27271,20802,144,686
BA,38997,SEBASTIÃO LARANJEIRAS,3674,1009,2072,6984,4912,55,174
BA,39012,SENHOR DO BONFIM,24116,11970,10955,48603,37648,399,1163
BA,39039,SENTO SÉ,10841,6737,7186,25327,18141,96,467
BA,39047,SERRA DO RAMALHO,12283,2308,6395,21708,15313,117,605
BA,39055,SERRA DOURADA,7848,1876,3180,13270,10090,60,306
BA,39071,SERRA PRETA,7903,1518,2252,12320,10068,129,518
BA,39098,SERRINHA,33436,4662,11823,51783,39960,280,1582
BA,39110,SERROLÂNDIA,4150,1961,2498,8964,6466,69,286
BA,39136,SIMÕES FILHO,48963,5151,12268,68264,55996,616,1266
BA,39144,SÍTIO DO MATO,4547,1087,2374,8216,5842,27,181
BA,39152,SOUTO SOARES,5046,2486,3000,10870,7870,66,272
BA,39179,TABOCAS DO BREJO VELHO,5091,1212,2385,8997,6612,45,264
BA,39195,TANHAÇU,6737,4452,3983,15810,11827,90,548
BA,39217,TANQUINHO,3475,579,417,4638,4221,41,126
BA,39233,TAPEROÁ,4997,2098,1626,9288,7662,130,437
BA,39250,TAPIRAMUTÁ,5552,1217,2764,9977,7213,73,371
BA,39276,TEODORO SAMPAIO,3301,480,752,4739,3987,46,160
BA,39292,TEOFILÂNDIA,8374,1523,1929,12333,10404,73,434
BA,39314,TEOLÂNDIA,4514,2052,2767,9775,7008,63,379
BA,39330,TERRA NOVA,5768,924,2746,9747,7001,67,242
BA,39357,TREMEDAL,5374,3547,6741,16280,9539,73,545
BA,39373,TUCANO,18621,4738,9424,34000,24576,195,1022
BA,39390,UAUÁ,9673,4379,6111,20779,14668,159,457
BA,39411,UBAÍRA,6584,3238,4680,15159,10479,92,565
BA,39438,UBAITABA,7434,2739,4988,15730,10742,95,474
BA,39454,UBATÃ,6227,3036,3271,13070,9799,128,408
BA,39470,UIBAÍ,6187,1424,1325,9218,7893,52,230
BA,39489,UMBURANAS,3793,1937,2827,8848,6021,32,259
BA,39497,UNA,7643,2950,7527,18686,11159,105,461
BA,39519,URANDI,6127,1804,3789,12209,8420,109,380
BA,39535,URUÇUCA,7718,3046,3022,14394,11372,88,520
BA,39551,UTINGA,6845,1380,3306,11962,8656,73,358
BA,39578,VALENÇA,27999,8693,11913,51418,39505,745,2068
BA,39594,VALENTE,8563,3986,1556,14696,13140,127,464
BA,39616,VÁRZEA DO POÇO,3096,1257,1090,5700,4610,67,190
BA,39624,VARZEDO,4227,767,1591,6853,5262,52,216
BA,39632,VERA CRUZ,15272,1422,6002,23160,17158,162,302
BA,39640,VEREDAS,2926,926,1253,5328,4075,33,190
BA,39659,VITÓRIA DA CONQUISTA,77596,59171,40573,184110,143537,1551,5219
BA,39675,WAGNER,3584,742,1890,6416,4526,30,170
BA,39691,WENCESLAU GUIMARÃES,5561,2709,4707,13597,8890,91,529
BA,39713,XIQUE-XIQUE,17193,4381,10321,33275,22954,161,1219
BA,39730,LAPÃO,11109,2810,3856,18372,14516,106,491
BA,39748,MADRE DE DEUS,8240,973,1307,10732,9425,70,142
BA,39756,MAETINGA,2408,1056,2306,6028,3722,14,244
BA,39772,MANSIDÃO,3802,2033,2292,8342,6050,28,187
BA,39799,NORDESTINA,5197,758,1941,8305,6364,65,344
BA,39810,PÉ DE SERRA,5047,2295,1786,9502,7716,59,315
BA,39837,PINTADAS,3666,1778,2711,8430,5719,44,231
BA,39845,QUIXABEIRA,3252,1404,1045,5996,4951,77,218
BA,39853,RAFAEL JAMBEIRO,8259,2280,5576,16876,11300,102,659
BA,39870,SANTA LUZIA,3750,1598,3506,9140,5634,47,239
BA,39896,SÃO GABRIEL,7755,2405,3385,14032,10647,88,399
BA,39900,SÍTIO DO QUINTO,4854,1028,1848,8051,6203,44,277
BA,39918,TANQUE NOVO,6753,1418,2161,10802,8641,100,370
BA,39926,SÃO JOSÉ DA VITÓRIA,2434,639,759,3968,3209,16,120
BA,39934,TEIXEIRA DE FREITAS,44517,12122,21000,79861,58861,435,1787
BA,39942,NOVO HORIZONTE,4409,1025,1431,7163,5732,56,242
BA,39950,VÁRZEA NOVA,4411,1915,2256,9001,6745,73,346
BA,39969,NOVA IBIÁ,2342,1104,1223,4835,3612,41,125
BA,39977,VÁRZEA DA ROÇA,5083,1693,2988,10287,7299,126,397
BA,39985,SOBRADINHO,9269,2359,4371,16453,12082,104,350
BA,39993,WANDERLEY,4820,1893,3310,10317,7007,34,260
CE,13005,JIJOCA DE JERICOACOARA,5215,2092,1954,9501,7547,45,195
CE,13013,ABAIARA,3714,595,1358,5950,4592,54,229
CE,13021,MADALENA,7048,1050,2723,11091,8368,57,213
CE,13030,ACARAÚ,22556,2662,8570,34730,26160,179,763
CE,13048,PIRES FERREIRA,4329,532,792,5835,5043,30,152
CE,13056,ACOPIARA,21874,4444,8639,36466,27827,260,1249
CE,13064,GRAÇA,6722,896,3155,11176,8021,60,343
CE,13072,AIUABA,5036,2437,1829,9664,7835,56,306
CE,13080,TURURU,7691,626,2040,10630,8590,54,219
CE,13099,ALCÂNTARAS,4955,518,1777,7536,5759,58,228
CE,13102,QUITERIANÓPOLIS,8409,2248,3776,14885,11109,82,370
CE,13110,ALTANEIRA,2977,707,962,4834,3872,27,161
CE,13129,BARREIRA,9070,2114,2860,14571,11711,116,411
CE,13137,ALTO SANTO,7795,549,2260,10909,8649,69,236
CE,13145,ACARAPE,6573,845,1729,9372,7643,50,175
CE,13153,ANTONINA DO NORTE,3215,653,1637,5694,4057,29,160
CE,13161,CHOROZINHO,9566,1204,2082,13272,11190,115,305
CE,13170,APUIARÉS,6361,1018,2759,10388,7629,46,204
CE,13188,HORIZONTE,19595,3365,4021,27652,23631,208,463
CE,13196,AQUIRAZ,29037,4700,8850,43803,34953,297,919
CE,13200,ERERÊ,1967,1343,918,4368,3450,25,115
CE,13218,ARACATI,27713,7897,8592,45415,36823,446,767
CE,13226,EUSÉBIO,20005,2392,4541,27542,23001,156,448
CE,13234,ARACOIABA,12010,2516,2984,18074,15090,112,452
CE,13242,GUAIÚBA,9879,2293,3263,15846,12583,61,350
CE,13250,ARARIPE,9211,1943,3491,15270,11779,95,530
CE,13269,POTIRETAMA,3338,214,788,4434,3646,24,70
CE,13277,ARATUBA,5329,1017,1494,8169,6675,71,258
CE,13285,PINDORETAMA,9053,1029,1707,12089,10382,62,238
CE,13293,ARNEIROZ,3399,768,1625,5977,4352,26,159
CE,13307,OCARA,11913,1841,4440,18771,14331,120,457
CE,13315,ASSARÉ,9704,1622,4140,16044,11904,95,483
CE,13323,TEJUÇUOCA,6631,2020,2367,11391,9024,61,312
CE,13331,AURORA,10799,3405,4385,19218,14833,120,509
CE,13340,IPAPORANGA,4047,2404,2202,8987,6785,52,282
CE,13358,BAIXIO,3253,329,978,4679,3701,32,87
CE,13366,TARRAFAS,4033,444,1584,6255,4671,28,166
CE,13374,BARBALHA,20813,6561,6984,35308,28324,207,743
CE,13382,BANABUIÚ,7367,1133,3154,11947,8793,64,229
CE,13390,BARRO,10192,985,3786,15426,11640,89,374
CE,13404,BARROQUINHA,6603,1742,2369,11093,8724,72,307
CE,13412,BATURITÉ,14579,2848,5801,23965,18164,197,540
CE,13420,ARARENDÁ,4739,1217,1166,7299,6133,37,140
CE,13439,BEBERIBE,18932,6037,7335,33252,25917,260,688
CE,13447,CATUNDA,4775,591,1368,6943,5575,31,178
CE,13455,BELA CRUZ,11750,2455,4942,19859,14917,144,568
CE,13463,CHORÓ,5918,685,2620,9496,6876,45,228
CE,13471,BOA VIAGEM,22789,3633,10461,37915,27454,199,833
CE,13480,ITAITINGA,15068,1747,3370,20745,17375,131,429
CE,13498,BREJO SANTO,18473,3797,6685,29823,23138,158,710
CE,13501,FORTIM,7198,855,2772,11097,8325,68,204
CE,13510,CAMOCIM,23512,4956,8397,37947,29550,277,805
CE,13536,CAMPOS SALES,10288,3242,4064,18237,14173,118,525
CE,13552,CANINDÉ,29428,5160,12978,49044,36066,296,1182
CE,13579,CAPISTRANO,8575,826,2011,11810,9799,98,300
CE,13595,CARIDADE,6916,2494,2568,12396,9828,77,341
CE,13617,CARIRÉ,7486,2543,2374,12888,10514,101,384
CE,13633,CARIRIAÇU,9856,4143,6171,20828,14657,115,543
CE,13650,CARIÚS,8551,1780,4023,14834,10811,112,368
CE,13676,CARNAUBAL,6846,960,3616,11821,8205,70,329
CE,13692,CASCAVEL,27796,5700,8799,43539,34740,385,859
CE,13714,CATARINA,4119,1033,2222,7641,5419,37,230
CE,13730,CAUCAIA,109150,13683,24678,151422,126744,967,2944
CE,13757,CEDRO,11802,3033,4262,19760,15498,149,514
CE,13773,CHAVAL,6268,765,2236,9585,7349,55,261
CE,13811,COREAÚ,9159,2119,4211,16187,11976,112,586
CE,13838,CRATEÚS,28923,8628,14337,53855,39518,417,1550
CE,13854,CRATO,46056,12699,14673,75645,60972,538,1679
CE,13870,FARIAS BRITO,8099,3328,2844,14895,12051,145,479
CE,13897,FORTALEZA,953351,214433,210343,1421936,1211593,11446,32363
CE,13919,FRECHEIRINHA,5673,1032,1672,8784,7112,73,334
CE,13935,GENERAL SAMPAIO,3086,639,939,4827,3888,15,148
CE,13951,GRANJA,18495,4939,7202,32049,24847,215,1198
CE,13978,GRANJEIRO,1932,1258,1062,4407,3345,22,133
CE,13994,GROAÍRAS,4552,903,1329,7058,5729,88,186
CE,14010,GUARACIABA DO NORTE,14514,4089,7200,26721,19521,165,753
CE,14036,GUARAMIRANGA,3008,414,831,4392,3561,29,110
CE,14052,HIDROLÂNDIA,8919,1113,3415,13789,10374,59,283
CE,14060,IBARETAMA,5859,1275,2418,9867,7449,56,259
CE,14079,IBIAPINA,8405,2968,4245,16227,11982,153,456
CE,14095,ICÓ,27364,4927,14120,47725,33605,234,1080
CE,14117,IGUATU,41344,5238,15475,63958,48483,511,1390
CE,14133,INDEPENDÊNCIA,10073,4087,5071,19897,14826,144,522
CE,14150,IPAUMIRIM,5506,890,1250,7934,6684,61,227
CE,14176,IPU,17977,2463,8691,30099,21408,193,775
CE,14192,IPUEIRAS,16521,2703,9096,29434,20338,198,916
CE,14214,IRACEMA,6629,700,1523,9182,7659,55,275
CE,14230,IRAUÇUBA,10270,983,3515,15120,11605,54,298
CE,14257,ITAIÇABA,3049,1192,638,5032,4394,32,121
CE,14273,ITAPAGÉ,21881,3605,6280,32636,26356,207,663
CE,14290,ITAPIPOCA,45710,5885,15448,68892,53444,390,1459
CE,14311,ITAPIÚNA,8442,1516,2928,13338,10410,85,367
CE,14338,ITATIRA,8240,1117,2705,12514,9809,61,391
CE,14354,JAGUARETAMA,8634,1114,3728,13857,10129,93,288
CE,14370,JAGUARIBARA,4736,856,1616,7437,5821,49,180
CE,14397,JAGUARIBE,16416,2394,7005,26614,19609,165,634
CE,14419,JAGUARUANA,14396,3097,5280,23676,18396,379,524
CE,14435,JARDIM,8042,6454,4866,19933,15067,83,488
CE,14451,JATI,3846,566,1273,5859,4586,26,148
CE,14478,JUAZEIRO DO NORTE,82123,25278,31427,142716,111289,973,2915
CE,14494,JUCÁS,8296,3355,4638,16916,12278,159,468
CE,14516,LAVRAS DA MANGABEIRA,13301,2611,6998,23670,16672,135,625
CE,14532,LIMOEIRO DO NORTE,27310,2923,7425,38739,31314,347,734
CE,14559,MARANGUAPE,42496,5694,11142,60874,49732,363,1179
CE,14575,MARCO,9960,2986,3263,16677,13414,95,373
CE,14591,MARTINÓPOLE,4449,701,1351,6759,5408,45,213
CE,14613,MASSAPÊ,11602,5646,5054,23117,18063,172,643
CE,14630,MAURITI,15172,6274,6941,29445,22504,179,879
CE,14656,MERUOCA,6682,954,1694,9693,7999,84,279
CE,14672,MILAGRES,13843,2026,4982,21419,16437,122,446
CE,14680,MIRAÍMA,5899,830,2725,9692,6967,35,203
CE,14699,MISSÃO VELHA,13961,4460,5440,24724,19284,135,728
CE,14710,MOMBAÇA,15946,5257,8194,30697,22503,250,1050
CE,14737,MONSENHOR TABOSA,7495,1853,2946,12703,9757,63,346
CE,14753,MORADA NOVA,34333,2958,13665,52416,38751,287,1173
CE,14770,MORAÚJO,3888,478,1205,5820,4615,53,196
CE,14796,MORRINHOS,7019,2434,3581,13401,9820,84,283
CE,14818,MUCAMBO,6386,1102,2751,10644,7893,137,268
CE,14834,MULUNGU,4588,559,1711,7097,5386,51,188
CE,14850,NOVA OLINDA,5176,2372,1799,9669,7870,79,243
CE,14877,NOVA RUSSAS,13779,1983,3666,20072,16406,171,473
CE,14893,NOVO ORIENTE,10038,3896,4888,19534,14646,127,585
CE,14915,ORÓS,10908,1724,4009,17118,13109,95,382
CE,14931,PACAJUS,22704,3283,5630,32551,26921,362,572
CE,14958,PACATUBA,24733,3350,6151,35103,28952,224,645
CE,14974,PACOTI,5981,686,1482,8454,6972,74,231
CE,14990,PACUJÁ,3111,566,1152,5014,3862,38,147
CE,15016,PALHANO,3968,1674,1518,7350,5832,55,135
CE,15032,PALMÁCIA,5170,610,2060,8102,6042,46,216
CE,15059,PARACURU,14311,2031,4788,21651,16863,130,391
CE,15075,PARAMBU,13490,2852,6230,23363,17133,129,662
CE,15091,PARAMOTI,4938,1436,1909,8532,6623,43,206
CE,15113,PEDRA BRANCA,18664,1776,9545,31074,21529,216,873
CE,15130,PENAFORTE,3821,773,1186,5962,4776,37,145
CE,15156,PENTECOSTE,18333,1915,5313,26261,20948,120,580
CE,15172,PEREIRO,6418,2144,3303,12286,8983,78,343
CE,15199,PIQUET CARNEIRO,6475,1403,2352,10616,8264,66,320
CE,15210,PORANGA,5153,1196,1986,8730,6744,48,347
CE,15237,PORTEIRAS,7705,869,2649,11763,9114,75,465
CE,15253,POTENGI,3966,1006,1305,6531,5226,46,208
CE,15270,QUIXADÁ,25971,10100,11303,48552,37249,310,868
CE,15296,QUIXERAMOBIM,27056,7299,10810,46474,35664,275,1034
CE,15318,QUIXERÉ,9372,1385,2236,13424,11188,124,307
CE,15334,REDENÇÃO,13262,2159,4255,20405,16150,183,546
CE,15350,RERIUTABA,8096,1908,4302,14807,10505,106,395
CE,15377,RUSSAS,26072,7049,8043,42485,34442,396,925
CE,15393,SABOEIRO,7105,1080,3349,12036,8687,78,424
CE,15415,SANTANA DO ACARAÚ,13680,2039,2753,19100,16347,143,485
CE,15431,SANTANA DO CARIRI,6983,2009,3010,12394,9384,62,330
CE,15440,SALITRE,6229,1243,2063,9914,7851,58,321
CE,15458,SANTA QUITÉRIA,16537,5194,8910,31347,22437,144,562
CE,15474,SÃO BENEDITO,18101,5163,9082,33438,24356,257,835
CE,15490,SÃO GONÇALO DO AMARANTE,18423,3699,6767,29636,22869,165,582
CE,15512,SÃO JOÃO DO JAGUARIBE,5310,361,1225,7069,5844,46,127
CE,15539,SÃO LUÍS DO CURU,7184,703,1910,10039,8129,54,188
CE,15555,SENADOR POMPEU,10494,3726,4379,19175,14796,144,432
CE,15571,SENADOR SÁ,3041,550,1320,5081,3761,30,140
CE,15598,SOBRAL,77521,10111,17918,109404,91486,1379,2475
CE,15610,SOLONÓPOLE,7898,1513,3755,13551,9796,76,309
CE,15636,TABULEIRO DO NORTE,14958,2107,3153,20856,17703,178,460
CE,15652,TAMBORIL,10540,3624,2801,17554,14753,113,476
CE,15679,TAUÁ,22638,6565,9217,39787,30570,293,1074
CE,15695,TIANGUÁ,24459,6710,7996,40877,32881,444,1268
CE,15717,TRAIRI,20965,3454,8125,33383,25258,173,666
CE,15733,UBAJARA,13160,2716,4739,21505,16766,188,702
CE,15750,UMARI,3257,1218,1330,5980,4650,23,152
CE,15776,URUBURETAMA,10222,1538,2775,15035,12260,136,364
CE,15792,URUOCA,5554,1025,2361,9246,6885,46,260
CE,15814,VÁRZEA ALEGRE,16977,3514,4347,25840,21493,246,756
CE,15830,VIÇOSA DO CEARÁ,12739,15177,7097,36209,29112,210,986
CE,15857,MARACANAÚ,89754,10161,19814,122649,102835,748,2172
CE,15873,AMONTADA,14513,3313,7009,25499,18490,128,536
CE,15881,CROATÁ,7330,1083,3752,12686,8934,81,440
CE,15890,CRUZ,8903,3114,3944,16419,12475,83,375
CE,15911,FORQUILHA,9893,1255,3036,14808,11772,177,447
CE,15920,IBICUITINGA,6108,938,1134,8436,7302,61,195
CE,15938,ICAPUÍ,5936,4512,2639,13339,10700,80,172
CE,15954,ITAREMA,13813,1939,5874,22187,16313,110,451
CE,15970,MILHÃ,6296,1201,2225,9984,7759,49,213
CE,15989,DEPUTADO IRAPUAN PINHEIRO,4075,1174,1711,7215,5504,41,214
CE,15997,PARAIPABA,12958,1662,3453,18573,15120,119,381
CE,98531,QUIXELÔ,8196,1637,2495,12878,10383,135,415
CE,98558,UMIRIM,7950,1078,3432,12805,9373,61,284
CE,98574,VARJOTA,7969,1100,2888,12361,9473,101,303
DF,97012,BRASÍLIA,765008,578137,259284,1655050,1395766,15578,37043
ES,56006,SÃO DOMINGOS DO NORTE,3220,1656,726,5725,4999,40,83
ES,56014,AFONSO CLÁUDIO,10190,7341,5682,23894,18212,194,487
ES,56022,ÁGUA DOCE DO NORTE,4678,1750,2407,9069,6662,50,184
ES,56030,ALEGRE,10941,6476,6352,24601,18249,262,570
ES,56049,IRUPI,3511,2239,1780,7725,5945,58,137
ES,56057,ALFREDO CHAVES,4401,3561,1663,10000,8337,133,242
ES,56065,ALTO RIO NOVO,2742,1164,959,5033,4074,36,132
ES,56073,ANCHIETA,7864,4510,2538,15393,12855,187,294
ES,56081,VILA PAVÃO,3679,1798,1365,6961,5596,36,83
ES,56090,APIACÁ,3101,1254,1640,6149,4509,37,117
ES,56103,MARECHAL FLORIANO,4569,4217,2101,11252,9151,150,215
ES,56111,ARACRUZ,29731,11095,7817,49916,42099,399,874
ES,56120,MARATAÍZES,11846,4884,5956,23235,17279,205,344
ES,56138,ATÍLIO VIVACQUA,3990,2056,1073,7293,6220,56,118
ES,56146,BREJETUBA,3401,2208,2440,8296,5856,54,193
ES,56154,BAIXO GUANDU,11497,5783,4620,22459,17839,181,378
ES,56162,SÃO ROQUE DO CANAÃ,3848,2573,1550,8215,6665,98,146
ES,56170,BARRA DE SÃO FRANCISCO,14049,7796,8156,30737,22581,208,528
ES,56189,SOORETAMA,8445,2990,3420,15297,11877,151,291
ES,56197,BOA ESPERANÇA,5294,2551,3207,11322,8115,82,188
ES,56200,PONTO BELO,2914,1191,1407,5670,4263,32,126
ES,56219,BOM JESUS DO NORTE,3883,1888,1545,7572,6027,54,202
ES,56227,VILA VALÉRIO,6354,1937,2028,10545,8517,76,150
ES,56235,CACHOEIRO DE ITAPEMIRIM,58166,36001,21024,118666,97642,1477,1998
ES,56251,CARIACICA,132590,45662,30864,214580,183716,2183,3281
ES,56278,CASTELO,12395,8345,5323,26868,21545,309,496
ES,56294,COLATINA,34549,27675,15235,79664,64429,833,1372
ES,56308,GOVERNADOR LINDENBERG,4364,1739,1690,7985,6295,75,117
ES,56316,CONCEIÇÃO DA BARRA,10114,3196,5720,19765,14045,164,571
ES,56332,CONCEIÇÃO DO CASTELO,2836,3435,1165,7743,6578,127,180
ES,56359,DIVINO DE SÃO LOURENÇO,1592,1142,829,3670,2841,34,73
ES,56375,DOMINGOS MARTINS,9915,9638,4952,25168,20216,270,393
ES,56391,DORES DO RIO PRETO,2668,1300,1268,5386,4118,35,115
ES,56413,ECOPORANGA,8452,4589,5436,18987,13551,123,387
ES,56430,FUNDÃO,6217,2606,1569,10753,9184,114,247
ES,56456,GUAÇUÍ,8329,6179,4605,19677,15072,163,401
ES,56472,GUARAPARI,31649,22527,15756,72218,56462,805,1481
ES,56499,IBIRAÇU,4433,2205,1388,8324,6936,108,190
ES,56502,IBITIRAMA,3409,1561,2113,7285,5172,53,149
ES,56510,ICONHA,4071,4303,1389,9972,8583,78,131
ES,56537,ITAGUAÇU,5884,3116,2766,12160,9394,133,261
ES,56553,ITAPEMIRIM,12389,5094,5875,23958,18083,208,392
ES,56570,ITARANA,3857,3024,1833,9038,7205,111,213
ES,56596,IÚNA,8469,6106,5188,20287,15099,176,348
ES,56618,JERÔNIMO MONTEIRO,4663,2206,1790,8952,7162,86,207
ES,56626,JOÃO NEIVA,6588,3256,1954,12192,10238,143,251
ES,56634,LINHARES,39653,28244,17966,88712,70746,1065,1784
ES,56650,MANTENÓPOLIS,3951,3216,2531,10018,7487,72,248
ES,56677,MIMOSO DO SUL,10053,5204,4853,20763,15910,192,461
ES,56693,MONTANHA,6403,2923,4471,14206,9735,125,284
ES,56715,MUCURICI,2119,1056,991,4279,3288,28,85
ES,56731,MUNIZ FREIRE,6831,3371,3665,14248,10583,106,275
ES,56758,MUQUI,4985,3741,1903,10976,9073,107,240
ES,56774,NOVA VENÉCIA,16135,7665,7483,32131,24648,260,588
ES,56790,PANCAS,7518,3132,4448,15465,11017,83,284
ES,56812,PINHEIROS,8585,3345,4870,17236,12366,119,317
ES,56839,PIÚMA,5109,3343,2844,11642,8798,118,228
ES,56855,PRESIDENTE KENNEDY,3987,1885,1980,8081,6101,47,182
ES,56871,RIO NOVO DO SUL,4406,2982,1875,9517,7642,96,158
ES,56898,SANTA LEOPOLDINA,4610,2644,1767,9287,7520,103,163
ES,56910,SANTA TERESA,6864,6370,2973,16778,13805,189,382
ES,56936,SÃO GABRIEL DA PALHA,10733,5712,4589,21536,16947,199,303
ES,56952,SÃO JOSÉ DO CALÇADO,4491,2059,1766,8632,6866,86,230
ES,56979,SÃO MATEUS,36557,11347,15589,65034,49445,468,1073
ES,56995,SERRA,135900,40809,38648,222031,183383,2407,4267
ES,57010,VIANA,23292,7415,5831,37298,31467,322,438
ES,57037,VILA VELHA,132872,73448,43864,258441,214577,3258,4999
ES,57053,VITÓRIA,111613,76824,40955,237554,196599,2954,5208
ES,57070,MARILÂNDIA,4292,2601,1131,8304,7173,113,167
ES,57096,IBATIBA,6190,5668,3680,15852,12172,87,227
ES,57118,RIO BANANAL,6996,3003,2978,13313,10335,138,198
ES,57134,JAGUARÉ,9602,3025,3212,16265,13053,172,254
ES,57150,PEDRO CANÁRIO,7626,3146,3455,14732,11277,151,354
ES,57916,LARANJA DA TERRA,3566,3406,1559,8757,7198,69,157
ES,57932,SANTA MARIA DO JETIBÁ,9371,9015,2640,21620,18980,230,364
ES,57959,VARGEM ALTA,5704,4026,2567,12646,10079,140,209
ES,57975,VENDA NOVA DO IMIGRANTE,4516,5850,2478,13272,10794,181,247
ES,57991,ÁGUIA BRANCA,4182,1554,1973,7850,5877,47,94
GO,92010,ABADIÂNIA,3225,3067,2111,9099,6988,118,578
GO,92029,BONFINÓPOLIS,2281,1687,1385,5825,4440,52,420
GO,92037,ÁGUA LIMPA,805,660,391,1974,1583,21,97
GO,92053,ALEXÂNIA,5261,6126,3760,16644,12884,197,1300
GO,92061,CAMPOS VERDES,2645,954,1432,5369,3937,20,318
GO,92096,ALOÂNDIA,698,703,213,1734,1521,23,97
GO,92100,CEZARINA,2658,1957,1598,6680,5082,48,419
GO,92118,ALTO PARAÍSO DE GOIÁS,1537,1231,1472,4606,3134,37,329
GO,92126,COLINAS DO SUL,1057,665,736,2697,1961,11,228
GO,92150,ALVORADA DO NORTE,1586,2172,1915,6285,4370,68,544
GO,92169,MORRO AGUDO DE GOIÁS,891,767,325,2110,1785,18,109
GO,92177,AMORINÓPOLIS,1171,1291,590,3269,2679,18,199
GO,92207,EDEALINA,1161,1227,568,3201,2633,23,222
GO,92215,ANÁPOLIS,70396,83019,38034,206218,168184,2631,12138
GO,92223,FAINA,2341,1593,1834,6190,4356,53,369
GO,92231,ANHANGÜERA,339,296,165,855,690,4,51
GO,92258,ANICUNS,6660,4311,3277,15248,11971,133,867
GO,92266,GOUVELÂNDIA,1331,1202,474,3297,2823,32,258
GO,92274,APARECIDA DE GOIÂNIA,106141,53861,42914,218323,175409,2341,13066
GO,92282,ITAGUARI,1800,865,570,3508,2938,33,240
GO,92290,APORÉ,857,773,936,2777,1841,14,197
GO,92312,ARAÇU,1469,1343,571,3615,3044,29,203
GO,92320,MATRINCHÃ,1238,1237,1120,3843,2723,15,233
GO,92339,ARAGARÇAS,5447,2808,2911,11930,9019,110,654
GO,92347,MIMOSO DE GOIÁS,1044,668,530,2435,1905,15,178
GO,92355,ARAGOIÂNIA,2427,2000,1040,5845,4805,46,332
GO,92363,MONTIVIDIU,1897,3424,1631,7429,5798,61,416
GO,92444,NOVO PLANALTO,1251,846,751,3058,2307,21,189
GO,92460,PALESTINA DE GOIÁS,840,1054,712,2780,2068,22,152
GO,92495,ARUANÃ,1962,1050,1600,4880,3280,34,234
GO,92517,AURILÂNDIA,1653,780,720,3392,2672,26,213
GO,92550,AVELINÓPOLIS,849,979,624,2631,2007,22,157
GO,92568,SANTA FÉ DE GOIÁS,1656,732,945,3552,2607,29,190
GO,92614,BALIZA,1114,368,631,2304,1673,13,178
GO,92622,SÃO JOÃO DA PARAÚNA,655,540,446,1729,1283,7,81
GO,92630,BARRO ALTO,2060,1504,952,4911,3959,48,347
GO,92649,SÃO LUIZ DO NORTE,1389,882,525,3031,2506,25,210
GO,92657,BELA VISTA DE GOIÁS,5303,6251,3283,16136,12853,189,1110
GO,92665,SÃO MIGUEL DO PASSA QUATRO,1025,1109,569,2882,2313,18,161
GO,92673,BOM JARDIM DE GOIÁS,2711,1911,1660,6632,4972,49,301
GO,92690,BOM JESUS DE GOIÁS,4451,4848,2730,13053,10323,185,839
GO,92703,SENADOR CANEDO,21504,8312,9002,41827,32825,394,2615
GO,92711,BRAZABRANTES,1095,826,553,2638,2085,27,137
GO,92720,SIMOLÂNDIA,1863,1514,1131,4966,3835,35,423
GO,92754,BRITÂNIA,1725,1285,830,4186,3356,39,307
GO,92762,TERESINA DE GOIÁS,916,389,722,2228,1506,7,194
GO,92770,BURITI ALEGRE,2140,2993,1420,7113,5693,77,483
GO,92789,TROMBAS,1074,827,649,2785,2136,20,215
GO,92797,CABECEIRAS,2284,1579,1448,5677,4229,56,310
GO,92800,TURVELÂNDIA,1107,1027,1030,3312,2282,15,133
GO,92819,CACHOEIRA ALTA,2174,1936,1662,6226,4564,58,396
GO,92827,RIO QUENTE,805,897,482,2324,1842,21,119
GO,92835,CACHOEIRA DE GOIÁS,559,436,422,1523,1101,6,100
GO,92851,CAÇU,2446,3769,2150,8942,6792,73,504
GO,92860,GUARINOS,847,592,382,1970,1588,9,140
GO,92878,CAIAPÔNIA,4210,3611,2364,10998,8634,87,726
GO,92886,COCALZINHO DE GOIÁS,3809,3256,2554,10601,8047,121,861
GO,92894,CALDAS NOVAS,14663,14900,9500,42021,32521,457,2501
GO,92908,SANTO ANTÔNIO DE GOIÁS,1443,772,389,2819,2430,36,179
GO,92916,CAMPESTRE DE GOIÁS,1013,910,566,2668,2102,24,155
GO,92924,CHAPADÃO DO CÉU,1258,1372,845,3654,2809,34,145
GO,92932,CAMPINORTE,2722,2120,2121,7453,5332,71,419
GO,92940,ALTO HORIZONTE,852,824,411,2282,1871,23,172
GO,92959,CAMPO ALEGRE DE GOIÁS,1187,1889,512,3834,3322,27,219
GO,92967,CASTELÂNDIA,1267,917,873,3262,2389,22,183
GO,92975,CAMPOS BELOS,5917,2769,3797,13700,9903,117,1100
GO,92983,JESÚPOLIS,740,597,337,1800,1463,14,112
GO,92991,CARMO DO RIO VERDE,2611,2239,1447,6780,5333,73,410
GO,93009,APARECIDA DO RIO DOCE,1084,762,570,2582,2012,18,148
GO,93017,CATALÃO,22816,19001,8085,53729,45644,671,3156
GO,93025,CIDADE OCIDENTAL,15519,5391,5517,28080,22563,254,1399
GO,93033,CATURAÍ,1429,1298,730,3727,2997,37,233
GO,93041,PROFESSOR JAMIL,1227,780,855,3046,2191,18,166
GO,93050,CAVALCANTE,2397,770,2718,6535,3817,41,609
GO,93068,PEROLÂNDIA,1123,578,544,2408,1864,14,149
GO,93076,CERES,6087,5291,2866,15201,12335,139,818
GO,93084,NOVA IGUAÇU DE GOIÁS,815,644,603,2215,1612,13,140
GO,93092,DIVINÓPOLIS DE GOIÁS,1544,1089,1456,4587,3131,35,463
GO,93106,BURITI DE GOIÁS,1133,724,670,2675,2005,40,108
GO,93122,CALDAZINHA,986,862,463,2464,2001,15,138
GO,93149,GUARAÍTA,950,591,282,1961,1679,18,120
GO,93157,CÓRREGO DO OURO,760,1028,473,2380,1907,17,102
GO,93165,INACIOLÂNDIA,1434,1363,914,4027,3113,32,284
GO,93173,CORUMBÁ DE GOIÁS,1972,2734,1617,7023,5406,94,606
GO,93181,MONTIVIDIU DO NORTE,1147,731,673,2827,2154,27,249
GO,93190,CORUMBAÍBA,2622,1996,1409,6391,4982,54,310
GO,93203,SANTO ANTÔNIO DA BARRA,1332,1346,800,3763,2963,29,256
GO,93220,TEREZÓPOLIS DE GOIÁS,2010,1334,1166,4886,3720,37,339
GO,93246,UIRAPURU,1202,529,641,2520,1879,8,140
GO,93254,CRISTALINA,6993,10679,5528,25220,19692,285,1735
GO,93262,BURITINÓPOLIS,659,1024,816,2798,1982,23,276
GO,93270,CRISTIANÓPOLIS,756,1299,534,2756,2222,29,138
GO,93289,VILA BOA,1171,669,814,2885,2071,21,210
GO,93297,CRIXÁS,5452,1967,2760,10861,8101,83,599
GO,93300,VALPARAÍSO DE GOIÁS,26344,9539,8671,47596,38925,539,2503
GO,93319,CROMÍNIA,1360,1181,405,3142,2737,29,167
GO,93327,NOVO GAMA,21224,7698,7332,38908,31576,435,2219
GO,93335,CUMARI,1072,789,406,2420,2014,28,125
GO,93343,ÁGUAS LINDAS DE GOIÁS,24488,10077,11199,49077,37878,551,2762
GO,93351,DAMIANÓPOLIS,607,1458,828,3127,2299,25,209
GO,93360,ABADIA DE GOIÁS,1731,1592,917,4515,3598,32,243
GO,93378,DAMOLÂNDIA,1299,874,301,2632,2331,17,141
GO,93386,AMARALINA,906,662,615,2380,1765,14,183
GO,93394,DAVINÓPOLIS,855,696,153,1794,1641,20,70
GO,93408,BONÓPOLIS,908,705,511,2313,1802,11,178
GO,93424,PORTEIRÃO,816,665,490,2117,1627,19,127
GO,93432,DIORAMA,995,665,365,2145,1780,4,116
GO,93440,SANTA RITA DO NOVO DESTINO,1333,674,502,2703,2201,15,179
GO,93483,SÃO PATRÍCIO,747,586,204,1685,1481,30,118
GO,93491,EDÉIA,2745,2888,1582,7764,6182,55,494
GO,93505,VILA PROPÍCIO,1586,1050,1504,4517,3013,32,345
GO,93513,ESTRELA DO NORTE,1044,916,753,2924,2171,15,196
GO,93530,FAZENDA NOVA,2131,1634,1428,5557,4129,39,325
GO,93548,IPIRANGA DE GOIÁS,1055,744,534,2495,1961,17,145
GO,93564,GAMELEIRA DE GOIÁS,796,871,492,2295,1803,12,124
GO,93572,FIRMINÓPOLIS,2800,2620,1704,7688,5984,59,505
GO,93580,CAMPO LIMPO DE GOIÁS,1693,1680,1023,4795,3772,51,348
GO,93599,FLORES DE GOIÁS,1780,1357,1460,5076,3616,34,445
GO,93602,LAGOA SANTA,365,458,236,1127,891,7,61
GO,93610,FORMOSA,22627,19597,10761,57659,46898,590,4084
GO,93637,FORMOSO,1471,1290,893,3943,3050,28,261
GO,93670,GOIANÁPOLIS,2979,2905,2402,8980,6578,75,619
GO,93696,GOIANDIRA,1685,1418,667,4040,3373,35,235
GO,93718,GOIANÉSIA,16445,11402,8386,38981,30595,428,2320
GO,93734,GOIÂNIA,315501,309221,140767,819655,678888,8863,45303
GO,93750,GOIANIRA,6984,3991,3500,15593,12093,163,955
GO,93777,GOIÁS,7979,5777,6234,21326,15092,178,1158
GO,93793,GOIATUBA,8458,9266,5367,24725,19358,236,1398
GO,93815,GUAPÓ,3977,3108,2144,9913,7769,93,591
GO,93831,GUARANI DE GOIÁS,1324,1062,902,3595,2693,18,289
GO,93874,HEITORAÍ,1360,1032,757,3363,2606,31,183
GO,93890,HIDROLÂNDIA,4341,4122,2371,11744,9373,130,780
GO,93912,HIDROLINA,1394,1162,547,3313,2766,35,175
GO,93939,IACIARA,2514,2181,2172,7654,5482,52,735
GO,93955,INHUMAS,14232,11765,6588,34985,28397,310,2090
GO,93971,IPAMERI,5400,7718,4075,18445,14370,171,1081
GO,93998,IPORÁ,8933,7597,5795,23916,18121,196,1395
GO,94013,ISRAELÂNDIA,890,821,545,2405,1860,18,131
GO,94030,ITABERAÍ,8822,7041,4701,22088,17387,212,1312
GO,94072,ITAGUARU,2525,1212,690,4806,4116,47,332
GO,94110,ITAJÁ,1417,1476,998,4155,3157,25,239
GO,94137,ITAPACI,4923,3416,2550,11764,9214,96,779
GO,94153,ITAPIRAPUÃ,2281,2335,2036,7076,5040,38,386
GO,94196,ITAPURANGA,9663,5183,5180,21526,16346,230,1270
GO,94218,ITARUMÃ,1152,1859,1141,4370,3229,33,185
GO,94234,ITAUÇU,2880,2262,1384,7021,5637,77,418
GO,94250,ITUMBIARA,23336,24700,13109,65111,52002,690,3276
GO,94277,IVOLÂNDIA,1045,663,655,2520,1865,8,149
GO,94293,JANDAIA,2533,1859,819,5524,4705,35,278
GO,94315,JARAGUÁ,10354,8308,5638,26332,20694,333,1699
GO,94331,JATAÍ,20634,21420,11018,56540,45522,508,2960
GO,94358,JAUPACI,1461,574,644,2835,2191,14,142
GO,94374,JOVIÂNIA,1891,2092,1168,5519,4351,52,316
GO,94390,JUSSARA,4770,5421,4447,15639,11192,123,878
GO,94439,LEOPOLDO DE BULHÕES,2130,1761,1083,5498,4415,74,450
GO,94455,LUZIÂNIA,42172,25922,17122,92346,75224,967,6163
GO,94471,MAIRIPOTABA,622,1002,389,2149,1760,14,122
GO,94498,MAMBAÍ,1064,1726,1055,4251,3196,22,384
GO,94510,MARA ROSA,3022,2537,2212,8435,6223,61,603
GO,94536,MARZAGÃO,590,653,240,1575,1335,9,83
GO,94552,PARANAIGUARA,3072,1808,1701,6999,5298,53,365
GO,94579,MAURILÂNDIA,3569,1915,2002,7999,5997,63,450
GO,94595,MINEIROS,12359,10721,5944,31193,25249,305,1864
GO,94650,MOIPORÁ,586,759,472,1937,1465,26,94
GO,94676,MONTE ALEGRE DE GOIÁS,2143,1021,1714,5413,3699,28,507
GO,94714,MONTES CLAROS DE GOIÁS,2387,1730,1325,5789,4464,62,285
GO,94730,MORRINHOS,11648,10416,6021,30210,24189,282,1843
GO,94757,MOSSÂMEDES,1764,1267,926,4242,3316,34,251
GO,94773,MOZARLÂNDIA,3886,2798,2457,9855,7398,64,650
GO,94790,MUTUNÓPOLIS,1242,1031,709,3178,2469,11,185
GO,94854,NAZÁRIO,2565,1954,1203,6203,5000,59,422
GO,94870,NERÓPOLIS,6763,5111,3495,16646,13151,198,1079
GO,94897,NIQUELÂNDIA,12366,7110,8101,29664,21563,247,1840
GO,94919,NOVA AMÉRICA,737,784,322,1994,1672,20,131
GO,94935,NOVA AURORA,641,816,198,1772,1574,21,96
GO,94951,NOVA ROMA,932,820,626,2606,1980,17,211
GO,94978,NOVA VENEZA,2423,1958,1016,5828,4812,49,382
GO,95010,NOVO BRASIL,1167,1159,614,3119,2505,24,155
GO,95036,ORIZONA,3326,4698,2031,10876,8845,140,681
GO,95052,OURO VERDE DE GOIÁS,1138,1302,598,3342,2744,41,263
GO,95079,OUVIDOR,2005,1477,437,4143,3706,36,188
GO,95095,PADRE BERNARDO,5017,3957,3992,14194,10202,129,1099
GO,95117,PALMEIRAS DE GOIÁS,5035,6849,2903,15741,12838,102,852
GO,95133,PALMELO,587,731,327,1787,1460,17,125
GO,95150,PALMINÓPOLIS,1118,1331,746,3375,2629,24,156
GO,95176,PANAMÁ,802,923,362,2224,1862,18,119
GO,95230,PARAÚNA,3237,2491,1867,8199,6332,55,549
GO,95311,PETROLINA DE GOIÁS,2478,3214,1585,7866,6281,77,512
GO,95354,PILAR DE GOIÁS,986,708,460,2317,1857,19,144
GO,95397,PIRACANJUBA,7006,6114,4276,18573,14297,148,1029
GO,95419,PIRANHAS,4072,2382,2002,9129,7127,69,604
GO,95435,PIRENÓPOLIS,6419,6350,4113,18295,14182,216,1197
GO,95451,PIRES DO RIO,6854,7999,4492,20896,16404,267,1284
GO,95494,PONTALINA,5299,4457,3122,13889,10767,121,890
GO,95559,PORANGATU,13011,6856,8129,29654,21525,157,1501
GO,95575,PORTELÂNDIA,1145,960,452,2747,2295,29,161
GO,95613,POSSE,6839,7013,4914,20455,15541,129,1560
GO,95630,QUIRINÓPOLIS,11363,9634,5354,28256,22902,354,1551
GO,95656,RIALMA,3125,2293,1812,7823,6011,89,504
GO,95672,RIANÁPOLIS,1191,1322,522,3328,2806,49,244
GO,95710,RIO VERDE,32182,37484,16212,91810,75598,783,5149
GO,95737,RUBIATABA,5554,4890,3115,14518,11403,154,805
GO,95753,SANCLERLÂNDIA,2879,1760,1066,6095,5029,60,330
GO,95770,SANTA BÁRBARA DE GOIÁS,1838,1270,743,4128,3385,29,248
GO,95796,SANTA CRUZ DE GOIÁS,741,1139,751,2793,2042,16,146
GO,95818,SANTA HELENA DE GOIÁS,11273,10745,4960,28558,23598,208,1372
GO,95834,SANTA RITA DO ARAGUAIA,1270,1384,897,3799,2902,35,213
GO,95850,SANTA ROSA DE GOIÁS,1089,1052,484,2897,2413,57,215
GO,95877,SANTA TEREZA DE GOIÁS,1245,934,705,3139,2434,46,209
GO,95893,SANTA TEREZINHA DE GOIÁS,3670,2348,2975,9492,6517,47,452
GO,95915,SÃO DOMINGOS,2349,1677,2400,7115,4715,57,632
GO,95931,SÃO FRANCISCO DE GOIÁS,1603,1472,1033,4532,3499,49,375
GO,95958,PLANALTINA,21564,9146,8181,42153,33972,457,2805
GO,95974,SÃO JOÃO D'ALIANÇA,1712,1872,1469,5529,4060,50,426
GO,95990,SÃO LUÍS DE MONTES BELOS,7833,7119,4885,21466,16581,237,1392
GO,96016,SÃO MIGUEL DO ARAGUAIA,4937,5952,4786,17010,12224,112,1223
GO,96059,SÃO SIMÃO,5145,2349,1861,10011,8150,94,562
GO,96075,SERRANÓPOLIS,1825,1714,1150,5048,3898,48,311
GO,96091,SILVÂNIA,4435,5334,2451,13147,10696,127,800
GO,96113,SÍTIO D'ABADIA,674,878,613,2333,1720,14,154
GO,96172,TAQUARAL DE GOIÁS,1132,1064,484,2937,2453,34,223
GO,96237,TRÊS RANCHOS,1224,845,361,2565,2204,27,108
GO,96253,TRINDADE,28048,18145,12266,62885,50619,587,3839
GO,96318,TURVÂNIA,1549,1608,849,4297,3448,29,262
GO,96334,URUAÇU,9871,6019,6654,24022,17368,185,1293
GO,96350,URUANA,4473,3029,2854,11102,8248,91,655
GO,96377,URUTAÍ,923,887,483,2455,1972,34,128
GO,96393,VARJÃO,876,1365,595,3062,2467,27,199
GO,96415,VIANÓPOLIS,2011,3959,1437,8037,6600,82,548
GO,96458,ACREÚNA,4863,5567,3446,14972,11526,126,970
GO,96474,MINAÇU,10121,6231,8063,25828,17765,171,1242
GO,96512,MUNDO NOVO,1933,988,1573,4858,3285,39,325
GO,96539,NOVA CRIXÁS,2532,2377,2135,7601,5466,44,513
GO,96555,NOVA GLÓRIA,3218,1521,1943,7164,5221,60,422
GO,96571,VICENTINÓPOLIS,2286,1609,942,5161,4219,43,281
GO,96610,AMERICANO DO BRASIL,1924,1253,650,4137,3487,27,283
GO,96695,ARAGUAPAZ,2016,1798,1692,5857,4165,41,310
GO,96717,ARENÓPOLIS,1378,725,577,2869,2292,16,173
GO,96733,CACHOEIRA DOURADA,2549,2331,1846,7266,5420,79,461
GO,96750,DOVERLÂNDIA,2262,2081,1394,6117,4723,29,351
GO,96776,SANTO ANTÔNIO DO DESCOBERTO,15086,8751,6962,33286,26324,333,2154
GO,96814,INDIARA,4020,2240,1865,8822,6957,94,603
GO,96873,CAMPINAÇU,1396,849,751,3199,2448,29,174
GO,96890,SANTA ISABEL,881,1170,668,2939,2271,38,182
GO,96911,ADELÂNDIA,979,708,360,2183,1823,10,126
GO,96938,ÁGUA FRIA DE GOIÁS,1014,1398,1325,4015,2690,30,248
MA,7005,ÁGUA DOCE,4398,890,2016,8189,6173,56,829
MA,7013,AFONSO CUNHA,3109,207,1215,5023,3808,26,466
MA,7021,ALTO ALEGRE DO MARANHÃO,7657,581,2809,12155,9346,64,1044
MA,7030,ALCÂNTARA,9069,699,3470,14070,10600,70,762
MA,7048,ALTO ALEGRE DO PINDARÉ,10946,822,4956,18245,13289,78,1443
MA,7056,ALDEIAS ALTAS,7852,489,3174,12995,9821,94,1386
MA,7064,APICUM-AÇU,4476,1146,1607,7822,6215,25,568
MA,7072,ALTAMIRA DO MARANHÃO,3293,418,1329,5464,4135,36,388
MA,7080,AMAPÁ DO MARANHÃO,1938,653,1205,4188,2983,20,372
MA,7099,ALTO PARNAÍBA,2871,1239,1841,6645,4804,47,647
MA,7102,ARAGUANÃ,3522,288,2013,6210,4197,22,365
MA,7110,AMARANTE DO MARANHÃO,9812,3130,4166,19245,15079,137,2000
MA,7129,BACABEIRA,6222,700,1927,9431,7504,50,532
MA,7137,ANAJATUBA,10016,730,5055,17106,12051,108,1197
MA,7145,BACURITUBA,2397,135,1203,3958,2755,19,204
MA,7153,ANAPURUS,5904,668,1505,8923,7418,70,776
MA,7161,BELÁGUA,3093,120,797,4389,3592,17,362
MA,7170,ARAIÓSES,12958,3294,6632,25768,19136,275,2609
MA,7188,BELA VISTA,3937,577,2152,7095,4943,27,402
MA,7196,ARARI,10924,2324,4885,19524,14639,192,1199
MA,7200,BERNARDO DO MEARIM,2579,281,855,4011,3156,19,277
MA,7218,AXIXÁ,4968,429,2106,7933,5827,23,407
MA,7226,CACHOEIRA GRANDE,3188,162,1652,5404,3752,19,383
MA,7234,BACABAL,35529,5181,15766,60551,44785,366,3709
MA,7242,DAVINÓPOLIS,4818,696,2609,8535,5926,21,391
MA,7250,BACURI,5630,1168,2754,10424,7670,46,826
MA,7269,BOM JESUS DAS SELVAS,5811,2369,4056,13640,9584,94,1310
MA,7277,BALSAS,18641,10770,9108,41977,32869,284,3174
MA,7285,BOM LUGAR,5356,552,2297,8806,6509,34,567
MA,7293,BARÃO DE GRAJAÚ,6785,930,2645,11290,8645,86,844
MA,7307,BREJO DE AREIA,3616,661,1586,6577,4991,42,672
MA,7315,BARRA DO CORDA,27766,4430,11877,48241,36364,338,3830
MA,7323,BOA VISTA DO GURUPI,1741,732,976,3684,2708,13,222
MA,7331,BARREIRINHAS,20266,1887,6401,30724,24323,104,2066
MA,7340,BURITICUPU,19560,3321,7642,33303,25661,178,2602
MA,7358,BENEDITO LEITE,1363,1129,1321,4274,2953,20,441
MA,7366,BURITIRANA,4492,1385,2551,9278,6727,84,766
MA,7374,BEQUIMÃO,9712,926,4182,15848,11666,165,863
MA,7382,CAMPESTRE DO MARANHÃO,5014,759,1864,8198,6334,37,524
MA,7390,BREJO,12040,2025,4796,20512,15716,94,1557
MA,7404,CAPINZAL DO NORTE,4316,499,1239,6580,5341,44,482
MA,7412,BURITI,9583,1234,4253,16896,12643,122,1704
MA,7420,CENTRAL DO MARANHÃO,3501,101,1348,5341,3993,27,364
MA,7439,BURITI BRAVO,9172,947,2959,14067,11108,83,906
MA,7447,CENTRO DO GUILHERME,2741,194,1264,4569,3305,15,355
MA,7455,CAJAPIÓ,4335,496,1994,7356,5362,43,488
MA,7463,CENTRO NOVO DO MARANHÃO,4593,470,1584,7233,5649,38,548
MA,7471,CAJARI,6756,417,3143,11284,8141,60,908
MA,7480,CIDELÂNDIA,4484,1027,2262,8363,6101,46,544
MA,7498,CÂNDIDO MENDES,5455,1411,3619,11359,7740,32,842
MA,7501,CONCEIÇÃO DO LAGO AÇU,4754,504,1804,7797,5993,22,713
MA,7510,CANTANHEDE,5627,838,2548,9944,7396,53,878
MA,7528,FEIRA NOVA DO MARANHÃO,2201,1300,884,4801,3917,19,397
MA,7536,CAROLINA,8188,2396,4460,16257,11797,105,1108
MA,7544,FERNANDO FALCÃO,3785,292,1350,5806,4456,27,352
MA,7552,CARUTAPERA,6906,1913,3428,13076,9648,54,775
MA,7560,FORMOSA DA SERRA NEGRA,2723,3407,1824,8729,6905,41,734
MA,7579,CAXIAS,55566,5457,23040,91158,68118,579,6516
MA,7595,CEDRAL,4562,373,1690,7037,5347,53,359
MA,7609,GOVERNADOR EDSON LOBÃO,4021,1333,1858,7734,5876,31,491
MA,7617,CHAPADINHA,26879,2618,9284,41605,32321,277,2547
MA,7625,GOVERNADOR LUIZ ROCHA,3648,746,1168,5965,4797,27,376
MA,7633,CODÓ,38228,5099,23721,73067,49346,459,5560
MA,7641,GOVERNADOR NEWTON BELLO,3810,582,2291,7221,4930,35,503
MA,7650,COELHO NETO,18072,2619,8686,32246,23560,231,2638
MA,7668,GOVERNADOR NUNES FREIRE,7024,1243,2825,12098,9273,64,942
MA,7676,COLINAS,13032,1635,5325,22063,16738,150,1921
MA,7684,IGARAPÉ DO MEIO,3986,548,1860,7052,5192,44,614
MA,7692,COROATÁ,24651,2056,9442,39450,30008,300,3001
MA,7706,ITAIPAVA DO GRAJAÚ,4102,891,1790,7377,5587,19,575
MA,7714,CURURUPU,13478,1336,6040,22200,16160,137,1209
MA,7722,ITINGA DO MARANHÃO,7270,3416,4481,16252,11771,85,1000
MA,7730,DOM PEDRO,8635,1711,3478,14734,11256,79,831
MA,7749,JATOBÁ,3116,407,947,4920,3973,36,414
MA,7757,DUQUE BACELAR,4145,509,1771,7138,5367,50,663
MA,7765,JENIPAPO DOS VIEIRAS,5824,597,2026,9569,7543,79,1043
MA,7773,ESPERANTINÓPOLIS,8376,705,2559,12599,10040,85,874
MA,7781,JUNCO DO MARANHÃO,2102,501,1062,3947,2885,21,261
MA,7790,FORTALEZA DOS NOGUEIRAS,4133,1501,1867,8066,6199,65,500
MA,7803,LAGO DOS RODRIGUES,4618,553,1706,7357,5651,26,454
MA,7811,FORTUNA,6920,809,2597,11135,8538,73,736
MA,7820,LAGOA DO MATO,4304,262,1602,6720,5118,20,532
MA,7838,GODOFREDO VIANA,2583,736,1684,5369,3685,13,353
MA,7846,LAGOA GRANDE DO MARANHÃO,4462,635,1588,7177,5589,30,462
MA,7854,GONÇALVES DIAS,6956,624,2431,10751,8320,49,691
MA,7862,LAJEADO NOVO,2166,1165,1043,4698,3655,21,303
MA,7870,GOVERNADOR ARCHER,4218,215,1434,6437,5003,34,536
MA,7889,MARACAÇUMÉ,5163,1470,2895,10352,7457,48,776
MA,7897,GOVERNADOR EUGÊNIO BARROS,5632,719,1849,9072,7223,53,819
MA,7900,MARAJÁ DO SENA,3463,597,1645,6290,4645,35,550
MA,7919,GRAÇA ARANHA,3312,234,1074,4924,3850,13,291
MA,7927,MARANHÃOZINHO,3376,513,1315,5566,4251,13,349
MA,7935,GRAJAÚ,17184,3785,6948,30508,23560,153,2438
MA,7943,MATÕES DO NORTE,3133,201,1888,5707,3819,24,461
MA,7951,GUIMARÃES,5673,491,2354,9081,6727,81,482
MA,7960,MILAGRES DO MARANHÃO,2488,264,928,4019,3091,17,322
MA,7978,HUMBERTO DE CAMPOS,9754,492,4401,16086,11685,57,1382
MA,7986,NOVA COLINAS,1882,631,629,3432,2803,18,272
MA,7994,ICATU,11228,517,4468,17365,12897,63,1089
MA,8001,NOVA OLINDA DO MARANHÃO,6358,716,2419,10243,7824,45,705
MA,8010,IGARAPÉ GRANDE,4672,663,1961,7759,5798,26,437
MA,8028,OLINDA NOVA DO MARANHÃO,4488,304,2194,7598,5404,45,567
MA,8036,IMPERATRIZ,74238,30862,33353,145265,111912,811,6001
MA,8044,PAULINO NEVES,4293,1369,2378,8940,6562,66,834
MA,8052,SÃO LUIS GONZAGA DO MARANHÃO,10275,785,4662,17225,12563,95,1408
MA,8060,PEDRO DO ROSÁRIO,6670,370,2796,10872,8076,54,982
MA,8079,ITAPECURU-MIRIM,20941,1832,8133,33425,25292,204,2315
MA,8087,PERITORÓ,8201,563,2839,12766,9927,76,1087
MA,8095,JOÃO LISBOA,9221,1772,4929,17044,12115,99,1023
MA,8109,PORTO RICO DO MARANHÃO,3197,523,1443,5474,4031,53,258
MA,8117,JOSELÂNDIA,6569,469,2159,10273,8114,81,995
MA,8125,PRESIDENTE MEDICI,2533,415,892,4160,3268,19,301
MA,8133,LAGO DA PEDRA,16992,2997,8460,30423,21963,181,1793
MA,8141,PRESIDENTE SARNEY,5985,302,2549,9675,7126,37,802
MA,8150,LAGO DO JUNCO,3917,788,1566,6779,5213,50,458
MA,8168,RAPOSA,8917,1065,3772,14474,10702,63,657
MA,8176,LAGO VERDE,6525,307,2661,10224,7563,42,689
MA,8184,RIBAMAR FIQUENE,2440,993,1240,5051,3811,36,342
MA,8192,LIMA CAMPOS,4738,1425,1994,9000,7006,80,763
MA,8206,SANTA FILOMENA DO MARANHÃO,2912,327,728,4324,3596,33,324
MA,8214,LORETO,3424,877,1762,6699,4937,35,601
MA,8222,SANTANA DO MARANHÃO,3111,295,1500,5498,3998,32,560
MA,8230,LUIS DOMINGUES DO MARANHÃO,1976,843,1264,4373,3109,19,271
MA,8249,SANTO AMARO DO MARANHÃO,4333,432,2771,8153,5382,37,580
MA,8257,MAGALHÃES DE ALMEIDA,5820,1185,2848,10586,7738,46,687
MA,8265,SÃO DOMINGOS DO AZEITÃO,2668,426,1249,4779,3530,28,408
MA,8273,MATA ROMA,6159,982,1781,9785,8004,80,783
MA,8281,SÃO FRANCISCO DO BREJÃO,2543,1203,1162,5346,4184,29,409
MA,8290,MATINHA,9529,1314,2999,14989,11990,96,1051
MA,8303,SÃO JOÃO DO CARU,4220,891,2273,8064,5791,37,643
MA,8311,MATÕES,11064,846,4831,18610,13779,127,1742
MA,8320,SÃO JOÃO DO PARAÍSO,3356,1685,1676,7230,5554,37,476
MA,8338,MIRADOR,7268,1106,3128,12612,9484,59,1051
MA,8346,SÃO JOÃO DO SÓTER,5657,565,3130,10288,7158,45,891
MA,8354,MIRINZAL,5704,480,2380,9107,6727,59,484
MA,8362,SÃO JOSÉ DOS BASILIOS,3914,237,1358,5979,4621,29,441
MA,8370,MONÇÃO,9266,1203,4253,16186,11933,49,1415
MA,8389,SÃO PEDRO DA ÁGUA BRANCA,3818,691,2080,7005,4925,26,390
MA,8397,MONTES ALTOS,3676,1007,1462,6674,5212,41,488
MA,8400,SÃO PEDRO DOS CRENTES,1037,1320,628,3214,2586,10,219
MA,8419,MORROS,7093,346,2673,10857,8184,39,706
MA,8427,SÃO RAIMUNDO DA DOCA BEZERRA,2838,359,1014,4492,3478,9,272
MA,8435,NINA RODRIGUES,4361,636,1448,6883,5435,29,409
MA,8443,SÃO ROBERTO,2513,118,795,3646,2851,8,212
MA,8451,NOVA IORQUE,1731,552,748,3351,2603,23,297
MA,8460,SATUBINHA,2663,282,1130,4388,3258,18,295
MA,8478,OLHO D`ÁGUA DAS CUNHÃS,7030,1330,3662,13044,9382,70,952
MA,8486,SENADOR ALEXANDRE COSTA,3970,460,2221,7186,4965,31,504
MA,8494,PAÇO DO LUMIAR,28283,4318,7956,42531,34575,325,1649
MA,8508,SENADOR LA ROQUE,8305,1487,3745,14791,11046,84,1170
MA,8516,PALMEIRÂNDIA,7226,491,3551,12257,8706,69,920
MA,8524,SERRANO DO MARANHÃO,4515,186,1869,7158,5289,40,548
MA,8532,PARAIBANO,7663,988,3792,13693,9901,77,1173
MA,8540,SUCUPIRA DO RIACHÃO,2387,279,888,3907,3019,24,329
MA,8559,PARNARAMA,12510,1338,5688,21663,15975,140,1987
MA,8567,TRIZIDELA DO VALE,8154,1150,3696,13878,10182,75,803
MA,8575,PASSAGEM FRANCA,6700,1292,3456,12836,9380,69,1319
MA,8583,TUFILÂNDIA,2791,138,1182,4395,3213,9,275
MA,8591,PASTOS BONS,6938,1098,2453,11453,9000,45,919
MA,8605,TURILÂNDIA,6600,462,3342,11201,7859,37,760
MA,8613,PEDREIRAS,15800,2956,6980,27587,20607,158,1693
MA,8621,VILA NOVA DOS MARTÍRIOS,2871,697,896,4791,3895,30,297
MA,8630,PENALVA,13180,867,5993,21673,15680,81,1552
MA,8656,PERI MIRIM,5163,538,3125,9396,6271,47,523
MA,8672,PINDARÉ-MIRIM,11912,1100,4587,19058,14471,108,1351
MA,8699,PINHEIRO,28842,3929,12217,47900,35683,250,2662
MA,8710,PIO XII,9029,1770,4097,16023,11926,74,1053
MA,8737,PIRAPEMAS,6140,578,2676,10336,7660,72,870
MA,8753,POÇÃO DE PEDRAS,8896,1249,3821,14896,11075,81,849
MA,8770,PORTO FRANCO,6501,2788,2576,12499,9923,68,566
MA,8796,PRESIDENTE DUTRA,16333,2402,6484,26847,20363,166,1462
MA,8818,PRESIDENTE JUSCELINO,4656,246,1896,7376,5480,15,563
MA,8834,PRESIDENTE VARGAS,5214,330,1662,7815,6153,34,575
MA,8850,PRIMEIRA CRUZ,4626,314,2483,8138,5655,41,674
MA,8877,RIACHÃO,6755,1564,3277,12644,9367,71,977
MA,8893,SÃO JOSÉ DE RIBAMAR,35588,4296,10828,53511,42683,338,2461
MA,8915,ROSÁRIO,15176,1381,5914,24148,18234,147,1530
MA,8931,SAMBAÍBA,2392,532,1036,4294,3258,20,314
MA,8958,SANTA HELENA,11854,1059,5234,19298,14064,104,1047
MA,8974,SANTA LUZIA,23715,3915,12145,42951,30806,207,2969
MA,8990,SANTA QUITÉRIA DO MARANHÃO,10632,735,3155,15779,12624,93,1164
MA,9016,SANTA RITA,9839,1548,4277,16909,12632,116,1129
MA,9032,SANTO ANTÔNIO DOS LOPES,6821,650,2080,10273,8193,33,689
MA,9059,SÃO BENEDITO DO RIO PRETO,7280,437,1943,10414,8471,49,705
MA,9075,SÃO BENTO,13039,1962,7033,23571,16538,140,1397
MA,9091,SÃO BERNARDO,8324,2475,3638,16215,12577,91,1687
MA,9113,SÃO DOMINGOS DO MARANHÃO,13254,4052,5154,24222,19068,185,1577
MA,9130,SÃO FÉLIX DE BALSAS,2002,191,904,3389,2485,15,277
MA,9156,SÃO FRANCISCO DO MARANHÃO,4930,498,1931,8151,6220,71,721
MA,9172,SÃO JOÃO BATISTA,9637,540,5900,17101,11201,52,972
MA,9199,SÃO JOÃO DOS PATOS,8461,1997,4853,16718,11865,162,1245
MA,9210,SÃO LUÍS,379094,89661,120226,615977,495751,5327,21669
MA,9237,SÃO MATEUS DO MARANHÃO,14222,1657,7190,25140,17950,153,1918
MA,9253,SÃO RAIMUNDO DAS MANGABEIRAS,4978,2086,2968,10955,7987,49,874
MA,9270,SÃO VICENTE FERRER,8143,521,4735,14363,9628,87,877
MA,9296,SÍTIO NOVO,5500,2410,2737,11579,8842,67,865
MA,9318,SUCUPIRA DO NORTE,4552,480,1602,7297,5695,44,619
MA,9334,TASSO FRAGOSO,2043,1030,1197,4671,3474,26,375
MA,9350,TIMBIRAS,9198,971,5105,16765,11660,89,1402
MA,9377,TIMON,57744,5675,18828,89866,71038,607,7012
MA,9393,TUNTUM,15445,1606,5848,24758,18910,136,1723
MA,9415,TURIAÇU,10099,2343,6712,20865,14153,77,1634
MA,9431,TUTÓIA,12992,4942,7249,27908,20659,247,2478
MA,9458,URBANO SANTOS,9957,770,3632,15737,12105,114,1264
MA,9474,VARGEM GRANDE,14126,2101,6221,24667,18446,166,2053
MA,9490,VIANA,17870,3492,7250,31081,23831,196,2273
MA,9512,VITÓRIA DO MEARIM,11470,1901,6877,21861,14984,181,1432
MA,9539,VITORINO FREIRE,11809,1955,5236,20645,15409,102,1543
MA,9555,BOM JARDIM,12665,2389,6903,23856,16953,135,1764
MA,9571,SANTA INÊS,29417,5856,11046,49452,38406,287,2846
MA,9598,PAULO RAMOS,8010,1086,3101,13295,10194,85,1013
MA,9610,AÇAILÂNDIA,30311,11517,15227,61029,45802,364,3610
MA,9636,ESTREITO,8928,3261,3804,17205,13401,92,1120
MA,9652,SANTA LUZIA DO PARUÁ,8235,1785,3298,14345,11047,81,946
MA,9679,ARAME,8639,2890,4344,17475,13131,87,1515
MA,9695,MIRANDA DO NORTE,7493,543,3410,12133,8723,44,643
MA,9717,ZÉ DOCA,16258,2694,8350,29322,20972,140,1880
MG,40002,ALFREDO VASCONCELOS,2685,900,500,4224,3724,30,109
MG,40010,ABADIA DOS DOURADOS,2533,1692,866,5293,4427,59,143
MG,40029,ARAPORÃ,2316,1489,695,4618,3923,33,85
MG,40037,ABAETÉ,6553,6506,4049,17615,13566,197,310
MG,40045,BRASILÂNDIA DE MINAS,3829,2589,1974,8571,6597,55,124
MG,40053,ABRE CAMPO,5024,2742,2345,10533,8188,115,307
MG,40061,CAPITÃO ANDRADE,1812,825,814,3590,2776,22,117
MG,40070,ACAIACA,1693,631,903,3335,2432,31,77
MG,40088,CARNEIRINHO,3834,2220,1692,7895,6203,44,105
MG,40096,AÇUCENA,4280,1211,2862,8772,5910,122,297
MG,40100,CATUJI,3273,1046,1921,6503,4582,38,225
MG,40118,ÁGUA BOA,5238,1639,3999,11258,7259,53,329
MG,40126,DIVISA ALEGRE,1800,1104,1083,4131,3048,31,113
MG,40134,ÁGUA COMPRIDA,599,857,388,1900,1512,22,34
MG,40142,DIVISÓPOLIS,2731,1370,1509,5779,4270,20,149
MG,40150,AGUANIL,1778,602,472,2959,2487,30,77
MG,40169,DURANDÉ,2433,1342,1363,5305,3942,43,124
MG,40177,ÁGUAS FORMOSAS,6593,2395,4173,13636,9463,83,392
MG,40185,ENTRE FOLHAS,2834,688,769,4435,3666,31,113
MG,40193,ÁGUAS VERMELHAS,3680,2214,2800,9107,6307,53,360
MG,40207,FERVEDOURO,3863,1578,1558,7261,5703,72,190
MG,40215,AIMORÉS,9080,5097,5385,20056,14671,142,352
MG,40223,FRANCISCÓPOLIS,2092,443,1472,4204,2732,35,162
MG,40231,AIURUOCA,1889,1647,1149,4867,3718,34,148
MG,40240,ICARAÍ DE MINAS,3240,1528,2382,7311,4929,25,136
MG,40258,ALAGOA,753,967,546,2339,1793,24,49
MG,40266,IPABA,6770,1390,2557,10914,8357,55,142
MG,40274,ALBERTINA,921,833,468,2292,1824,13,57
MG,40282,JAÍBA,9031,4313,4359,18299,13940,110,486
MG,40290,ALÉM PARAÍBA,15440,5545,5869,27734,21865,270,610
MG,40304,JAMPRUCA,2185,482,1161,3975,2814,23,124
MG,40312,ALFENAS,19776,19553,9642,50575,40933,607,997
MG,40320,JUATUBA,7529,2405,2273,12757,10484,185,365
MG,40339,ALMENARA,13643,4033,8131,26867,18736,189,871
MG,40347,LAGOA GRANDE,2489,1934,1295,5836,4541,36,82
MG,40355,ALPERCATA,3038,899,970,5046,4076,33,106
MG,40363,LIMEIRA DO OESTE,2750,1166,1044,5086,4042,41,85
MG,40371,ALPINÓPOLIS,6760,3751,2596,13523,10927,134,282
MG,40380,LONTRA,3726,708,1955,6632,4677,48,195
MG,40398,ALTEROSA,3883,4332,1669,10161,8492,96,181
MG,40401,MAMONAS,2319,1297,866,4631,3765,28,121
MG,40410,ALTO RIO DOCE,4471,2634,3664,11205,7541,127,309
MG,40428,MATA VERDE,2614,1101,1580,5540,3960,26,219
MG,40436,ALVARENGA,1841,1134,827,3893,3066,25,66
MG,40444,MATIAS CARDOSO,3028,1106,1897,6260,4363,32,197
MG,40452,ALVINÓPOLIS,7336,1996,2701,12519,9818,108,378
MG,40460,MONTEZUMA,2287,773,1492,4784,3292,28,204
MG,40479,ALVORADA DE MINAS,1634,237,1165,3163,1998,20,107
MG,40487,NAQUE,2491,733,1026,4438,3412,59,129
MG,40495,AMPARO DO SERRA,2456,737,1158,4525,3367,44,130
MG,40509,NOVO ORIENTE DE MINAS,3691,1167,2993,8226,5233,55,320
MG,40517,ANDRADAS,7980,12708,3593,25278,21685,302,695
MG,40525,PALMÓPOLIS,2802,852,2162,6038,3876,24,198
MG,40533,CACHOEIRA DE PAJEÚ,3391,1265,2090,7021,4931,42,233
MG,40541,PEDRAS DE MARIA DA CRUZ,3923,565,1896,6567,4671,32,151
MG,40550,ANDRELÂNDIA,3515,3485,1907,9315,7408,123,285
MG,40568,PERIQUITO,3085,849,1542,5687,4145,57,154
MG,40576,ANTÔNIO CARLOS,5391,1633,1619,8997,7378,103,251
MG,40584,PONTO DOS VOLANTES,2812,2102,1909,7144,5235,41,280
MG,40592,ANTÔNIO DIAS,4244,1623,1890,8091,6201,101,233
MG,40606,RIACHINHO,2733,979,1229,5088,3859,35,112
MG,40614,ANTÔNIO PRADO DE MINAS,793,447,244,1543,1299,12,47
MG,40622,ROSÁRIO DA LIMEIRA,2147,1184,670,4142,3472,36,105
MG,40630,ARAÇAÍ,1031,563,554,2221,1667,16,57
MG,40649,SANTA BÁRBARA DO LESTE,3528,1300,1324,6369,5045,64,153
MG,40657,ARACITABA,915,476,321,1820,1499,37,71
MG,40665,SANTA RITA DE MINAS,2580,906,848,4491,3643,51,106
MG,40673,ARAÇUAÍ,9893,6661,8691,26022,17331,158,619
MG,40681,SANTANA DO PARAÍSO,7241,1955,2455,11973,9518,107,215
MG,40690,ARAGUARI,31551,30502,13692,78603,64911,839,2019
MG,40703,SÃO JOÃO DA LAGOA,1820,710,937,3573,2636,19,87
MG,40711,ARANTINA,1251,584,528,2447,1919,25,59
MG,40720,SÃO JOÃO DO MANHUAÇU,3592,1860,1185,6834,5649,67,130
MG,40738,ARAPONGA,3324,818,1264,5716,4452,73,237
MG,40746,SÃO JOÃO DO MANTENINHA,2213,889,690,3879,3189,21,66
MG,40754,ARAPUÁ,679,1338,396,2529,2133,43,73
MG,40762,SÃO JOÃO DO PACUÍ,1949,295,933,3292,2359,22,93
MG,40770,ARAÚJOS,1444,2711,845,5147,4302,61,86
MG,40789,SÃO JOSÉ DA LAPA,8395,2489,2031,13367,11336,161,291
MG,40797,ARAXÁ,24392,27134,10873,64723,53850,687,1637
MG,40800,SARZEDO,7420,2284,1710,11831,10121,168,249
MG,40819,ARCEBURGO,2146,3010,1355,6786,5431,71,204
MG,40827,SEM PEIXE,1422,594,753,2881,2128,33,79
MG,40835,ARCOS,12541,8475,3869,26237,22368,518,834
MG,40843,SENADOR AMARAL,2331,1062,878,4367,3489,34,62
MG,40851,AREADO,4120,4239,1762,10426,8664,98,207
MG,40860,UBAPORANGA,3785,2308,2333,8670,6337,67,177
MG,40878,ARGIRITA,1611,467,623,2786,2163,25,60
MG,40886,URUCUIA,3086,1081,1496,5821,4325,32,126
MG,40894,ARINOS,5695,2795,3551,12485,8934,86,358
MG,40908,VARGEM ALEGRE,3103,822,1625,5722,4097,31,141
MG,40916,ASTOLFO DUTRA,5041,2682,1518,9549,8031,110,198
MG,40924,JOSENÓPOLIS,1838,267,1030,3295,2265,15,145
MG,40932,ATALÉIA,6032,1283,4230,11942,7712,71,326
MG,40940,JUVENÍLIA,2400,904,1526,4968,3442,15,123
MG,40959,AUGUSTO DE LIMA,2112,750,1042,4007,2965,25,78
MG,40967,LEME DO PRADO,1549,721,1195,3574,2379,14,95
MG,40975,BAEPENDI,6183,5287,2342,14304,11962,157,335
MG,40983,LUISBURGO,1562,1974,821,4496,3675,39,100
MG,40991,BALDIM,3609,1095,1941,6831,4890,54,132
MG,41009,LUISLÂNDIA,2891,381,1579,4987,3408,16,120
MG,41017,BAMBUÍ,6357,6657,4061,17700,13639,198,427
MG,41025,MÁRIO CAMPOS,4426,1469,1344,7545,6201,110,196
MG,41033,BANDEIRA,1896,632,1050,3731,2681,18,135
MG,41041,MARTINS SOARES,2573,1233,940,4924,3984,52,126
MG,41050,BANDEIRA DO SUL,1948,1625,791,4481,3690,36,81
MG,41068,MIRAVÂNIA,1860,452,1029,3445,2416,11,93
MG,41076,BARÃO DE COCAIS,12164,3092,2997,18974,15977,276,445
MG,41084,MONTE FORMOSO,1610,781,1050,3598,2548,15,142
MG,41092,BARÃO DE MONTE ALTO,2361,1444,1259,5251,3992,52,135
MG,41106,NATALÂNDIA,1427,570,616,2668,2052,16,39
MG,41114,BARBACENA,51539,18805,13433,87811,74378,995,3039
MG,41122,NINHEIRA,2194,2035,2059,6664,4605,64,312
MG,41130,BARRA LONGA,2650,1179,1133,5180,4047,62,156
MG,41149,NOVA BELÉM,1510,617,1293,3526,2233,22,84
MG,41157,TRÊS MARIAS,10029,4478,4433,19559,15126,223,396
MG,41165,NOVA PORTEIRINHA,3472,833,1076,5533,4457,37,115
MG,41173,BARROSO,9199,2830,2514,15272,12758,255,474
MG,41181,NOVORIZONTE,1981,840,1193,4156,2963,28,114
MG,41190,BELA VISTA DE MINAS,5389,853,1764,8255,6491,92,157
MG,41203,OLHOS D'ÁGUA,2357,410,1166,4092,2926,24,135
MG,41211,BELMIRO BRAGA,1510,750,359,2727,2368,24,84
MG,41220,ORATÓRIOS,2384,495,832,3838,3006,26,101
MG,41238,BELO HORIZONTE,848978,494749,300967,1742843,1441876,27887,70262
MG,41246,ORIZÂNIA,2970,990,1089,5182,4093,33,100
MG,41254,BELO ORIENTE,9725,2261,3584,16161,12577,240,351
MG,41262,PADRE CARVALHO,1949,629,1315,4045,2730,15,137
MG,41270,BELO VALE,3613,1602,1197,6732,5535,125,195
MG,41289,PAI PEDRO,2672,348,1414,4617,3203,29,154
MG,41297,BERILO,4241,1530,3231,9358,6127,74,282
MG,41300,PATIS,2193,680,1566,4565,2999,17,109
MG,41319,BERTÓPOLIS,1646,578,573,2971,2398,33,141
MG,41327,PEDRA BONITA,2278,1346,853,4628,3775,31,120
MG,41335,BETIM,130305,41179,32666,212206,179540,2589,5467
MG,41343,PIEDADE DE CARATINGA,2707,1058,1391,5288,3897,30,102
MG,41351,BIAS FORTES,1869,717,837,3552,2715,33,96
MG,41360,PINGO D'ÁGUA,1970,450,614,3135,2521,14,87
MG,41378,BICAS,5003,3168,2083,10786,8703,98,434
MG,41386,PINTÓPOLIS,2887,751,1558,5329,3771,26,107
MG,41394,BIQUINHAS,1034,638,503,2293,1790,50,68
MG,41408,PONTO CHIQUE,1593,627,848,3137,2289,11,58
MG,41416,BOA ESPERANÇA,13301,8114,5988,28122,22134,246,473
MG,41424,REDUTO,2276,1124,1018,4542,3524,34,90
MG,41432,BOCAINA DE MINAS,1206,1864,771,4016,3245,48,127
MG,41440,SANTA BÁRBARA DO MONTE VERDE,1351,626,426,2503,2077,21,79
MG,41459,BOCAIÚVA,18408,4394,7848,31736,23888,279,807
MG,41467,SANTA CRUZ DE MINAS,3049,1658,738,5681,4943,89,147
MG,41475,BOM DESPACHO,13531,11953,5938,32621,26683,487,712
MG,41483,SANTA CRUZ DE SALINAS,2233,384,1059,3843,2784,21,146
MG,41491,BOM JARDIM DE MINAS,2555,1475,931,5151,4220,55,135
MG,41505,SANTA HELENA DE MINAS,1904,1146,1500,4738,3238,30,158
MG,41513,BOM JESUS DA PENHA,1143,1165,475,2872,2397,27,62
MG,41521,SANTO ANTÔNIO DO RETIRO,2737,662,1204,4916,3712,35,278
MG,41530,BOM JESUS DO AMPARO,2273,971,940,4391,3451,50,157
MG,41548,SÃO DOMINGOS DAS DORES,1820,1225,846,4013,3167,42,80
MG,41556,BOM JESUS DO GALHO,5785,3076,3362,12649,9287,118,308
MG,41564,SÃO FÉLIX DE MINAS,1493,457,479,2511,2032,18,64
MG,41572,BOM REPOUSO,3469,2586,1072,7373,6301,83,163
MG,41580,SÃO GERALDO DO BAIXIO,1266,523,513,2364,1851,15,47
MG,41599,BOM SUCESSO,5397,5005,2964,13919,10955,178,375
MG,41602,SÃO JOÃO DAS MISSÕES,3341,826,1556,6114,4558,54,337
MG,41610,BONFIM,2915,1660,778,5705,4927,144,208
MG,41629,SÃO JOAQUIM DE BICAS,8357,2008,2560,13404,10844,145,334
MG,41637,BONFINÓPOLIS DE MINAS,2068,1317,1534,5044,3510,37,88
MG,41645,SÃO JOSÉ DA BARRA,2832,1256,1216,5446,4230,46,96
MG,41653,BORDA DA MATA,4711,4850,1821,11834,10013,120,332
MG,41661,ALTO CAPARAÓ,1192,1581,734,3608,2874,35,66
MG,41670,BOTELHOS,5428,3565,2556,11947,9391,104,294
MG,41688,ANGELÂNDIA,2141,1570,1707,5672,3965,53,201
MG,41696,BOTUMIRIM,2628,526,1569,4875,3306,23,129
MG,41700,ARICANDUVA,1551,999,992,3737,2745,37,158
MG,41718,BRASÍLIA DE MINAS,13484,2527,6936,23695,16759,159,589
MG,41726,BERIZAL,1862,659,916,3574,2658,16,121
MG,41734,BRÁS PIRES,1748,860,957,3693,2736,44,84
MG,41742,BONITO DE MINAS,3336,451,1682,5720,4038,21,230
MG,41750,BRAÚNAS,2156,639,805,3811,3006,56,155
MG,41769,BUGRE,1570,1016,740,3454,2714,19,109
MG,41777,BRASÓPOLIS,3265,5981,2460,12001,9541,93,202
MG,41785,CABECEIRA GRANDE,2065,1234,1083,4482,3399,27,73
MG,41793,BRUMADINHO,11118,5268,3135,20487,17352,324,642
MG,41807,CAMPO AZUL,1777,425,729,3012,2283,15,66
MG,41815,BUENO BRANDÃO,2507,3806,1533,8129,6596,105,178
MG,41823,CANTAGALO,1369,781,1014,3316,2302,30,122
MG,41831,BUENÓPOLIS,3225,1558,2873,7925,5052,63,206
MG,41840,CATAS ALTAS,2082,770,577,3551,2974,37,85
MG,41858,BURITIS,5622,4984,3990,15058,11068,115,347
MG,41866,CATUTI,2335,635,1424,4572,3148,25,153
MG,41874,BURITIZEIRO,9275,3265,5216,18372,13156,163,453
MG,41882,CHAPADA GAÚCHA,3163,1121,1811,6340,4529,28,217
MG,41890,CABO VERDE,4350,2923,1927,9489,7562,83,206
MG,41904,CÔNEGO MARINHO,2816,791,1760,5574,3814,34,173
MG,41912,CACHOEIRA DA PRATA,1611,939,470,3180,2710,73,87
MG,41920,CONFINS,2542,939,396,4024,3628,59,88
MG,41939,CACHOEIRA DE MINAS,2914,3732,1312,8247,6935,116,173
MG,41947,CÓRREGO FUNDO,2320,1276,499,4299,3800,74,130
MG,41955,CACHOEIRA DOURADA,1056,475,670,2247,1577,14,32
MG,41963,CRISÓLITA,2374,644,1481,4694,3213,19,176
MG,41971,CAETANÓPOLIS,3259,1986,1100,6661,5561,95,221
MG,41980,CUPARAQUE,1479,965,717,3248,2531,16,71
MG,41998,CAETÉ,17118,6077,5340,29640,24300,331,774
MG,42005,CURRAL DE DENTRO,2578,1017,1377,5176,3799,21,183
MG,42013,CAIANA,2007,833,758,3742,2984,36,108
MG,42021,DELTA,2407,522,558,3600,3042,50,63
MG,42030,CAJURI,2358,606,752,3859,3107,37,106
MG,42048,DOM BOSCO,1199,990,587,2838,2251,13,49
MG,42056,CALDAS,3558,4609,1252,9735,8483,83,233
MG,42064,FREI LAGONEGRO,1388,504,580,2566,1986,9,85
MG,42072,CAMACHO,1404,931,569,3031,2462,37,90
MG,42080,FRUTA DE LEITE,2580,292,1743,4827,3084,26,186
MG,42099,CAMANDUCAIA,6220,5174,2584,14499,11915,192,329
MG,42102,GAMELEIRAS,1808,1061,1420,4433,3013,15,129
MG,42110,CAMBUÍ,7141,7272,3260,18337,15077,155,509
MG,42129,GLAUCILÂNDIA,1741,437,494,2760,2266,30,58
MG,42137,CAMBUQUIRA,3248,4014,1735,9341,7606,85,259
MG,42145,GOIABEIRA,1327,523,424,2339,1915,18,47
MG,42153,CAMPANÁRIO,1631,399,764,2902,2138,21,87
MG,42161,GOIANÁ,1668,728,540,3064,2524,36,92
MG,42170,CAMPANHA,3188,5163,2019,10757,8738,114,273
MG,42188,GUARACIAMA,3139,407,907,4610,3703,26,131
MG,42196,CAMPESTRE,5123,6927,2790,15317,12527,189,288
MG,42200,IBIRACATU,2553,848,1412,5050,3638,25,212
MG,42218,CAMPINA VERDE,5624,5404,3582,14945,11363,101,234
MG,42226,IMBÉ DE MINAS,2375,1041,1424,5005,3581,29,136
MG,42234,CAMPO BELO,19760,9102,7243,37437,30194,420,912
MG,42242,INDAIABIRA,1895,1460,1471,5089,3618,27,236
MG,42250,CAMPO DO MEIO,4891,1897,2074,9137,7063,98,177
MG,42269,JAPONVAR,3719,665,1980,6603,4623,45,194
MG,42277,CAMPO FLORIDO,1466,1385,539,3442,2903,19,33
MG,42285,JENIPAPO DE MINAS,1659,1060,1995,4913,2918,42,157
MG,42293,CAMPOS ALTOS,3751,3438,2114,9584,7470,91,190
MG,42307,JOSÉ GONÇALVES DE MINAS,1332,850,1051,3378,2327,16,129
MG,42315,CAMPOS GERAIS,9083,5812,4090,19581,15491,203,393
MG,42323,JOSÉ RAYDAN,1809,429,894,3302,2408,19,151
MG,42331,CANAÃ,2479,562,431,3648,3217,36,140
MG,42340,SÃO SEBASTIÃO DA VARGEM ALEGRE,1283,560,358,2284,1926,26,57
MG,42358,CANÁPOLIS,4469,1848,1617,8128,6511,46,148
MG,42366,SÃO SEBASTIÃO DO ANTA,1850,1122,1061,4146,3085,26,87
MG,42374,CANA VERDE,2629,960,909,4650,3741,44,108
MG,42382,SERRANÓPOLIS DE MINAS,1667,774,537,3121,2584,27,116
MG,42390,CANDEIAS,5175,3709,1985,11389,9404,175,345
MG,42404,SETUBINHA,3026,1027,2335,6788,4453,57,343
MG,42412,CAPARAÓ,1605,1340,769,3841,3072,27,100
MG,42420,TAPARUBA,1120,973,608,2800,2192,34,65
MG,42439,CAPELA NOVA,1812,1232,749,4010,3261,106,111
MG,42447,UNIÃO DE MINAS,1633,944,1022,3665,2643,15,51
MG,42455,CAPELINHA,8395,5753,6418,21484,15066,202,716
MG,42463,URUANA DE MINAS,1459,567,797,2903,2106,20,60
MG,42471,CAPETINGA,2501,1742,1321,5725,4404,49,112
MG,42480,VARGEM GRANDE DO RIO PARDO,1359,1107,828,3444,2616,20,130
MG,42498,CAPIM BRANCO,3673,1272,902,6051,5149,79,125
MG,42501,VARJÃO DE MINAS,1396,1839,1215,4555,3340,44,61
MG,42510,CAPINÓPOLIS,4898,4014,1953,11134,9181,76,193
MG,42528,VERDELÂNDIA,2889,760,1274,5135,3861,41,171
MG,42536,CAPITÃO ENÉAS,5813,1575,2770,10546,7776,74,314
MG,42544,VEREDINHA,2325,612,1062,4138,3076,21,118
MG,42552,CAPITÓLIO,3116,1797,1362,6481,5119,82,124
MG,42560,VERMELHO NOVO,2046,996,538,3714,3176,52,82
MG,42579,CAPUTIRA,3436,1770,1282,6755,5473,107,160
MG,42587,TOCOS DO MOJI,1418,1208,263,2974,2711,26,59
MG,42595,CARAÍ,6838,1465,4188,13181,8993,92,598
MG,42617,CARANAÍBA,1311,946,435,2858,2423,64,102
MG,42633,CARANDAÍ,8434,5488,2134,17104,14970,447,601
MG,42650,CARANGOLA,12444,5258,5344,23856,18512,194,616
MG,42676,CARATINGA,30264,12884,12480,57538,45058,560,1350
MG,42692,CARBONITA,3058,1848,2000,7082,5082,37,139
MG,42714,CAREAÇU,1766,1691,916,4502,3586,35,94
MG,42730,CARLOS CHAGAS,7086,3766,5104,16478,11374,120,402
MG,42757,CARMÉSIA,1077,281,316,1743,1427,8,61
MG,42773,CARMO DA CACHOEIRA,4574,2006,1751,8645,6894,90,224
MG,42790,CARMO DA MATA,3750,2837,1014,7983,6969,117,265
MG,42811,CARMO DE MINAS,3139,3712,1398,8514,7116,87,178
MG,42838,CARMO DO CAJURU,7118,4410,2169,14303,12134,243,363
MG,42854,CARMO DO PARANAÍBA,6733,8833,4717,21116,16399,334,499
MG,42870,CARMO DO RIO CLARO,6628,4576,2882,14542,11660,137,319
MG,42897,CARMÓPOLIS DE MINAS,5010,3967,1868,11238,9370,119,274
MG,42919,CARRANCAS,1285,1122,487,3030,2543,29,107
MG,42935,CARVALHÓPOLIS,1045,1110,388,2617,2229,20,54
MG,42951,CARVALHOS,1366,1434,625,3608,2983,49,134
MG,42978,CASA GRANDE,945,702,342,2133,1791,61,83
MG,42994,CASCALHO RICO,853,901,432,2233,1801,8,39
MG,43010,CÁSSIA,5600,4350,2690,13082,10392,119,323
MG,43036,CONCEIÇÃO DA BARRA DE MINAS,1441,1051,676,3298,2622,30,100
MG,43052,CATAGUASES,31248,8540,8570,50247,41677,467,1422
MG,43079,CATAS ALTAS DA NORUEGA,1563,599,537,2815,2278,29,87
MG,43095,CAXAMBU,6924,6097,3731,17298,13567,153,393
MG,43117,CEDRO DO ABAETÉ,333,460,260,1096,836,11,32
MG,43133,CENTRAL DE MINAS,2667,1339,1185,5361,4176,36,134
MG,43150,CENTRALINA,3715,1708,1776,7377,5601,46,132
MG,43176,CHÁCARA,1055,502,204,1823,1619,18,44
MG,43192,CHALÉ,1926,1470,1179,4738,3559,56,107
MG,43214,CHAPADA DO NORTE,3800,1365,3903,9485,5582,51,366
MG,43230,CHIADOR,1266,696,385,2452,2067,26,79
MG,43257,CIPOTÂNEA,2443,834,1321,4859,3538,102,159
MG,43273,CLARAVAL,1052,2056,673,3870,3197,27,62
MG,43290,CLARO DOS POÇÕES,3343,1336,1708,6600,4892,47,166
MG,43311,CLÁUDIO,7560,6308,2229,16773,14544,272,404
MG,43338,COIMBRA,2819,1602,906,5578,4672,91,160
MG,43354,COLUNA,2832,1344,1978,6502,4524,61,287
MG,43370,COMENDADOR GOMES,633,1133,474,2280,1806,13,27
MG,43397,COMERCINHO,3355,1062,2036,6767,4731,55,259
MG,43419,CONCEIÇÃO DA APARECIDA,3467,2139,1579,7402,5823,84,133
MG,43435,CONCEIÇÃO DAS PEDRAS,1067,822,297,2268,1971,33,49
MG,43451,CONCEIÇÃO DAS ALAGOAS,7167,4235,3128,14848,11720,101,217
MG,43478,CONCEIÇÃO DE IPANEMA,1670,1187,629,3597,2968,21,90
MG,43494,CONCEIÇÃO DO MATO DENTRO,7359,1427,4527,13864,9337,104,447
MG,43516,CONCEIÇÃO DO PARÁ,1990,1224,617,3958,3341,51,76
MG,43532,CONCEIÇÃO DO RIO VERDE,4393,2846,1861,9391,7530,92,199
MG,43559,CONCEIÇÃO DOS OUROS,2508,3425,1103,7202,6099,57,109
MG,43575,CONGONHAL,2069,3546,740,6561,5821,89,117
MG,43591,CONGONHAS,20738,6660,4023,32868,28845,510,937
MG,43613,CONGONHAS DO NORTE,2034,266,1174,3687,2513,34,179
MG,43630,CONQUISTA,1916,1987,716,4762,4046,34,109
MG,43656,CONSELHEIRO LAFAIETE,49352,16528,10474,80086,69612,1119,2613
MG,43672,CONSELHEIRO PENA,7679,3654,3332,15127,11795,108,354
MG,43699,CONSOLAÇÃO,596,598,237,1503,1266,18,54
MG,43710,CONTAGEM,236976,73760,60166,389262,329096,5409,12951
MG,43737,COQUEIRAL,3043,2285,1553,7123,5570,61,181
MG,43753,CORAÇÃO DE JESUS,11237,2403,5303,19530,14227,156,431
MG,43770,CORDISBURGO,3373,1296,1667,6571,4904,82,153
MG,43796,CORDISLÂNDIA,1244,814,654,2791,2137,16,63
MG,43818,CORINTO,9266,3685,5399,18859,13460,147,362
MG,43834,COROACI,3444,1818,2692,8270,5578,78,238
MG,43850,COROMANDEL,8312,7742,4789,21473,16684,199,431
MG,43877,CORONEL FABRICIANO,44035,12935,14387,73207,58820,605,1245
MG,43893,CORONEL MURTA,3776,1094,2158,7277,5119,51,198
MG,43915,CORONEL PACHECO,1512,366,213,2210,1997,35,84
MG,43931,CORONEL XAVIER CHAVES,1271,746,421,2536,2115,26,72
MG,43958,CÓRREGO DANTA,964,1078,640,2752,2112,21,49
MG,43974,CÓRREGO DO BOM JESUS,1283,1390,447,3245,2798,33,92
MG,43990,CÓRREGO NOVO,1633,478,765,2962,2197,27,59
MG,44016,COUTO DE MAGALHÃES DE MINAS,2015,308,870,3305,2435,22,90
MG,44032,CRISTAIS,4043,1707,1258,7288,6030,90,190
MG,44059,CRISTÁLIA,2198,477,1208,4005,2797,25,97
MG,44075,CRISTIANO OTONI,2007,1124,556,3935,3379,81,167
MG,44091,CRISTINA,2363,3380,1667,7666,5999,60,196
MG,44113,CRUCILÂNDIA,1901,1216,758,4047,3289,64,108
MG,44130,CRUZEIRO DA FORTALEZA,1368,1106,697,3247,2550,28,48
MG,44156,CRUZÍLIA,4433,4090,1787,10672,8885,93,269
MG,44172,CURVELO,26071,11247,10875,49667,38792,496,978
MG,44199,DATAS,2364,445,1124,4079,2955,42,104
MG,44210,DELFIM MOREIRA,2300,2641,1214,6319,5105,55,109
MG,44237,DELFINÓPOLIS,2092,1584,841,4678,3837,52,109
MG,44253,DESCOBERTO,1716,1508,556,3941,3385,46,115
MG,44270,DESTERRO DE ENTRE RIOS,2315,1948,1189,5707,4518,100,155
MG,44296,DESTERRO DO MELO,1220,1078,383,2811,2428,35,95
MG,44318,DIAMANTINA,17539,5613,7741,31973,24232,275,805
MG,44334,DIOGO DE VASCONCELOS,1849,518,723,3237,2514,22,125
MG,44350,DIONÍSIO,3945,1092,2253,7513,5260,68,155
MG,44377,DIVINÉSIA,1746,672,528,3047,2519,31,70
MG,44393,DIVINO,6670,3311,3228,13614,10386,96,309
MG,44415,DIVINO DAS LARANJEIRAS,1868,953,857,3821,2964,30,113
MG,44431,DIVINOLÂNDIA DE MINAS,2364,1011,1509,5082,3573,60,138
MG,44458,DIVINÓPOLIS,79898,38307,18532,143843,125311,2239,4867
MG,44474,DIVISA NOVA,2101,1220,800,4233,3433,20,92
MG,44490,DOM CAVATI,1809,1412,591,3944,3353,29,103
MG,44512,DOM JOAQUIM,1875,489,760,3312,2552,44,144
MG,44539,DOM SILVÉRIO,2229,1176,753,4352,3599,43,151
MG,44555,DOM VIÇOSO,951,981,279,2287,2008,22,54
MG,44571,DONA EUSÉBIA,2702,1123,800,4745,3945,47,73
MG,44598,DORES DE CAMPOS,3160,2331,706,6687,5981,204,286
MG,44610,DORES DE GUANHÃES,2574,467,1039,4310,3271,32,198
MG,44636,DORES DO INDAIÁ,4044,4209,2113,10753,8640,119,268
MG,44652,DORES DO TURVO,1890,962,989,4009,3020,47,121
MG,44679,DORESÓPOLIS,586,444,318,1396,1078,21,27
MG,44695,DOURADOQUARA,875,468,284,1658,1374,14,17
MG,44717,ELÓI MENDES,7205,6435,2392,16575,14183,174,369
MG,44733,ENGENHEIRO CALDAS,3441,1559,1605,6824,5219,58,161
MG,44750,ENGENHEIRO NAVARRO,3294,686,1260,5455,4195,35,180
MG,44776,ENTRE RIOS DE MINAS,5652,2765,2234,11055,8821,141,263
MG,44792,ERVÁLIA,7600,3335,3347,14994,11647,198,514
MG,44814,ESMERALDAS,17709,5905,6365,30978,24613,341,658
MG,44830,ESPERA FELIZ,8319,3752,3608,16179,12571,117,383
MG,44857,ESPINOSA,9576,5280,8638,24211,15573,159,558
MG,44873,ESPÍRITO SANTO DO DOURADO,1597,1353,338,3453,3115,52,113
MG,44890,ESTIVA,3399,3168,1135,7928,6793,71,155
MG,44911,ESTRELA DALVA,1318,353,520,2255,1735,16,48
MG,44938,ESTRELA DO INDAIÁ,1137,922,584,2729,2145,21,65
MG,44954,ESTRELA DO SUL,2441,1498,729,4838,4109,38,132
MG,44970,EUGENÓPOLIS,4097,2047,1035,7472,6437,83,210
MG,44997,EWBANK DA CÂMARA,1994,501,578,3156,2578,26,57
MG,45012,EXTREMA,7519,6834,2971,17912,14941,190,398
MG,45039,FAMA,912,792,379,2170,1791,28,59
MG,45055,FARIA LEMOS,1664,620,573,2972,2399,29,86
MG,45071,FELÍCIO DOS SANTOS,1984,767,1427,4339,2912,32,129
MG,45098,SÃO GONÇALO DO RIO PRETO,1308,433,633,2501,1868,40,87
MG,45110,FELISBURGO,2237,928,1499,4845,3346,28,153
MG,45136,FELIXLÂNDIA,5000,2520,2578,10448,7870,148,202
MG,45152,FERNANDES TOURINHO,1107,658,493,2323,1830,17,48
MG,45179,FERROS,4695,1547,2969,9656,6687,68,377
MG,45195,FLORESTAL,2574,1167,813,4760,3947,76,130
MG,45217,FORMIGA,21413,18116,7876,49699,41823,714,1580
MG,45233,FORMOSO,1856,1330,1608,5007,3399,23,190
MG,45250,FORTALEZA DE MINAS,1162,1107,476,2904,2428,56,103
MG,45276,FORTUNA DE MINAS,1106,553,457,2193,1736,13,64
MG,45292,FRANCISCO BADARÓ,2306,2129,2722,7384,4662,53,174
MG,45314,FRANCISCO DUMONT,1427,1046,1167,3789,2622,33,116
MG,45330,FRANCISCO SÁ,10810,1927,5097,18435,13338,97,504
MG,45357,FREI GASPAR,2625,539,1140,4546,3406,39,203
MG,45373,FREI INOCÊNCIO,3602,868,1744,6415,4671,49,152
MG,45390,FRONTEIRA,4326,1956,1356,7882,6526,65,179
MG,45411,FRUTAL,12792,14664,7006,35393,28387,346,585
MG,45438,FUNILÂNDIA,1581,720,618,3028,2410,29,80
MG,45454,GALILÉIA,2764,925,1085,4923,3838,42,107
MG,45470,GONÇALVES,947,1566,608,3212,2604,23,68
MG,45497,GONZAGA,1713,1065,1606,4577,2971,44,149
MG,45519,GOUVEIA,5160,1115,2459,9106,6647,110,262
MG,45535,GOVERNADOR VALADARES,91233,45783,44001,185247,141246,1398,2832
MG,45551,GRÃO MOGOL,4917,1625,3121,10108,6987,77,368
MG,45578,GRUPIARA,536,499,280,1364,1084,18,31
MG,45594,GUANHÃES,8774,5024,6067,20906,14839,261,780
MG,45616,GUAPÉ,4203,3156,1921,9579,7658,116,183
MG,45632,GUARACIABA,3769,2041,1655,7810,6155,84,261
MG,45659,GUARANÉSIA,7435,3162,2386,13476,11090,136,357
MG,45675,GUARANI,3556,1837,1513,7206,5693,73,227
MG,45691,GUARARÁ,1536,965,588,3237,2649,26,122
MG,45713,GUARDA-MOR,1673,1694,1427,4916,3489,36,86
MG,45730,GUAXUPÉ,16694,10511,6570,35187,28617,416,996
MG,45756,GUIDOVAL,3653,1256,1109,6256,5147,81,157
MG,45772,GUIMARÂNIA,1802,2274,1139,5394,4255,64,115
MG,45799,GUIRICEMA,3816,1868,1325,7377,6052,126,242
MG,45810,GURINHATÃ,1914,2067,1783,5880,4097,30,86
MG,45837,HELIODORA,2343,1250,685,4418,3733,41,99
MG,45853,IAPU,3553,1898,1869,7579,5710,78,181
MG,45870,IBERTIOGA,2449,957,669,4229,3560,61,93
MG,45896,IBIÁ,6069,6231,3673,16469,12796,171,325
MG,45918,IBIAÍ,3121,684,1478,5410,3932,29,98
MG,45934,IBIRACI,2493,3521,990,7199,6209,62,133
MG,45950,IBIRITÉ,56042,11276,13110,83362,70252,1054,1880
MG,45977,IBITIÚRA DE MINAS,1193,1049,320,2690,2370,43,85
MG,45993,IBITURUNA,936,841,367,2186,1819,16,26
MG,46019,IGARAPÉ,11819,3792,3944,20300,16356,256,489
MG,46035,IGARATINGA,3318,1154,807,5515,4708,115,121
MG,46051,IGUATAMA,2935,2283,1520,6938,5418,70,130
MG,46078,IJACI,1646,2057,686,4573,3887,65,119
MG,46094,ILICÍNEA,3474,2858,1388,7908,6520,78,110
MG,46116,INCONFIDENTES,1966,2486,638,5235,4597,52,93
MG,46132,INDIANÓPOLIS,2032,1309,921,4387,3466,31,94
MG,46159,INGAÍ,893,728,401,2100,1699,25,53
MG,46175,INHAPIM,9099,4691,3688,18030,14342,173,379
MG,46191,INHAÚMA,2410,920,818,4293,3475,46,99
MG,46213,INIMUTABA,2801,879,1097,4904,3807,35,92
MG,46230,IPANEMA,5243,4425,3885,14030,10145,140,337
MG,46256,IPATINGA,88944,38644,31048,162969,131921,1560,2773
MG,46272,IPIAÇU,1446,1073,877,3473,2596,22,55
MG,46299,IPUIÚNA,2683,3103,1032,7019,5987,49,152
MG,46310,IRAÍ DE MINAS,2028,1654,806,4645,3839,60,97
MG,46337,ITABIRA,45499,18748,12098,79453,67355,847,2261
MG,46353,ITABIRINHA,3776,1512,1767,7345,5578,86,204
MG,46370,ITABIRITO,16083,9685,4012,31238,27226,495,963
MG,46396,ITACAMBIRA,2237,295,1301,3958,2657,21,104
MG,46418,ITACARAMBI,7349,977,3366,12133,8767,71,370
MG,46434,ITAGUARA,4338,2921,1424,9234,7810,222,329
MG,46450,ITAIPÉ,3367,1452,2247,7439,5192,61,312
MG,46477,ITAJUBÁ,23080,28250,11295,64768,53473,532,1611
MG,46493,ITAMARANDIBA,9652,5717,5348,21547,16199,235,595
MG,46515,ITAMARATI DE MINAS,1917,735,581,3345,2764,27,85
MG,46531,ITAMBACURI,8854,2301,5857,17808,11951,140,656
MG,46558,ITAMBÉ DO MATO DENTRO,1172,365,385,2034,1649,36,76
MG,46574,ITAMOGI,3644,2734,1910,8656,6746,92,276
MG,46590,ITAMONTE,4186,3710,1433,9658,8225,102,227
MG,46612,ITANHANDU,3913,4591,1661,10494,8833,96,233
MG,46639,ITANHOMI,4227,2307,1984,8878,6894,74,286
MG,46655,ITAOBIM,5556,4897,4989,16108,11119,162,504
MG,46671,ITAPAGIPE,3492,3472,1923,9117,7194,65,165
MG,46698,ITAPECERICA,6999,5535,2138,15398,13260,225,501
MG,46710,ITAPEVA,2440,2779,1340,6756,5416,63,134
MG,46736,ITATIAIUÇU,3930,1315,1223,6740,5517,115,157
MG,46752,ITAÚNA,32211,17582,7202,59642,52440,776,1871
MG,46779,ITAVERAVA,2764,1158,1037,5167,4130,71,137
MG,46795,ITINGA,5182,1560,3227,10308,7081,54,285
MG,46817,ITUETA,2000,1602,826,4554,3728,48,78
MG,46833,ITUIUTABA,31552,21751,15905,70705,54800,419,1078
MG,46850,ITUMIRIM,1824,2189,993,5217,4224,75,136
MG,46876,ITURAMA,12442,6024,4862,23772,18910,127,317
MG,46892,ITUTINGA,1347,1073,712,3250,2538,38,80
MG,46914,JABOTICATUBAS,6309,2532,2647,11957,9310,110,359
MG,46930,JACINTO,3437,2507,3358,9675,6317,81,292
MG,46957,JACUÍ,1347,3188,1053,5771,4718,60,123
MG,46973,JACUTINGA,5218,7554,3362,16637,13275,137,366
MG,46990,JAGUARAÇU,1385,436,309,2200,1891,27,43
MG,47015,JANAÚBA,25303,7051,10140,43864,33724,317,1053
MG,47031,JANUÁRIA,24438,6300,13029,45120,32091,301,1052
MG,47058,JAPARAÍBA,1135,1265,457,2938,2481,44,37
MG,47074,JECEABA,2548,1040,993,4731,3738,56,94
MG,47090,JEQUERI,5521,1721,2887,10701,7814,140,432
MG,47112,JEQUITAÍ,3369,842,2090,6529,4439,60,168
MG,47139,JEQUITIBÁ,2171,1169,946,4434,3488,44,104
MG,47155,JEQUITINHONHA,8374,2618,5309,16997,11688,112,584
MG,47171,JESUÂNIA,1885,1148,746,3893,3147,27,87
MG,47198,JOAÍMA,5387,1668,3078,10650,7572,82,435
MG,47210,JOANÉSIA,2309,750,958,4273,3315,75,181
MG,47236,JOÃO MONLEVADE,29703,12001,10447,53785,43338,562,1072
MG,47252,JOÃO PINHEIRO,13976,9696,7919,32353,24434,238,524
MG,47279,JOAQUIM FELÍCIO,1455,723,1004,3307,2303,38,87
MG,47295,JORDÂNIA,3284,1534,2476,7547,5071,33,220
MG,47317,NOVA UNIÃO,2713,833,1099,4806,3707,52,109
MG,47333,JUIZ DE FORA,204873,75988,53257,354929,301672,4423,16388
MG,47350,JURAMENTO,1983,580,572,3249,2677,27,87
MG,47376,JURUAIA,2200,2740,1040,6196,5156,75,141
MG,47392,LADAINHA,5558,1302,3537,11031,7494,82,552
MG,47414,LAGAMAR,2228,2381,1022,5773,4751,43,99
MG,47430,LAGOA DA PRATA,12634,11161,4425,29255,24830,363,672
MG,47457,LAGOA DOS PATOS,1690,730,1150,3670,2520,19,81
MG,47473,LAGOA DOURADA,3321,3254,1186,8343,7157,244,338
MG,47490,LAGOA FORMOSA,4379,5703,2963,13544,10581,251,248
MG,47511,LAGOA SANTA,16079,8736,5344,31430,26086,495,776
MG,47538,LAJINHA,5977,4092,2351,12920,10569,151,349
MG,47554,LAMBARI,6900,4690,2645,14787,12142,161,391
MG,47570,LAMIM,1686,639,557,3051,2494,59,110
MG,47597,LARANJAL,2390,1815,890,5273,4383,38,140
MG,47619,LASSANCE,2656,677,1252,4715,3463,27,103
MG,47635,LAVRAS,23984,24957,10176,62116,51940,799,2200
MG,47651,LEANDRO FERREIRA,1235,843,420,2594,2174,43,53
MG,47678,LEOPOLDINA,20131,8714,7603,37685,30082,407,830
MG,47694,LIBERDADE,1908,1415,679,4172,3493,56,114
MG,47716,LIMA DUARTE,6698,2747,2794,12784,9990,121,424
MG,47732,LUMINÁRIAS,1725,1463,612,3962,3350,50,112
MG,47759,LUZ,4162,5802,3111,13505,10394,191,239
MG,47775,MACHACALIS,2865,953,1833,5884,4051,43,190
MG,47791,MACHADO,9103,11693,4543,26298,21755,309,650
MG,47813,MADRE DE DEUS DE MINAS,1628,1363,932,4082,3150,49,110
MG,47830,MALACACHETA,7011,2348,5149,15331,10182,143,680
MG,47856,MANGA,7497,2240,4458,14655,10197,89,371
MG,47872,MANHUAÇU,24660,13462,9577,49325,39748,539,1087
MG,47899,MANHUMIRIM,6518,4854,3398,15259,11861,132,357
MG,47910,MANTENA,8498,5955,6225,21323,15098,172,473
MG,47937,MARAVILHAS,2540,1623,844,5144,4300,48,89
MG,47953,MAR DE ESPANHA,3646,2963,1632,8558,6926,70,247
MG,47970,MARIA DA FÉ,4294,4740,1770,11141,9371,100,237
MG,47996,MARIANA,21933,7684,6220,37629,31409,513,1279
MG,48011,MARILAC,1929,469,730,3266,2536,29,109
MG,48038,MARIPÁ DE MINAS,1288,785,459,2661,2202,25,104
MG,48054,MARLIÉRIA,2070,582,503,3262,2759,37,70
MG,48070,MARMELÓPOLIS,1585,532,679,2856,2177,20,40
MG,48097,MARTINHO CAMPOS,3936,2956,2101,9354,7253,141,220
MG,48119,MATERLÂNDIA,1904,571,1285,3930,2645,35,135
MG,48135,MATEUS LEME,9588,3794,3225,17497,14272,327,563
MG,48151,MATIAS BARBOSA,5703,2318,1564,9995,8431,120,290
MG,48178,MATIPÓ,5993,3162,2574,12243,9669,158,356
MG,48194,MATO VERDE,5929,1698,1762,9712,7950,64,259
MG,48216,MATOZINHOS,15020,4999,4228,25253,21025,337,669
MG,48232,MATUTINA,986,1235,613,2927,2314,27,66
MG,48259,MEDEIROS,728,1170,580,2565,1985,36,51
MG,48275,MEDINA,7322,3113,6330,17464,11134,178,521
MG,48291,MENDES PIMENTEL,2708,1025,1055,4949,3894,41,120
MG,48313,MERCÊS,4045,1873,1927,8178,6251,105,228
MG,48330,MESQUITA,2494,965,1391,5065,3674,59,156
MG,48356,MINAS NOVAS,8674,2988,8119,20642,12523,163,698
MG,48372,MINDURI,1186,1143,583,3051,2468,31,108
MG,48399,MIRABELA,5738,978,2840,9765,6925,48,161
MG,48410,MIRADOURO,4313,1940,1647,8293,6646,93,300
MG,48437,MIRAÍ,4502,2728,1693,9311,7618,108,280
MG,48453,MOEDA,1956,1037,680,3847,3167,46,128
MG,48470,MOEMA,2043,2274,1209,5666,4457,52,88
MG,48496,MONJOLOS,839,476,529,1922,1393,17,61
MG,48518,MONSENHOR PAULO,2340,2135,857,5526,4669,66,128
MG,48534,MONTALVÂNIA,5561,2538,3676,12298,8622,88,435
MG,48550,MONTE ALEGRE DE MINAS,5738,4745,3470,14428,10958,144,331
MG,48577,MONTE AZUL,9484,3587,5418,19122,13704,125,508
MG,48593,MONTE BELO,4382,3389,1799,9966,8167,162,234
MG,48615,MONTE CARMELO,16674,9226,6523,33441,26918,298,720
MG,48631,MONTE SANTO DE MINAS,5261,6679,3264,15802,12538,176,422
MG,48658,MONTES CLAROS,125158,45220,35530,214886,179356,2072,6906
MG,48674,MONTE SIÃO,2695,8883,2627,14667,12040,164,298
MG,48690,MORADA NOVA DE MINAS,2764,1756,1373,6095,4722,63,139
MG,48712,MORRO DA GARÇA,1146,613,558,2379,1821,17,45
MG,48739,MORRO DO PILAR,1574,481,483,2677,2194,25,114
MG,48755,MUNHOZ,2060,2091,1049,5375,4326,46,129
MG,48771,MURIAÉ,37391,16902,13731,70471,56740,617,1830
MG,48798,MUTUM,8837,6368,5226,21241,16015,241,569
MG,48810,MUZAMBINHO,6063,6325,3135,16071,12936,207,341
MG,48836,NACIP RAYDAN,947,493,599,2136,1537,11,86
MG,48852,NANUQUE,13819,7409,9337,31465,22128,257,643
MG,48879,NATÉRCIA,1102,1962,632,3871,3239,65,110
MG,48895,NAZARENO,3153,1353,1239,5946,4707,78,123
MG,48917,NEPOMUCENO,8823,5886,3502,18903,15401,245,447
MG,48933,NOVA ERA,8487,2169,3033,14148,11115,131,328
MG,48950,NOVA LIMA,30989,11242,6646,51153,44507,640,1636
MG,48976,NOVA MÓDICA,1756,465,839,3178,2339,23,95
MG,48992,NOVA PONTE,4069,2429,1535,8202,6667,50,119
MG,49018,NOVA RESENDE,4683,3589,1484,10199,8715,184,259
MG,49034,NOVA SERRANA,10757,14991,5165,32093,26928,554,626
MG,49050,NOVO CRUZEIRO,9374,2454,8096,20913,12817,156,833
MG,49077,OLARIA,1117,512,352,2054,1702,16,57
MG,49093,OLÍMPIO NORONHA,1065,674,292,2102,1810,19,52
MG,49115,OLIVEIRA,12923,9854,4758,28798,24040,404,859
MG,49131,OLIVEIRA FORTES,1091,273,207,1687,1480,36,80
MG,49158,ONÇA DE PITANGUI,1112,892,548,2617,2069,20,45
MG,49174,OURO BRANCO,13729,5452,3892,23978,20086,283,622
MG,49190,OURO FINO,6302,11807,3956,22752,18796,236,451
MG,49212,OURO PRETO,30831,10550,8602,52441,43839,695,1763
MG,49239,OURO VERDE DE MINAS,2540,1054,1239,5110,3871,43,234
MG,49255,PADRE PARAÍSO,6148,2868,4442,14017,9575,104,455
MG,49271,PAINEIRAS,1876,1165,982,4139,3157,34,82
MG,49298,PAINS,2148,2940,778,6019,5241,62,91
MG,49310,PAIVA,913,214,199,1396,1197,22,48
MG,49336,PALMA,2670,1250,892,4989,4097,56,121
MG,49352,FRONTEIRA DOS VALES,1876,736,1458,4206,2748,23,113
MG,49379,PAPAGAIOS,5649,2360,1486,9764,8278,82,187
MG,49395,PARACATU,21135,21186,10118,53837,43719,455,943
MG,49417,PARÁ DE MINAS,24462,19570,7219,54135,46916,975,1909
MG,49433,PARAGUAÇU,6282,5849,2380,14924,12544,139,274
MG,49450,PARAISÓPOLIS,4409,7143,2346,14342,11996,137,307
MG,49476,PARAOPEBA,8820,3679,2641,15698,13057,190,368
MG,49492,PASSABÉM,803,340,284,1505,1221,14,64
MG,49514,PASSA QUATRO,5665,3865,1879,11784,9905,103,272
MG,49530,PASSA TEMPO,3183,1684,1580,6814,5234,121,246
MG,49557,PASSA VINTE,795,621,237,1746,1509,20,73
MG,49573,PASSOS,37913,19301,12422,71791,59369,781,1374
MG,49590,PATOS DE MINAS,33635,40082,18481,95320,76839,1203,1919
MG,49611,PATROCÍNIO,22915,19292,10329,54733,44404,712,1485
MG,49638,PATROCÍNIO DO MURIAÉ,1855,1390,698,4095,3397,31,121
MG,49654,PAULA CÂNDIDO,3850,1296,1530,6950,5420,67,207
MG,49670,PAULISTAS,1876,791,877,3746,2869,36,166
MG,49697,PAVÃO,2943,1384,1352,5946,4594,52,215
MG,49719,PEÇANHA,5009,2758,4431,12722,8291,124,400
MG,49735,PEDRA AZUL,8987,2955,5713,18413,12700,123,635
MG,49751,PEDRA DO ANTA,1900,517,734,3331,2597,51,129
MG,49778,PEDRA DO INDAIÁ,1238,1351,410,3141,2731,49,93
MG,49794,PEDRA DOURADA,987,363,278,1667,1389,6,33
MG,49816,PEDRALVA,3128,3819,1644,8851,7207,84,176
MG,49832,PEDRINÓPOLIS,993,1170,474,2716,2242,28,51
MG,49859,PEDRO LEOPOLDO,22661,10009,5320,39855,34535,604,1261
MG,49875,PEDRO TEIXEIRA,928,417,267,1675,1408,20,43
MG,49891,PEQUERI,1155,862,497,2612,2115,22,76
MG,49913,PEQUI,1487,928,431,2959,2528,39,74
MG,49930,PERDIGÃO,1613,2561,795,5197,4402,82,146
MG,49956,PERDIZES,2646,4206,2577,9682,7105,73,180
MG,49972,PERDÕES,7444,4227,2400,14751,12351,220,460
MG,49999,PESCADOR,1773,485,782,3141,2359,23,78
MG,50016,PIAU,1463,676,426,2685,2259,42,78
MG,50032,PIEDADE DE PONTE NOVA,2019,481,493,3132,2639,32,107
MG,50059,PIEDADE DO RIO GRANDE,1777,1042,924,3986,3062,54,189
MG,50075,PIEDADE DOS GERAIS,1652,1235,624,3699,3075,93,95
MG,50091,PIMENTA,2391,2207,1039,5954,4915,143,174
MG,50113,PIRACEMA,2906,1297,572,5126,4554,131,220
MG,50130,PIRAJUBA,1228,906,635,2833,2198,24,40
MG,50156,PIRANGA,6090,2758,3794,13213,9419,129,442
MG,50172,PIRANGUÇU,1398,1856,761,4116,3355,31,70
MG,50199,PIRANGUINHO,2534,2260,899,5859,4960,37,129
MG,50210,PIRAPETINGA,5532,1551,1497,8948,7451,123,245
MG,50237,PIRAPORA,18152,7824,8605,35941,27336,410,950
MG,50253,PIRAÚBA,4364,2178,1604,8451,6847,96,209
MG,50270,PITANGUI,8422,6081,3157,18288,15131,213,415
MG,50296,PIUMHI,10159,7149,4307,22577,18270,382,580
MG,50318,PLANURA,3314,1932,1599,6989,5390,48,96
MG,50334,POÇO FUNDO,4476,5006,1918,11802,9884,169,233
MG,50350,POÇOS DE CALDAS,38773,41301,17138,100865,83727,959,2694
MG,50377,POCRANE,3240,2098,1436,7006,5570,54,178
MG,50393,POMPÉU,9453,5510,3884,19663,15779,280,536
MG,50415,PONTE NOVA,24235,7867,9477,42979,33502,461,939
MG,50431,PORTEIRINHA,15033,4860,7870,28818,20948,242,813
MG,50458,PORTO FIRME,3575,1384,1325,6583,5258,103,196
MG,50474,POTÉ,5378,2227,3262,11418,8156,82,469
MG,50490,POUSO ALEGRE,36855,29667,12824,82301,69477,819,2136
MG,50512,POUSO ALTO,1697,2338,898,5091,4193,41,117
MG,50539,PRADOS,2703,2237,800,6141,5341,137,264
MG,50555,PRATA,8102,5895,4517,18986,14469,136,336
MG,50571,PRATÁPOLIS,2892,2544,1056,6821,5765,96,233
MG,50598,PRATINHA,624,1273,493,2483,1990,36,57
MG,50610,PRESIDENTE BERNARDES,2283,1212,1121,4793,3672,47,130
MG,50636,PRESIDENTE JUSCELINO,2080,453,1122,3778,2656,25,98
MG,50652,PRESIDENTE KUBITSCHEK,1428,363,577,2449,1872,10,71
MG,50679,PRESIDENTE OLEGÁRIO,5300,5504,3263,14540,11277,114,359
MG,50695,ALTO JEQUITIBÁ,2185,2654,1304,6347,5043,40,164
MG,50717,PRUDENTE DE MORAIS,3257,1958,1093,6620,5527,115,197
MG,50733,QUARTEL GERAL,1077,936,519,2639,2120,30,77
MG,50750,QUELUZITO,1110,481,308,1981,1673,27,55
MG,50776,RAPOSOS,8262,1361,1460,11509,10049,131,295
MG,50792,RAUL SOARES,9260,3816,5333,19147,13814,230,508
MG,50814,RECREIO,3872,1828,1027,6992,5965,69,196
MG,50830,RESENDE COSTA,3548,2723,1416,8029,6613,125,217
MG,50857,RESPLENDOR,5578,3676,2305,11856,9551,91,206
MG,50873,RESSAQUINHA,2167,1030,438,3773,3335,41,97
MG,50890,RIACHO DOS MACHADOS,3931,626,2007,6835,4828,39,232
MG,50911,RIBEIRÃO DAS NEVES,95816,22216,26564,149990,123426,1854,3540
MG,50938,RIBEIRÃO VERMELHO,1661,778,475,3083,2608,40,129
MG,50954,RIO ACIMA,3724,1558,1025,6548,5523,104,137
MG,50970,RIO CASCA,6228,2130,2242,11069,8827,138,331
MG,50997,RIO DOCE,1098,493,319,1969,1650,10,49
MG,51012,RIO DO PRADO,2326,523,1297,4327,3030,30,151
MG,51039,RIO ESPERA,2012,1658,1590,5553,3963,102,191
MG,51055,RIO MANSO,1903,952,504,3494,2990,53,82
MG,51071,RIO NOVO,3434,1969,1476,7168,5692,99,190
MG,51098,RIO PARANAÍBA,2901,3257,1832,8331,6499,145,196
MG,51110,RIO PARDO DE MINAS,10526,2738,4243,18428,14185,168,753
MG,51136,RIO PIRACICABA,6772,1864,2423,11467,9044,124,284
MG,51152,RIO POMBA,6269,3526,2643,13078,10435,201,439
MG,51179,RIO PRETO,2336,1316,776,4602,3826,40,134
MG,51195,RIO VERMELHO,4884,1616,3970,10962,6992,89,403
MG,51217,RITÁPOLIS,1739,1431,646,4017,3371,65,136
MG,51233,ROCHEDO DE MINAS,970,502,256,1792,1536,10,54
MG,51250,RODEIRO,2900,957,612,4615,4003,53,93
MG,51276,ROMARIA,1425,813,692,3012,2320,28,54
MG,51292,RUBELITA,3268,1063,2609,7206,4597,41,225
MG,51314,RUBIM,2479,2226,2729,7741,5012,50,257
MG,51330,SABARÁ,47081,14270,11440,76523,65083,1355,2377
MG,51357,SABINÓPOLIS,5877,1654,3529,11666,8137,131,475
MG,51373,SACRAMENTO,4937,8227,3411,17015,13604,96,344
MG,51390,SALINAS,13456,6188,7113,27668,20555,207,704
MG,51411,SALTO DA DIVISA,2151,1027,1832,5189,3357,11,168
MG,51438,SANTA BÁRBARA,12725,2783,3376,19520,16144,218,418
MG,51454,SANTA BÁRBARA DO TUGÚRIO,2003,1101,532,3825,3293,52,137
MG,51470,SANTA CRUZ DO ESCALVADO,2603,518,864,4151,3287,39,127
MG,51497,SANTA EFIGÊNIA DE MINAS,1640,670,1262,3784,2522,64,148
MG,51519,SANTA FÉ DE MINAS,1659,369,1178,3265,2087,14,45
MG,51535,SANTA JULIANA,2664,2784,1264,6899,5635,87,100
MG,51551,SANTA LUZIA,78644,24308,22254,130422,108168,1857,3359
MG,51578,SANTA MARGARIDA,5363,3064,1806,10646,8840,120,293
MG,51594,SANTA MARIA DE ITABIRA,4040,1681,1651,7683,6032,65,246
MG,51616,SANTA MARIA DO SALTO,2224,736,1106,4203,3097,25,112
MG,51632,SANTA MARIA DO SUAÇUÍ,5146,1817,4255,11663,7408,52,393
MG,51659,SANTANA DA VARGEM,3349,1439,1159,6110,4951,63,100
MG,51675,SANTANA DE CATAGUASES,1269,1092,321,2777,2456,27,68
MG,51691,SANTANA DE PIRAPAMA,3714,1098,1579,6632,5053,70,171
MG,51713,SANTANA DO DESERTO,1754,644,448,2967,2519,33,88
MG,51730,SANTANA DO GARAMBÉU,858,596,291,1826,1535,23,58
MG,51756,SANTANA DO JACARÉ,2072,628,620,3479,2859,44,115
MG,51772,SANTANA DO MANHUAÇU,2965,1576,1723,6456,4733,62,130
MG,51799,SANTANA DO RIACHO,1847,615,902,3529,2627,44,121
MG,51810,SANTANA DOS MONTES,1316,1214,554,3255,2701,76,95
MG,51837,SANTA RITA DE CALDAS,2912,2836,1131,7083,5952,48,156
MG,51853,SANTA RITA DE JACUTINGA,1859,1468,646,4167,3521,55,139
MG,51870,SANTA RITA DO IBITIPOCA,1485,769,642,3006,2364,29,81
MG,51896,SANTA RITA DO ITUETO,2031,1360,1330,4824,3494,29,74
MG,51918,SANTA RITA DO SAPUCAÍ,7744,13015,3995,25588,21593,220,614
MG,51934,SANTA ROSA DA SERRA,1149,702,528,2477,1949,41,57
MG,51950,SANTA VITÓRIA,6589,3352,2406,12669,10263,91,231
MG,51977,SANTO ANTÔNIO DO AMPARO,7488,2075,1968,11931,9963,131,269
MG,51993,SANTO ANTÔNIO DO AVENTUREIRO,1382,1019,479,3026,2547,53,93
MG,52019,SANTO ANTÔNIO DO GRAMA,1730,782,906,3573,2667,47,108
MG,52035,SANTO ANTÔNIO DO ITAMBÉ,1674,379,1169,3395,2226,33,140
MG,52051,SANTO ANTÔNIO DO JACINTO,4003,2160,3647,10260,6613,61,389
MG,52078,SANTO ANTÔNIO DO MONTE,5757,7383,2633,16451,13818,275,403
MG,52094,SANTO ANTÔNIO DO RIO ABAIXO,860,204,466,1599,1133,23,46
MG,52116,SANTO HIPÓLITO,1572,333,966,2981,2015,19,91
MG,52132,SANTOS DUMONT,23708,5930,6213,37077,30864,358,868
MG,52159,SÃO BENTO ABADE,1134,1430,572,3235,2663,34,65
MG,52175,SÃO BRÁS DO SUAÇUÍ,1461,695,337,2595,2258,35,67
MG,52191,SÃO DOMINGOS DO PRATA,7993,2431,3285,14235,10950,109,417
MG,52213,SÃO FRANCISCO,18944,4356,10052,34420,24368,196,872
MG,52230,SÃO FRANCISCO DE PAULA,2416,1706,1029,5340,4311,47,142
MG,52256,SÃO FRANCISCO DE SALES,2234,1069,1054,4473,3419,32,84
MG,52272,SÃO FRANCISCO DO GLÓRIA,2412,776,930,4276,3346,28,130
MG,52299,SÃO GERALDO,3297,1250,1049,5866,4817,74,196
MG,52310,SÃO GERALDO DA PIEDADE,1823,547,831,3359,2528,35,123
MG,52337,SÃO GONÇALO DO ABAETÉ,1757,1217,1184,4246,3062,28,60
MG,52353,SÃO GONÇALO DO PARÁ,3061,2206,1022,6581,5559,104,188
MG,52370,SÃO GONÇALO DO RIO ABAIXO,4397,1118,1215,7036,5821,98,208
MG,52396,SÃO GONÇALO DO SAPUCAÍ,7488,6011,3216,17210,13994,135,360
MG,52418,SÃO GOTARDO,4225,11749,5194,21878,16684,287,423
MG,52434,SÃO JOÃO BATISTA DO GLÓRIA,2647,1416,863,5108,4245,73,109
MG,52450,SÃO JOÃO DA MATA,896,1061,349,2384,2035,38,40
MG,52477,SÃO JOÃO DA PONTE,9798,2893,6673,20096,13423,101,631
MG,52493,SÃO JOÃO DEL REI,29648,19694,10479,62955,52476,912,2222
MG,52515,SÃO JOÃO DO ORIENTE,3479,1403,1857,6971,5114,67,165
MG,52531,SÃO JOÃO DO PARAÍSO,5414,5292,4136,15711,11575,205,664
MG,52558,SÃO JOÃO EVANGELISTA,5733,2180,4207,12580,8373,100,360
MG,52574,SÃO JOÃO NEPOMUCENO,9642,5082,3361,18832,15471,195,552
MG,52590,SÃO JOSÉ DA SAFIRA,1602,450,1020,3169,2149,16,81
MG,52612,SÃO JOSÉ DA VARGINHA,1250,945,508,2825,2317,48,74
MG,52639,SÃO JOSÉ DO ALEGRE,1070,1452,546,3174,2628,39,67
MG,52655,SÃO JOSÉ DO DIVINO,1593,575,653,2918,2265,23,74
MG,52671,SÃO JOSÉ DO GOIABAL,2612,867,790,4494,3704,58,167
MG,52698,SÃO JOSÉ DO JACURI,2303,856,1664,5036,3372,36,177
MG,52710,SÃO JOSÉ DO MANTIMENTO,879,750,422,2155,1733,38,66
MG,52736,SÃO LOURENÇO,8060,14944,5354,29486,24132,311,817
MG,52752,SÃO MIGUEL DO ANTA,2968,1188,675,5076,4401,87,158
MG,52779,SÃO PEDRO DA UNIÃO,1340,1681,886,4127,3241,112,108
MG,52795,SÃO PEDRO DOS FERROS,3805,1132,1317,6501,5184,48,199
MG,52817,SÃO PEDRO DO SUAÇUÍ,2107,734,847,3923,3076,36,199
MG,52833,SÃO ROMÃO,3300,566,2107,6137,4030,29,135
MG,52850,SÃO ROQUE DE MINAS,1366,2424,1023,4998,3975,72,113
MG,52876,SÃO SEBASTIÃO DA BELA VISTA,1721,1086,469,3374,2905,35,63
MG,52892,SÃO SEBASTIÃO DO MARANHÃO,3314,1523,3198,8405,5207,75,295
MG,52914,SÃO SEBASTIÃO DO OESTE,1959,1124,425,3656,3231,41,107
MG,52930,SÃO SEBASTIÃO DO PARAÍSO,18608,15326,7725,43237,35512,463,1115
MG,52957,SÃO SEBASTIÃO DO RIO PRETO,660,303,305,1360,1055,17,75
MG,52973,SÃO SEBASTIÃO DO RIO VERDE,772,712,221,1775,1554,27,43
MG,52990,SÃO TIAGO,3256,2783,1476,7898,6422,143,240
MG,53015,SÃO TOMÁS DE AQUINO,1854,2147,1123,5295,4172,42,129
MG,53031,SÃO THOMÉ DAS LETRAS,2047,1670,1047,4944,3897,58,122
MG,53058,SÃO VICENTE DE MINAS,1996,1966,1342,5474,4132,42,128
MG,53074,SAPUCAÍ MIRIM,1775,1597,753,4223,3470,32,66
MG,53090,SARDOÁ,1745,813,1146,3878,2732,38,136
MG,53112,SENADOR CORTES,1002,445,418,1935,1517,17,53
MG,53139,SENADOR FIRMINO,3502,1201,1299,6233,4934,47,184
MG,53155,SENADOR JOSÉ BENTO,652,742,346,1805,1459,25,40
MG,53171,SENADOR MODESTINO GONÇALVES,2006,766,1200,4131,2931,29,130
MG,53198,SENHORA DE OLIVEIRA,2729,740,1033,4722,3689,73,147
MG,53210,SENHORA DO PORTO,1350,721,1260,3535,2275,39,165
MG,53236,SENHORA DOS REMÉDIOS,3559,2105,1800,7758,5958,69,225
MG,53252,SERICITA,2751,1551,948,5502,4554,63,189
MG,53279,SERITINGA,730,444,318,1587,1269,23,72
MG,53295,SERRA AZUL DE MINAS,1535,554,1057,3340,2283,23,171
MG,53317,SERRA DA SAUDADE,310,329,276,935,659,3,17
MG,53333,SERRA DOS AIMORÉS,2982,810,960,4898,3938,28,118
MG,53350,SERRA DO SALITRE,2697,2620,1597,7065,5468,59,92
MG,53376,SERRANIA,2571,1668,1186,5566,4380,43,98
MG,53392,SERRANOS,803,622,384,1885,1501,15,61
MG,53414,SERRO,7770,1788,4400,14616,10216,113,545
MG,53430,SETE LAGOAS,77177,34331,20218,138200,117982,2095,4379
MG,53457,SILVEIRÂNIA,1191,425,303,1989,1686,14,56
MG,53473,SILVIANÓPOLIS,1525,2120,990,4820,3830,45,140
MG,53490,SIMÃO PEREIRA,1260,607,487,2433,1946,20,59
MG,53511,SIMONÉSIA,5458,4073,2836,12831,9995,145,319
MG,53538,SOBRÁLIA,2236,892,923,4198,3275,35,112
MG,53554,SOLEDADE DE MINAS,1692,1735,694,4245,3551,39,85
MG,53570,TABULEIRO,1589,1217,743,3696,2953,45,102
MG,53597,TAIOBEIRAS,9077,6885,5892,22694,16802,167,673
MG,53619,TAPIRA,866,1582,641,3182,2541,30,63
MG,53635,TAPIRAÍ,759,639,556,2012,1456,23,35
MG,53651,TAQUARAÇU DE MINAS,1628,886,625,3236,2611,35,62
MG,53678,TARUMIRIM,4655,3230,3160,11375,8215,95,235
MG,53694,TEIXEIRAS,4737,2297,1458,8964,7506,145,327
MG,53716,TEÓFILO OTONI,48981,20275,26917,99603,72686,928,2502
MG,53732,TIMÓTEO,32848,11477,9359,55222,45863,521,1017
MG,53759,TIRADENTES,2055,2090,916,5333,4417,91,181
MG,53775,TIROS,1322,2543,2060,6112,4052,73,114
MG,53791,TOCANTINS,5859,3801,1816,11955,10139,164,315
MG,53813,TOLEDO,1579,1674,781,4145,3364,33,78
MG,53830,TOMBOS,2773,2582,1634,7213,5579,43,181
MG,53856,TRÊS CORAÇÕES,20462,19071,7978,49427,41449,608,1308
MG,53872,TRÊS PONTAS,18250,11763,6511,37769,31258,481,764
MG,53899,TUMIRITINGA,2238,814,1096,4256,3160,26,82
MG,53910,TUPACIGUARA,8753,5712,3573,18538,14965,162,338
MG,53937,TURMALINA,6486,2119,3248,12262,9014,119,290
MG,53953,TURVOLÂNDIA,1157,1456,639,3405,2766,51,102
MG,53970,UBÁ,39805,10211,9027,61222,52195,646,1533
MG,53996,UBAÍ,4241,1360,2833,8690,5857,40,216
MG,54011,UBERABA,91708,64805,34588,198520,163932,1730,5689
MG,54038,UBERLÂNDIA,193546,103851,58513,373744,315231,3966,13868
MG,54054,UMBURATIBA,1182,378,456,2108,1652,21,71
MG,54070,UNAÍ,17224,21806,12542,52858,40316,415,871
MG,54097,URUCÂNIA,4295,1554,1750,7906,6156,75,232
MG,54119,VARGEM BONITA,955,546,490,2055,1565,26,38
MG,54135,VARGINHA,35114,33856,11575,83598,72023,973,2080
MG,54151,VÁRZEA DA PALMA,13547,4873,6005,25186,19181,226,535
MG,54178,VARZELÂNDIA,5416,3282,4044,13311,9267,96,473
MG,54194,VAZANTE,7542,3678,4012,15684,11672,184,268
MG,54216,WENCESLAU BRAZ,999,786,292,2159,1867,23,59
MG,54232,VERÍSSIMO,964,852,504,2377,1873,17,40
MG,54259,VESPASIANO,35609,9390,10291,57328,47037,717,1321
MG,54275,VIÇOSA,27793,10944,8383,49231,40848,700,1411
MG,54291,VIEIRAS,1852,653,512,3134,2622,25,92
MG,54313,MATHIAS LOBATO,1528,469,575,2663,2088,15,76
MG,54330,VIRGEM DA LAPA,4570,1540,3413,9920,6507,56,341
MG,54356,VIRGÍNIA,3132,2004,1307,6620,5313,31,146
MG,54372,VIRGINÓPOLIS,3668,1738,2670,8405,5735,90,239
MG,54399,VIRGOLÂNDIA,2472,513,1538,4682,3144,40,119
MG,54410,VISCONDE DO RIO BRANCO,14764,6936,3861,26682,22821,417,704
MG,54437,VOLTA GRANDE,2089,751,973,3974,3001,40,121
MG,54453,ITAÚ DE MINAS,4362,4529,2088,11524,9436,186,359
MS,55000,NOVA ALVORADA DO SUL,3151,3184,1913,8385,6472,29,108
MS,55018,ALCINÓPOLIS,579,1692,671,2987,2316,7,38
MS,55026,LAGUNA CARAPÃ,1260,1648,720,3699,2979,10,61
MS,55034,JAPORÃ,1694,1372,1289,4482,3193,27,100
MS,55042,NOVO HORIZONTE DO SUL,1298,1571,1332,4311,2979,15,95
MS,55069,FIGUEIRÃO,429,888,419,1775,1356,7,32
MS,90034,ÁGUA CLARA,2816,3060,2831,8835,6004,39,89
MS,90115,AMAMBAÍ,7419,8075,5271,21232,15961,107,360
MS,90131,ANASTÁCIO,6801,5352,4403,16890,12487,86,248
MS,90158,ANAURILÂNDIA,1722,2708,1504,6045,4541,27,84
MS,90174,ANTÔNIO JOÃO,2096,2308,1259,5829,4570,39,127
MS,90190,APARECIDA DO TABOADO,4917,5945,3017,14253,11236,89,285
MS,90212,AQUIDAUANA,12270,10254,9165,32245,23080,155,401
MS,90298,BANDEIRANTES,1458,1997,858,4423,3565,16,94
MS,90379,BATAGUASSU,4905,5016,2914,13106,10192,78,193
MS,90395,BATAIPORÃ,2817,3026,1933,7970,6037,39,155
MS,90417,BELA VISTA,5141,5823,3984,15164,11180,58,158
MS,90433,BONITO,4792,5103,3729,13843,10114,56,163
MS,90450,BRASILÂNDIA,2861,3227,2774,9076,6302,45,169
MS,90492,CAMAPUÃ,3053,5195,2914,11363,8449,40,161
MS,90514,CAMPO GRANDE,163408,233149,87509,496172,408663,3110,8996
MS,90530,CARACOL,1296,1461,811,3607,2796,12,27
MS,90557,CAARAPÓ,5796,5683,2478,14352,11874,108,287
MS,90573,CASSILÂNDIA,3698,8153,3903,16206,12303,105,347
MS,90611,CORGUINHO,844,1239,694,2832,2138,21,34
MS,90638,CORUMBÁ,31033,16323,14783,63241,48458,295,807
MS,90654,COXIM,7030,10152,6288,23871,17583,84,317
MS,90735,DOURADOS,39241,62754,25061,129683,104622,665,1962
MS,90751,FÁTIMA DO SUL,4414,7291,2724,14760,12036,99,232
MS,90794,GLÓRIA DE DOURADOS,2040,3408,1027,6640,5613,51,114
MS,90816,GUIA LOPES DA LAGUNA,2347,3022,2030,7562,5532,37,126
MS,90859,IGUATEMI,2492,4407,2536,9600,7064,39,126
MS,90875,INOCÊNCIA,1315,2737,1837,6012,4175,18,105
MS,90891,ITAPORÃ,3647,5572,2379,11816,9437,74,144
MS,90930,IVINHEMA,4852,7198,3955,16408,12453,148,255
MS,90972,JARAGUARI,1237,1713,1220,4261,3041,18,73
MS,90999,JARDIM,5952,6795,4302,17393,13091,89,255
MS,91014,JATEÍ,977,1462,963,3451,2488,8,41
MS,91030,LADÁRIO,5058,2435,2230,9926,7696,46,157
MS,91073,MARACAJU,8447,7968,4549,21333,16784,100,269
MS,91111,MIRANDA,7022,5436,4318,17108,12790,66,266
MS,91138,NAVIRAÍ,11443,12132,6641,30885,24244,203,466
MS,91154,NIOAQUE,3339,3560,2762,9822,7060,44,117
MS,91235,NOVA ANDRADINA,9105,11879,6568,28061,21493,159,350
MS,91251,PARANAÍBA,7005,14207,6913,28762,21849,179,458
MS,91278,PEDRO GOMES,1655,2952,1697,6456,4759,36,116
MS,91316,PONTA PORÃ,18301,18013,12096,49303,37207,263,630
MS,91375,PORTO MURTINHO,2791,2585,1916,7398,5482,18,88
MS,91413,RIBAS DO RIO PARDO,3436,3826,2111,9583,7472,57,153
MS,91430,RIO BRILHANTE,6325,6668,3099,16381,13282,66,223
MS,91456,RIO NEGRO,1285,1636,665,3663,2998,14,63
MS,91472,RIO VERDE DE MATO GROSSO,3643,5838,3581,13300,9719,47,191
MS,91499,ROCHEDO,726,1735,1122,3655,2533,22,50
MS,91570,SIDROLÂNDIA,8176,7210,4036,19762,15726,91,249
MS,91596,TERENOS,2921,3944,2045,9074,7029,38,126
MS,91650,TRÊS LAGOAS,25160,19178,12505,58479,45974,421,1215
MS,91693,ANGÉLICA,2014,2227,1401,5772,4371,38,92
MS,91715,ARAL MOREIRA,2126,1934,1231,5427,4196,23,113
MS,91731,ELDORADO,2718,3582,2051,8543,6492,52,140
MS,91758,DEODÁPOLIS,2285,3916,1139,7535,6396,69,126
MS,91782,CHAPADÃO DO SUL,2774,4827,2233,9991,7758,52,105
MS,91790,MUNDO NOVO,3447,4864,1739,10308,8569,65,193
MS,91804,DOIS IRMÃOS DO BURITI,2754,2108,2134,7131,4997,28,107
MS,91820,JUTI,1475,1640,1105,4338,3233,15,103
MS,91847,PARANHOS,2555,1975,1739,6482,4743,27,186
MS,91863,SANTA RITA DO PARDO,1527,1752,1103,4472,3369,18,72
MS,91880,SONORA,3655,2895,2567,9282,6715,41,124
MS,91901,VICENTINA,1533,2056,872,4552,3680,22,69
MS,98019,BODOQUENA,2344,2150,1919,6542,4623,38,91
MS,98035,COSTA RICA,3691,6251,3464,13685,10221,66,213
MS,98051,DOURADINA,1318,1740,738,3899,3161,17,86
MS,98078,ITAQUIRAÍ,3847,4364,3118,11544,8426,60,155
MS,98094,SÃO GABRIEL DO OESTE,4274,6880,3321,14715,11394,77,163
MS,98116,SELVÍRIA,2037,1285,1059,4480,3421,21,78
MS,98132,SETE QUEDAS,2941,3053,1429,7645,6216,60,162
MS,98159,TACURU,2623,1432,1496,5671,4175,19,101
MS,98175,TAQUARUSSU,897,1236,673,2871,2198,19,46
MS,98590,CORONEL SAPUCAIA,4195,2159,3006,9565,6559,30,175
MT,89788,COLNIZA,6384,5085,4895,16761,11866,124,273
MT,89796,COLÍDER,3535,11850,5147,20962,15815,137,293
MT,89800,CURVELÂNDIA,1337,1553,1034,4008,2974,22,62
MT,89818,NOVA BRASILÂNDIA,906,1790,816,3610,2794,17,81
MT,89826,NOVA SANTA HELENA,812,1023,825,2717,1892,15,42
MT,89834,PARANATINGA,2970,5939,3626,12828,9202,58,235
MT,89843,SANTO ANTÔNIO DO LESTE,540,798,875,2248,1373,10,25
MT,89850,SINOP,17640,32016,15576,66421,50845,416,773
MT,89877,ALTA FLORESTA,10259,16455,7672,34990,27318,155,449
MT,89893,ARAPUTANGA,4362,3892,2083,10603,8520,63,203
MT,89915,JAURU,2525,2830,2826,8405,5579,43,181
MT,89931,SÃO JOSÉ DOS QUATRO MARCOS,6049,3916,3884,14176,10292,118,209
MT,89958,RIO BRANCO,1640,1275,1178,4205,3027,29,83
MT,89960,RONDOLÂNDIA,1136,563,694,2423,1729,7,23
MT,89974,SALTO DO CÉU,972,1161,1004,3217,2213,26,54
MT,89990,PONTES E LACERDA,8488,10791,8225,28131,19906,200,427
MT,90018,ACORIZAL,2651,1010,1695,5445,3750,15,74
MT,90026,SÃO JOSÉ DO POVO,1109,1102,562,2838,2276,23,42
MT,90042,ALTO BOA VISTA,540,1654,1010,3265,2255,18,43
MT,90050,ALTO ARAGUAIA,3478,3961,2812,10448,7636,50,147
MT,90069,QUERÊNCIA,1950,2845,2016,6940,4924,37,92
MT,90077,ALTO GARÇAS,1811,3210,1625,6837,5212,48,143
MT,90085,CANABRAVA DO NORTE,682,1713,1119,3595,2476,15,66
MT,90093,ALTO PARAGUAI,2260,1781,1972,6160,4188,33,114
MT,90107,SANTA CARMEM,671,1405,821,2952,2131,22,33
MT,90123,NOVA MARINGÁ,878,1564,1312,3803,2491,10,39
MT,90140,NOVA GUARITA,1414,1227,739,3466,2727,33,53
MT,90166,NOVA MARILÂNDIA,593,736,594,1950,1356,8,19
MT,90182,PORTO ESTRELA,1422,733,1126,3376,2250,13,82
MT,90204,GLÓRIA D'OESTE,871,876,523,2328,1805,17,41
MT,90220,TABAPORÃ,1470,2559,1735,5881,4146,31,86
MT,90239,ARAGUAINHA,454,253,233,976,743,12,24
MT,90247,SÃO JOSÉ DO XINGU,776,1607,1437,3907,2470,10,77
MT,90255,ARENÁPOLIS,2365,2792,2238,7556,5318,39,122
MT,90263,APIACÁS,1522,2405,1507,5575,4068,34,107
MT,90271,ARIPUANÃ,3007,5041,3435,11701,8266,64,154
MT,90280,CONFRESA,3706,5333,4149,13492,9343,86,218
MT,90301,LAMBARI D'OESTE,1256,1469,1313,4141,2828,29,74
MT,90310,BARÃO DE MELGAÇO,2560,966,2024,5653,3629,23,80
MT,90328,SANTO AFONSO,718,784,801,2347,1546,8,36
MT,90336,BARRA DO BUGRES,8806,6266,5639,21183,15544,129,343
MT,90344,PLANALTO DA SERRA,711,820,462,2041,1579,8,40
MT,90352,BARRA DO GARÇAS,15243,13267,10546,39887,29341,230,601
MT,90360,NOVA MONTE VERDE,1635,2366,1228,5348,4120,37,82
MT,90387,NOVA BANDEIRANTE,2162,3513,1920,7804,5884,77,132
MT,90409,SÃO PEDRO DA CIPA,1352,1142,661,3231,2570,21,55
MT,90425,COTRIGUAÇU,3288,3115,2169,8811,6642,67,172
MT,90441,RIBEIRÃOZINHO,648,593,493,1762,1269,5,23
MT,90468,BRASNORTE,2392,3632,2374,8603,6229,53,152
MT,90476,CÁCERES,25947,15879,14273,57087,42814,233,755
MT,90484,CAMPO NOVO DO PARECIS,4922,6175,5080,16427,11347,82,168
MT,90506,CAMPO VERDE,7176,6962,4403,18846,14443,114,191
MT,90522,CLÁUDIA,1399,4157,1818,7521,5703,36,111
MT,90549,CASTANHEIRA,1980,2109,1353,5604,4251,37,125
MT,90565,JANGADA,2377,1429,1589,5564,3975,29,140
MT,90581,JURUENA,1928,2169,1434,5679,4245,40,108
MT,90590,CHAPADA DOS GUIMARÃES,5310,3498,2730,11845,9115,50,257
MT,90603,LUCAS DO RIO VERDE,6683,7605,3917,18508,14591,97,206
MT,90620,MATUPÁ,2826,4195,2580,9776,7196,55,120
MT,90646,NOVA MUTUM,4079,5707,3199,13241,10042,93,163
MT,90662,RIBEIRÃO CASCALHEIRA,1175,3433,1798,6567,4769,28,133
MT,90670,CUIABÁ,156985,125075,66322,356495,290173,2141,5972
MT,90689,TAPURAH,1568,2323,1430,5403,3973,26,56
MT,90697,DIAMANTINO,4695,5125,2781,12854,10073,63,190
MT,90700,PONTAL DO ARAGUAIA,1591,1278,836,3795,2959,25,65
MT,90719,DOM AQUINO,2364,2419,1754,6713,4959,32,144
MT,90727,SAPEZAL,2727,3102,2564,8519,5955,30,96
MT,90743,CAMPOS DE JÚLIO,834,1352,1170,3407,2237,18,33
MT,90760,CARLINDA,2541,3510,2111,8295,6184,34,99
MT,90778,GENERAL CARNEIRO,1786,1038,1306,4212,2906,26,56
MT,90786,FELIZ NATAL,1775,2609,1829,6315,4486,24,78
MT,90808,NOVO MUNDO,1889,1531,1347,4851,3504,19,65
MT,90824,GAÚCHA DO NORTE,808,1561,971,3406,2435,18,48
MT,90832,GUIRATINGA,2972,4192,2839,10273,7434,65,205
MT,90840,UNIÃO DO SUL,752,1085,804,2701,1897,13,47
MT,90867,NOVA LACERDA,1071,1060,1027,3205,2178,13,34
MT,90883,NOVA UBIRATÃ,1781,1576,1384,4810,3426,22,47
MT,90905,BOM JESUS DO ARAGUAIA,703,1057,1024,2851,1827,12,55
MT,90913,ITIQUIRA,2079,3326,2866,8417,5551,49,97
MT,90921,SERRA NOVA DOURADA,180,429,429,1055,626,4,13
MT,90948,NOVO SANTO ANTONIO,332,647,358,1359,1001,3,19
MT,90956,JACIARA,6270,7148,4136,17964,13828,138,272
MT,90964,NOVA NAZARÉ,461,557,689,1744,1055,4,33
MT,90980,SANTA CRUZ DO XINGU,300,783,628,1747,1119,10,26
MT,91006,CONQUISTA D'OESTE,621,961,603,2239,1636,15,39
MT,91022,VALE DE SÃO DOMINGOS,702,1201,672,2629,1957,13,41
MT,91049,SANTA RITA DO TRIVELATO,286,726,557,1589,1032,6,14
MT,91057,LUCIARA,592,753,583,1979,1396,6,45
MT,91081,IPIRANGA DO NORTE,683,1176,651,2544,1893,11,23
MT,91090,VILA BELA DA SANTÍSSIMA TRINDADE,2562,2801,2744,8285,5541,29,149
MT,91103,ITANHANGÁ,989,1423,1228,3693,2465,15,38
MT,91170,NOBRES,2765,4848,2012,9847,7835,42,180
MT,91197,NORTELÂNDIA,1993,1639,1781,5544,3763,32,99
MT,91219,NOSSA SENHORA DO LIVRAMENTO,4605,1885,2042,8743,6701,38,173
MT,91294,POCONÉ,10720,4950,4695,20812,16117,85,362
MT,91332,PONTE BRANCA,529,682,371,1615,1244,8,25
MT,91359,PORTO DOS GAÚCHOS,847,2051,1044,4017,2973,19,56
MT,91391,POXORÉU,4757,4339,4553,14013,9460,89,275
MT,91510,RONDONÓPOLIS,51330,37543,23576,115025,91449,777,1799
MT,91537,ROSÁRIO OESTE,4322,4342,4286,13245,8959,55,240
MT,91553,SANTO ANTÔNIO DO LEVERGER,6159,3175,2683,12275,9592,52,206
MT,91618,TESOURO,642,887,901,2491,1590,20,41
MT,91634,TORIXORÉU,1328,1386,747,3537,2790,17,59
MT,91677,VÁRZEA GRANDE,77850,42261,31225,154436,123211,823,2277
MT,91774,MIRASSOL D'OESTE,6312,5633,4802,17161,12359,118,296
MT,91812,PEDRA PRETA,4092,4403,1835,10567,8732,47,190
MT,91839,SÃO FÉLIX DO ARAGUAIA,1925,2395,2496,6962,4466,22,124
MT,91855,TANGARÁ DA SERRA,13691,23336,11848,49906,38058,308,723
MT,91898,JUSCIMEIRA,3567,2941,2529,9266,6737,57,172
MT,91910,ÁGUA BOA,3228,5842,4010,13332,9322,77,175
MT,91936,CANARANA,3014,5250,3481,11999,8518,79,175
MT,91952,NOVA XAVANTINA,4325,5068,3733,13390,9657,58,206
MT,91979,SANTA TEREZINHA,1475,1257,1589,4460,2871,35,104
MT,91995,SÃO JOSÉ DO RIO CLARO,2711,4167,2655,9774,7119,60,181
MT,98191,JUARA,5000,10356,5595,21357,15762,156,250
MT,98310,JUÍNA,8156,12318,6356,27395,21039,190,375
MT,98337,DENISE,2252,1754,1275,5384,4109,38,65
MT,98612,ALTO TAQUARI,1014,2219,1323,4616,3293,16,44
MT,98639,ARAGUAIANA,836,899,665,2442,1777,12,30
MT,98655,CAMPINÁPOLIS,2416,3147,2343,8044,5701,33,105
MT,98671,COCALINHO,1705,817,1194,3791,2597,20,55
MT,98698,ITAÚBA,874,1765,1164,3877,2713,21,53
MT,98710,MARCELÂNDIA,1441,5528,3063,10239,7176,42,165
MT,98736,NOVA OLÍMPIA,6256,2425,2203,11120,8917,83,153
MT,98752,NOVA CANAÃ DO NORTE,1897,4170,1943,8222,6279,65,147
MT,98779,NOVO SÃO JOAQUIM,1134,2615,1831,5687,3856,27,80
MT,98795,NOVO HORIZONTE DO NORTE,804,1408,714,2977,2263,13,38
MT,98817,PEIXOTO DE AZEVEDO,7119,6639,6179,20360,14181,115,308
MT,98833,PARANAÍTA,1945,3870,1877,7864,5987,50,122
MT,98850,PORTO ALEGRE DO NORTE,1651,2638,2181,6612,4431,37,105
MT,98876,PORTO ESPERIDIÃO,2471,2351,1766,6756,4990,29,139
MT,98892,PRIMAVERA DO LESTE,8106,13854,7129,29571,22442,145,337
MT,98914,RESERVA DO CABAÇAL,767,566,382,1776,1394,16,45
MT,98930,SORRISO,12202,14819,7972,35605,27633,212,400
MT,98957,TERRA NOVA DO NORTE,3646,2802,2307,8916,6609,54,107
MT,98973,VERA,1658,2944,1776,6489,4713,40,71
MT,98990,VILA RICA,3754,5812,3623,13503,9880,108,206
MT,99015,COMODORO,3182,5277,3962,12663,8701,45,197
MT,99031,FIGUEIRÓPOLIS D'OESTE,806,1468,893,3234,2341,20,47
MT,99058,GUARANTÃ DO NORTE,4382,8887,4798,18457,13659,117,273
MT,99074,INDIAVAÍ,859,537,431,1875,1444,13,35
PA,4006,GOIANÉSIA DO PARÁ,7800,4276,6016,18543,12527,96,355
PA,4014,ABAETETUBA,42674,18654,13074,75816,62742,287,1127
PA,4022,TAILÂNDIA,11277,8346,9988,30314,20326,170,533
PA,4030,ACARÁ,9960,7463,7871,25988,18117,106,588
PA,4049,BOM JESUS DO TOCANTINS,2829,2442,3075,8601,5526,41,214
PA,4057,AFUÁ,4346,4676,4843,14197,9354,33,299
PA,4065,SÃO JOÃO DE PIRABAS,5666,2167,4164,12285,8121,53,235
PA,4073,ALENQUER,10459,11887,9032,31880,22848,82,420
PA,4081,TUCUMÃ,7203,5417,6745,19726,12981,88,273
PA,4090,ALMEIRIM,10817,3039,2831,17097,14266,73,337
PA,4103,MÃE DO RIO,8179,6245,5346,20251,14905,106,375
PA,4111,ALTAMIRA,15180,22416,12287,50996,38709,283,830
PA,4120,ELDORADO DOS CARAJÁS,6838,2632,4064,13882,9818,80,268
PA,4138,ANAJÁS,1847,4843,4113,11060,6947,33,224
PA,4146,SANTA LUZIA DO PARÁ,4951,3534,3428,12171,8743,57,201
PA,4154,ANANINDEUA,110783,62885,35243,214460,179217,1775,3774
PA,4162,PALESTINA DO PARÁ,1879,1505,1810,5330,3520,22,114
PA,4170,AUGUSTO CORRÊA,10378,6575,8033,25707,17674,92,629
PA,4189,IPIXUNA DO PARÁ,5587,3150,3692,12787,9095,61,297
PA,4197,AVEIRO,3656,1893,2500,8189,5689,30,110
PA,4200,JACAREACANGA,1779,2144,2620,6742,4122,42,157
PA,4219,BAGRE,2882,2109,3488,8691,5203,30,182
PA,4227,BRASIL NOVO,2319,5564,2505,10565,8060,48,129
PA,4235,BAIÃO,8688,3137,3464,15578,12114,50,239
PA,4243,SANTA BÁRBARA DO PARÁ,4843,2963,1844,9832,7988,58,124
PA,4251,BARCARENA,25185,10237,4270,40578,36308,231,655
PA,4260,ÁGUA AZUL DO NORTE,2738,1900,2164,6983,4819,32,149
PA,4278,BELÉM,424531,329683,149186,927758,778572,7083,17275
PA,4286,TRAIRÃO,1753,3159,2000,7035,5035,28,95
PA,4294,BENEVIDES,12827,7505,4075,24832,20757,114,311
PA,4308,PAU D'ARCO,1942,1527,1849,5447,3598,22,107
PA,4316,BONITO,3702,2312,2594,8782,6188,23,151
PA,4324,ULIANÓPOLIS,4679,2641,3745,11330,7585,36,229
PA,4332,BRAGANÇA,29860,13321,17722,62053,44331,194,956
PA,4340,AURORA DO PARÁ,5816,3783,3860,13866,10006,67,340
PA,4359,BREVES,16356,8984,16047,42161,26114,99,675
PA,4367,TERRA SANTA,4453,1943,2495,9023,6528,32,100
PA,4375,BUJARU,6357,3595,3346,13619,10273,47,274
PA,4383,NOVO PROGRESSO,3424,5994,3874,13495,9621,67,136
PA,4391,CACHOEIRA DO ARARI,5543,2555,4157,12481,8324,17,209
PA,4405,VITÓRIA DO XINGU,2260,2779,2375,7557,5182,21,122
PA,4413,CAMETÁ,32733,16269,12473,62636,50163,198,963
PA,4421,NOVO REPARTIMENTO,13138,8810,11173,33962,22789,141,700
PA,4430,CAPANEMA,20667,10015,11294,42858,31564,316,566
PA,4448,BREU BRANCO,10517,5501,6003,22576,16573,66,489
PA,4456,CAPITÃO POÇO,10340,9855,8649,29574,20925,138,592
PA,4464,SÃO DOMINGOS DO ARAGUAIA,5710,3506,4507,14134,9627,84,327
PA,4472,CASTANHAL,40991,28576,16987,88372,71385,556,1262
PA,4480,NOVA ESPERANÇA DO PIRIÁ,3771,2912,2888,9817,6929,33,213
PA,4499,CHAVES,2468,3250,4088,9998,5910,18,174
PA,4502,ABEL FIGUEIREDO,2063,1585,1680,5438,3758,21,89
PA,4510,COLARES,3418,1838,1858,7248,5390,40,94
PA,4529,CUMARU DO NORTE,1350,1239,1973,4634,2661,8,64
PA,4537,CONCEIÇÃO DO ARAGUAIA,10622,8040,9773,29176,19403,200,541
PA,4545,TERRA ALTA,3679,1696,1801,7294,5493,28,90
PA,4553,CURRALINHO,6190,2087,3549,12111,8562,30,255
PA,4561,FLORESTA DO ARAGUAIA,4072,2786,3226,10381,7155,73,224
PA,4570,CURUÇÁ,12853,3321,5074,21636,16562,62,326
PA,4588,BANNACH,806,880,872,2617,1745,15,44
PA,4596,FARO,2859,537,1196,4639,3443,7,40
PA,4600,NOVA IPIXUNA,3020,3451,3237,9949,6712,50,191
PA,4618,GURUPÁ,4921,2941,3383,11449,8066,19,185
PA,4626,PLACAS,1828,4766,1974,8773,6799,34,171
PA,4634,IGARAPÉ-AÇU,11723,4956,4014,21237,17223,152,392
PA,4642,MARITUBA,25383,13205,8319,47759,39440,246,606
PA,4650,IGARAPÉ-MIRI,18008,6777,10513,36101,25588,144,659
PA,4669,TRACUATEUA,9266,2985,4141,16841,12700,56,393
PA,4677,INHANGAPI,2609,2180,1052,5981,4929,19,121
PA,4685,QUATIPURU,2735,2378,2820,8063,5243,33,97
PA,4693,IRITUIA,9489,5175,5116,20200,15084,90,330
PA,4707,CANAÃ DOS CARAJÁS,5261,3801,4979,14289,9310,91,157
PA,4715,ITAITUBA,18254,19250,21147,59715,38568,199,865
PA,4723,ANAPU,1914,5331,3091,10545,7454,37,172
PA,4731,ITUPIRANGA,11803,4959,9465,26916,17451,116,573
PA,4740,CURUÁ,2672,2399,1462,6660,5198,18,109
PA,4758,JACUNDÁ,11499,10374,10716,33242,22526,156,497
PA,4766,CACHOEIRA DO PIRIÁ,3932,2357,3351,9923,6572,28,255
PA,4774,JURUTI,7442,5699,4342,17794,13452,58,253
PA,4782,PIÇARRA,2431,2491,2848,7972,5124,36,166
PA,4790,LIMOEIRO DO AJURU,6381,3688,2442,12816,10374,49,256
PA,4804,BELTERRA,4864,3333,2745,11171,8426,43,186
PA,4812,MAGALHÃES BARATA,2623,2010,1646,6398,4752,20,99
PA,4820,SÃO JOÃO DA PONTA,1663,947,636,3298,2662,8,44
PA,4839,MARABÁ,54222,26769,28172,111481,83309,619,1699
PA,4847,SAPUCAIA,887,1129,846,2958,2112,14,82
PA,4855,MARACANÃ,8163,4293,3284,16091,12807,91,260
PA,4871,MARAPANIM,8297,4335,4857,17811,12954,44,278
PA,4898,MELGAÇO,2489,2254,6395,11308,4913,26,144
PA,4910,MOCAJUBA,8993,3304,3470,16122,12652,74,281
PA,4936,MOJU,16465,7049,10530,34775,24245,134,597
PA,4952,MONTE ALEGRE,12410,13829,8719,35490,26771,87,445
PA,4979,MUANÁ,8322,3118,4245,16015,11770,44,286
PA,4995,NOVA TIMBOTEUA,4842,2154,2265,9516,7251,69,186
PA,5010,ÓBIDOS,15032,4812,8096,28380,20284,98,342
PA,5037,OEIRAS DO PARÁ,6488,3568,3102,13590,10488,40,392
PA,5053,ORIXIMINÁ,15337,9253,9675,34824,25149,145,414
PA,5070,OURÉM,5122,2773,3085,11280,8195,69,231
PA,5096,PARAGOMINAS,22560,13610,15301,52540,37239,218,851
PA,5118,PEIXE-BOI,2946,1540,1702,6329,4627,18,123
PA,5134,PONTA DE PEDRAS,6812,2817,3940,13824,9884,41,214
PA,5150,PORTEL,7246,6864,9708,24435,14727,68,549
PA,5177,PORTO DE MOZ,3103,5484,3264,12110,8846,25,234
PA,5193,PRAINHA,6434,4949,4405,16055,11650,36,231
PA,5215,PRIMAVERA,3171,2478,2647,8463,5816,37,130
PA,5231,SALINÓPOLIS,10738,5550,5167,21765,16598,82,228
PA,5258,SALVATERRA,6014,2441,2754,11421,8667,45,167
PA,5274,SANTA CRUZ DO ARARI,2216,1182,1655,5141,3486,11,77
PA,5290,SANTA IZABEL DO PARÁ,15210,7791,5657,29287,23630,189,440
PA,5312,SANTA MARIA DO PARÁ,7092,4313,4045,15869,11824,116,303
PA,5339,SANTANA DO ARAGUAIA,5507,4950,5476,16317,10841,91,293
PA,5355,SANTARÉM,71723,62395,42614,179938,137324,782,2424
PA,5371,SANTARÉM NOVO,2201,1089,762,4153,3391,14,87
PA,5398,SANTO ANTÔNIO DO TAUÁ,7856,4656,3446,16247,12801,71,218
PA,5410,SÃO CAETANO DE ODIVELAS,5501,2569,3045,11295,8250,35,145
PA,5436,SÃO DOMINGOS DO CAPIM,7127,4861,5157,17694,12537,91,458
PA,5452,SÃO FÉLIX DO XINGU,9009,7976,8498,26176,17678,159,534
PA,5479,SÃO FRANCISCO DO PARÁ,4689,2813,2076,9766,7690,45,143
PA,5495,SÃO JOÃO DO ARAGUAIA,3556,1894,3203,8905,5702,40,212
PA,5517,SÃO MIGUEL DO GUAMÁ,12558,7265,7398,27772,20374,110,441
PA,5533,SÃO SEBASTIÃO DA BOA VISTA,6735,2605,3359,12963,9604,45,219
PA,5550,SENADOR JOSÉ PORFÍRIO,2255,2271,2614,7265,4651,19,106
PA,5576,SOURE,8641,1875,4433,15183,10750,53,181
PA,5592,TOMÉ-AÇU,15665,5836,9190,31372,22182,141,540
PA,5614,TUCURUÍ,31098,12364,15483,59978,44495,255,778
PA,5630,VIGIA,15063,5503,7642,28729,21087,144,377
PA,5657,VISEU,16079,4871,10747,32538,21791,105,736
PA,5673,REDENÇÃO,18522,13482,13533,46438,32905,245,656
PA,5690,RIO MARIA,4568,3604,2827,11289,8462,71,219
PA,5711,XINGUARA,8703,7071,6998,23292,16294,146,374
PA,5738,RONDON DO PARÁ,11178,7068,9292,28224,18932,149,537
PA,5754,URUARÁ,4233,11067,6255,22105,15850,142,408
PA,5770,MEDICILÂNDIA,2917,7478,3796,14540,10744,73,276
PA,5797,SÃO GERALDO DO ARAGUAIA,6866,4834,6981,19182,12201,107,394
PA,5819,CONCÓRDIA DO PARÁ,5960,4468,3967,14722,10755,46,281
PA,5835,PARAUAPEBAS,36918,14720,17062,70098,53036,525,873
PA,5851,CURIONÓPOLIS,5551,2232,2326,10395,8069,65,221
PA,5878,GARRAFÃO DO NORTE,5395,4839,5032,15746,10714,75,405
PA,5894,RURÓPOLIS,4215,6150,3664,14433,10769,87,317
PA,5916,PACAJÁ,4971,7959,5105,18512,13407,81,396
PA,5932,BREJO GRANDE DO ARAGUAIA,2189,1582,1994,5916,3922,32,119
PA,5959,OURILÂNDIA DO NORTE,4686,2922,3783,11627,7844,46,190
PA,5975,DOM ELISEU,12220,5381,7309,25463,18154,133,420
PA,5991,SANTA MARIA DAS BARREIRAS,2974,2219,3288,8701,5413,49,171
PB,19003,RIACHÃO DO POÇO,2060,665,417,3345,2928,42,161
PB,19011,ÁGUA BRANCA,3755,715,1326,6226,4900,58,372
PB,19020,SOBRADO,2924,1191,1052,5496,4444,49,280
PB,19038,AGUIAR,3034,457,734,4514,3780,36,253
PB,19046,SÃO JOSÉ DOS RAMOS,2185,833,461,3727,3266,30,218
PB,19054,ALAGOA GRANDE,10692,3722,5009,21229,16220,268,1538
PB,19062,CAPIM,2117,875,799,4068,3269,46,231
PB,19070,ALAGOA NOVA,7539,2846,2521,14149,11628,173,1070
PB,19089,CUITÉ DE MAMANGUAPE,3029,767,1314,5469,4155,54,305
PB,19097,ALAGOINHA,5919,1122,1881,9644,7763,93,629
PB,19100,CURRAL DE CIMA,2026,1241,531,4164,3633,48,318
PB,19119,ALHANDRA,7804,2557,1511,12881,11370,166,843
PB,19127,RIACHÃO DO BACAMARTE,2054,421,450,3217,2767,51,241
PB,19135,SÃO JOÃO DO RIO DO PEIXE,8685,1604,2412,13607,11195,160,746
PB,19143,MATINHAS,1961,616,386,3210,2824,41,206
PB,19151,ARAÇAGI,6961,1797,3679,13336,9657,150,749
PB,19160,LOGRADOURO,1787,511,374,2861,2487,24,165
PB,19178,ARARA,4799,1119,1628,8111,6483,62,503
PB,19186,SERTÃOZINHO,1733,720,289,2939,2650,36,161
PB,19194,ARARUNA,6223,3247,2044,12252,10208,107,631
PB,19208,RIACHÃO,1496,558,265,2453,2188,22,112
PB,19216,AREIA,9660,2822,3216,17369,14153,290,1381
PB,19224,SÃO DOMINGOS DO CARIRI,935,761,471,2241,1770,10,64
PB,19232,AREIAL,2666,1042,805,4802,3997,56,233
PB,19240,CARAÚBAS,1871,478,476,3023,2547,33,165
PB,19259,AROEIRAS,7125,3023,2685,13920,11235,185,902
PB,19267,SANTO ANDRÉ,1417,364,359,2302,1943,42,120
PB,19275,DAMIÃO,2103,687,350,3273,2923,19,114
PB,19283,SOSSÊGO,1409,518,289,2332,2043,17,99
PB,19291,BAIA DA TRAIÇÃO,3119,427,920,4822,3902,37,319
PB,19305,BARAÚNAS,1937,357,297,2794,2497,31,172
PB,19313,BANANEIRAS,8942,2944,2974,15939,12965,184,895
PB,19321,ASSUNÇÃO,1564,650,294,2640,2346,30,102
PB,19330,BARRA DE SANTA ROSA,4892,2586,1447,9390,7943,51,414
PB,19348,ZABELÊ,999,322,230,1664,1434,23,90
PB,19356,BARRA DE SÃO MIGUEL,2624,686,803,4382,3579,54,215
PB,19364,CACIMBAS,2395,714,1465,5045,3580,81,390
PB,19372,BAYEUX,42509,9467,9898,65908,56010,742,3292
PB,19380,CAJAZEIRINHAS,2253,408,547,3420,2873,30,182
PB,19399,BELÉM,6686,2419,2154,11960,9806,131,570
PB,19402,SÃO BENTINHO,1627,565,541,2905,2364,17,155
PB,19410,BELÉM DO BREJO DO CRUZ,3317,577,967,5157,4190,42,254
PB,19429,SÃO DOMINGOS DE POMBAL,1828,383,365,2784,2419,10,198
PB,19437,BOA VENTURA,2875,461,1044,4655,3611,32,243
PB,19445,SÃO JOSÉ DE PRINCESA,1877,218,774,3143,2369,20,254
PB,19453,BOM JESUS,1427,235,330,2098,1768,20,86
PB,19461,MARIZÓPOLIS,3521,498,831,5154,4323,41,263
PB,19470,BOM SUCESSO,2848,440,896,4424,3528,42,198
PB,19488,MATO GROSSO,1466,117,429,2109,1680,11,86
PB,19496,BONITO DE SANTA FÉ,3859,1246,1561,7152,5591,52,434
PB,19500,BERNARDINO BATISTA,1446,297,406,2262,1856,10,103
PB,19518,BOQUEIRÃO,7165,2690,2692,13241,10549,132,562
PB,19526,POÇO DE JOSÉ DE MOURA,2493,381,443,3509,3066,43,149
PB,19534,IGARACY,3006,565,1350,5211,3861,30,260
PB,19542,SÃO JOSÉ DO BREJO CRUZ,933,265,163,1429,1266,15,53
PB,19550,BORBOREMA,1860,855,710,3718,3008,37,256
PB,19569,SANTA INÊS,1951,473,611,3270,2659,20,215
PB,19577,BREJO DO CRUZ,5076,1538,2456,9658,7202,107,481
PB,19585,AMPARO,1298,174,298,1862,1564,10,82
PB,19593,BREJO DOS SANTOS,3017,1029,693,5000,4307,62,199
PB,19607,CASSERENGUE,2930,771,954,4994,4040,40,299
PB,19615,CAAPORÃ,9565,1523,2859,14845,11986,167,731
PB,19623,GADO BRAVO,3100,1531,1707,6857,5150,111,408
PB,19631,CABACEIRAS,2501,816,529,4076,3547,51,179
PB,19640,POÇO DANTAS,1995,240,492,2946,2454,10,209
PB,19658,CABEDELO,20238,6223,5362,33866,28504,350,1693
PB,19666,SANTARÉM,1274,405,283,2083,1800,20,101
PB,19674,CACHOEIRA DOS ÍNDIOS,4448,665,1302,6894,5592,61,418
PB,19682,TENÓRIO,1255,421,312,2132,1820,26,118
PB,19690,CACIMBA DE AREIA,1755,303,297,2496,2199,23,118
PB,19704,COXIXOLA,848,259,98,1312,1214,22,85
PB,19712,CACIMBA DE DENTRO,6546,3057,2737,13134,10397,97,697
PB,19720,PARARI,905,362,178,1518,1340,15,58
PB,19739,CAIÇARA,3449,1171,968,5883,4915,32,263
PB,19747,PEDRO RÉGIS,1897,853,776,3804,3028,45,233
PB,19755,CAJAZEIRAS,22939,5936,9057,40147,31090,490,1725
PB,19763,ALCANTIL,1876,1146,451,3703,3252,36,194
PB,19771,CALDAS BRANDÃO,2644,573,709,4205,3496,46,233
PB,19780,BARRA DE SANTANA,3278,1580,1000,6341,5341,85,398
PB,19798,CAMALAÚ,2869,540,648,4316,3668,43,216
PB,19801,CATURITÉ,2241,692,380,3554,3174,39,202
PB,19810,CAMPINA GRANDE,134237,71933,33789,253683,219894,2696,11028
PB,19828,RIACHO DE SANTO ANTÔNIO,780,496,115,1468,1353,9,68
PB,19836,CARRAPATEIRA,1293,62,491,1935,1444,5,84
PB,19844,APARECIDA,3315,1024,655,5436,4781,67,375
PB,19852,CATINGUEIRA,2032,763,310,3308,2998,38,165
PB,19860,SÃO FRANCISCO,2034,602,366,3179,2813,36,141
PB,19879,CATOLÉ DO ROCHA,12308,3299,3015,19584,16569,229,733
PB,19887,VIEIRÓPOLIS,2590,577,689,4165,3476,60,249
PB,19895,CONCEIÇÃO,8014,1321,3041,13309,10268,109,824
PB,19909,AREIA DE BARAÚNAS,863,335,246,1547,1301,11,92
PB,19917,CONDADO,3452,719,877,5363,4486,45,270
PB,19925,ALGODÃO DE JANDAIRA,1456,247,221,2055,1834,16,115
PB,19933,CONDE,7031,1463,973,10335,9362,135,733
PB,19941,BOA VISTA,2368,1569,292,4437,4145,36,172
PB,19950,CONGO,2476,532,604,3820,3216,41,167
PB,19968,MARCAÇÃO,2604,680,936,4578,3642,45,313
PB,19976,COREMAS,6839,1266,2281,11033,8752,83,564
PB,19984,MATURÉIA,2656,497,540,3959,3419,32,234
PB,19992,CRUZ DO ESPÍRITO SANTO,7688,1658,1554,11836,10282,188,748
PB,20001,SANTA CECILIA DE UMBUZEIRO,2302,1538,1208,5272,4064,28,196
PB,20010,CUBATI,2910,1238,726,5263,4537,77,312
PB,20036,CUITÉ,8348,2635,3310,15176,11866,110,773
PB,20052,CUITEGI,2652,990,859,4875,4016,62,312
PB,20079,CURRAL VELHO,861,514,589,2083,1494,12,107
PB,20095,DESTERRO,3439,1039,1186,6053,4867,58,331
PB,20117,VISTA SERRANA,1227,515,698,2560,1862,22,98
PB,20133,DIAMANTE,3144,445,1114,5037,3923,32,302
PB,20150,DONA INÊS,4024,1856,1506,7825,6319,50,389
PB,20176,DUAS ESTRADAS,1769,674,395,3048,2653,39,171
PB,20192,EMAS,1490,726,362,2688,2326,10,100
PB,20214,ESPERANÇA,12353,4211,4739,22783,18044,263,1217
PB,20230,FAGUNDES,4630,2098,2330,9670,7340,63,549
PB,20257,FREI MARTINHO,1435,593,263,2431,2168,15,125
PB,20273,GUARABIRA,21303,7110,5485,35784,30299,445,1441
PB,20290,GURINHÉM,5480,2213,2233,10470,8237,81,463
PB,20311,GURJÃO,1506,618,287,2547,2260,26,110
PB,20338,IBIARA,2910,546,1190,5000,3810,41,313
PB,20354,IMACULADA,4165,1349,1492,7524,6032,63,455
PB,20370,INGÁ,7738,1565,3732,13978,10246,162,781
PB,20397,ITABAIANA,11806,2376,1983,17375,15392,174,1036
PB,20419,ITAPORANGA,9179,1945,3725,15719,11994,114,756
PB,20435,ITAPOROROCA,6129,2041,1589,10603,9014,130,714
PB,20451,ITATUBA,4272,1379,1789,7905,6116,83,382
PB,20478,JACARAÚ,5508,2176,2283,10745,8462,128,650
PB,20494,JERICÓ,4026,671,1064,6053,4989,49,243
PB,20516,JOÃO PESSOA,255548,90777,58243,430643,372400,4348,21727
PB,20532,JUAREZ TAVORA,3533,773,1051,5789,4738,95,337
PB,20559,JUAZEIRINHO,6859,1641,1594,10821,9227,103,624
PB,20575,JUNCO DO SERIDÓ,2692,1081,658,4740,4082,57,252
PB,20591,JURIPIRANGA,5137,970,808,7423,6615,71,437
PB,20613,JURU,4410,525,2300,7757,5457,60,462
PB,20630,LAGOA,2646,388,616,3915,3299,43,222
PB,20656,LAGOA DE DENTRO,3102,974,1167,5686,4519,57,386
PB,20672,LAGOA SECA,8829,4429,1854,16336,14482,304,920
PB,20699,LASTRO,2156,234,321,2883,2562,10,162
PB,20710,LIVRAMENTO,2942,990,859,5089,4230,52,246
PB,20737,LUCENA,5121,931,1805,8394,6589,69,468
PB,20753,MÃE D'ÁGUA,1892,512,489,3063,2574,31,139
PB,20770,MALTA,2536,745,1138,4676,3538,49,208
PB,20796,MAMANGUAPE,14584,5669,5920,28138,22218,313,1652
PB,20818,MANAÍRA,4634,612,2175,7993,5818,66,506
PB,20834,MARI,8468,2126,2630,14099,11469,167,708
PB,20850,MASSARANDUBA,4562,1979,1872,9180,7308,130,637
PB,20877,MATARACA,3168,786,1035,5355,4320,55,311
PB,20893,MOGEIRO,5123,1654,2468,9727,7259,65,417
PB,20915,MONTADAS,1805,942,564,3511,2947,29,171
PB,20931,MONTE HOREBE,2089,279,928,3500,2572,23,181
PB,20958,MONTEIRO,13397,2709,3715,21338,17623,300,1217
PB,20974,MULUNGU,4909,1110,1297,7765,6468,83,366
PB,20990,NATUBA,3404,1085,1251,6415,5164,131,544
PB,21016,NAZAREZINHO,3721,749,1201,6095,4894,70,354
PB,21032,NOVA FLORESTA,3196,2004,1044,6626,5582,52,330
PB,21059,NOVA OLINDA,2600,687,879,4454,3575,47,241
PB,21075,NOVA PALMEIRA,1488,931,314,2932,2618,39,160
PB,21091,OLHO D'ÁGUA,3547,1077,907,5960,5053,54,375
PB,21113,OLIVEDOS,1721,536,317,2798,2481,43,181
PB,21130,OURO VELHO,1642,492,303,2521,2218,15,69
PB,21156,PASSAGEM,978,426,350,1831,1481,13,64
PB,21172,PATOS,35247,12669,11531,62371,50840,556,2368
PB,21199,PAULISTA,4992,1344,1781,8667,6886,92,458
PB,21210,PEDRA BRANCA,1782,620,617,3147,2530,20,108
PB,21237,PEDRA LAVRADA,2579,1838,625,5398,4773,53,303
PB,21253,PEDRAS DE FOGO,12058,2667,4662,20813,16151,173,1253
PB,21270,PIANCÓ,6798,2224,2068,11794,9726,79,625
PB,21296,PICUÍ,7670,2518,2457,13544,11087,142,757
PB,21318,PILAR,5278,1121,1222,8278,7056,76,581
PB,21334,PILÕES,2917,1337,1226,5946,4720,81,385
PB,21350,PILÕEZINHOS,2352,956,903,4527,3624,61,255
PB,21377,PIRPIRITUBA,3604,1667,1393,7157,5764,95,398
PB,21393,PITIMBU,5223,1041,1624,8456,6832,71,497
PB,21415,POCINHOS,5976,3425,1717,11920,10203,178,624
PB,21431,POMBAL,13206,3952,4008,22342,18334,168,1008
PB,21458,PRATA,1968,548,496,3183,2687,29,142
PB,21474,PRINCESA ISABEL,7697,2225,2824,13664,10840,113,805
PB,21490,PUXINANÃ,5318,1869,1024,8860,7836,127,522
PB,21512,QUEIMADAS,14186,6084,5109,27345,22236,377,1589
PB,21539,QUIXABÁ,790,427,92,1370,1278,11,50
PB,21555,REMÍGIO,7189,1777,2117,11841,9724,99,659
PB,21571,RIACHO DOS CAVALOS,4284,802,1208,6646,5438,67,285
PB,21598,RIO TINTO,9770,2656,3551,17038,13487,162,899
PB,21610,SALGADINHO,1198,578,403,2307,1904,24,104
PB,21636,SALGADO DE SÃO FÉLIX,4860,1462,2516,9398,6882,61,499
PB,21652,SANTA CRUZ,3667,511,685,5128,4443,33,232
PB,21679,SANTA HELENA,3098,513,861,4773,3912,46,255
PB,21695,SANTA LUZIA,4768,3858,1833,11043,9210,145,439
PB,21717,SANTANA DE MANGUEIRA,2885,336,934,4410,3476,24,231
PB,21733,SANTANA DOS GARROTES,3218,1143,1306,6060,4754,37,356
PB,21750,SANTA RITA,46528,12714,13397,78716,65319,1104,4973
PB,21776,SANTA TERESINHA,2071,969,530,3786,3256,27,189
PB,21792,SÃO BENTO,10044,5427,3915,20325,16410,196,743
PB,21814,SÃO JOÃO DO CARIRI,2061,743,628,3632,3004,35,165
PB,21830,SÃO JOÃO DO TIGRE,1808,529,514,3128,2614,41,236
PB,21857,SÃO JOSÉ DA LAGOA TAPADA,3597,944,793,5847,5054,72,441
PB,21873,SÃO JOSÉ DE CAIANA,2569,462,1189,4550,3361,23,307
PB,21890,SÃO JOSÉ DE ESPINHARAS,2461,687,446,3811,3365,24,193
PB,21911,SÃO JOSÉ DE PIRANHAS,8717,1091,2892,13490,10598,110,680
PB,21938,SÃO JOSÉ DO BONFIM,1726,548,308,2717,2409,28,107
PB,21954,SÃO JOSÉ DO SABUGI,1725,964,377,3258,2881,34,158
PB,21970,SÃO JOSÉ DOS CORDEIROS,1989,469,554,3185,2631,30,143
PB,21997,SÃO MAMEDE,3086,2033,1264,6640,5376,43,214
PB,22012,SÃO MIGUEL DE TAIPU,2562,854,657,4445,3788,50,322
PB,22039,SÃO SEBASTIÃO DE LAGOA DE ROÇA,3983,2006,1382,7914,6532,96,447
PB,22055,SÃO SEBASTIÃO DO UMBUZEIRO,1687,325,207,2348,2141,22,107
PB,22071,SAPÉ,19429,4795,8710,35303,26593,430,1939
PB,22098,SÃO VICENTE DO SERIDÓ,3924,1296,1348,6939,5591,81,290
PB,22110,SERRA BRANCA,4789,2066,1610,9045,7435,97,483
PB,22136,SERRA DA RAIZ,1260,758,524,2661,2137,24,95
PB,22152,SERRA GRANDE,1553,342,512,2565,2053,24,134
PB,22179,SERRA REDONDA,3426,879,1101,5838,4737,59,373
PB,22195,SERRARIA,2715,743,760,4655,3895,53,384
PB,22217,SOLÂNEA,9514,4525,6000,21553,15553,252,1262
PB,22233,SOLEDADE,4973,2558,1395,9585,8190,143,516
PB,22250,SOUSA,27195,5749,8402,43828,35426,486,1996
PB,22276,SUMÉ,7319,1397,2055,11552,9497,103,678
PB,22292,CAMPO DE SANTANA,3792,1189,1259,6677,5418,61,376
PB,22314,TAPEROÁ,4930,2523,1835,9857,8022,100,469
PB,22330,TAVARES,5504,1103,2404,9736,7332,110,615
PB,22357,TEIXEIRA,5152,2006,1601,9344,7743,100,485
PB,22373,TRIUNFO,4185,690,1808,7084,5276,62,339
PB,22390,UIRAÚNA,6623,1295,1862,10444,8582,100,564
PB,22411,UMBUZEIRO,3270,1853,1338,6920,5582,67,392
PB,22438,VÁRZEA,1220,564,173,2041,1868,14,70
PE,23000,QUIXABA,3371,171,924,4934,4010,46,422
PE,23019,AFOGADOS DA INGAZEIRA,12502,4033,6484,24912,18428,259,1634
PE,23027,LAGOA DO CARRO,5870,2347,2005,11107,9102,160,725
PE,23035,AFRÂNIO,8712,841,2218,13107,10889,149,1187
PE,23043,SANTA CRUZ DA BAIXA VERDE,5892,412,2184,9368,7184,85,795
PE,23051,AGRESTINA,9992,1505,2235,15494,13259,253,1509
PE,23060,XEXÉU,4966,1171,3388,10460,7072,104,831
PE,23078,ÁGUA PRETA,10264,1924,6061,19944,13883,254,1441
PE,23086,VERTENTE DO LÉRIO,3143,1028,961,5809,4848,99,578
PE,23094,ÁGUAS BELAS,14303,3435,8056,28881,20825,247,2840
PE,23108,SANTA CRUZ,5528,747,2356,9559,7203,113,815
PE,23116,ALAGOINHA,4858,2156,1175,9078,7903,100,789
PE,23124,JUCATI,4874,556,2000,8428,6428,139,859
PE,23132,ALIANÇA,14730,2671,7800,27565,19765,391,1973
PE,23140,DORMENTES,7218,1576,2346,12243,9897,123,980
PE,23159,ALTINHO,8215,2650,3879,16640,12761,364,1532
PE,23167,CARNAUBEIRA DA PENHA,4928,343,2546,8732,6186,81,834
PE,23175,AMARAJI,8130,1997,4735,16361,11626,317,1182
PE,23183,LAGOA GRANDE,9224,1180,3866,15751,11885,125,1356
PE,23191,ANGELIM,3516,1981,1401,7428,6027,55,475
PE,23205,ARAÇOIABA,7380,1747,2454,12670,10216,129,960
PE,23213,ARARIPINA,26365,4849,12221,48522,36301,491,4596
PE,23221,CASINHAS,5494,1117,2829,10655,7826,143,1072
PE,23230,ARCOVERDE,24361,5471,10020,42913,32893,484,2577
PE,23248,MANARI,4991,1117,1969,9076,7107,92,907
PE,23256,BARRA DE GUABIRABA,4675,1181,2208,8806,6598,120,622
PE,23264,JATOBÁ,6390,776,2293,10145,7852,59,627
PE,23272,BARREIROS,15547,3122,9036,30213,21177,397,2111
PE,23280,TAMANDARÉ,6578,2017,3437,13050,9613,125,893
PE,23299,BELÉM DE MARIA,4249,940,1171,7241,6070,112,769
PE,23302,JAQUEIRA,3416,2012,2266,8433,6167,70,669
PE,23310,BELÉM DE SÃO FRANCISCO,8328,1123,4187,14961,10774,125,1198
PE,23329,SANTA FILOMENA,4783,1309,2184,8964,6780,66,622
PE,23337,BELO JARDIM,26540,10866,10622,52292,41670,619,3645
PE,23353,BETÂNIA,5019,299,1979,8444,6465,123,1024
PE,23370,BEZERROS,22147,6710,8644,42164,33520,1055,3608
PE,23396,BODOCÓ,11250,3472,4021,21011,16990,223,2045
PE,23418,BOM CONSELHO,16283,2509,8751,30612,21861,317,2752
PE,23434,BOM JARDIM,12733,5246,7731,28424,20693,407,2307
PE,23450,BONITO,15931,2454,6174,26857,20683,340,1958
PE,23477,BREJÃO,4801,790,1191,7847,6656,145,920
PE,23493,BREJINHO,3623,484,777,5488,4711,64,540
PE,23515,BREJO DA MADRE DE DEUS,12793,3763,5548,25077,19529,551,2422
PE,23531,BUENOS AIRES,5762,1205,1370,9197,7827,117,743
PE,23558,BUÍQUE,17866,1545,8054,31688,23634,413,3810
PE,23574,CABO DE SANTO AGOSTINHO,78949,13854,21103,125865,104762,2136,9823
PE,23590,CABROBÓ,11541,1732,4937,19886,14949,168,1508
PE,23612,CACHOEIRINHA,7388,2242,3453,14278,10825,237,958
PE,23639,CAETÉS,9228,1083,4009,15948,11939,182,1446
PE,23655,CALÇADO,3747,771,1724,7104,5380,132,730
PE,23671,CALUMBI,3635,187,886,5208,4322,50,450
PE,23698,CAMOCIM DE SÃO FÉLIX,7615,992,2925,12772,9847,244,996
PE,23710,CAMUTANGA,3892,1065,741,6244,5503,91,455
PE,23736,CANHOTINHO,7741,3533,4787,17543,12756,162,1320
PE,23752,CAPOEIRAS,8126,1333,4142,14825,10683,247,977
PE,23779,CARNAÍBA,7443,1717,2073,12451,10378,147,1071
PE,23795,CARPINA,22347,11598,8229,46238,38009,772,3292
PE,23817,CARUARU,98653,35094,26183,174680,148497,3574,11176
PE,23833,CATENDE,13433,2198,6757,24184,17427,248,1548
PE,23850,CEDRO,4151,741,2148,7814,5666,88,686
PE,23876,CHÃ DE ALEGRIA,5672,918,1006,8506,7500,126,784
PE,23892,CHÃ GRANDE,6958,2860,2357,13684,11327,318,1191
PE,23914,CONDADO,9678,1813,3943,16705,12762,173,1098
PE,23930,CORRENTES,6844,967,3380,12273,8893,126,956
PE,23957,CORTÊS,5927,1304,1519,9865,8346,119,996
PE,23973,CUMARU,7738,1526,3955,14361,10406,216,926
PE,23990,CUPIRA,9646,1251,5321,17806,12485,225,1363
PE,24015,CUSTÓDIA,13804,1531,7046,24493,17447,246,1866
PE,24031,ESCADA,25046,5568,10191,44363,34172,440,3118
PE,24058,EXU,13130,2369,7553,25596,18043,216,2328
PE,24074,FEIRA NOVA,8000,2327,3872,15764,11892,289,1276
PE,24090,FERREIROS,5015,1254,2121,9253,7132,171,692
PE,24112,FLORES,9729,778,5457,17472,12015,193,1315
PE,24139,FLORESTA,12433,1271,4255,19585,15330,109,1517
PE,24155,FREI MIGUELINHO,5471,2124,2124,10890,8766,198,973
PE,24171,GAMELEIRA,7964,1658,4243,15077,10834,131,1081
PE,24198,GARANHUNS,50003,5491,16196,77949,61753,958,5301
PE,24210,GLÓRIA DO GOITÁ,9746,3475,4632,19879,15247,289,1737
PE,24236,GOIANA,32968,4544,9706,51100,41394,711,3171
PE,24252,GRANITO,2744,330,865,4309,3444,53,317
PE,24279,GRAVATÁ,22642,12115,9861,49991,40130,1099,4274
PE,24295,IATI,7488,712,4105,13829,9724,115,1409
PE,24317,IBIMIRIM,10764,745,5321,18177,12856,133,1214
PE,24333,IBIRAJUBA,2914,1002,933,5446,4513,100,497
PE,24350,IGARASSU,35457,8016,9636,58250,48614,844,4297
PE,24376,IGUARACI,4486,1327,2610,9279,6669,82,774
PE,24392,INAJÁ,5927,351,1882,8884,7002,59,665
PE,24414,INGAZEIRA,1952,364,440,3057,2617,40,261
PE,24430,IPOJUCA,28307,5259,9906,48334,38428,679,4183
PE,24457,IPUBI,8807,1639,4552,16943,12391,168,1777
PE,24473,ITACURUBA,2163,155,544,3131,2587,23,246
PE,24490,ITAÍBA,8487,2288,4527,17097,12570,148,1647
PE,24511,ITAMARACÁ,7718,2021,2952,13649,10697,121,837
PE,24538,ITAPETIM,6881,703,3350,11797,8447,110,753
PE,24554,ITAQUITINGA,6916,803,2917,11589,8672,95,858
PE,24570,JABOATÃO DOS GUARARAPES,217316,62248,60371,372803,312432,6469,26399
PE,24597,JATAÚBA,5353,2503,2466,11341,8875,96,923
PE,24619,JOÃO ALFREDO,11188,3082,6367,22992,16625,359,1996
PE,24635,JOAQUIM NABUCO,6234,1240,1910,10247,8337,129,734
PE,24651,JUPI,5850,645,1178,8660,7482,160,827
PE,24678,JUREMA,4928,1742,1899,9505,7606,100,836
PE,24694,LAGOA DE ITAENGA,7328,4145,1591,14607,13016,249,1294
PE,24716,LAGOA DO OURO,5310,911,1172,8502,7330,92,1017
PE,24732,LAGOA DOS GATOS,6241,975,3007,11426,8419,129,1074
PE,24759,LAJEDO,13114,4952,7026,27532,20506,442,1998
PE,24775,LIMOEIRO,21906,7868,10094,43993,33899,970,3155
PE,24791,MACAPARANA,9412,2068,2816,16188,13372,239,1653
PE,24813,MACHADOS,4654,1120,1219,7905,6686,159,753
PE,24830,MARAIAL,4469,1138,3312,9875,6563,123,833
PE,24856,MIRANDIBA,5408,1253,3284,10907,7623,107,855
PE,24872,MORENO,20947,5555,6629,37083,30454,773,3179
PE,24899,NAZARÉ DA MATA,11780,5083,5123,24227,19104,622,1619
PE,24910,OLINDA,173575,45942,41618,283834,242216,4175,18524
PE,24937,OROBÓ,8035,2380,5268,17385,12117,274,1428
PE,24953,OROCÓ,4570,1716,2192,9440,7248,115,847
PE,24970,OURICURI,19638,4451,10482,38700,28218,367,3762
PE,24996,PALMARES,23134,4089,11579,42017,30438,496,2719
PE,25011,PALMEIRINA,3788,334,1802,6706,4904,72,710
PE,25038,PANELAS,6515,5633,5749,19734,13985,148,1689
PE,25054,PARANATAMA,5289,443,1046,7846,6800,97,971
PE,25070,PARNAMIRIM,8880,1208,3390,14633,11243,136,1019
PE,25097,PASSIRA,12108,2329,5981,22733,16752,398,1917
PE,25119,PAUDALHO,13314,8678,5275,30653,25378,666,2720
PE,25135,PAULISTA,107560,27277,27298,174476,147178,2487,9854
PE,25151,PEDRA,8704,1531,4022,16045,12023,244,1544
PE,25178,PESQUEIRA,25653,4058,10730,44571,33841,563,3567
PE,25194,PETROLÂNDIA,13102,1897,4287,20600,16313,155,1159
PE,25216,PETROLINA,86264,19538,26843,144394,117551,1674,10075
PE,25232,POÇÃO,4590,1220,1611,8464,6853,145,898
PE,25259,POMBOS,9213,2735,1606,15182,13576,320,1308
PE,25275,PRIMAVERA,4605,1294,2136,8890,6754,122,733
PE,25291,QUIPAPÁ,7994,1375,5788,16642,10854,220,1265
PE,25313,RECIFE,588020,229757,171531,1075408,903877,17393,68707
PE,25330,RIACHO DAS ALMAS,8578,1751,1562,13496,11934,353,1252
PE,25356,RIBEIRÃO,16125,2833,9005,30391,21386,332,2096
PE,25372,RIO FORMOSO,8216,2390,5034,17119,12085,173,1306
PE,25399,SAIRÉ,5667,1124,1427,9465,8038,272,975
PE,25410,SALGADINHO,2343,1171,911,5004,4093,60,519
PE,25437,SALGUEIRO,17688,6484,7562,34329,26767,345,2250
PE,25453,SALOÁ,6544,870,3051,11806,8755,145,1196
PE,25470,SANHARÓ,8440,1198,1672,12528,10856,112,1106
PE,25496,SANTA CRUZ DO CAPIBARIBE,21045,10916,7205,42624,35419,1018,2440
PE,25518,SANTA MARIA DA BOA VISTA,14174,2625,5050,23798,18748,156,1793
PE,25534,SANTA MARIA DO CAMBUCÁ,4619,1742,1316,8714,7398,161,876
PE,25550,SANTA TEREZINHA,4572,760,1983,7805,5822,50,440
PE,25577,SÃO BENEDITO DO SUL,3010,963,2612,7480,4868,116,779
PE,25593,SÃO BENTO DO UNA,16575,3315,7737,30865,23128,478,2760
PE,25615,SÃO CAITANO,13782,3433,5604,25910,20306,671,2420
PE,25631,SÃO JOÃO,9430,786,3599,15181,11582,113,1253
PE,25658,SÃO JOAQUIM DO MONTE,9384,1620,3723,16280,12557,194,1359
PE,25674,SÃO JOSÉ DA COROA GRANDE,5625,1719,1644,10016,8372,148,880
PE,25690,SÃO JOSÉ DO BELMONTE,12695,2179,7368,24224,16856,191,1791
PE,25712,SÃO JOSÉ DO EGITO,11924,2499,5783,22169,16386,320,1643
PE,25739,SÃO LOURENÇO DA MATA,37728,10652,11769,66341,54572,1146,5046
PE,25755,SÃO VICENTE FERRER,6863,1363,3334,12783,9449,129,1094
PE,25771,SERRA TALHADA,31068,3301,12661,51276,38615,464,3782
PE,25798,SERRITA,6108,2358,3460,13120,9660,90,1104
PE,25810,SERTÂNIA,12086,3648,7635,25480,17845,294,1817
PE,25836,SIRINHAÉM,14163,3502,6882,26541,19659,218,1776
PE,25852,MOREILÂNDIA,4995,687,2415,8941,6526,68,776
PE,25879,SOLIDÃO,2693,295,803,4224,3421,45,388
PE,25895,SURUBIM,19648,5777,8134,36926,28792,738,2629
PE,25917,TABIRA,11640,1279,4388,18751,14363,191,1253
PE,25933,TACAIMBÓ,4976,1501,2325,9911,7586,178,931
PE,25950,TACARATU,6036,1374,3160,11787,8627,138,1079
PE,25976,ITAMBÉ,11491,3594,5597,22623,17026,258,1683
PE,25992,TAQUARITINGA DO NORTE,7618,4028,2581,15644,13063,305,1112
PE,26018,TEREZINHA,3083,706,875,5342,4467,61,617
PE,26034,TERRA NOVA,4615,482,1116,6816,5700,70,533
PE,26050,TIMBAÚBA,22789,5181,11748,42736,30988,484,2534
PE,26077,TORITAMA,8810,3459,3104,16753,13649,344,1036
PE,26093,TRACUNHAÉM,5134,1850,2297,10198,7901,176,741
PE,26115,TRINDADE,8718,1773,4697,16870,12173,169,1513
PE,26131,TRIUNFO,6938,720,2159,10832,8673,134,881
PE,26158,TUPANATINGA,7090,1289,4391,14347,9956,151,1426
PE,26174,TUPARETAMA,4431,495,994,6485,5491,80,485
PE,26190,VENTUROSA,7050,978,2676,11835,9159,136,995
PE,26212,VERDEJANTE,3617,1479,2024,7859,5835,52,687
PE,26239,VERTENTES,5968,2550,2192,12036,9844,300,1026
PE,26255,VICÊNCIA,11261,2564,6068,22004,15936,311,1800
PE,26271,VITÓRIA DE SANTO ANTÃO,47760,16827,15682,87573,71891,1397,5907
PE,26298,CAMARAGIBE,58687,17048,14200,99675,85475,1873,7867
PE,26310,ABREU E LIMA,45799,8852,11888,71978,60090,926,4513
PE,26336,ITAPISSUMA,10025,1544,2919,15749,12830,271,990
PE,30015,FERNANDO DE NORONHA,828,268,536,1752,1216,16,104
PI,10006,BRASILEIRA,2772,1372,1495,5848,4353,59,150
PI,10014,AGRICOLÂNDIA,2795,554,890,4385,3495,28,118
PI,10022,ALEGRETE DO PIAUÍ,2360,290,727,3490,2763,12,101
PI,10030,ÁGUA BRANCA,7152,1153,2382,11083,8701,78,318
PI,10049,BAIXA GRANDE DO RIBEIRO,2449,1388,1265,5323,4058,33,188
PI,10057,ALTO LONGÁ,5313,1775,2249,9793,7544,56,400
PI,10065,BOM PRINCÍPIO DO PIAUÍ,2447,952,1351,4911,3560,27,134
PI,10073,ALTOS,17041,3541,4982,26512,21530,178,770
PI,10081,BONFIM DO PIAUÍ,2656,251,834,3904,3070,17,146
PI,10090,AMARANTE,7984,1476,2978,12909,9931,106,365
PI,10103,BURITI DOS MONTES,3237,772,967,5137,4170,21,140
PI,10111,ANGICAL DO PIAUÍ,3781,718,1300,5994,4694,34,161
PI,10120,CABECEIRAS DO PIAUÍ,4372,747,1627,7025,5398,28,251
PI,10138,ANÍSIO DE ABREU,4018,463,904,5548,4644,26,137
PI,10146,CALDEIRÃO GRANDE DO PIAUÍ,2367,753,729,3982,3253,16,117
PI,10154,ANTÔNIO ALMEIDA,1075,695,770,2613,1843,14,59
PI,10162,CANAVIEIRA,1449,549,810,2905,2095,18,79
PI,10170,AROAZES,2923,457,1332,4875,3543,23,140
PI,10189,COIVARAS,1923,709,834,3608,2774,22,120
PI,10197,ARRAIAL,2049,514,840,3544,2704,24,117
PI,10200,COLÔNIA DO GURGUÉIA,2826,353,921,4228,3307,18,110
PI,10219,AVELINO LOPES,4822,925,1275,7323,6048,43,258
PI,10227,COLÔNIA DO PIAUÍ,3570,349,1141,5276,4135,28,188
PI,10235,BARRAS,12272,6332,4811,24540,19729,167,958
PI,10243,CORONEL JOSÉ DIAS,2737,528,703,4111,3408,20,123
PI,10251,BARREIRAS DO PIAUÍ,1520,302,774,2699,1925,12,91
PI,10260,FARTURA DO PIAUÍ,2679,277,857,3990,3133,23,154
PI,10278,BARRO DURO,3040,664,1388,5266,3878,27,147
PI,10286,JACOBINA DO PIAUÍ,3029,209,768,4134,3366,19,109
PI,10294,BATALHA,9381,3939,4463,18507,14044,103,621
PI,10308,JARDIM DO MULATO,2086,382,941,3545,2604,33,103
PI,10316,BENEDITINOS,5031,928,1623,7987,6364,74,331
PI,10324,LAGOA ALEGRE,3476,799,1454,5948,4494,24,195
PI,10332,BERTOLÍNIA,1999,698,920,3793,2873,23,153
PI,10340,LAGOA DO BARRO DO PIAUÍ,2109,415,578,3257,2679,25,130
PI,10359,BOCAINA,2543,1464,745,4879,4134,29,98
PI,10367,MARCOLÂNDIA,3257,659,552,4730,4178,40,222
PI,10375,BOM JESUS,6543,2577,2485,12052,9567,72,375
PI,10383,PATOS DO PIAUÍ,2922,685,863,4817,3954,59,288
PI,10391,BURITI DOS LOPES,6819,3225,2116,12627,10511,91,376
PI,10405,PASSAGEM FRANCA DO PIAUÍ,2076,240,952,3388,2436,12,108
PI,10413,CAMPINAS DO PIAUÍ,2264,1003,769,4211,3442,30,145
PI,10421,QUEIMADA NOVA,3716,557,1255,5822,4567,54,240
PI,10430,CAMPO MAIOR,19813,5341,6602,32955,26353,228,971
PI,10448,SANTA CRUZ DOS MILAGRES,1668,244,968,2984,2016,18,86
PI,10456,CANTO DO BURITI,7856,2720,2779,13943,11164,110,478
PI,10464,SANTA ROSA DO PIAUÍ,1953,816,874,3807,2933,19,145
PI,10472,CAPITÃO DE CAMPOS,4075,1661,2114,8271,6157,77,344
PI,10480,SANTANA DO PIAUÍ,2535,365,584,3639,3055,23,132
PI,10499,CARACOL,4531,609,809,6280,5471,46,285
PI,10502,SÃO BRAZ DO PIAUÍ,2256,208,595,3173,2578,14,100
PI,10510,CASTELO DO PIAUÍ,8057,1892,3881,14488,10607,109,549
PI,10529,SÃO JOSÉ DO DIVINO,2301,960,766,4184,3418,23,134
PI,10537,COCAL,7070,5560,4577,18060,13483,154,699
PI,10545,SIGEFREDO PACHECO,3815,1167,1290,6528,5238,45,211
PI,10553,CONCEIÇÃO DO CANINDÉ,2198,577,892,3852,2960,36,149
PI,10561,SÃO LOURENÇO DO PIAUÍ,2809,408,874,4268,3394,21,156
PI,10570,CORRENTE,8071,2724,3521,14951,11430,101,534
PI,10588,VÁRZEA BRANCA,2201,322,802,3454,2652,14,115
PI,10596,CRISTALÂNDIA DO PIAUÍ,2546,1068,1568,5383,3815,17,184
PI,10600,BARRA D'ALCÂNTARA,1212,694,912,2932,2020,23,91
PI,10618,CRISTINO CASTRO,3943,619,1427,6325,4898,46,290
PI,10626,BELA VISTA DO PIAUÍ,1969,160,252,2526,2274,35,110
PI,10634,CURIMATÁ,4184,1488,1551,7484,5933,51,210
PI,10642,BREJO DO PIAUÍ,2238,200,488,3061,2573,19,116
PI,10650,DEMERVAL LOBÃO,5928,1373,1675,9363,7688,63,324
PI,10669,BOA HORA,2076,1091,859,4176,3317,24,126
PI,10677,DOM EXPEDITO LOPES,3594,767,1012,5537,4525,23,141
PI,10685,DOM INOCÊNCIO,4577,413,1189,6495,5306,37,279
PI,10693,ELESBÃO VELOSO,6778,1244,3868,12360,8492,50,420
PI,10707,CAPITÃO GERVÁSIO OLIVEIRA,2017,378,518,3061,2543,19,129
PI,10715,ELISEU MARTINS,2223,514,678,3535,2857,19,101
PI,10723,CAMPO GRANDE DO PIAUÍ,2592,421,480,3686,3206,30,163
PI,10731,ESPERANTINA,13562,5279,5810,25716,19906,179,886
PI,10740,CAMPO LARGO DO PIAUÍ,2371,527,993,4082,3089,22,169
PI,10758,FLORES DO PIAUÍ,1708,846,811,3522,2711,22,135
PI,10766,CURRAIS,2428,539,903,4037,3134,17,150
PI,10774,FLORIANO,21698,6268,8156,37174,29018,260,792
PI,10782,GEMINIANO,2555,668,722,4185,3463,38,202
PI,10790,FRANCINÓPOLIS,2133,662,1399,4354,2955,25,135
PI,10804,GUARIBAS,2263,152,702,3214,2512,9,88
PI,10812,FRANCISCO AYRES,2205,542,1031,3913,2882,16,119
PI,10820,ILHA GRANDE,3167,907,637,4916,4279,33,172
PI,10839,FRANCISCO SANTOS,3391,1071,1207,5932,4725,65,198
PI,10847,JUREMA,2139,723,592,3614,3022,18,142
PI,10855,FRONTEIRAS,4879,1033,1779,7985,6206,40,254
PI,10863,LAGOA DE SÃO FRANCISCO,2514,582,640,3897,3257,34,127
PI,10871,GILBUÉS,3636,995,1885,6778,4893,31,231
PI,10880,MORRO CABEÇA NO TEMPO,1556,723,672,3146,2474,33,162
PI,10898,GUADALUPE,3801,1305,1870,7175,5305,42,157
PI,10901,NOVO SANTO ANTÔNIO,1671,344,698,2841,2143,17,111
PI,10910,HUGO NAPOLEÃO,1959,413,841,3329,2488,26,90
PI,10928,NOSSA SENHORA DE NAZARÉ,2496,442,830,3924,3094,24,132
PI,10936,INHUMA,6734,1078,2623,10907,8284,75,397
PI,10944,PAQUETÁ,2307,288,803,3551,2748,8,145
PI,10952,IPIRANGA DO PIAUÍ,4257,544,1338,6461,5123,48,274
PI,10960,NOVA SANTA RITA,2149,355,631,3261,2630,14,112
PI,10979,ISAÍAS COELHO,3074,993,1363,5705,4342,41,234
PI,10987,SÃO JOÃO DO ARRAIAL,2732,1373,792,5083,4291,31,155
PI,10995,ITAINÓPOLIS,4812,1618,1560,8374,6814,82,302
PI,11010,ITAUEIRA,3712,1573,2607,8254,5647,86,276
PI,11037,JAICÓS,6197,1725,2627,11170,8543,103,518
PI,11053,JERUMENHA,1740,777,983,3644,2661,34,110
PI,11070,JOAQUIM PIRES,5357,1642,1799,9199,7400,59,342
PI,11088,SÃO JOÃO DA CANABRAVA,2156,678,750,3734,2984,22,128
PI,11096,JOSÉ DE FREITAS,16228,2953,4805,24845,20040,202,657
PI,11118,LANDRI SALES,2212,599,1219,4178,2959,22,126
PI,11134,LUIS CORREIA,10100,5062,4286,20186,15900,136,602
PI,11150,LUZILÂNDIA,9849,2715,3465,16726,13261,125,572
PI,11177,MANOEL EMÍDIO,2574,405,759,3887,3128,24,125
PI,11193,MARCOS PARENTE,1570,980,1025,3700,2675,27,98
PI,11215,MATIAS OLÍMPIO,3240,2098,1647,7321,5674,45,291
PI,11231,MIGUEL ALVES,10831,3223,4910,20010,15100,148,898
PI,11258,MIGUEL LEÃO,628,93,212,960,748,2,25
PI,11274,MONSENHOR GIL,5376,865,1827,8309,6482,53,188
PI,11290,MONSENHOR HIPÓLITO,2923,1562,852,5626,4774,45,244
PI,11312,MONTE ALEGRE DO PIAUÍ,3735,1245,1744,6963,5219,30,209
PI,11339,NAZARÉ DO PIAUÍ,3798,531,1371,5978,4607,42,236
PI,11355,NOSSA SENHORA DOS REMÉDIOS,3171,1191,1216,5837,4621,36,223
PI,11371,NOVO ORIENTE DO PIAUÍ,2998,410,1259,4883,3624,41,175
PI,11398,OEIRAS,13327,4335,4554,23117,18563,154,747
PI,11410,DOMINGOS MOURÃO,1679,547,568,2927,2359,20,113
PI,11436,PADRE MARCOS,2977,975,1113,5296,4183,45,186
PI,11452,PAES LANDIM,1717,832,671,3333,2662,21,92
PI,11479,PALMEIRA DO PIAUÍ,2068,692,797,3712,2915,28,127
PI,11495,PALMEIRAIS,6083,1155,1708,9323,7615,74,303
PI,11517,PARNAGUÁ,3721,520,1337,5784,4447,30,176
PI,11533,PARNAÍBA,47062,18153,18834,86242,67408,497,1696
PI,11550,PAULISTANA,9052,958,2483,13050,10567,78,479
PI,11576,PEDRO II,12064,4779,4632,22415,17783,179,761
PI,11592,PICOS,26209,8468,7566,43774,36208,329,1202
PI,11614,PIMENTEIRAS,4681,1353,1800,8095,6295,41,220
PI,11630,PIO IX,7523,1903,2167,12079,9912,76,410
PI,11657,PIRACURUCA,9945,3980,3765,18377,14612,110,577
PI,11673,PIRIPIRI,20867,9286,9262,40961,31699,357,1189
PI,11690,PORTO,4080,976,1912,7297,5385,56,273
PI,11711,PRATA DO PIAUÍ,1531,487,1074,3198,2124,14,92
PI,11738,REDENÇÃO DO GURGUÉIA,3012,1137,1136,5492,4356,34,173
PI,11754,REGENERAÇÃO,7329,941,3251,12039,8788,65,453
PI,11770,RIBEIRO GONÇALVES,2094,1076,1408,4753,3345,26,149
PI,11797,RIO GRANDE DO PIAUÍ,2640,1137,1573,5564,3991,24,190
PI,11819,SANTA CRUZ DO PIAUÍ,2964,432,1107,4715,3608,35,177
PI,11835,SANTA FILOMENA,1476,1248,903,3839,2936,35,177
PI,11851,SANTA LUZ,2394,666,624,3843,3219,26,133
PI,11878,SANTO ANTÔNIO DE LISBOA,2745,723,698,4383,3685,64,153
PI,11894,SANTO INÁCIO DO PIAUÍ,1691,351,594,2740,2146,11,93
PI,11916,SÃO FÉLIX DO PIAUÍ,1768,273,1107,3230,2123,12,70
PI,11932,SÃO FRANCISCO DO PIAUÍ,2736,634,1179,4787,3608,31,207
PI,11959,SÃO GONÇALO DO PIAUÍ,2410,439,716,3677,2961,15,97
PI,11975,SÃO JOÃO DA SERRA,2486,1391,1751,5854,4103,36,190
PI,11991,SÃO JOÃO DO PIAUÍ,6104,2757,2513,11859,9346,84,401
PI,12009,SÃO JOÃO DA FRONTEIRA,2323,484,863,3822,2959,30,122
PI,12017,SÃO JOSÉ DO PEIXE,1438,509,631,2713,2082,28,107
PI,12025,SÃO JOÃO DA VARJOTA,2090,402,555,3211,2656,25,139
PI,12033,SÃO JOSÉ DO PIAUÍ,3470,626,837,5158,4321,33,192
PI,12041,SEBASTIÃO BARROS,1951,473,1106,3675,2569,14,131
PI,12050,SÃO JULIÃO,2856,652,762,4487,3725,19,198
PI,12068,SEBASTIÃO LEAL,1642,559,543,2849,2306,24,81
PI,12076,SÃO MIGUEL DO TAPUIO,7448,2467,3655,14172,10517,77,525
PI,12084,ALVORADA DO GURGUÉIA,2368,171,597,3259,2662,13,110
PI,12092,SÃO PEDRO DO PIAUÍ,5424,1843,2004,9626,7622,70,285
PI,12106,ASSUNÇÃO DO PIAUÍ,1916,1899,1366,5461,4095,45,235
PI,12114,SÃO RAIMUNDO NONATO,11730,2878,3098,18284,15186,99,479
PI,12122,BETÂNIA DO PIAUÍ,2857,410,955,4383,3428,17,144
PI,12130,SIMÕES,5752,908,2437,9642,7205,87,458
PI,12149,BOQUEIRÃO DO PIAUÍ,2427,449,1236,4293,3057,35,146
PI,12157,SIMPLÍCIO MENDES,4514,1859,1862,8523,6661,71,217
PI,12165,CARIDADE DO PIAUÍ,2408,290,730,3606,2876,21,157
PI,12173,SOCORRO DO PIAUÍ,2092,593,831,3688,2857,23,149
PI,12181,CURRAL NOVO DO PIAUÍ,1929,268,780,3146,2366,24,145
PI,12190,TERESINA,298190,83968,76118,470213,394095,2703,9234
PI,12203,JÚLIO BORGES,2478,238,818,3703,2885,17,152
PI,12211,UNIÃO,18373,3556,5854,28970,23116,184,1003
PI,12220,LAGOA DO SÍTIO,2457,291,739,3656,2917,19,150
PI,12238,URUÇUÍ,4017,4643,3344,12495,9151,106,385
PI,12246,MILTON BRANDÃO,3013,739,1233,5194,3961,34,175
PI,12254,VALENÇA DO PIAUÍ,8719,2169,3666,15252,11586,124,574
PI,12262,PAJEÚ DO PIAUÍ,1335,510,913,2865,1952,10,97
PI,12270,VÁRZEA GRANDE,1573,790,1016,3604,2588,35,190
PI,12289,PAVUSSU,2122,254,932,3419,2487,12,99
PI,12297,DIRCEU ARCOVERDE,2960,565,1079,4801,3722,19,178
PI,12300,RIACHO FRIO,2547,305,886,3846,2960,10,98
PI,12319,ALAGOINHA,2410,2073,879,5660,4781,41,257
PI,12327,ACAUÃ,3367,374,756,4658,3902,31,130
PI,12335,BELÉM DO PIAUÍ,1447,388,370,2313,1943,22,86
PI,12343,CAJAZEIRAS DO PIAUÍ,1341,426,594,2483,1889,26,96
PI,12351,CAMPO ALEGRE DO FIDALGO,1984,682,703,3503,2800,21,113
PI,12360,COCAL DE TELHA,2465,302,952,3884,2932,34,131
PI,12378,FRANCISCO MACEDO,1059,494,269,1908,1639,14,72
PI,12386,JOÃO COSTA,1724,343,497,2681,2184,20,97
PI,12394,JATOBÁ DO PIAUÍ,2601,588,970,4310,3340,25,126
PI,12408,JOCA MARQUES,1628,836,660,3283,2623,20,139
PI,12416,JUAZEIRO DO PIAUÍ,3153,852,1272,5456,4184,38,141
PI,12424,LAGOA DO PIAUÍ,1870,465,537,3006,2469,23,111
PI,12432,LAGOINHA DO PIAUÍ,1377,196,467,2105,1638,13,52
PI,12440,MADEIRO,2440,1203,1073,4917,3844,26,175
PI,12459,MORRO DO CHAPÉU DO PIAUÍ,2356,1280,1036,4838,3802,18,148
PI,12467,MASSAPÊ DO PIAUÍ,3022,726,755,4848,4093,54,291
PI,12475,MURICI DOS PORTELAS,2493,1172,1264,5167,3903,59,179
PI,12483,OLHO D'ÁGUA DO PIAUÍ,1396,171,520,2167,1647,9,71
PI,12491,PEDRO LAURENTINO,1305,312,505,2210,1705,13,75
PI,12505,SÃO FRANCISCO DE ASSIS DO PIAUÍ,2006,800,557,3557,3000,35,159
PI,12513,SUSSUAPARA,2953,993,720,4868,4148,45,157
PI,12521,TANQUE DO PIAUÍ,1222,271,411,1992,1581,18,70
PI,12530,TAMBORIL DO PIAUÍ,802,1001,497,2408,1911,7,101
PI,12548,VILA NOVA DO PIAUÍ,1629,266,260,2273,2013,23,95
PI,12556,VERA MENDES,1492,394,589,2637,2048,27,135
PI,12564,WALL FERRAZ,2281,265,713,3434,2721,29,146
PI,12572,CAJUEIRO DA PRAIA,3044,773,1090,5057,3967,30,120
PI,12580,CURRALINHOS,2213,397,499,3214,2715,13,92
PI,12599,PORTO ALEGRE DO PIAUÍ,978,307,361,1702,1341,10,46
PI,12602,RIBEIRA DO PIAUÍ,1942,388,799,3263,2464,18,116
PI,12610,SÃO GONÇALO DO GURGUÉIA,1242,165,554,2029,1475,12,56
PI,12629,SÃO LUIS DO PIAUÍ,1187,458,398,2134,1736,10,81
PI,12637,FLORESTA DO PIAUÍ,1322,250,433,2129,1696,12,112
PI,12653,SANTO ANTÔNIO DOS MILAGRES,1147,87,278,1555,1277,8,35
PI,12661,SÃO MIGUEL DA BAIXA GRANDE,1231,267,489,2071,1582,17,67
PI,12670,CARAÚBAS DO PIAUÍ,1823,1214,1045,4296,3251,42,172
PI,12688,CAXINGÓ,1738,1087,1110,4097,2987,28,134
PI,12696,COCAL DOS ALVES,1991,1092,884,4184,3300,49,168
PI,12700,SÃO MIGUEL DO FIDALGO,1454,260,402,2211,1809,18,77
PI,12718,PAU D'ARCO DO PIAUÍ,1962,347,713,3132,2419,15,95
PI,12726,NAZÁRIA,4529,867,1595,7239,5644,38,210
PI,12734,AROEIRAS DO ITAIM,1804,435,716,3088,2372,27,106
PR,74004,GODOY MOREIRA,1091,879,707,2911,2204,21,213
PR,74012,ABATIÁ,1884,2454,1019,5755,4736,67,331
PR,74020,IBEMA,1812,1176,728,3959,3231,22,221
PR,74039,ADRIANÓPOLIS,2214,885,1224,4774,3550,41,410
PR,74047,LINDOESTE,2081,1053,862,4234,3372,31,207
PR,74055,AGUDOS DO SUL,2378,2435,1209,6460,5251,83,355
PR,74063,OURO VERDE DO OESTE,1691,1614,685,4255,3570,37,228
PR,74071,ALMIRANTE TAMANDARÉ,26844,13756,6019,50783,44764,728,3436
PR,74080,SANTA TEREZA DO OESTE,2565,1952,811,5701,4890,53,320
PR,74098,ALTO PARANÁ,3326,3322,1471,8870,7399,92,659
PR,74101,ANAHY,1013,820,490,2469,1979,17,129
PR,74110,ALTO PIQUIRI,3167,2278,1647,7716,6069,88,536
PR,74128,ÂNGULO,755,1025,422,2338,1916,20,116
PR,74136,ALVORADA DO SUL,2887,2056,1834,7183,5349,49,357
PR,74144,BOA ESPERANÇA DO IGUAÇU,1075,714,433,2347,1914,30,95
PR,74152,AMAPORÃ,1295,1021,358,2906,2548,32,200
PR,74160,BOM SUCESSO DO SUL,1118,1014,275,2568,2293,31,130
PR,74179,AMPÉRE,5945,2765,1671,11005,9334,79,545
PR,74187,BRASILÂNDIA DO SUL,1089,988,699,3016,2317,26,214
PR,74195,ANDIRÁ,7251,5080,3550,17155,13605,188,1086
PR,74209,CAFEZAL DO SUL,1166,1403,715,3501,2786,29,188
PR,74217,ANTONINA,5492,5179,3393,14965,11572,142,759
PR,74225,CANDÓI,4331,3146,2275,10558,8283,89,717
PR,74233,ANTONIO OLINTO,1699,2575,742,5524,4782,100,408
PR,74241,CRUZEIRO DO IGUAÇU,1424,663,444,2691,2247,21,139
PR,74250,APUCARANA,22826,40469,14903,83938,69035,1133,4607
PR,74268,DIAMANTE DO SUL,1198,638,715,2719,2004,10,158
PR,74276,ARAPONGAS,20731,33008,11850,70408,58558,911,3908
PR,74284,ENTRE RIOS DO OESTE,1138,1297,361,2907,2546,16,95
PR,74292,ARAPOTI,6102,7509,2458,17214,14756,186,959
PR,74306,FAROL,1129,937,693,2935,2242,31,145
PR,74314,ARARUNA,3433,4023,1992,10062,8070,84,530
PR,74322,FAZENDA RIO GRANDE,23580,9917,8183,44356,36173,463,2213
PR,74330,MARILÂNDIA DO SUL,2301,2827,1127,6749,5622,71,423
PR,74349,FLOR DA SERRA DO SUL,1917,1119,610,3851,3241,45,160
PR,74357,ARAUCÁRIA,40229,20192,10984,76459,65475,823,4231
PR,74365,HONÓRIO SERPA,2297,972,1244,4744,3500,29,202
PR,74373,ASSAÍ,3346,6152,2972,13250,10278,125,655
PR,74381,IGUATU,897,590,225,1797,1572,8,77
PR,74390,ASTORGA,6153,8318,3655,19375,15720,228,1021
PR,74403,IRACEMA DO OESTE,1096,649,405,2348,1943,20,178
PR,74411,ATALAIA,1219,1227,442,3059,2617,35,136
PR,74420,NOVO ITACOLOMI,707,1172,317,2336,2019,27,113
PR,74438,BALSA NOVA,3974,2893,871,8325,7454,108,479
PR,74446,ITAPERUÇU,8794,3300,2383,15493,13110,130,886
PR,74454,BANDEIRANTES,10347,7852,4388,24392,20004,248,1557
PR,74462,IVATÉ,2478,1530,1371,5814,4443,60,375
PR,74470,BARBOSA FERRAZ,3689,2830,2438,9703,7265,86,660
PR,74489,LIDIANÓPOLIS,1112,1355,795,3528,2733,34,232
PR,74497,BARRACÃO,2594,1900,852,5630,4778,43,241
PR,74500,MARIPÁ,1113,2608,495,4375,3880,35,124
PR,74519,BARRA DO JACARÉ,955,695,304,2156,1852,20,182
PR,74527,MATO RICO,1434,938,445,3056,2611,34,205
PR,74535,BELA VISTA DO PARAÍSO,3873,5259,2539,12530,9991,110,749
PR,74543,MAUÁ DA SERRA,1683,2546,1020,5649,4629,57,343
PR,74551,BITURUNA,4075,4307,1971,11224,9253,106,765
PR,74560,MERCEDES,1376,1764,422,3737,3315,24,151
PR,74578,BOA ESPERANÇA,1346,1618,727,3912,3185,48,173
PR,74586,NOVA LARANJEIRAS,2587,2247,2182,7559,5377,63,480
PR,74594,BOCAIÚVA DO SUL,2652,2456,856,6484,5628,70,450
PR,74608,NOVA SANTA BÁRBARA,1212,1049,629,3136,2507,32,214
PR,74616,BOM SUCESSO,2202,1290,815,4716,3901,39,370
PR,74624,PATO BRAGADO,1470,1703,558,3872,3314,14,127
PR,74632,BORRAZÓPOLIS,2136,2807,1414,6798,5384,70,371
PR,74640,PINHAL DE SÃO BENTO,1176,268,286,1836,1550,12,94
PR,74659,CAFEARA,1105,479,307,2073,1766,23,159
PR,74667,PITANGUEIRAS,661,1045,272,2093,1821,19,96
PR,74675,CALIFÓRNIA,2011,2579,1094,6093,4999,102,307
PR,74683,QUATRO PONTES,737,1693,330,2883,2553,14,109
PR,74691,CAMBARÁ,6955,6592,2990,17908,14918,210,1161
PR,74705,RAMILÂNDIA,1234,904,486,2865,2379,23,218
PR,74713,CAMBÉ,23230,27278,10583,65863,55280,794,3978
PR,74721,RANCHO ALEGRE D'OESTE,828,803,319,2100,1781,18,132
PR,74730,CAMBIRA,2261,2166,784,5553,4769,65,277
PR,74748,RIO BONITO DO IGUAÇU,4124,2071,2247,9027,6780,65,520
PR,74756,CAMPINA DA LAGOA,4301,3878,2462,11454,8992,114,699
PR,74764,SANTA LÚCIA,1493,758,724,3201,2477,31,195
PR,74772,CAMPINA GRANDE DO SUL,11582,7736,4913,25951,21038,300,1420
PR,74780,CAMPO BONITO,1619,854,925,3596,2671,23,175
PR,74799,CAMPO DO TENENTE,1303,2313,728,4643,3915,45,254
PR,74802,SANTA MARIA DO OESTE,3579,2098,2506,8694,6188,59,452
PR,74810,CAMPO LARGO,31011,24628,9530,70634,61104,1226,4239
PR,74829,SANTA MÔNICA,1196,694,496,2570,2074,17,167
PR,74837,CAMPO MOURÃO,21511,21673,12391,58589,46198,493,2521
PR,74845,SÃO MANOEL DO PARANÁ,459,890,217,1685,1468,15,104
PR,74853,CÂNDIDO DE ABREU,4860,4286,1939,11831,9892,92,654
PR,74861,SÃO PEDRO DO IGUAÇU,2215,1838,1013,5510,4497,57,387
PR,74870,CAPANEMA,5853,4594,1511,12541,11030,91,492
PR,74888,TUNAS DO PARANÁ,1487,1178,1021,4063,3042,29,348
PR,74896,CAPITÃO LEÔNIDAS MARQUES,5380,2558,2059,10606,8547,82,527
PR,74900,VENTANIA,2199,2887,1109,6677,5568,55,427
PR,74918,CARLÓPOLIS,3781,3490,2067,10069,8002,109,622
PR,74926,ALTO PARAÍSO,970,825,842,2860,2018,26,197
PR,74934,CASCAVEL,69931,64738,32900,177768,144868,1924,8275
PR,74942,DOUTOR ULYSSES,1974,1312,479,4142,3663,49,328
PR,74950,CASTRO,14654,20305,7478,45773,38295,570,2766
PR,74969,VIRMOND,1094,1384,534,3171,2637,36,123
PR,74977,CATANDUVAS,2564,2589,1307,6925,5618,68,397
PR,74985,LARANJAL,2109,843,1394,4682,3288,23,313
PR,74993,CENTENÁRIO DO SUL,3884,1995,1427,7966,6539,79,581
PR,75000,ITAIPULÂNDIA,3100,1947,1082,6462,5380,35,298
PR,75019,CERRO AZUL,5891,2588,1464,10784,9320,132,709
PR,75027,NOVA ESPERANÇA DO SUDOESTE,2247,893,767,4131,3364,30,194
PR,75035,CHOPINZINHO,6484,4423,3016,14731,11715,125,683
PR,75043,PINHAIS,35654,22718,13402,77048,63646,1161,4113
PR,75051,CIANORTE,13788,21592,8762,47204,38442,580,2482
PR,75060,SAUDADE DO IGUAÇU,1517,961,670,3360,2690,30,182
PR,75078,CIDADE GAÚCHA,3756,2109,1261,7606,6345,53,427
PR,75086,ARIRANHA DO IVAÍ,920,628,408,2078,1670,14,108
PR,75094,CLEVELÂNDIA,5290,3969,3370,13399,10029,99,671
PR,75108,ARAPUÃ,1450,1000,475,3154,2679,23,206
PR,75116,MANGUEIRINHA,5991,3395,3281,13501,10220,78,756
PR,75124,BELA VISTA DA CAROBA,1542,826,399,2947,2548,34,146
PR,75132,COLOMBO,61101,32250,18167,120274,102107,1680,7076
PR,75140,BOA VENTURA DE SÃO ROQUE,2163,1327,560,4327,3767,30,247
PR,75159,COLORADO,6301,5993,3553,17168,13615,266,1055
PR,75167,BOM JESUS DO SUL,1376,948,465,2944,2479,12,143
PR,75175,CONGONHINHAS,2391,1874,994,5712,4718,46,407
PR,75183,CAMPINA DO SIMÃO,1319,904,553,3000,2447,34,190
PR,75191,CONSELHEIRO MAIRINCK,1364,804,414,2788,2374,23,183
PR,75205,CAMPO MAGRO,6924,3887,1564,13424,11860,189,860
PR,75213,CONTENDA,4061,3852,1308,9878,8570,123,534
PR,75221,CARAMBEÍ,2966,6256,1730,11800,10070,165,683
PR,75230,CORBÉLIA,4255,5142,1763,11764,10001,97,507
PR,75248,CORONEL DOMINGOS SOARES,1779,1219,934,4217,3283,28,257
PR,75256,CORNÉLIO PROCÓPIO,12752,14492,7276,36744,29468,385,1839
PR,75264,CRUZMALTINA,893,1098,483,2668,2185,17,177
PR,75272,CORONEL VIVIDA,7388,5284,3964,17625,13661,155,834
PR,75280,CORUMBATAÍ DO SUL,1721,1029,1034,4083,3049,26,273
PR,75299,CRUZEIRO DO OESTE,7156,3759,2969,15143,12174,175,1084
PR,75302,ESPERANÇA NOVA,634,637,394,1791,1397,25,101
PR,75310,CRUZEIRO DO SUL,1621,1077,395,3373,2978,27,253
PR,75329,ESPIGÃO ALTO DO IGUAÇU,1436,1284,844,3789,2945,45,180
PR,75337,CRUZ MACHADO,4058,5791,1850,12500,10650,111,690
PR,75345,FERNANDES PINHEIRO,1518,1897,882,4630,3748,43,290
PR,75353,CURITIBA,454912,501954,183053,1217263,1034210,15900,61444
PR,75361,FOZ DO JORDÃO,1760,743,1031,3794,2763,20,240
PR,75370,CURIÚVA,3458,3792,2285,10422,8137,127,760
PR,75388,GOIOXIM,2370,1098,1147,4992,3845,32,345
PR,75396,DIAMANTE DO NORTE,1598,1613,1076,4594,3518,49,258
PR,75400,DIAMANTE DO OESTE,1698,840,468,3276,2808,22,248
PR,75418,DOIS VIZINHOS,9681,8194,4807,24009,19202,262,1065
PR,75426,GUAMIRANGA,1595,2874,793,5656,4863,74,320
PR,75434,DOUTOR CAMARGO,1481,2246,506,4504,3998,48,223
PR,75442,IMBAÚ,3014,1834,1389,6745,5356,70,438
PR,75450,ENÉAS MARQUES,2063,1513,743,4561,3818,37,205
PR,75469,MANFRINÓPOLIS,1371,518,308,2341,2033,21,123
PR,75477,ENGENHEIRO BELTRÃO,3906,4003,1508,10025,8517,95,513
PR,75485,MARQUINHO,1313,1187,1088,3838,2750,27,223
PR,75493,FAXINAL,3525,4836,3104,12265,9161,108,692
PR,75507,PEROBAL,1467,1636,906,4344,3438,46,289
PR,75515,FÊNIX,1242,1495,739,3711,2972,32,203
PR,75523,PONTAL DO PARANÁ,5062,3271,3046,11972,8926,87,506
PR,75531,FLORAÍ,1605,1921,686,4524,3838,55,257
PR,75540,PORTO BARREIRO,1095,1071,550,2878,2328,13,149
PR,75558,FLORESTA,1412,2231,659,4533,3874,37,194
PR,75566,PRADO FERREIRA,1444,750,501,2874,2373,24,155
PR,75574,FLORESTÓPOLIS,4679,2251,2220,9776,7556,67,559
PR,75582,QUARTO CENTENÁRIO,1431,1283,641,3645,3004,27,263
PR,75590,FLÓRIDA,992,609,299,2025,1726,20,105
PR,75604,RESERVA DO IGUAÇU,2298,1190,1261,5104,3843,39,316
PR,75612,FORMOSA DO OESTE,1622,2953,985,6012,5027,77,375
PR,75620,RIO BRANCO DO IVAÍ,958,1027,652,2849,2197,32,180
PR,75639,FOZ DO IGUAÇU,76010,51258,41054,178749,137695,1589,8838
PR,75647,SERRANÓPOLIS DO IGUAÇU,1156,1819,437,3535,3098,13,110
PR,75655,FRANCISCO BELTRÃO,23772,15282,10117,51880,41763,462,2247
PR,75663,TAMARANA,2144,3313,1574,7547,5973,78,438
PR,75671,GENERAL CARNEIRO,3213,3554,2080,9514,7434,95,572
PR,75698,GOIOERÊ,7062,7988,4180,20499,16319,193,1076
PR,75710,GUAÍRA,8434,6030,3025,18752,15727,166,1097
PR,75736,GUAIRAÇÁ,1328,1712,551,3893,3342,28,274
PR,75744,ROSÁRIO DO IVAÍ,1334,1818,1200,4699,3499,39,308
PR,75752,GUAPIRAMA,1291,1074,794,3407,2613,24,224
PR,75760,NOVA TEBAS,2594,1696,1419,6256,4837,51,496
PR,75779,GUAPOREMA,685,606,254,1643,1389,10,88
PR,75787,SULINA,1285,826,452,2741,2289,20,158
PR,75795,GUARACI,1255,1673,528,3668,3140,32,180
PR,75809,LUIZIANA,2477,1482,1180,5572,4392,54,379
PR,75817,GUARANIAÇU,4518,4147,1949,11367,9418,90,663
PR,75833,GUARAPUAVA,39961,42683,19393,108496,89103,1114,5345
PR,75850,GUARAQUEÇABA,2504,1532,1771,6158,4387,34,317
PR,75876,GUARATUBA,7398,7603,5463,21703,16240,163,1076
PR,75892,IBAITI,8135,6460,3588,19775,16187,189,1403
PR,75914,IBIPORÃ,9472,15380,6241,33627,27386,473,2061
PR,75930,ICARAÍMA,2282,2501,1089,6364,5275,69,423
PR,75957,IGUARAÇU,1270,1074,441,2942,2501,29,128
PR,75973,IMBITUVA,3498,11390,2469,18483,16014,168,958
PR,75990,INÁCIO MARTINS,2378,3493,1724,8258,6534,78,585
PR,76015,INAJÁ,1147,546,428,2333,1905,17,195
PR,76031,IPIRANGA,2538,5256,1468,9861,8393,101,498
PR,76058,IPORÃ,4258,4433,2664,12115,9451,120,640
PR,76074,IRATI,12754,17667,6458,39487,33029,502,2106
PR,76090,IRETAMA,3298,2490,1967,8470,6503,101,614
PR,76112,ITAGUAJÉ,1314,1184,718,3516,2798,36,264
PR,76139,ITAMBARACÁ,2296,1561,946,5274,4328,56,415
PR,76155,ITAMBÉ,1817,1544,698,4295,3597,41,195
PR,76171,ITAPEJARA DO OESTE,3611,2298,834,7191,6357,67,381
PR,76198,ITAÚNA DO SUL,1176,711,828,2907,2079,29,163
PR,76210,IVAÍ,1909,4994,676,8025,7349,67,379
PR,76236,IVAIPORÃ,8696,7808,3278,21214,17936,190,1242
PR,76252,IVATUBA,813,845,556,2349,1793,20,115
PR,76279,JABOTI,1513,1194,586,3535,2949,35,207
PR,76295,JACAREZINHO,12347,9191,7011,30332,23321,231,1552
PR,76317,JAGUAPITÃ,3082,3439,1693,8841,7148,105,522
PR,76333,JAGUARIAÍVA,8828,8511,4359,23348,18989,213,1437
PR,76350,JANDAIA DO SUL,5147,6429,2317,14897,12580,185,819
PR,76376,JANIÓPOLIS,2554,1527,1389,5879,4490,57,352
PR,76392,JAPIRA,1840,1028,725,3847,3122,31,223
PR,76414,JAPURÁ,1973,3125,902,6422,5520,97,325
PR,76430,JARDIM ALEGRE,3417,3292,1717,9035,7318,95,514
PR,76457,JARDIM OLINDA,592,336,263,1267,1004,7,69
PR,76473,JATAIZINHO,2876,3517,1848,8889,7041,101,547
PR,76490,JOAQUIM TÁVORA,2781,2785,995,7124,6129,92,471
PR,76511,JUNDIAÍ DO SUL,1195,576,629,2594,1965,16,178
PR,76538,JUSSARA,2012,1759,794,4931,4137,78,288
PR,76554,KALORÉ,1381,1592,684,3894,3210,38,199
PR,76570,LAPA,13555,11736,5171,32475,27304,382,1631
PR,76597,LARANJEIRAS DO SUL,8278,6596,5388,21466,16078,146,1058
PR,76619,LEÓPOLIS,1378,1149,522,3269,2747,24,196
PR,76635,LOANDA,5657,4783,3214,14596,11382,143,799
PR,76651,LOBATO,1608,937,448,3174,2726,34,147
PR,76678,LONDRINA,68064,186001,55732,332086,276354,3923,18366
PR,76694,LUPIONÓPOLIS,1443,1014,627,3375,2748,36,255
PR,76716,MALLET,2813,4616,1617,9669,8052,108,515
PR,76732,MAMBORÊ,3723,4642,2013,11074,9061,106,590
PR,76759,MANDAGUAÇU,5563,4613,2435,13676,11241,178,887
PR,76775,MANDAGUARI,9105,9433,4546,24819,20273,324,1411
PR,76791,MANDIRITUBA,6640,4490,2515,14640,12125,164,831
PR,76813,MANOEL RIBAS,3317,3918,1494,9234,7740,65,440
PR,76830,MARECHAL CÂNDIDO RONDON,11658,14014,4454,31759,27305,308,1325
PR,76856,MARIA HELENA,1789,1658,827,4580,3753,23,283
PR,76872,MARIALVA,7718,9791,4150,23128,18978,347,1122
PR,76899,MARILUZ,3374,2120,1560,7676,6116,84,538
PR,76910,MARINGÁ,69412,104352,39264,226025,186761,2452,10545
PR,76937,MARIÓPOLIS,1915,1807,498,4488,3990,40,228
PR,76953,MARMELEIRO,4192,2713,2069,9513,7444,96,443
PR,76970,MARUMBI,1485,1215,548,3537,2989,37,252
PR,76996,MATELÂNDIA,3501,4840,2224,11265,9041,144,556
PR,77011,MEDIANEIRA,10692,10940,5855,29132,23277,314,1331
PR,77038,MIRADOR,872,391,372,1756,1384,16,105
PR,77054,MIRASELVA,722,672,220,1708,1488,12,82
PR,77070,MOREIRA SALES,2992,3692,1896,9360,7464,123,657
PR,77097,MORRETES,4563,4855,3007,13325,10318,148,752
PR,77119,MUNHOZ DE MELLO,1067,1008,423,2721,2298,33,190
PR,77135,NOSSA SENHORA DAS GRAÇAS,1223,1029,607,3113,2506,42,212
PR,77151,NOVA ALIANÇA DO IVAÍ,469,391,197,1136,939,7,72
PR,77178,NOVA AMÉRICA DA COLINA,1121,937,491,2724,2233,25,150
PR,77194,NOVA CANTU,2557,1630,1916,6474,4558,31,340
PR,77216,NOVA ESPERANÇA,7701,7071,4723,20815,16092,237,1083
PR,77232,NOVA FÁTIMA,2345,1956,1284,6012,4728,62,365
PR,77259,NOVA LONDRINA,3270,3290,2861,10013,7152,79,513
PR,77275,ORTIGUEIRA,7210,4391,5993,18997,13004,156,1247
PR,77291,OURIZONA,1164,903,231,2500,2269,29,173
PR,77313,PAIÇANDU,10148,7026,4057,23001,18944,319,1451
PR,77330,PALMAS,8189,10073,5263,25387,20124,219,1643
PR,77356,PALMEIRA,7584,10736,3624,23337,19713,275,1118
PR,77372,PALMITAL,4545,3074,3925,12367,8442,80,743
PR,77399,PALOTINA,6837,8942,3626,20436,16810,157,874
PR,77410,PARAÍSO DO NORTE,3810,2528,1472,8393,6921,76,507
PR,77437,PARANACITY,2734,2388,1660,7243,5583,63,398
PR,77453,PARANAGUÁ,41837,31386,13033,91293,78260,896,4141
PR,77470,PARANAPOEMA,972,562,329,2013,1684,18,132
PR,77496,PARANAVAÍ,17655,24553,12549,58060,45511,534,2769
PR,77518,PATO BRANCO,18830,16283,8952,46560,37608,478,2017
PR,77534,PAULA FREITAS,1256,1877,413,3789,3376,51,192
PR,77550,PAULO FRONTIN,1440,2562,803,5070,4267,54,211
PR,77577,PEABIRU,3860,3388,2391,10309,7918,110,560
PR,77593,PÉROLA D'OESTE,2364,1816,843,5326,4483,53,250
PR,77615,PIÊN,1746,4156,569,6898,6329,71,356
PR,77631,PINHALÃO,1791,1799,1008,4942,3934,48,296
PR,77658,PINHÃO,8415,6409,4408,20764,16356,226,1306
PR,77674,PIRAÍ DO SUL,5374,7683,3139,17436,14297,259,981
PR,77690,PIRAQUARA,23340,11103,8223,45668,37445,550,2452
PR,77712,PITANGA,9473,8407,5967,25631,19664,213,1571
PR,77739,PLANALTINA DO PARANÁ,1346,965,509,3041,2532,44,177
PR,77755,PLANALTO,5446,2453,1623,9964,8341,78,364
PR,77771,PONTA GROSSA,56930,103507,30548,204026,173478,2384,10657
PR,77798,PORECATU,5471,2659,1829,10626,8797,91,576
PR,77810,PORTO AMAZONAS,986,1433,542,3212,2670,55,196
PR,77836,PORTO RICO,1007,573,268,1976,1708,10,118
PR,77852,PORTO VITÓRIA,960,1275,499,2940,2441,47,159
PR,77879,PRESIDENTE CASTELO BRANCO,1909,862,674,3659,2985,28,186
PR,77895,PRIMEIRO DE MAIO,2757,3587,1222,8057,6835,69,422
PR,77917,PRUDENTÓPOLIS,7565,19831,7159,36925,29766,357,2013
PR,77933,QUATIGUÁ,1917,2467,707,5434,4727,53,290
PR,77950,QUATRO BARRAS,4544,3935,1070,10287,9217,125,613
PR,77976,QUERÊNCIA DO NORTE,3659,1933,1806,7998,6192,62,538
PR,77992,QUINTA DO SOL,1590,1388,889,4171,3282,42,262
PR,78018,QUITANDINHA,4308,4398,1172,10649,9477,139,632
PR,78034,RANCHO ALEGRE,1317,1219,647,3389,2742,34,172
PR,78050,REALEZA,5484,3274,1849,11302,9453,109,586
PR,78077,REBOUÇAS,3613,4763,2031,11142,9111,129,606
PR,78093,RENASCENÇA,1988,1684,568,4499,3931,35,224
PR,78115,RESERVA,7186,5275,2432,16343,13911,190,1260
PR,78131,RIBEIRÃO CLARO,3178,2893,969,7686,6717,124,522
PR,78158,RIBEIRÃO DO PINHAL,4628,2689,3233,11231,7998,74,607
PR,78174,RIO AZUL,2023,5777,1372,9858,8486,87,599
PR,78190,RIO BOM,742,1366,463,2812,2349,50,191
PR,78212,RIO BRANCO DO SUL,11355,6419,2694,22115,19421,244,1403
PR,78239,RIO NEGRO,5029,11735,3460,21563,18103,278,1061
PR,78255,ROLÂNDIA,9818,21374,6806,40534,33728,549,1987
PR,78271,RONCADOR,3787,2965,2094,9451,7357,70,535
PR,78298,RONDON,2760,2437,1016,6726,5710,73,440
PR,78310,SABÁUDIA,1428,2036,359,4145,3786,68,254
PR,78336,SALGADO FILHO,1554,1136,643,3547,2904,40,174
PR,78352,SALTO DO ITARARÉ,1719,1285,672,3996,3324,35,285
PR,78379,SALTO DO LONTRA,4709,2125,1917,9353,7436,123,479
PR,78395,SANTA AMÉLIA,1092,1308,728,3405,2677,31,246
PR,78417,SANTA CECÍLIA DO PAVÃO,932,1266,727,3164,2437,28,211
PR,78433,SANTA CRUZ DO MONTE CASTELO,2385,1901,1030,5839,4809,73,450
PR,78450,SANTA FÉ,2445,2790,889,6606,5717,73,409
PR,78476,SANTA INÊS,631,596,366,1687,1321,11,83
PR,78492,SANTA ISABEL DO IVAÍ,2228,2630,1294,6666,5372,81,433
PR,78514,SANTA IZABEL DO OESTE,3507,2167,1235,7498,6263,87,502
PR,78530,SANTA MARIANA,4243,2902,1932,9739,7807,81,581
PR,78557,SANTANA DO ITARARÉ,1848,1161,750,3997,3247,34,204
PR,78573,SANTO ANTÔNIO DO SUDOESTE,5677,3191,1879,11536,9657,86,703
PR,78590,SANTO ANTÔNIO DA PLATINA,10486,10419,3885,26825,22940,340,1695
PR,78611,SANTO ANTONIO DO CAIUÁ,1017,645,447,2268,1821,15,144
PR,78638,SANTO ANTONIO DO PARAÍSO,778,714,417,2029,1612,15,105
PR,78654,SANTO INÁCIO,1756,1260,648,3925,3277,30,231
PR,78670,SÃO CARLOS DO IVAÍ,1324,1984,883,4524,3641,73,260
PR,78697,SÃO JERÔNIMO DA SERRA,3178,2696,1961,8476,6515,78,563
PR,78719,SÃO JOÃO,3781,2609,1236,8029,6793,73,330
PR,78735,SÃO JOÃO DO CAIUÁ,2292,971,1094,4703,3609,45,301
PR,78751,SÃO JOÃO DO IVAÍ,3872,2994,2128,9714,7586,87,633
PR,78778,SÃO JOÃO DO TRIUNFO,3292,4093,1433,9545,8112,138,589
PR,78794,SÃO JORGE DO IVAÍ,1436,1870,403,3942,3539,38,195
PR,78816,SÃO JORGE D'OESTE,2879,2417,1339,7101,5762,82,384
PR,78832,SÃO JOSÉ DA BOA VISTA,1621,1765,849,4487,3638,33,219
PR,78859,SÃO JOSÉ DOS PINHAIS,62538,50118,21488,143945,122457,2132,7669
PR,78875,SÃO MATEUS DO SUL,9405,12526,3966,27924,23958,361,1666
PR,78891,SÃO MIGUEL DO IGUAÇU,7965,6556,3975,19541,15566,114,931
PR,78913,SÃO PEDRO DO IVAÍ,2853,2267,1120,6734,5614,57,437
PR,78930,SÃO PEDRO DO PARANÁ,841,757,420,2193,1773,16,159
PR,78956,SÃO SEBASTIÃO DA AMOREIRA,2843,1967,1275,6488,5213,41,362
PR,78972,SÃO TOMÉ,1486,1772,667,4219,3552,49,245
PR,78999,SAPOPEMA,2179,1379,1009,4912,3903,56,289
PR,79014,SENGÉS,4183,5868,2439,13570,11131,107,973
PR,79030,SERTANEJA,1788,1928,910,4867,3957,45,196
PR,79057,SERTANÓPOLIS,3586,5931,2200,12459,10259,160,582
PR,79073,SIQUEIRA CAMPOS,5766,3976,2799,13487,10688,156,790
PR,79090,TAMBOARA,1225,1458,503,3457,2954,52,219
PR,79111,TAPEJARA,4654,2822,1559,9706,8147,116,555
PR,79138,TEIXEIRA SOARES,1842,3145,1198,6601,5403,69,347
PR,79154,TELÊMACO BORBA,20392,13606,8219,45021,36802,492,2312
PR,79170,TERRA BOA,3826,4805,1825,11218,9393,120,642
PR,79197,TERRA RICA,3980,3881,1933,10561,8628,133,634
PR,79219,TERRA ROXA,4035,5172,2471,12490,10019,129,683
PR,79235,TIBAGI,4973,4648,2697,13193,10496,104,771
PR,79251,TIJUCAS DO SUL,3220,3415,1822,9161,7339,130,574
PR,79278,TOLEDO,29943,29241,12476,76405,63929,744,4001
PR,79294,TOMAZINA,2220,2526,1262,6509,5247,73,428
PR,79316,TUNEIRAS DO OESTE,2130,2639,1107,6358,5251,60,422
PR,79332,UBIRATÃ,6270,5651,2827,15682,12855,142,792
PR,79359,UMUARAMA,22288,27846,15772,70062,54290,767,3389
PR,79375,UNIÃO DA VITÓRIA,11533,17122,7100,37784,30684,332,1697
PR,79391,UNIFLOR,926,632,263,1955,1692,21,113
PR,79413,URAÍ,3502,3225,1681,8998,7317,73,517
PR,79430,WENCESLAU BRAZ,4297,5702,2409,13386,10977,142,836
PR,79456,VERÊ,3146,1963,1016,6541,5525,83,333
PR,79472,VITORINO,1508,1762,819,4334,3515,39,206
PR,79499,XAMBRÊ,2176,1588,872,5002,4130,50,316
PR,79510,ALTÔNIA,4842,5864,2556,14342,11786,207,873
PR,79537,ASSIS CHATEAUBRIAND,7917,10644,4705,24797,20092,218,1313
PR,79553,QUEDAS DO IGUAÇU,8078,6086,5559,20888,15329,181,984
PR,79570,CÉU AZUL,2812,3444,1254,8008,6754,94,404
PR,79596,GRANDES RIOS,1922,1731,1186,5211,4025,48,324
PR,79618,INDIANÓPOLIS,1074,1281,500,3087,2587,50,182
PR,79634,MATINHOS,7129,6435,5399,20032,14633,218,851
PR,79650,NOVA AURORA,3434,3619,1503,9197,7694,103,538
PR,79677,NOVA OLÍMPIA,1956,1206,781,4290,3509,48,299
PR,79693,PÉROLA,2670,2606,869,6705,5836,118,442
PR,79715,SANTA HELENA,7352,6491,2240,16905,14665,139,683
PR,79731,TAPIRA,1653,1682,906,4561,3655,51,269
PR,79758,MARILENA,2181,1321,1257,5160,3903,43,358
PR,79774,FRANCISCO ALVES,1756,1928,969,4998,4029,77,268
PR,79790,NOVA SANTA ROSA,1341,3290,697,5568,4871,39,201
PR,79812,BOA VISTA DA APARECIDA,2652,1689,1283,6000,4717,66,310
PR,79839,BRAGANEY,1984,1415,830,4506,3676,27,250
PR,79855,CAFELÂNDIA,3677,3135,1460,8702,7242,64,366
PR,79871,TRÊS BARRAS DO PARANÁ,3183,3227,1605,8564,6959,77,472
PR,79898,VERA CRUZ DO OESTE,2269,2695,1232,6673,5441,51,426
PR,79910,PRANCHITA,2157,1351,583,4346,3763,44,211
PR,79936,TUPÃSSI,2302,2552,998,6213,5215,60,301
PR,79952,NOVA PRATA DO IGUAÇU,3591,2132,1787,7955,6168,77,368
PR,79979,JESUÍTAS,2246,2940,905,6636,5731,82,463
PR,79995,SÃO JORGE DO PATROCÍNIO,1876,1570,958,4738,3780,64,270
PR,84514,CANTAGALO,3580,2593,2628,9378,6750,50,527
PR,84530,TURVO,4486,3036,1641,9873,8232,78,632
PR,84557,ALTAMIRA DO PARANÁ,1561,879,1526,4237,2711,17,254
PR,84573,FIGUEIRA,2915,1564,1345,6286,4941,62,400
PR,84590,LUNARDELLI,1457,1651,853,4277,3424,37,279
PR,84611,SARANDI,21079,17310,9377,51597,42220,661,3170
PR,84638,JURANDA,2031,2359,1483,6202,4719,57,272
PR,84654,DOURADINA,2060,1675,915,4952,4037,48,254
PR,84670,SANTA TEREZINHA DE ITAIPU,5166,5709,2823,14569,11746,121,750
PR,84697,MISSAL,3657,3114,1227,8406,7179,54,354
PR,84719,SÃO JOSÉ DAS PALMEIRAS,1284,911,509,2926,2417,32,190
RJ,58009,QUISSAMÃ,7117,2267,2560,13177,10617,168,1065
RJ,58017,ANGRA DOS REIS,50413,22914,18566,100323,81757,1551,6879
RJ,58025,QUATIS,4158,2433,1268,8680,7412,98,723
RJ,58033,ARARUAMA,31637,19599,16225,74108,57883,1097,5550
RJ,58041,BELFORD ROXO,177273,32051,48057,280606,232549,3864,19361
RJ,58050,BARRA DO PIRAÍ,38344,12449,11251,67680,56429,900,4736
RJ,58068,CARDOSO MOREIRA,4964,2177,2014,10061,8047,139,767
RJ,58076,BARRA MANSA,67325,26192,18323,122702,104379,1760,9102
RJ,58084,VARRE E SAI,2553,2260,915,6512,5597,86,698
RJ,58092,BOM JARDIM,7362,5792,3747,19287,15540,416,1970
RJ,58106,GUAPIMIRIM,17133,4595,6275,30586,24311,314,2269
RJ,58114,BOM JESUS DO ITABAPOANA,11916,7684,4366,26257,21891,286,2005
RJ,58122,QUEIMADOS,53495,9392,14102,84460,70358,1229,6242
RJ,58130,CABO FRIO,47474,23908,19682,99804,80122,1798,6942
RJ,58149,JAPERI,35952,6454,10759,58769,48010,801,4803
RJ,58157,CACHOEIRAS DE MACACU,17893,7991,7493,37332,29839,611,3344
RJ,58165,COMENDADOR LEVY GASPARIAN,3363,1164,580,5693,5113,73,513
RJ,58173,CAMBUCI,5318,2897,2801,12153,9352,171,966
RJ,58181,APERIBÉ,3292,1897,966,6829,5863,115,559
RJ,58190,CAMPOS,154022,67129,58397,311678,253281,6526,25604
RJ,58203,RIO DAS OSTRAS,20097,8230,7518,39331,31813,657,2829
RJ,58211,CANTAGALO,5934,5629,2957,16184,13227,217,1447
RJ,58220,AREAL,3056,3110,867,7825,6958,122,670
RJ,58238,CARMO,6104,3178,1365,11834,10469,150,1037
RJ,58246,PINHEIRAL,8647,2279,2151,14125,11974,119,929
RJ,58254,CASIMIRO DE ABREU,9924,4181,2470,18302,15832,204,1523
RJ,58262,IGUABA GRANDE,6499,4228,2771,14745,11974,195,1052
RJ,58270,CONCEIÇÃO DE MACABU,7262,3410,3600,15797,12197,254,1271
RJ,58289,SÃO FRANCISCO DE ITABAPOANA,11821,8193,10220,32995,22775,597,2164
RJ,58297,CORDEIRO,6299,4011,2940,14807,11867,222,1335
RJ,58300,CARAPEBUS,4357,1806,1353,8345,6992,133,696
RJ,58319,DUAS BARRAS,2743,2585,983,7270,6287,122,837
RJ,58327,PORTO REAL,5866,1920,1324,10006,8682,118,778
RJ,58335,DUQUE DE CAXIAS,329489,78331,85038,543646,458608,8712,42076
RJ,58343,SÃO JOSÉ DE UBÁ,2386,1884,688,5445,4757,66,421
RJ,58351,ENGENHEIRO PAULO DE FRONTIN,5203,2316,1232,9851,8619,149,951
RJ,58360,TANGUÁ,11862,2966,3473,20023,16550,246,1476
RJ,58378,ITABORAÍ,81539,17383,21443,133258,111815,2096,10797
RJ,58386,MACUCO,2662,1313,876,5469,4593,65,553
RJ,58394,ITAGUAÍ,37817,14230,12546,70336,57790,1108,4635
RJ,58408,ARMAÇÃO DE BÚZIOS,8030,4989,2853,17229,14376,242,1115
RJ,58416,ITAOCARA,7104,5831,2551,17288,14737,366,1436
RJ,58424,SEROPÉDICA,23187,9520,7177,43829,36652,756,3189
RJ,58432,ITAPERUNA,30253,18799,14608,69947,55339,1042,5245
RJ,58440,ITATIAIA,9065,5352,3759,19737,15978,257,1304
RJ,58459,LAJE DO MURIAÉ,2841,1616,1530,6789,5259,110,692
RJ,58467,MESQUITA,71602,20456,19225,121970,102745,1984,8703
RJ,58475,MACAÉ,58359,17922,20981,106759,85778,1926,7571
RJ,58491,MAGÉ,90127,17251,24307,143646,119339,1714,10247
RJ,58513,MANGARATIBA,13453,5910,6400,28001,21601,368,1870
RJ,58530,MARICÁ,31190,15492,12912,65117,52205,924,4599
RJ,58556,MENDES,7083,3184,1693,13377,11684,219,1198
RJ,58572,MIGUEL PEREIRA,8125,5908,3165,19057,15892,261,1598
RJ,58599,MIRACEMA,9072,4670,5183,21070,15887,335,1810
RJ,58610,NATIVIDADE,4392,3931,2853,12403,9550,146,1081
RJ,58637,NILÓPOLIS,70236,19977,10802,110956,100154,1969,7972
RJ,58653,NITERÓI,159007,102027,37051,333078,296027,5786,29207
RJ,58670,NOVA FRIBURGO,51141,46356,23966,137454,113488,3180,12811
RJ,58696,NOVA IGUAÇU,283830,86083,81092,500226,419134,8558,40663
RJ,58718,PARACAMBI,16073,6637,2910,28453,25543,448,2385
RJ,58734,PARAÍBA DO SUL,13021,9164,6157,31205,25048,477,2386
RJ,58750,PARATI,8740,6585,4434,21673,17239,320,1594
RJ,58777,PETRÓPOLIS,90065,76316,36686,225658,188972,4139,18452
RJ,58793,PIRAÍ,9951,3187,1752,16273,14521,163,1220
RJ,58815,PORCIÚNCULA,5720,3049,3224,13256,10032,159,1104
RJ,58831,RESENDE,33330,23194,15605,78614,63009,1197,5288
RJ,58858,RIO BONITO,18848,10330,7413,40617,33204,671,3355
RJ,58874,RIO CLARO,6667,2918,2764,13660,10896,178,1133
RJ,58890,RIO DAS FLORES,3191,1478,910,6242,5332,54,609
RJ,58912,SANTA MARIA MADALENA,2954,2296,1482,7634,6152,107,795
RJ,58939,SANTO ANTÔNIO DE PÁDUA,13539,7064,6754,30335,23581,486,2492
RJ,58955,SÃO FIDÉLIS,10072,9678,7301,29786,22485,460,2275
RJ,58971,SÃO GONÇALO,368969,89680,98360,617268,518908,10396,49863
RJ,58998,SÃO JOÃO DA BARRA,11545,5508,4145,23607,19462,557,1852
RJ,59013,SÃO JOÃO DE MERITI,202024,47461,54287,334743,280456,5391,25580
RJ,59030,SÃO PEDRO DA ALDEIA,25452,10268,10379,50227,39848,812,3316
RJ,59056,SÃO SEBASTIÃO DO ALTO,2786,1967,1502,7038,5536,112,671
RJ,59072,SAPUCAIA,6306,4130,2481,14440,11959,225,1298
RJ,59099,SAQUAREMA,21108,12078,11944,49409,37465,638,3641
RJ,59110,SILVA JARDIM,6051,3958,3418,14976,11558,194,1355
RJ,59137,SUMIDOURO,4061,4804,2482,12553,10071,222,984
RJ,59153,TERESÓPOLIS,38170,42508,19773,112078,92305,2147,9480
RJ,59170,TRAJANO DE MORAIS,3939,1722,1458,8120,6662,128,873
RJ,59196,TRÊS RIOS,30561,11209,9500,56092,46592,770,4052
RJ,59218,VALENÇA,27881,11633,10333,54919,44586,651,4421
RJ,59234,VASSOURAS,11223,7510,5432,26798,21366,386,2247
RJ,59250,VOLTA REDONDA,121582,34716,31380,202805,171425,2479,12648
RJ,59277,ARRAIAL DO CABO,9704,5097,3941,20468,16527,378,1348
RJ,59293,ITALVA,4619,2768,1808,10078,8270,171,712
RJ,59315,PATI DO ALFERES,8011,5554,4160,19573,15413,262,1586
RJ,59331,SÃO JOSÉ DO VALE DO RIO PRETO,4243,5823,2228,13531,11303,186,1051
RJ,60011,RIO DE JANEIRO,2143210,1108495,816704,4534940,3718236,89014,377517
RN,16004,TENENTE LAURENTINO CRUZ,2565,462,643,4131,3488,41,420
RN,16012,ACARI,4891,1949,1475,8956,7481,104,537
RN,16020,SERRA DO MEL,4226,1023,1473,7282,5809,80,480
RN,16039,AÇU,21256,5805,5309,34922,29613,357,2195
RN,16047,CAIÇARA DO NORTE,2411,959,1100,4847,3747,46,331
RN,16055,AFONSO BEZERRA,4597,1919,1624,8861,7237,109,612
RN,16063,SÃO MIGUEL DO GOSTOSO,3383,1080,791,5776,4985,47,475
RN,16071,ÁGUA NOVA,1498,105,379,2201,1822,18,201
RN,16080,ITAJÁ,3094,1140,702,5358,4656,49,373
RN,16098,ALEXANDRIA,6646,778,1263,9489,8226,64,738
RN,16101,BODÓ,1491,300,401,2448,2047,35,221
RN,16110,ALMINO AFONSO,2902,544,966,4786,3820,57,317
RN,16128,TRIUNFO POTIGUAR,2071,483,583,3414,2831,32,245
RN,16136,ALTO DO RODRIGUES,5385,1285,1016,8455,7439,121,648
RN,16144,FERNANDO PEDROSA,1504,692,320,2736,2416,32,188
RN,16152,ANGICOS,4619,2478,1055,8800,7745,113,535
RN,16160,MAJOR SALES,1767,149,524,2645,2121,15,190
RN,16179,ANTÔNIO MARTINS,3721,532,749,5524,4775,71,451
RN,16187,VENHA VER,1658,341,696,3090,2394,32,363
RN,16195,APODI,16330,3750,3555,25474,21919,337,1502
RN,16209,SERRINHA DOS PINTOS,2167,661,716,3907,3191,37,326
RN,16217,AREIA BRANCA,10893,3879,3490,19808,16318,289,1257
RN,16225,TIBAU,1709,463,466,2911,2445,45,228
RN,16233,ARÊS,5990,1225,1703,9894,8191,117,859
RN,16241,SANTA MARIA,1940,846,497,3592,3095,39,270
RN,16250,CAMPO GRANDE,4879,913,1310,7644,6334,95,447
RN,16268,RIO DO FOGO,3055,2500,2087,8241,6154,76,523
RN,16276,BAÍA FORMOSA,3196,1128,1613,6467,4854,97,433
RN,16284,PORTO DO MANGUE,2320,448,492,3609,3117,26,323
RN,16292,BARCELONA,1754,1126,512,3704,3192,39,273
RN,16306,JUNDIÁ,1512,700,261,2760,2499,29,258
RN,16314,BENTO FERNANDES,2255,767,431,3793,3362,37,303
RN,16330,BOM JESUS,3307,1725,1877,7515,5638,61,545
RN,16357,BREJINHO,3428,2333,1522,8117,6595,103,731
RN,16373,CAIÇARA DO RIO DO VENTO,1474,1202,614,3576,2962,31,255
RN,16390,CAICÓ,22418,9831,6858,41874,35016,507,2260
RN,16411,CAMPO REDONDO,4434,719,1483,7373,5890,101,636
RN,16438,CANGUARETAMA,10809,3094,4501,20491,15990,271,1816
RN,16454,CARAÚBAS,10121,2035,2862,16518,13656,283,1217
RN,16470,CARNAÚBA DOS DANTAS,2327,2084,612,5391,4779,86,282
RN,16497,CARNAUBAIS,4210,1943,932,7667,6735,78,504
RN,16519,CEARÁ-MIRIM,23265,7911,8224,43174,34950,529,3245
RN,16535,CERRO-CORÁ,3492,1777,1704,7767,6063,83,711
RN,16551,CORONEL EZEQUIEL,2332,642,675,4095,3420,48,398
RN,16578,CORONEL JOÃO PESSOA,2217,217,1029,3912,2883,32,417
RN,16594,CRUZETA,3674,1288,935,6403,5468,103,403
RN,16616,CURRAIS NOVOS,15296,7067,6313,31194,24881,425,2093
RN,16632,DOUTOR SEVERIANO,3326,393,1154,5443,4289,42,528
RN,16659,ENCANTO,2621,218,835,4102,3267,39,389
RN,16675,EQUADOR,2376,698,794,4273,3479,53,352
RN,16691,ESPÍRITO SANTO,3216,1570,1209,6584,5375,95,494
RN,16713,EXTREMOZ,7782,3853,3702,16641,12939,182,1122
RN,16730,FELIPE GUERRA,3989,650,425,5486,5061,72,350
RN,16756,FLORÂNIA,4103,1377,1021,7173,6152,93,579
RN,16772,FRANCISCO DANTAS,1615,356,408,2610,2202,15,216
RN,16799,GALINHOS,977,683,432,2251,1819,16,143
RN,16810,GOIANINHA,8526,3318,2410,16002,13592,269,1479
RN,16837,GOVERNADOR DIX-SEPT ROSADO,5686,1702,1577,9890,8313,194,731
RN,16853,GROSSOS,4203,1121,851,6727,5876,140,412
RN,16870,GUAMARÉ,5296,1961,1799,9850,8051,75,719
RN,16896,IELMO MARINHO,4468,2159,2376,9827,7451,83,741
RN,16918,IPANGUAÇU,7019,1545,1934,11391,9457,80,813
RN,16934,IPUEIRA,1081,329,150,1663,1513,26,77
RN,16950,ITAÚ,3025,394,548,4356,3808,60,329
RN,16977,JAÇANÃ,2852,1131,933,5542,4609,76,550
RN,16993,JANDAÍRA,2560,1132,880,5059,4179,62,425
RN,17019,JANDUÍS,2615,642,760,4361,3601,56,288
RN,17035,BOA SAÚDE,3202,1478,1146,6493,5347,71,596
RN,17051,JAPI,2466,1097,517,4461,3944,38,343
RN,17078,JARDIM DE ANGICOS,1513,420,408,2515,2107,20,154
RN,17094,JARDIM DE PIRANHAS,6278,1266,1772,10010,8238,93,601
RN,17116,JARDIM DO SERIDÓ,5150,2453,1380,9728,8348,176,569
RN,17132,JOÃO CÂMARA,12192,4690,4011,22727,18716,220,1614
RN,17159,JOÃO DIAS,1607,104,449,2449,2000,13,276
RN,17175,JOSÉ DA PENHA,3383,285,1216,5471,4255,49,538
RN,17191,JUCURUTU,7372,3415,2638,14467,11829,134,908
RN,17213,MESSIAS TARGINO,2307,405,378,3372,2994,42,240
RN,17230,LAGOA D'ANTA,2588,800,1031,4862,3831,44,399
RN,17256,LAGOA DE PEDRAS,2528,1597,909,5494,4585,61,399
RN,17272,LAGOA DE VELHOS,1384,489,305,2395,2090,29,188
RN,17299,LAGOA NOVA,4980,2469,2164,10534,8370,128,793
RN,17310,LAGOA SALGADA,3364,1921,578,6653,6075,134,656
RN,17337,LAJES,4372,1754,1055,7820,6765,66,573
RN,17353,LAJES PINTADAS,2269,751,656,4091,3435,58,357
RN,17370,LUCRÉCIA,1959,259,349,2806,2457,36,203
RN,17396,LUIS GOMES,4945,423,1668,7719,6051,47,636
RN,17418,MACAÍBA,18989,11109,6405,40206,33801,494,3209
RN,17434,MACAU,12339,4230,4646,22701,18055,234,1252
RN,17450,MARCELINO VIEIRA,4112,338,744,5777,5033,55,528
RN,17477,MARTINS,2826,1923,1197,6407,5210,52,409
RN,17493,MAXARANGUAPE,3264,1775,1139,6809,5670,55,576
RN,17515,FRUTUOSO GOMES,2315,272,648,3555,2907,63,257
RN,17531,MONTANHAS,4624,915,2131,8365,6234,86,609
RN,17558,MONTE ALEGRE,5736,3614,2371,12758,10387,180,857
RN,17574,MONTE DAS GAMELEIRAS,1376,219,601,2473,1872,19,258
RN,17590,MOSSORÓ,84605,30712,22730,149398,126668,2057,9294
RN,17612,NATAL,228095,150175,75259,488322,413063,5771,29022
RN,17639,NÍSIA FLORESTA,7208,3013,2118,13785,11667,223,1223
RN,17655,NOVA CRUZ,11533,7083,5742,26426,20684,305,1763
RN,17671,OLHO D'ÁGUA DO BORGES,2368,658,505,3841,3336,59,251
RN,17698,OURO BRANCO,2142,926,568,3981,3413,60,285
RN,17710,PARANÁ,2126,160,580,3183,2603,24,293
RN,17736,PARAÚ,2324,476,671,3756,3085,41,244
RN,17752,PARAZINHO,1826,939,490,3601,3111,50,296
RN,17779,PARELHAS,8398,3749,2093,15435,13342,239,956
RN,17795,PARNAMIRIM,36499,25048,12003,79622,67619,1097,4975
RN,17817,PASSA E FICA,3495,1161,1455,6884,5429,89,684
RN,17833,PASSAGEM,1364,711,260,2587,2327,22,230
RN,17850,PATU,5214,1274,1745,9058,7313,152,673
RN,17876,PAU DOS FERROS,10610,2482,3006,17412,14406,183,1131
RN,17892,PEDRA GRANDE,1791,516,712,3345,2633,49,277
RN,17914,PEDRA PRETA,1512,713,280,2749,2469,24,220
RN,17930,PEDRO AVELINO,2605,1806,1265,6154,4889,51,427
RN,17957,PEDRO VELHO,5523,1685,2853,11189,8336,150,978
RN,17973,PENDÊNCIAS,5699,1541,1841,9833,7992,103,649
RN,17990,PILÕES,1903,301,292,2703,2411,24,183
RN,18015,POÇO BRANCO,4754,1828,1303,8659,7356,129,645
RN,18031,PORTALEGRE,2369,1821,536,5293,4757,82,485
RN,18058,SERRA CAIADA,3796,997,1195,6594,5399,54,552
RN,18074,PUREZA,2899,1301,1132,5899,4767,70,497
RN,18090,RAFAEL FERNANDES,2534,369,368,3646,3278,55,320
RN,18112,RIACHO DA CRUZ,1580,353,334,2468,2134,16,185
RN,18139,RIACHO DE SANTANA,2117,225,708,3430,2722,42,338
RN,18155,RIACHUELO,2787,1185,909,5295,4386,54,360
RN,18171,RODOLFO FERNANDES,2785,493,397,4060,3663,37,348
RN,18198,RUY BARBOSA,1200,1085,580,3075,2495,30,180
RN,18210,SÃO FRANCISCO DO OESTE,1832,544,282,2927,2645,42,227
RN,18236,SANTA CRUZ,12988,4055,4102,23123,19021,274,1704
RN,18252,SANTANA DO SERIDÓ,1261,375,220,2045,1825,32,157
RN,18279,SANTANA DO MATOS,5218,2908,2160,11298,9138,169,843
RN,18295,SANTO ANTÔNIO,9362,1704,3334,16141,12807,210,1531
RN,18317,SÃO BENTO DO NORTE,1700,456,607,3052,2445,25,264
RN,18333,SÃO BENTO DO TRAIRI,1899,527,270,2977,2707,32,249
RN,18350,SÃO FERNANDO,1792,621,213,2823,2610,31,166
RN,18376,SÃO GONÇALO DO AMARANTE,25968,15217,10469,55789,45320,633,3502
RN,18392,SÃO JOÃO DO SABUGI,3037,1076,565,4943,4378,45,220
RN,18414,SÃO JOSÉ DE MIPIBU,12623,5351,4825,25393,20568,335,2259
RN,18430,SÃO JOSÉ DE CAMPESTRE,4686,1710,1934,9324,7390,184,810
RN,18457,SÃO JOSÉ DO SERIDÓ,1899,1028,286,3467,3181,53,201
RN,18473,SÃO MIGUEL,9033,1449,4051,16734,12683,242,1959
RN,18490,SÃO PAULO DO POTENGI,5515,3276,2084,11877,9793,140,862
RN,18511,SÃO PEDRO,3117,1356,850,5714,4864,54,337
RN,18538,SÃO RAFAEL,3840,1022,978,6484,5506,72,572
RN,18554,SÃO TOMÉ,4775,1236,1763,8611,6848,86,751
RN,18570,SÃO VICENTE,2887,634,623,4575,3952,51,380
RN,18597,SENADOR ELÓI DE SOUZA,1778,1251,823,4238,3415,48,338
RN,18619,SENADOR GEORGINO AVELINO,1711,774,523,3292,2769,57,227
RN,18635,SERRA DE SÃO BENTO,2163,889,1272,4815,3543,66,425
RN,18651,SERRA NEGRA DO NORTE,3278,1146,975,5938,4963,74,465
RN,18678,SERRINHA,3455,896,812,5771,4959,71,537
RN,18694,SEVERIANO MELO,3878,786,1512,6744,5232,65,503
RN,18716,SÍTIO NOVO,2132,710,564,3770,3206,59,305
RN,18732,TABOLEIRO GRANDE,1161,419,222,1956,1734,16,138
RN,18759,TAIPU,4298,1831,1129,8114,6985,134,722
RN,18775,TANGARÁ,4419,2636,2031,10174,8143,124,964
RN,18791,TENENTE ANANIAS,3839,977,1971,7528,5557,62,679
RN,18813,TIBAU DO SUL,3315,1775,977,6781,5804,133,581
RN,18830,TIMBAÚBA DOS BATISTAS,1111,575,206,2035,1829,30,113
RN,18856,TOUROS,8719,4482,4050,19315,15265,254,1810
RN,18872,UMARIZAL,5634,1131,1130,8605,7475,103,607
RN,18899,UPANEMA,5960,1351,1002,9028,8026,117,598
RN,18910,VÁRZEA,2141,1006,382,3833,3451,56,248
RN,18937,RAFAEL GODEIRO,1832,307,489,2852,2363,46,178
RN,18953,VERA CRUZ,3768,2222,804,7577,6773,109,674
RN,18970,VIÇOSA,935,176,136,1365,1229,18,100
RN,18996,VILA FLOR,1209,389,384,2183,1799,30,171
RN,30031,BARAÚNA,8056,2151,1513,13309,11796,224,1365
RO,19,GUAJARÁ-MIRIM,12124,6276,6961,25804,18843,105,338
RO,35,PORTO VELHO,129996,59620,45448,239787,194339,990,3733
RO,51,JI-PARANÁ,29364,24590,21180,76394,55214,400,860
RO,78,ARIQUEMES,21710,17727,14942,55362,40420,274,709
RO,94,CACOAL,20302,18088,12867,52403,39536,326,820
RO,116,PIMENTA BUENO,7434,9006,6581,23541,16960,135,385
RO,132,VILHENA,16170,15046,10512,42665,32153,258,679
RO,159,JARU,10935,16127,12146,40022,27876,243,571
RO,175,OURO PRETO DO OESTE,9118,10286,9717,29627,19910,128,378
RO,191,PRESIDENTE MÉDICI,6043,5636,5844,17903,12059,161,219
RO,213,COSTA MARQUES,3132,2569,2083,7914,5831,18,112
RO,230,COLORADO DO OESTE,5309,4858,4628,15124,10496,114,215
RO,256,ESPIGÃO DO OESTE,6612,7851,4521,19378,14857,118,276
RO,272,CEREJEIRAS,3413,5886,3869,13414,9545,62,184
RO,299,ROLIM DE MOURA,13697,10204,8773,33421,24648,200,547
RO,310,ALTA FLORESTA DO OESTE,7212,5707,5254,18479,13225,83,223
RO,337,ALVORADA DO OESTE,4184,4355,3809,12577,8768,55,174
RO,353,SANTA LUZIA DO OESTE,2516,2634,2364,7750,5386,63,173
RO,370,NOVA BRASILÂNDIA,4660,5395,3489,13868,10379,89,235
RO,396,MACHADINHO DO OESTE,6377,8191,5521,20422,14901,76,257
RO,418,SÃO MIGUEL DO GUAPORÉ,4465,4609,2966,12243,9277,48,155
RO,434,NOVA MAMORÉ,3029,5197,2930,11445,8515,70,219
RO,450,CABIXI,1760,1756,1276,4900,3624,33,75
RO,477,CANDEIAS DO JAMARI,5385,2171,2344,10093,7749,33,160
RO,493,ITAPUÃ DO OESTE,2101,1218,1194,4586,3392,13,60
RO,515,NOVO HORIZONTE DO OESTE,3259,2154,2237,7844,5607,51,143
RO,531,CASTANHEIRAS,1347,881,684,2966,2282,8,46
RO,558,VALE DO PARAÍSO,2081,2499,2254,6944,4690,26,84
RO,566,URUPÁ,2863,3650,2770,9496,6726,62,151
RO,574,MIRANTE DA SERRA,3198,3157,2873,9407,6534,54,125
RO,582,SERINGUEIRAS,3075,2972,1768,7952,6184,32,105
RO,590,THEOBROMA,2150,3232,2350,7864,5514,38,94
RO,604,MINISTRO ANDREAZZA,2416,2137,1721,6391,4670,40,77
RO,612,GOVERNADOR JORGE TEIXEIRA,1877,3329,1115,6478,5363,43,114
RO,620,CACAULÂNDIA,1326,1663,1357,4412,3055,18,48
RO,639,ALTO PARAÍSO,4025,2896,2719,9817,7098,64,113
RO,647,RIO CRESPO,877,751,468,2133,1665,14,23
RO,655,CORUMBIARA,1788,2330,1457,5698,4241,33,90
RO,663,MONTE NEGRO,3373,3446,3448,10485,7037,44,174
RO,671,CAMPO NOVO DE RONDÔNIA,1916,2190,2301,6528,4227,25,96
RO,680,CUJUBIM,2032,2581,1692,6448,4756,43,100
RO,698,VALE DO ANARI,1404,2664,1511,5707,4196,39,89
RO,701,PARECIS,1213,1110,797,3172,2375,9,43
RO,710,SÃO FELIPE DO OESTE,1530,1964,1162,4770,3608,25,89
RO,728,PRIMAVERA DE RONDÔNIA,996,1290,864,3237,2373,19,68
RO,736,ALTO ALEGRE DOS PARECIS,2817,2307,1775,7027,5252,34,94
RO,744,NOVA UNIÃO,2050,1706,1499,5334,3835,16,63
RO,752,TEIXEIRÓPOLIS,1199,1648,1420,4322,2902,17,38
RO,779,BURITIS,6339,7471,5296,19465,14169,123,236
RO,787,PIMENTEIRAS DO OESTE,641,543,666,1887,1221,13,24
RO,795,SÃO FRANCISCO DO GUAPORÉ,2788,3741,2397,9084,6687,36,122
RO,809,CHUPINGUAIA,1699,1491,1371,4641,3270,19,61
RR,3000,CAROEBE,1709,1733,904,4456,3552,22,88
RR,3018,BOA VISTA,41066,77427,34363,156282,121919,964,2462
RR,3026,IRACEMA,1507,1400,1291,4294,3003,19,77
RR,3034,CARACARAÍ,2943,3160,2915,9172,6257,36,118
RR,3042,AMAJARÍ,749,1466,1133,3381,2248,7,26
RR,3050,ALTO ALEGRE,2060,2917,1436,6534,5098,29,92
RR,3069,CANTÁ,1560,3216,1839,6722,4883,21,86
RR,3077,BONFIM,1106,2376,1251,4832,3581,17,82
RR,3085,RORAINÓPOLIS,4464,2456,2236,9347,7111,46,145
RR,3093,MUCAJAÍ,2839,2927,2528,8456,5928,45,117
RR,3107,UIRAMUTÃ,1317,1095,804,3331,2527,13,102
RR,3115,NORMANDIA,1138,1770,880,3852,2972,10,54
RR,3123,PACARAIMA,1059,2401,1053,4602,3549,20,69
RR,3131,SÃO JOÃO DO BALIZA,1603,1272,925,3875,2950,22,53
RR,3158,SÃO LUIZ DO ANAUÁ,1812,1274,1284,4460,3176,20,70
RS,84735,ÁUREA,947,1564,277,2902,2625,56,58
RS,84743,TRÊS ARROIOS,1022,1091,157,2337,2180,30,37
RS,84751,NOVA ROMA DO SUL,736,1574,249,2663,2414,37,67
RS,84760,PROGRESSO,1857,2040,611,4707,4096,92,107
RS,84778,PIRAPÓ,921,862,412,2257,1845,27,35
RS,84786,JABOTICABA,1331,1096,717,3266,2549,35,87
RS,84794,SÃO JORGE,707,1316,399,2512,2113,41,49
RS,84808,ALTO ALEGRE,531,776,169,1537,1368,36,25
RS,84816,NOVA HARTZ,6131,4058,1564,12041,10477,145,143
RS,84824,DOIS LAJEADOS,763,1476,233,2569,2336,51,46
RS,84832,SÃO DOMINGOS DO SUL,847,1092,234,2261,2027,48,40
RS,84840,TUNAS,1606,1076,398,3189,2791,32,77
RS,84859,SÃO JOÃO DA URTIGA,1620,1705,511,3977,3466,95,46
RS,84867,GUABIJU,307,765,311,1458,1147,41,34
RS,84875,QUINZE DE NOVEMBRO,983,1641,363,3042,2679,22,33
RS,84883,DOUTOR MAURÍCIO CARDOSO,1600,2236,477,4417,3940,31,73
RS,84891,CAPELA DE SANTANA,2954,2997,1109,7252,6143,87,105
RS,84905,JAQUIRANA,858,1792,991,3759,2768,50,68
RS,84913,VANINI,504,759,170,1513,1343,56,24
RS,84921,BOQUEIRÃO DO LEÃO,2475,2403,1059,6146,5087,83,126
RS,84930,FAGUNDES VARELA,607,1140,225,2059,1834,39,48
RS,84948,ÁGUA SANTA,941,1452,388,2857,2469,37,39
RS,84956,SILVEIRA MARTINS,734,1101,230,2111,1881,18,28
RS,84964,IBIRAPUITÃ,1162,1384,463,3100,2637,39,52
RS,84972,IBARAMA,1579,1300,354,3334,2980,34,67
RS,84980,PÂNTANO GRANDE,2974,3280,1896,8417,6521,149,118
RS,84999,IPÊ,1115,2737,486,4496,4010,67,91
RS,85006,TRINDADE DO SUL,2153,1282,824,4407,3583,49,99
RS,85014,AGUDO,4466,6050,1728,12591,10863,182,165
RS,85022,ERNESTINA,1040,1237,270,2606,2336,32,27
RS,85030,AJURICABA,1827,3065,795,5811,5016,47,77
RS,85049,DEZESSEIS DE NOVEMBRO,857,1048,509,2483,1974,26,43
RS,85057,ALECRIM,2587,2321,946,6014,5068,62,98
RS,85065,BROCHIER,1378,1836,293,3639,3346,42,90
RS,85073,ALEGRETE,21939,23740,13662,60463,46801,529,593
RS,85081,EREBANGO,844,1044,409,2372,1963,30,45
RS,85090,ALPESTRE,3108,2068,1148,6564,5416,101,139
RS,85103,ENTRE IJUÍS,3333,2599,877,6963,6086,68,86
RS,85111,ALVORADA,50390,51844,17452,124001,106549,1983,2332
RS,85120,NOVA ESPERANÇA DO SUL,1103,1975,595,3815,3220,58,84
RS,85138,ANTA GORDA,1179,2768,855,5036,4181,139,95
RS,85146,PAVERAMA,2396,2402,869,5849,4980,90,92
RS,85154,ANTÔNIO PRADO,2626,5841,1462,10295,8833,135,231
RS,85162,TERRA DE AREIA,2372,2668,1417,6663,5246,90,116
RS,85170,ARATIBA,2223,2539,515,5429,4914,65,87
RS,85189,HARMONIA,1120,1745,230,3217,2987,70,52
RS,85197,ARROIO DO MEIO,4949,7003,1821,14208,12387,207,228
RS,85200,CAMPOS BORGES,1108,1157,305,2675,2370,61,44
RS,85219,ARROIO DOS RATOS,3021,4696,2049,10111,8062,170,175
RS,85227,CERRO GRANDE,1117,541,269,1997,1728,26,44
RS,85235,ARROIO DO TIGRE,3805,4282,1376,9796,8420,151,182
RS,85243,IPIRANGA DO SUL,359,1159,155,1712,1557,17,22
RS,85251,ARROIO GRANDE,5399,6355,2875,15148,12273,288,231
RS,85260,LAGOÃO,2009,1566,861,4627,3766,54,137
RS,85278,ARVOREZINHA,2806,3193,1473,7877,6404,203,202
RS,85286,ESTAÇÃO,1428,2762,685,5045,4360,61,109
RS,85294,AUGUSTO PESTANA,2137,2902,1046,6232,5186,65,82
RS,85308,ARROIO DO SAL,1511,2248,1040,4960,3920,66,95
RS,85316,BAGÉ,36909,30363,14122,83485,69363,931,1160
RS,85324,SÃO JOSÉ DO HORTÊNCIO,1036,1586,277,3020,2743,57,64
RS,85332,BARÃO DE COTEGIPE,1701,2563,676,5070,4394,38,92
RS,85340,PINHAL,758,728,383,1929,1546,24,36
RS,85359,BARRACÃO,1437,1627,528,3778,3250,106,80
RS,85367,TRÊS CACHOEIRAS,2868,3079,1265,7406,6141,105,89
RS,85375,BARRA DO RIBEIRO,2945,4519,1639,9380,7741,132,145
RS,85383,SÃO VENDELINO,464,999,115,1626,1511,24,24
RS,85391,BARROS CASSAL,2728,3736,1850,8638,6788,138,186
RS,85405,PROTÁSIO ALVES,321,1260,217,1876,1659,41,37
RS,85413,BENTO GONÇALVES,22460,39355,8702,73309,64607,1036,1756
RS,85421,POUSO NOVO,626,709,385,1784,1399,20,44
RS,85430,BOA VISTA DO BURICÁ,1890,2418,853,5263,4410,60,42
RS,85448,EUGÊNIO DE CASTRO,800,1254,330,2440,2110,36,20
RS,85456,BOM JESUS,1824,4932,1439,8462,7023,159,108
RS,85464,CRISTAL,1891,2504,1052,5601,4549,71,83
RS,85472,BOM RETIRO DO SUL,2216,5053,1196,8743,7547,131,147
RS,85480,SÃO MIGUEL DAS MISSÕES,2306,2289,987,5716,4729,84,50
RS,85499,BOSSOROCA,2259,2030,1302,5781,4479,89,101
RS,85502,GLORINHA,1259,2963,880,5269,4389,80,87
RS,85510,BRAGA,1305,946,462,2799,2337,33,53
RS,85529,SEGREDO,2294,2165,899,5526,4627,58,110
RS,85537,BUTIÁ,5214,6912,3094,15770,12676,252,298
RS,85545,ALEGRIA,1546,1548,504,3714,3210,50,66
RS,85553,CAÇAPAVA DO SUL,10813,10624,5825,28361,22536,562,537
RS,85561,SALDANHA MARINHO,841,1248,277,2439,2162,39,34
RS,85570,CACEQUI,4237,3793,2854,11190,8336,121,185
RS,85588,SÃO JOSÉ DO HERVAL,764,694,385,1916,1531,26,47
RS,85596,CACHOEIRA DO SUL,21166,30576,13501,67126,53625,989,894
RS,85600,VISTA ALEGRE,1119,740,231,2136,1905,14,32
RS,85618,CACHOEIRINHA,33428,38361,12295,87022,74727,1349,1589
RS,85626,IVORÁ,664,886,203,1813,1610,31,29
RS,85634,CACIQUE DOBLE,1177,1565,397,3301,2904,85,77
RS,85642,VILA MARIA,1010,1778,325,3229,2904,58,58
RS,85650,CAIBATÉ,1806,1318,687,3933,3246,74,48
RS,85669,TAQUARUÇÚ DO SUL,1075,893,219,2228,2009,15,26
RS,85677,CAIÇARA,1585,1869,669,4226,3557,38,65
RS,85685,IMBÉ,3322,5407,1988,10943,8955,89,137
RS,85693,CAMAQUÃ,13379,25321,7368,47272,39904,641,563
RS,85707,SEDE NOVA,938,941,313,2270,1957,37,41
RS,85715,CAMBARÁ DO SUL,1336,2665,1299,5511,4212,117,94
RS,85723,TUPANDI,689,1716,190,2671,2481,43,33
RS,85731,CAMPINA DAS MISSÕES,1902,2406,698,5158,4460,33,119
RS,85740,RIOZINHO,1310,1650,545,3639,3094,64,70
RS,85758,CAMPINAS DO SUL,1186,2553,676,4507,3831,33,59
RS,85766,RELVADO,528,1006,417,2016,1599,26,39
RS,85774,CAMPO BOM,18053,20519,5428,45239,39811,508,731
RS,85782,IMIGRANTE,802,1225,230,2374,2144,57,60
RS,85790,CAMPO NOVO,2025,1455,1376,4995,3619,56,83
RS,85804,CIDREIRA,2698,3202,1697,7784,6087,67,120
RS,85812,CANDELÁRIA,7998,10520,3570,22879,19309,403,388
RS,85820,MONTAURI,377,760,143,1346,1203,44,22
RS,85839,CÂNDIDO GODÓI,1505,3143,595,5398,4803,73,82
RS,85847,VISTA GAÚCHA,843,1022,284,2211,1927,23,39
RS,85855,CANELA,5323,16121,3420,25637,22217,369,404
RS,85863,VISTA ALEGRE DO PRATA,403,790,214,1456,1242,25,24
RS,85871,CANGUÇÚ,13250,21308,6619,42746,36127,956,613
RS,85880,CASEIROS,734,1197,220,2237,2017,56,30
RS,85898,CANOAS,98517,94392,31594,232518,200924,3299,4716
RS,85901,ITACURUBI,972,992,705,2727,2022,29,29
RS,85910,CARAZINHO,15493,19855,7331,43793,36462,524,590
RS,85928,ENTRE RIOS DO SUL,966,1098,370,2492,2122,21,37
RS,85936,CARLOS BARBOSA,6305,8935,1825,17728,15903,286,377
RS,85944,CERRO GRANDE DO SUL,1739,3576,672,6218,5546,128,103
RS,85952,CASCA,1908,3625,964,6782,5818,176,109
RS,85960,CAMARGO,533,1199,223,2030,1807,20,55
RS,85979,CATUÍPE,2981,3675,1133,8021,6888,114,118
RS,85987,PARAÍSO DO SUL,1893,3067,755,5810,5055,55,40
RS,85995,CAXIAS DO SUL,83649,150436,31007,279761,248754,4307,10362
RS,86010,CERRO LARGO,3945,3636,2120,10010,7890,95,214
RS,86029,FAXINALZINHO,767,844,574,2257,1683,28,44
RS,86037,CHAPADA,2209,4182,858,7440,6582,99,92
RS,86045,AMARAL FERRADOR,1708,1917,575,4385,3810,76,109
RS,86053,CHIAPETTA,1218,1467,647,3414,2767,35,47
RS,86061,VILA FLORES,604,1812,287,2770,2483,24,43
RS,86070,CIRÍACO,1335,1656,449,3579,3130,86,53
RS,86088,CERRO BRANCO,1451,1619,416,3646,3230,66,94
RS,86096,COLORADO,789,1812,332,3009,2677,41,35
RS,86100,ANDRÉ DA ROCHA,245,660,295,1234,939,16,18
RS,86118,CONDOR,1814,2685,826,5452,4626,51,76
RS,86126,POÇO DAS ANTAS,545,913,179,1698,1519,31,30
RS,86134,CONSTANTINA,2943,3039,1045,7270,6225,119,124
RS,86142,TRÊS PALMEIRAS,1433,1349,565,3469,2904,55,67
RS,86150,CORONEL BICACO,2453,2245,984,5903,4919,68,153
RS,86169,NOVA ALVORADA,717,1253,266,2329,2063,44,49
RS,86177,CRISSIUMAL,5076,4412,1653,11415,9762,137,137
RS,86185,MORRO REDONDO,1622,2461,479,4756,4277,95,99
RS,86193,CRUZ ALTA,18623,19012,10240,48971,38731,500,596
RS,86207,SANTA MARIA DO HERVAL,1720,2532,344,4768,4424,101,71
RS,86215,CRUZEIRO DO SUL,3107,4437,1091,8956,7865,144,177
RS,86223,BARÃO,1238,2323,456,4103,3647,44,42
RS,86231,DAVID CANABARRO,1401,1625,589,3784,3195,121,48
RS,86240,ELDORADO DO SUL,8618,8193,3709,21151,17442,258,373
RS,86258,DOIS IRMÃOS,8005,8558,1947,18973,17026,194,269
RS,86274,DOM FELICIANO,2996,5197,1751,10353,8602,200,209
RS,86282,ALTO FELIZ,548,1322,142,2100,1958,30,58
RS,86290,DOM PEDRITO,10893,11588,6474,29594,23120,276,363
RS,86304,AMETISTA DO SUL,1733,2841,1109,5843,4734,67,93
RS,86312,DONA FRANCISCA,939,1515,360,2908,2548,51,43
RS,86320,ARAMBARÉ,798,1474,551,2905,2354,38,44
RS,86339,ENCANTADO,5080,7219,2340,15247,12907,249,359
RS,86347,BARÃO DO TRIUNFO,816,2970,723,4636,3913,55,72
RS,86355,ENCRUZILHADA DO SUL,5723,9163,3822,19371,15549,329,334
RS,86363,BARRA DO GUARITA,833,971,389,2278,1889,29,56
RS,86371,ERECHIM,26226,28742,10717,67735,57018,801,1249
RS,86380,BARRA DO RIO AZUL,774,773,193,1765,1572,10,15
RS,86398,HERVAL,2287,2008,980,5486,4506,102,109
RS,86401,BARRA FUNDA,872,900,218,2055,1837,29,36
RS,86410,ERVAL GRANDE,1715,1575,497,3939,3442,66,86
RS,86428,BOA VISTA DAS MISSÕES,708,678,222,1657,1435,19,30
RS,86436,ERVAL SECO,2774,1881,1477,6304,4827,66,106
RS,86444,BOM PROGRESSO,952,713,318,2035,1717,20,32
RS,86452,ESMERALDA,534,1313,406,2311,1905,30,28
RS,86460,CAMPESTRE DA SERRA,573,1426,573,2661,2088,48,41
RS,86479,ESPUMOSO,3972,6012,1897,12174,10277,141,152
RS,86487,CANDIOTA,3173,1774,1226,6289,5063,55,61
RS,86495,ESTÂNCIA VELHA,10616,13313,3096,27928,24832,312,591
RS,86509,CAPITÃO,808,1153,263,2311,2048,58,29
RS,86517,ESTEIO,28657,23621,8769,63003,54234,828,1128
RS,86525,CARLOS GOMES,613,684,229,1565,1336,28,11
RS,86533,ESTRELA,6773,11417,3250,22146,18896,288,418
RS,86541,CENTENÁRIO,1036,1082,205,2365,2160,12,30
RS,86550,FARROUPILHA,12691,25373,5545,45439,39894,708,1122
RS,86568,CHARRUA,747,1345,430,2615,2185,29,64
RS,86576,FAXINAL DO SOTURNO,1937,2626,946,5640,4694,53,78
RS,86584,COLINAS,572,1209,246,2089,1843,27,35
RS,86592,FELIZ,2774,4872,1153,9226,8073,166,261
RS,86606,COQUEIROS DO SUL,659,1235,213,2154,1941,25,22
RS,86614,FLORES DA CUNHA,3890,12743,2650,20173,17523,307,583
RS,86622,CORONEL BARROS,612,1213,203,2080,1877,20,32
RS,86630,FONTOURA XAVIER,3243,2780,2129,8468,6339,128,188
RS,86649,COXILHA,867,1108,281,2317,2036,27,34
RS,86657,FORMIGUEIRO,1583,3015,802,5600,4798,85,115
RS,86665,DERRUBADAS,928,1212,385,2595,2210,16,54
RS,86673,FREDERICO WESTPHALEN,7929,9150,3869,21415,17546,197,270
RS,86681,DOIS IRMÃOS DAS MISSÕES,800,673,392,1926,1534,17,44
RS,86690,GARIBALDI,6147,12160,2683,21926,19243,406,530
RS,86703,ENGENHO VELHO,536,463,205,1226,1021,9,13
RS,86711,GAURAMA,1652,2558,510,4861,4351,61,80
RS,86720,GARRUCHOS,1321,725,767,2882,2115,26,43
RS,86738,GENERAL CÂMARA,2659,2679,1034,6598,5564,105,121
RS,86746,GENTIL,390,787,190,1413,1223,32,14
RS,86754,SÃO VICENTE DO SUL,2289,2770,1453,6749,5296,121,116
RS,86762,GRAMADO DOS LOUREIROS,988,494,435,1989,1554,41,31
RS,86770,GETÚLIO VARGAS,3100,7075,2011,12476,10465,142,148
RS,86789,GRAMADO XAVIER,1194,1161,611,3067,2456,52,49
RS,86797,GIRUÁ,4813,5842,3335,14314,10979,135,189
RS,86800,HULHA NEGRA,1833,1480,456,3854,3398,29,56
RS,86819,GRAMADO,5300,15276,3527,24891,21364,377,411
RS,86827,INHACORÁ,882,604,311,1851,1540,14,40
RS,86835,GRAVATAÍ,58150,74765,20154,159510,139356,2728,3713
RS,86843,ITAPUCA,598,731,427,1833,1406,47,30
RS,86851,GUAÍBA,24017,30693,9069,66220,57151,1145,1296
RS,86860,LAJEADO DO BUGRE,805,462,187,1513,1326,18,41
RS,86878,GUAPORÉ,5012,8147,2148,15893,13745,299,287
RS,86886,LAGOA DOS TRÊS CANTOS,253,889,117,1291,1174,15,17
RS,86894,GUARANI DAS MISSÕES,2783,2566,983,6487,5504,67,88
RS,86908,LINDOLFO COLLOR,1955,1295,427,3789,3362,37,75
RS,86916,HORIZONTINA,5125,6882,2690,14992,12302,122,173
RS,86924,LINHA NOVA,289,733,117,1196,1079,24,33
RS,86932,CHARQUEADAS,7647,10098,2550,21027,18477,338,394
RS,86940,MANOEL VIANA,2265,2131,1400,5958,4558,71,91
RS,86959,HUMAITÁ,1569,1887,570,4128,3558,49,53
RS,86967,MAQUINÉ,2630,1737,1165,5744,4579,121,91
RS,86975,IBIAÇÁ,984,2071,335,3488,3153,57,41
RS,86983,MARATÁ,645,1257,198,2157,1959,20,37
RS,86991,IBIRAIARAS,1597,2860,899,5549,4650,108,85
RS,87009,MARIANA PIMENTEL,756,1923,480,3240,2760,29,52
RS,87017,IBIRUBÁ,4951,7393,2453,15107,12654,158,152
RS,87025,MATO CASTELHANO,576,1276,220,2139,1919,29,38
RS,87033,IGREJINHA,8932,9317,2688,21556,18868,283,336
RS,87041,MATO LEITÃO,1166,1366,271,2897,2626,42,52
RS,87050,IJUÍ,23836,22732,9976,57671,47695,482,645
RS,87068,MINAS DO LEÃO,1544,3079,742,5550,4808,95,90
RS,87076,ILÓPOLIS,953,1574,601,3294,2693,104,62
RS,87084,MONTE BELO DO SUL,817,1410,274,2601,2327,38,62
RS,87092,INDEPENDÊNCIA,1870,2685,1057,5722,4665,45,65
RS,87106,MORMAÇO,734,1039,281,2118,1837,30,34
RS,87114,IRAÍ,2681,2692,1552,7121,5569,81,115
RS,87122,MORRINHOS DO SUL,1270,1123,329,2809,2480,39,48
RS,87130,ITAQUI,10742,9611,5674,26496,20822,171,298
RS,87149,MORRO REUTER,1231,2645,430,4454,4024,71,77
RS,87157,ITATIBA DO SUL,1812,1425,337,3671,3334,28,69
RS,87165,MULITERNO,471,742,156,1429,1273,34,26
RS,87173,IVOTI,4976,6438,1363,13170,11807,117,276
RS,87181,NICOLAU VERGUEIRO,355,952,302,1655,1353,30,16
RS,87190,JACUTINGA,789,1665,441,2976,2535,39,42
RS,87203,NOVA BOA VISTA,531,1062,194,1825,1631,26,12
RS,87211,JAGUARÃO,8538,8419,4537,22081,17544,246,341
RS,87220,NOVA PÁDUA,314,1562,165,2102,1937,20,41
RS,87238,JAGUARI,3095,4759,1412,9665,8253,194,205
RS,87246,NOVA SANTA RITA,5327,5100,2018,12837,10819,175,217
RS,87254,JÚLIO DE CASTILHOS,6048,6189,2943,15537,12594,133,224
RS,87262,NOVO BARREIRO,1445,1262,291,3070,2779,20,52
RS,87270,LAGOA VERMELHA,5973,9734,3878,20178,16300,302,291
RS,87289,NOVO MACHADO,898,2004,390,3357,2967,20,45
RS,87297,LAJEADO,17633,22414,6779,48347,41568,669,852
RS,87300,NOVO TIRADENTES,828,615,472,1965,1493,19,31
RS,87319,LAVRAS DO SUL,2668,2372,781,6001,5220,70,110
RS,87327,PARECI NOVO,720,1462,303,2595,2292,35,75
RS,87335,LIBERATO SALZANO,1908,1799,670,4546,3876,67,102
RS,87343,PASSO DO SOBRADO,1913,2074,609,4753,4144,87,70
RS,87351,MACHADINHO,1652,1710,427,3997,3570,89,119
RS,87360,PICADA CAFÉ,1162,2086,378,3754,3376,50,78
RS,87378,MARAU,7366,12420,3256,23787,20531,345,400
RS,87386,PINHAL GRANDE,1449,1415,708,3681,2973,49,60
RS,87394,MARCELINO RAMOS,1966,1572,890,4540,3650,38,74
RS,87408,PINHEIRINHO DO VALE,1561,1186,624,3458,2834,48,39
RS,87416,MARIANO MORO,933,708,197,1897,1700,34,25
RS,87424,PONTÃO,1291,1261,335,2949,2614,27,35
RS,87432,MATA,1184,2126,728,4212,3484,95,79
RS,87440,PONTE PRETA,465,929,116,1550,1434,14,26
RS,87459,MAXIMILIANO DE ALMEIDA,1201,2000,533,3880,3347,61,85
RS,87467,PORTO MAUÁ,711,1069,272,2107,1835,25,30
RS,87475,MIRAGUAÍ,1607,1406,586,3685,3099,34,52
RS,87483,PORTO VERA CRUZ,827,646,235,1756,1521,19,29
RS,87491,MONTENEGRO,16495,17129,5375,40466,35091,675,792
RS,87505,PRESIDENTE LUCENA,581,1107,117,1868,1751,19,44
RS,87513,MOSTARDAS,2610,4263,1520,8696,7176,136,167
RS,87521,QUEVEDOS,894,825,432,2217,1785,32,34
RS,87530,MUÇUM,1151,2130,463,3941,3478,113,84
RS,87548,RIO DOS ÍNDIOS,1532,1137,639,3440,2801,54,78
RS,87556,NÃO-ME-TOQUE,3985,5965,1724,11982,10258,132,176
RS,87564,SAGRADA FAMÍLIA,1049,461,237,1802,1565,18,37
RS,87572,NONOAI,3440,3217,2510,9492,6982,142,183
RS,87580,SALVADOR DAS MISSÕES,809,1126,279,2269,1990,22,33
RS,87599,NOVA ARAÇÁ,745,1573,282,2736,2454,78,58
RS,87602,SANTA CLARA DO SUL,1405,2386,416,4374,3958,72,95
RS,87610,NOVA BASSANO,1876,3409,902,6451,5549,143,121
RS,87629,SANTA TEREZA,647,780,203,1688,1485,27,31
RS,87637,NOVA BRÉSCIA,685,1500,285,2553,2268,36,47
RS,87645,SANTO ANTÔNIO DO PALMA,725,750,157,1676,1519,22,22
RS,87653,NOVA PALMA,2037,2259,717,5129,4412,43,73
RS,87661,SANTO ANTÔNIO DO PLANALTO,484,1013,155,1690,1535,14,24
RS,87670,NOVA PETRÓPOLIS,3264,8860,1947,14611,12664,201,339
RS,87688,SANTO EXPEDITO DO SUL,732,1038,183,2029,1846,50,26
RS,87696,NOVA PRATA,4313,8671,2192,15744,13552,233,335
RS,87700,SÃO JOÃO DO POLÊSINE,686,1209,296,2246,1950,20,35
RS,87718,NOVO HAMBURGO,61826,79858,21301,168531,147230,2304,3242
RS,87726,SÃO JOSÉ DOS AUSENTES,675,1251,682,2680,1998,27,45
RS,87734,OSÓRIO,11706,12003,4643,29356,24713,488,516
RS,87742,SÃO JOSÉ DO INHACORÁ,822,869,234,1963,1729,16,22
RS,87750,PAIM FILHO,1629,1444,523,3689,3166,45,48
RS,87769,SÃO JOSÉ DAS MISSÕES,1275,620,354,2324,1970,24,51
RS,87777,PALMEIRA DAS MISSÕES,8615,9517,4665,23376,18711,223,356
RS,87785,SÃO MARTINHO DA SERRA,821,1459,276,2613,2337,21,36
RS,87793,PALMITINHO,2554,1886,944,5518,4574,56,78
RS,87807,SÃO PEDRO DA SERRA,790,1391,268,2539,2271,48,42
RS,87815,PANAMBI,8138,13605,4538,26796,22258,224,291
RS,87823,SÃO PEDRO DO BUTIÁ,754,1143,296,2260,1964,25,42
RS,87831,PARAÍ,1363,2873,586,5028,4442,125,81
RS,87840,SÃO VALENTIM DO SUL,648,1055,190,1961,1771,25,43
RS,87858,PASSO FUNDO,51657,51962,17723,124528,106805,1476,1710
RS,87866,SÃO VALÉRIO DO SUL,856,619,446,1967,1521,19,27
RS,87874,PEDRO OSÓRIO,2639,2225,871,5997,5126,130,132
RS,87882,SENTINELA DO SUL,932,2170,390,3623,3233,64,67
RS,87890,PEJUÇARA,1208,1329,336,2929,2593,21,35
RS,87904,SÉRIO,890,936,269,2194,1925,51,48
RS,87912,PELOTAS,77765,114416,37284,239370,202086,3787,6118
RS,87920,SERTÃO SANTANA,885,2702,697,4408,3711,50,74
RS,87939,PINHEIRO MACHADO,4232,4011,2031,10702,8671,196,232
RS,87947,SINIMBÚ,3427,2976,1239,7871,6632,94,135
RS,87955,PIRATINI,5353,6734,2966,15826,12860,444,329
RS,87963,TIRADENTES DO SUL,2571,1940,708,5355,4647,48,88
RS,87971,PLANALTO,3148,3260,1982,8703,6721,145,168
RS,87980,TRAVESSEIRO,847,934,198,2027,1829,17,31
RS,87998,PORTÃO,7578,8468,2600,19358,16758,303,409
RS,88005,TRÊS FORQUILHAS,1156,1035,467,2736,2269,53,25
RS,88013,PORTO ALEGRE,365760,461460,149824,1019126,869302,15645,26437
RS,88021,TUPANCI DO SUL,446,597,171,1273,1102,32,27
RS,88030,PORTO LUCENA,1884,1833,911,4770,3859,57,85
RS,88048,UNIÃO DA SERRA,422,831,185,1482,1297,15,29
RS,88056,PORTO XAVIER,3459,2987,2093,8814,6721,123,152
RS,88064,VALE DO SOL,3859,2979,942,8021,7079,131,110
RS,88072,PUTINGA,1278,1696,777,3900,3123,71,78
RS,88080,VALE REAL,1114,2079,457,3819,3362,68,101
RS,88099,QUARAÍ,7174,6489,4245,18237,13992,128,201
RS,88102,VILA NOVA DO SUL,1341,1442,665,3559,2894,73,38
RS,88110,REDENTORA,2370,2044,1373,5998,4625,69,142
RS,88129,VITÓRIA DAS MISSÕES,1366,1131,417,2962,2545,20,28
RS,88137,RESTINGA SÊCA,3548,6838,2406,13096,10690,151,153
RS,88145,XANGRI-LÁ,2179,3306,799,6423,5624,65,74
RS,88153,RIO GRANDE,60674,50350,20836,137187,116351,2240,3087
RS,88161,BOA VISTA DO SUL,682,1309,207,2295,2088,59,38
RS,88170,RIO PARDO,12710,10939,4805,29235,24430,395,386
RS,88188,DILERMANDO DE AGUIAR,767,1265,319,2407,2088,26,30
RS,88196,ROCA SALES,2839,3370,1251,7803,6552,186,157
RS,88200,CAPIVARI DO SUL,687,1433,390,2606,2216,36,60
RS,88218,RODEIO BONITO,1809,1820,897,4638,3741,41,71
RS,88226,NOVA CANDELÁRIA,844,1104,242,2266,2024,46,30
RS,88234,ROLANTE,4198,6714,1586,12954,11368,220,236
RS,88242,FLORIANO PEIXOTO,820,887,260,2002,1742,13,22
RS,88250,RONDA ALTA,3123,2970,1368,7632,6264,84,87
RS,88269,CHUVISCA,711,2527,265,3572,3307,41,28
RS,88277,RONDINHA,1841,2083,483,4508,4025,60,41
RS,88285,ESPERANÇA DO SUL,1249,1112,397,2832,2435,26,48
RS,88293,ROQUE GONZALES,2332,2128,847,5477,4630,84,86
RS,88307,DOUTOR RICARDO,728,795,303,1907,1604,44,37
RS,88315,ROSÁRIO DO SUL,11203,12028,7396,31420,24024,379,414
RS,88323,HERVEIRAS,1262,545,331,2185,1854,18,29
RS,88331,SALVADOR DO SUL,1436,2870,378,4839,4461,84,71
RS,88340,CARAÁ,1878,2466,787,5360,4573,119,110
RS,88358,SANANDUVA,3449,6543,1768,12128,10360,218,150
RS,88366,FAZENDA VILANOVA,909,1253,401,2658,2257,46,49
RS,88374,SANTA BÁRBARA DO SUL,2708,3278,1411,7546,6135,85,64
RS,88382,ITAARA,977,2046,721,3819,3098,37,38
RS,88390,SANTA CRUZ DO SUL,29621,42955,11021,86289,75268,1195,1497
RS,88404,ESTRELA VELHA,1181,1260,518,3047,2529,52,36
RS,88412,SANTA MARIA,54791,94847,29558,184419,154861,2346,2877
RS,88420,BENJAMIN CONSTANT DO SUL,879,513,410,1865,1455,23,40
RS,88439,SANTANA DA BOA VISTA,2864,2328,1146,6771,5625,225,208
RS,88447,MAÇAMBARA,1226,1494,1047,3828,2781,24,37
RS,88455,SANTANA DO LIVRAMENTO,27549,23431,16095,68388,52293,649,664
RS,88463,DOM PEDRO DE ALCÂNTARA,1517,735,317,2637,2320,25,43
RS,88471,SANTA ROSA,15335,22918,8973,48152,39179,377,549
RS,88480,UNISTALDA,796,1029,471,2347,1876,23,28
RS,88498,SANTA VITÓRIA DO PALMAR,8067,9978,4786,23585,18799,356,398
RS,88501,TURUÇU,620,1946,261,2903,2642,44,32
RS,88510,SANTIAGO,13259,15809,7611,37679,30068,550,450
RS,88528,CRISTAL DO SUL,1065,873,292,2302,2010,25,47
RS,88536,SANTO ÂNGELO,24933,20805,12159,59230,47071,601,732
RS,88544,MUITOS CAPÕES,396,1364,533,2377,1844,52,32
RS,88552,SANTO ANTÔNIO DA PATRULHA,8179,15351,4658,29241,24583,494,559
RS,88560,NOVA RAMADA,617,1102,208,1979,1771,25,27
RS,88579,SANTO ANTÔNIO DAS MISSÕES,3772,3139,2453,9626,7173,127,135
RS,88587,JARI,1235,1098,520,2974,2454,68,53
RS,88595,SANTO AUGUSTO,4239,4142,1699,10367,8668,114,173
RS,88609,UBIRETAMA,511,1236,186,1968,1782,11,24
RS,88617,SANTO CRISTO,5191,4994,1249,11642,10393,88,120
RS,88625,BARRA DO QUARAÍ,1026,1167,904,3134,2230,18,19
RS,88633,SÃO BORJA,20500,15156,10731,47229,36498,342,500
RS,88641,CERRITO,2200,2176,556,5153,4597,134,87
RS,88650,SÃO FRANCISCO DE ASSIS,5661,6094,3728,16078,12350,356,239
RS,88668,VALE VERDE,850,1254,433,2640,2207,50,53
RS,88676,SÃO FRANCISCO DE PAULA,4787,7686,3159,16138,12979,243,263
RS,88684,NOVO CABRAIS,1350,1528,396,3339,2943,28,37
RS,88692,SÃO GABRIEL,16808,17158,9132,44088,34956,494,496
RS,88706,SETE DE SETEMBRO,731,827,210,1811,1601,18,25
RS,88714,SÃO JERÔNIMO,5072,7754,2916,16205,13289,229,234
RS,88722,TABAÍ,1007,1486,338,2930,2592,44,55
RS,88730,SÃO JOSÉ DO NORTE,8696,7250,2904,19488,16584,310,328
RS,88749,VILA LÂNGARO,678,1099,220,2054,1834,36,21
RS,88757,SÃO JOSÉ DO OURO,1585,2882,643,5345,4702,140,95
RS,88765,SENADOR SALGADO FILHO,593,1413,237,2293,2056,20,30
RS,88773,SÃO LEOPOLDO,63754,55641,20033,143874,123841,1847,2599
RS,88781,VESPASIANO CORRÊA,464,1380,491,2427,1936,58,34
RS,88790,SÃO LOURENÇO DO SUL,12581,15660,5379,34320,28941,338,362
RS,88803,MONTE ALEGRE DOS CAMPOS,487,1666,506,2727,2221,35,33
RS,88811,SÃO LUIZ GONZAGA,10334,8928,6653,26687,20034,344,428
RS,88820,MARQUES DE SOUZA,1217,1691,400,3425,3025,54,63
RS,88838,SÃO MARCOS,2437,9996,2299,15257,12958,210,315
RS,88846,CHUÍ,1284,1070,525,2951,2426,44,28
RS,88854,SÃO MARTINHO,1777,2140,873,4920,4047,64,66
RS,88862,ARARICÁ,1726,1539,631,3990,3359,37,57
RS,88870,SÃO NICOLAU,1967,1285,1098,4506,3408,66,90
RS,88889,PASSA SETE,1570,1560,452,3729,3277,47,100
RS,88897,SÃO PAULO DAS MISSÕES,2034,2246,724,5104,4380,45,55
RS,88900,TOROPI,736,1460,270,2534,2264,33,35
RS,88919,SÃO PEDRO DO SUL,3975,6640,1773,12837,11064,223,226
RS,88927,BALNEÁRIO PINHAL,1925,2588,1268,5970,4702,68,121
RS,88935,SÃO SEBASTIÃO DO CAÍ,6165,8322,2400,17462,15062,230,345
RS,88943,MAMPITUBA,1128,948,378,2521,2143,26,41
RS,88951,SÃO SEPÉ,7046,7709,3917,19265,15348,307,286
RS,88978,SÃO VALENTIM,1158,1544,407,3214,2807,52,53
RS,88986,ACEGUÁ,1097,1701,500,3352,2852,24,30
RS,88994,SAPIRANGA,23897,21146,7073,53327,46254,552,659
RS,89001,ALMIRANTE TAMANDARÉ DO SUL,623,930,265,1846,1581,11,17
RS,89010,SAPUCAIA DO SUL,48476,31151,12246,94748,82502,1292,1583
RS,89028,ARROIO DO PADRE,285,1624,156,2111,1955,16,30
RS,89036,SARANDI,5070,7106,3006,15639,12633,209,248
RS,89044,BOA VISTA DO CADEADO,531,988,318,1869,1551,15,17
RS,89052,SEBERI,3259,3738,1171,8414,7243,115,131
RS,89060,BOA VISTA DO INCRA,709,923,276,1941,1665,20,13
RS,89079,SELBACH,1019,2309,601,4011,3410,31,51
RS,89087,BOZANO,604,1107,217,1948,1731,13,7
RS,89095,SERAFINA CORRÊA,3141,4773,1360,9733,8373,254,205
RS,89109,CANUDOS DO VALE,832,771,262,1918,1656,24,29
RS,89117,SERTÃO,1697,2851,976,5691,4715,93,74
RS,89125,CAPÃO BONITO DO SUL,476,815,217,1543,1326,18,17
RS,89133,SEVERIANO DE ALMEIDA,1252,1410,292,3037,2745,39,44
RS,89141,CAPÃO DO CIPÓ,935,1024,433,2452,2019,26,34
RS,89150,CAPÃO DA CANOA,8492,12040,4751,26052,21301,329,440
RS,89168,COQUEIRO BAIXO,333,776,194,1332,1138,12,17
RS,89176,SOBRADINHO,3479,4962,1956,10691,8735,115,179
RS,89184,CORONEL PILAR,439,791,194,1475,1281,24,27
RS,89192,SOLEDADE,7287,9850,4244,21971,17727,222,368
RS,89206,CRUZALTENSE,616,1021,217,1918,1701,23,41
RS,89214,TAPEJARA,3065,7437,1526,12304,10778,113,163
RS,89222,FORQUETINHA,763,1205,277,2326,2049,34,47
RS,89230,TAPERA,2897,3574,1172,7850,6678,79,128
RS,89247,SANTA CECÍLIA DO SUL,488,837,248,1618,1370,24,21
RS,89249,ITATI,954,974,449,2485,2036,56,52
RS,89257,TAPES,4020,6013,2587,13032,10445,198,214
RS,89265,JACUIZINHO,901,797,390,2142,1752,19,35
RS,89273,TAQUARA,12162,18745,6064,38215,32151,508,736
RS,89281,LAGOA BONITA DO SUL,957,904,263,2209,1946,35,50
RS,89290,TAQUARI,7207,9015,2958,19801,16843,303,318
RS,89303,MATO QUEIMADO,674,652,236,1608,1372,26,20
RS,89311,TENENTE PORTELA,3967,3940,2254,10410,8156,83,166
RS,89320,NOVO XINGÚ,702,553,186,1476,1290,15,20
RS,89338,TORRES,8928,9918,4562,24295,19733,328,559
RS,89346,PAULO BENTO,564,951,143,1706,1563,23,25
RS,89354,TRAMANDAÍ,9853,11486,6358,28439,22081,325,417
RS,89362,PINHAL DA SERRA,657,694,582,2004,1422,37,34
RS,89370,TRÊS COROAS,6089,7404,1862,15902,14040,269,278
RS,89389,QUATRO IRMÃOS,574,596,211,1412,1201,16,15
RS,89397,TRÊS DE MAIO,5224,9646,3771,18984,15213,143,200
RS,89400,ROLADOR,1077,822,539,2530,1991,45,47
RS,89419,TRÊS PASSOS,7375,7231,3502,18565,15063,182,275
RS,89435,TRIUNFO,6324,9605,2163,18803,16640,311,400
RS,89443,SANTA MARGARIDA DO SUL,729,1171,292,2257,1965,27,38
RS,89451,TUCUNDUVA,1431,2712,656,4906,4250,34,73
RS,89460,SÃO JOSÉ DO SUL,549,909,102,1629,1527,38,31
RS,89478,TUPANCIRETÃ,5713,7497,3059,16720,13661,207,244
RS,89486,SÃO PEDRO DAS MISSÕES,663,561,144,1424,1280,17,39
RS,89494,TUPARENDI,2313,3666,1319,7474,6155,73,103
RS,89508,TIO HUGO,774,943,279,2046,1767,22,28
RS,89516,URUGUAIANA,30995,36538,17501,86462,68961,604,824
RS,89524,WESTFÁLIA,655,1261,246,2232,1986,37,33
RS,89532,VACARIA,9600,24179,7523,42572,35049,635,635
RS,89559,VENÂNCIO AIRES,20519,19982,6214,48285,42071,718,852
RS,89567,PEDRAS ALTAS,766,759,436,1994,1558,9,24
RS,89575,VERA CRUZ,6782,7570,1816,16633,14817,188,277
RS,89591,VERANÓPOLIS,3365,10689,2306,17041,14735,298,383
RS,89613,VIADUTOS,1670,2158,798,4768,3970,65,77
RS,89630,VIAMÃO,59197,63974,20433,149260,128827,2468,3188
RS,89656,VICENTE DUTRA,1493,1784,953,4347,3394,42,75
RS,89672,PALMARES DO SUL,3264,4276,2087,9872,7785,97,148
RS,89699,VICTOR GRAEFF,658,1518,403,2634,2231,29,26
RS,89710,TAVARES,1916,1635,583,4277,3694,50,93
RS,89737,CAPÃO DO LEÃO,6135,7247,3030,17018,13988,293,313
RS,89753,SALTO DO JACUÍ,3730,3186,1685,8808,7123,78,129
RS,89770,COTIPORÃ,1086,1730,327,3320,2993,89,88
RS,98213,TEUTÔNIA,5955,9631,2217,18390,16173,253,334
RS,98230,BOM PRINCÍPIO,2209,4557,736,7815,7079,153,160
RS,98256,PAROBÉ,15504,11054,4326,31822,27496,392,546
RS,98272,FORTALEZA DOS VALOS,1441,1574,600,3686,3086,41,30
RS,98299,JÓIA,2437,2457,1052,6049,4997,48,55
SC,80004,MONTE CARLO,2452,2323,1463,6799,5336,88,473
SC,80012,ABELARDO LUZ,4810,3520,2653,11780,9127,107,690
SC,80020,IPORÃ DO OESTE,2223,2588,1003,6169,5166,52,303
SC,80039,AGROLÂNDIA,1951,2976,752,6119,5367,88,352
SC,80047,LINDÓIA DO SUL,1492,1418,560,3698,3138,43,185
SC,80055,AGRONÔMICA,954,1705,327,3202,2875,39,177
SC,80063,APIÚNA,2330,2767,1079,6644,5565,74,394
SC,80071,ÁGUA DOCE,2058,1813,933,5101,4168,42,255
SC,80080,DOUTOR PEDRINHO,629,1401,183,2368,2185,25,130
SC,80098,ÁGUAS DE CHAPECÓ,2063,1163,486,4022,3536,62,248
SC,80101,JOSÉ BOITEUX,1244,1378,589,3441,2852,35,195
SC,80110,ÁGUAS MORNAS,1510,2512,401,4821,4420,94,304
SC,80128,VITOR MEIRELES,1515,1725,795,4282,3487,39,208
SC,80136,ALFREDO WAGNER,2101,3582,1218,7326,6108,84,341
SC,80144,UNIÃO DO OESTE,1232,704,292,2393,2101,54,111
SC,80152,ANCHIETA,1886,1908,845,5019,4174,78,302
SC,80160,URUPEMA,706,897,265,1997,1732,30,99
SC,80179,ANGELINA,2123,1757,542,4692,4150,58,212
SC,80187,IRACEMINHA,1315,1476,367,3373,3006,47,168
SC,80195,ANITA GARIBALDI,2682,2325,2182,7686,5504,101,396
SC,80209,TIMBÓ GRANDE,958,2354,901,4551,3650,40,298
SC,80217,ANITÁPOLIS,1082,1022,411,2668,2257,25,128
SC,80225,ABDON BATISTA,853,956,148,2072,1924,32,83
SC,80233,ANTÔNIO CARLOS,1964,2632,387,5359,4972,67,309
SC,80241,SANTA ROSA DO SUL,2895,1841,948,6084,5136,115,285
SC,80250,ARAQUARI,4807,3965,2362,11928,9566,118,676
SC,80268,CELSO RAMOS,1027,648,380,2205,1825,52,98
SC,80276,ARARANGUÁ,16845,15798,6689,41609,34920,418,1859
SC,80284,SERRA ALTA,1081,857,385,2469,2084,37,109
SC,80292,ARMAZÉM,2135,2074,409,4913,4504,70,225
SC,80306,COCAL DO SUL,4827,3576,1639,10782,9143,152,588
SC,80314,ARROIO TRINTA,992,1153,411,2787,2376,40,191
SC,80322,NOVA ITABERABA,1542,1115,270,3137,2867,33,177
SC,80330,ASCURRA,1603,2590,890,5495,4605,75,337
SC,80349,SANTA TEREZINHA,1917,3009,907,6144,5237,42,269
SC,80357,ATALANTA,576,1552,247,2534,2287,41,118
SC,80365,MIRIM DOCE,651,1002,370,2120,1750,12,85
SC,80373,AURORA,1591,1880,553,4276,3723,52,200
SC,80381,CERRO NEGRO,1378,811,357,2761,2404,29,186
SC,80390,BALNEÁRIO CAMBORIÚ,21608,31556,14470,71442,56972,755,3053
SC,80403,PASSO DE TORRES,1650,1503,791,4169,3378,57,168
SC,80411,BARRA VELHA,3371,5273,2853,12280,9427,125,658
SC,80420,BRAÇO DO TROMBUDO,593,1547,417,2712,2295,19,136
SC,80438,BENEDITO NOVO,1766,4424,831,7524,6693,83,420
SC,80446,SUL BRASIL,1120,718,233,2194,1961,19,104
SC,80454,BIGUAÇU,11102,15375,4570,33760,29190,521,2192
SC,80462,VARGEM,960,862,390,2359,1969,24,123
SC,80470,BLUMENAU,58438,101441,27673,202657,174984,2739,12366
SC,80489,ARABUTÃ,1406,1289,379,3258,2879,52,132
SC,80497,BOM RETIRO,1531,3146,1429,6524,5095,75,343
SC,80500,ÁGUAS FRIAS,1012,648,218,1976,1758,13,85
SC,80519,BOTUVERÁ,1384,1177,252,3092,2840,71,208
SC,80527,GUATAMBÚ,1703,1246,405,3616,3211,42,220
SC,80535,BRAÇO DO NORTE,5202,10465,2444,19321,16877,253,957
SC,80543,PLANALTO ALEGRE,1055,747,204,2121,1917,15,100
SC,80551,BRUSQUE,21316,30793,7482,63577,56095,785,3201
SC,80560,RIQUEZA,1717,1121,433,3491,3058,47,173
SC,80578,CAÇADOR,16625,18492,7979,46778,38799,638,3044
SC,80586,LAJEADO GRANDE,612,532,200,1435,1235,20,71
SC,80594,CAIBI,2257,1662,772,5043,4271,75,277
SC,80608,RIO RUFINO,441,1049,394,2016,1622,28,104
SC,80616,CAMBORIÚ,11913,9107,5194,28092,22898,305,1573
SC,80624,PASSOS MAIA,1389,791,622,3019,2397,24,193
SC,80632,CAMPO ALEGRE,1724,5293,1242,8814,7572,90,465
SC,80640,SÃO JOÃO DO OESTE,1576,2218,444,4527,4083,57,232
SC,80659,CAMPO BELO DO SUL,1650,2938,1439,6447,5008,55,365
SC,80667,CALMON,923,969,879,3010,2131,16,223
SC,80675,CAMPO ERÊ,3068,1782,1321,6661,5340,94,396
SC,80683,BALNEÁRIO BARRA DO SUL,1857,2473,1536,6168,4632,42,260
SC,80691,CAMPOS NOVOS,6967,10514,4213,23148,18935,257,1197
SC,80705,PARAÍSO,1447,1109,449,3197,2748,25,167
SC,80713,CANELINHA,2317,2962,1173,7014,5841,119,443
SC,80721,SANTA HELENA,819,759,343,2082,1739,44,117
SC,80730,CANOINHAS,8801,20779,6161,37888,31727,325,1822
SC,80748,BELMONTE,749,962,331,2180,1849,17,121
SC,80756,CAPINZAL,5500,5572,2329,14500,12171,217,882
SC,80764,NOVO HORIZONTE,734,1035,243,2157,1914,34,111
SC,80772,CATANDUVAS,2565,2236,950,6153,5203,61,341
SC,80780,SÃO MIGUEL DA BOA VISTA,694,547,311,1645,1334,19,74
SC,80799,CAXAMBU DO SUL,1702,1416,356,3744,3388,66,204
SC,80802,ARVOREDO,845,576,140,1661,1521,15,85
SC,80810,CHAPECÓ,42263,43750,15390,107670,92280,1064,5203
SC,80829,IPUAÇU,2045,805,705,3831,3126,38,238
SC,80837,CONCÓRDIA,19854,19314,7722,49991,42269,589,2512
SC,80845,OURO VERDE,707,675,211,1738,1527,25,120
SC,80853,CORONEL FREITAS,3213,3099,1181,8089,6908,131,465
SC,80861,IRATI,632,636,212,1597,1385,19,98
SC,80870,CORUPÁ,3374,4690,1385,10049,8664,105,495
SC,80888,FORMOSA DO SUL,1003,624,336,2099,1763,30,106
SC,80896,CRICIÚMA,51618,49350,19776,128692,108916,1428,6520
SC,80900,MACIEIRA,773,534,393,1832,1439,17,115
SC,80918,CUNHA PORÃ,2201,4083,945,7737,6792,110,398
SC,80926,PONTE ALTA DO NORTE,775,990,420,2342,1922,17,140
SC,80934,CURITIBANOS,6636,13991,5779,28338,22559,283,1649
SC,80942,SÃO CRISTÓVÃO DO SUL,1033,1364,647,3237,2590,21,172
SC,80950,DESCANSO,2573,2800,676,6474,5798,80,345
SC,80969,VARGEM BONITA,1622,1302,502,3687,3185,37,224
SC,80977,DIONÍSIO CERQUEIRA,4105,3116,1592,9570,7978,120,637
SC,80985,BOMBINHAS,2576,3272,1746,8198,6452,132,472
SC,80993,DONA EMMA,985,1012,205,2353,2148,27,124
SC,81000,SANGÃO,2728,1894,865,5876,5011,86,303
SC,81019,ERVAL VELHO,1323,1448,439,3426,2987,32,184
SC,81027,CAPIVARI DE BAIXO,6935,3374,1072,12228,11156,115,732
SC,81035,FAXINAL DOS GUEDES,3548,2032,1166,7270,6104,91,433
SC,81043,CORDILHEIRA ALTA,1142,989,229,2519,2290,33,126
SC,81051,FLORIANÓPOLIS,99014,122104,45469,288746,243277,3729,18430
SC,81060,FORQUILHINHA,6956,4958,1674,14430,12756,152,690
SC,81078,FRAIBURGO,9596,8278,4947,24573,19626,318,1434
SC,81086,MORRO GRANDE,914,1133,196,2360,2164,25,92
SC,81094,GALVÃO,1110,979,674,2979,2305,36,180
SC,81108,CORONEL MARTINS,734,736,177,1773,1596,19,107
SC,81116,GOVERNADOR CELSO RAMOS,2989,4627,1961,10269,8308,129,563
SC,81124,SÃO JOÃO DO ITAPERIÚ,662,1187,243,2233,1990,24,117
SC,81132,GAROPABA,4983,4035,2090,11900,9810,147,645
SC,81140,JARDINÓPOLIS,696,466,220,1460,1240,17,61
SC,81159,GARUVA,2859,3743,1790,8881,7091,69,420
SC,81167,ERMO,898,1100,175,2296,2121,27,96
SC,81175,GASPAR,11859,15529,4215,33907,29692,428,1876
SC,81183,SÃO PEDRO DE ALCÂNTARA,1173,1558,269,3227,2958,38,189
SC,81191,GRÃO-PARÁ,1591,2692,449,5098,4649,84,282
SC,81205,SANTIAGO DO SUL,449,456,128,1120,992,17,70
SC,81213,GRAVATAL,2788,3245,869,7354,6485,72,380
SC,81221,BELA VISTA DO TOLDO,910,2564,561,4312,3751,47,230
SC,81230,GUABIRUBA,4296,4263,782,10182,9400,216,625
SC,81248,CAPÃO ALTO,575,1397,370,2510,2140,21,147
SC,81256,GUARACIABA,3262,3281,1159,8187,7028,90,395
SC,81264,PAINEL,785,950,235,2095,1860,21,104
SC,81272,GUARAMIRIM,8989,7385,2743,20340,17597,166,1057
SC,81280,BOCAINA DO SUL,781,1393,288,2641,2353,23,156
SC,81299,GUARUJÁ DO SUL,1413,1487,747,3864,3117,42,175
SC,81302,ALTO BELA VISTA,822,555,174,1648,1474,23,74
SC,81310,HERVAL D'OESTE,6321,5226,2205,14712,12507,110,850
SC,81329,FREI ROGÉRIO,758,907,392,2178,1786,25,96
SC,81337,IBICARÉ,1102,1130,396,2797,2401,41,128
SC,81345,TREVISO,1103,1264,233,2782,2549,29,153
SC,81353,IBIRAMA,3979,5499,2015,12377,10362,140,744
SC,81361,IOMERÊ,842,1061,237,2286,2049,34,112
SC,81370,IÇARA,19108,10562,5707,37697,31990,467,1853
SC,81388,BOM JESUS,1017,554,237,1923,1686,26,89
SC,81396,ILHOTA,3053,3884,1303,8848,7545,113,495
SC,81400,IBIAM,706,667,146,1622,1476,22,81
SC,81418,IMARUÍ,4301,2923,2470,10472,8002,129,649
SC,81426,ENTRE RIOS,1144,440,490,2226,1736,24,128
SC,81434,IMBITUBA,13331,7700,5084,28109,23025,355,1639
SC,81442,PAIAL,650,534,150,1401,1251,13,54
SC,81450,IMBUIA,1230,2162,548,4282,3734,108,234
SC,81469,BOM JESUS DO OESTE,779,686,232,1807,1575,42,68
SC,81477,INDAIAL,8628,17719,4363,33144,28781,394,2040
SC,81485,SÃO BERNARDINO,895,662,477,2187,1710,37,116
SC,81493,IPIRA,1591,1167,577,3556,2979,56,165
SC,81507,SANTA TEREZINHA DO PROGRESSO,944,774,362,2222,1860,31,111
SC,81515,IPUMIRIM,2339,2068,808,5578,4770,88,275
SC,81523,SALTINHO,1429,643,361,2725,2364,89,203
SC,81531,IRANI,2922,1984,926,6267,5341,88,347
SC,81540,JUPIÁ,624,691,186,1601,1415,23,77
SC,81558,IRINEÓPOLIS,2280,3248,1122,7132,6010,75,407
SC,81566,PALMEIRA,774,1082,226,2239,2013,17,140
SC,81574,ITÁ,2162,1824,951,5240,4289,44,259
SC,81582,BANDEIRANTE,1003,932,287,2360,2073,18,120
SC,81590,ITAIÓPOLIS,3212,8016,2271,14389,12118,149,741
SC,81604,FLOR DO SERTÃO,552,447,194,1310,1116,21,96
SC,81612,ITAJAÍ,36793,51012,17140,113062,95922,1629,6488
SC,81620,CUNHATAÍ,469,733,105,1383,1278,18,58
SC,81639,ITAPEMA,7315,10408,4669,23789,19120,309,1088
SC,81647,PRINCESA,893,737,378,2122,1744,32,82
SC,81655,ITAPIRANGA,4041,4712,1890,11211,9321,112,456
SC,81663,ITAPOÁ,2795,2989,2419,8640,6221,53,384
SC,81671,ITUPORANGA,4935,7792,2379,16082,13703,204,772
SC,81680,TIGRINHOS,736,377,189,1386,1197,16,68
SC,81698,JABORÁ,1322,1376,323,3264,2941,54,189
SC,81701,CHAPADÃO DO LAGEADO,817,862,156,1946,1790,21,90
SC,81710,JACINTO MACHADO,2669,4207,946,8327,7381,121,384
SC,81728,BALNEÁRIO ARROIO DO SILVA,2307,1876,907,5409,4502,41,278
SC,81736,JAGUARUNA,5649,3303,1867,11538,9671,157,562
SC,81744,BALNEÁRIO GAIVOTA,2409,1450,1029,5208,4179,54,266
SC,81752,JARAGUÁ DO SUL,38807,33663,10720,88457,77737,901,4366
SC,81760,BARRA BONITA,874,576,215,1792,1577,11,116
SC,81779,JOAÇABA,6883,8331,3312,19666,16354,207,933
SC,81787,BRUNÓPOLIS,1205,789,546,2724,2178,15,169
SC,81795,JOINVILLE,120474,139588,41253,321131,279878,3108,16708
SC,81809,LUZERNA,1653,2062,666,4685,4019,56,248
SC,81817,LACERDÓPOLIS,696,764,206,1775,1569,22,87
SC,81825,ZORTÉA,1021,858,328,2341,2013,21,113
SC,81833,LAGES,29078,55547,19311,110699,91388,1136,5627
SC,81850,LAGUNA,15635,11962,5987,36001,30014,374,2043
SC,81876,LAURENTINO,1487,1957,395,4142,3747,85,218
SC,81892,LAURO MÜLLER,3980,4693,1572,10987,9415,130,612
SC,81914,LEBON RÉGIS,2797,2929,2042,8444,6402,103,573
SC,81930,LEOBERTO LEAL,1112,1282,189,2736,2547,26,127
SC,81957,LONTRAS,2123,3068,983,6648,5665,104,370
SC,81973,LUÍS ALVES,1980,3483,760,6696,5936,68,405
SC,81990,MAFRA,8793,21676,5534,38650,33116,510,2137
SC,82015,MAJOR GERCINO,998,1015,410,2604,2194,44,137
SC,82031,MAJOR VIEIRA,1505,2746,777,5381,4604,37,316
SC,82058,MARAVILHA,6280,5615,3146,15975,12829,202,732
SC,82066,MAREMA,822,624,234,1808,1574,24,104
SC,82074,MASSARANDUBA,3426,5246,1260,10590,9330,96,562
SC,82090,MATOS COSTA,716,867,604,2336,1732,25,124
SC,82112,MELEIRO,1882,2459,584,5250,4666,49,276
SC,82139,MODELO,1201,1168,422,2974,2552,35,148
SC,82155,MONDAÍ,3476,2067,1151,7124,5973,66,364
SC,82171,MONTE CASTELO,1888,2599,1515,6471,4956,69,400
SC,82198,MORRO DA FUMAÇA,3940,4468,1119,10227,9108,124,576
SC,82210,NAVEGANTES,11763,12841,5805,32514,26709,405,1700
SC,82236,NOVA ERECHIM,1397,1117,452,3153,2701,32,155
SC,82252,NOVA TRENTO,2952,3866,1052,8510,7458,158,482
SC,82279,NOVA VENEZA,4193,3490,1077,9339,8262,100,479
SC,82295,ORLEANS,4098,8585,2168,15898,13730,209,838
SC,82317,OURO,1895,2589,824,5689,4865,83,298
SC,82333,PALHOÇA,29687,28765,9582,73836,64254,1074,4728
SC,82350,PALMA SOLA,2581,1524,1268,5756,4488,51,332
SC,82376,PALMITOS,4320,5112,2462,12664,10202,122,648
SC,82392,PAPANDUVA,5297,4600,2387,13149,10762,122,743
SC,82414,PAULO LOPES,2413,1547,694,5008,4314,72,282
SC,82430,PEDRAS GRANDES,1375,1676,498,3788,3290,59,180
SC,82457,PENHA,3659,6189,2878,13647,10769,164,757
SC,82473,PERITIBA,918,1238,384,2696,2312,34,122
SC,82490,PETROLÂNDIA,1551,2431,758,5064,4306,78,246
SC,82511,BALNEÁRIO PIÇARRAS,2958,4014,2366,9927,7561,83,506
SC,82538,PINHALZINHO,4499,3680,1663,10551,8888,146,563
SC,82554,PINHEIRO PRETO,771,1012,339,2285,1946,40,123
SC,82570,PIRATUBA,1705,1387,593,3898,3305,35,178
SC,82597,POMERODE,6567,8717,2088,18611,16523,200,1039
SC,82619,PONTE ALTA,1090,1852,697,3883,3186,25,219
SC,82635,PONTE SERRADA,3385,2220,1768,7942,6174,70,499
SC,82651,PORTO BELO,2557,3323,1738,8183,6445,99,466
SC,82678,PORTO UNIÃO,6983,10519,4725,23384,18659,211,946
SC,82694,POUSO REDONDO,3365,3928,1538,9541,8003,111,599
SC,82716,PRAIA GRANDE,2048,2105,502,5055,4553,87,313
SC,82732,PRESIDENTE CASTELO BRANCO,577,759,209,1620,1411,22,53
SC,82759,PRESIDENTE GETÚLIO,3319,4702,1318,9978,8660,126,513
SC,82775,PRESIDENTE NEREU,743,859,292,2043,1751,32,117
SC,82791,QUILOMBO,3273,3022,1101,7842,6741,95,351
SC,82813,RANCHO QUEIMADO,744,1151,301,2377,2076,50,131
SC,82830,RIO DAS ANTAS,1609,2486,912,5356,4444,65,284
SC,82856,RIO DO CAMPO,1381,2708,946,5311,4365,39,237
SC,82872,RIO DO OESTE,1770,2529,701,5336,4635,58,278
SC,82899,RIO DOS CEDROS,1900,3968,472,6827,6355,69,418
SC,82910,RIO DO SUL,11935,20569,6483,41553,35070,434,2132
SC,82937,RIO FORTUNA,1199,2102,241,3755,3514,51,162
SC,82953,RIO NEGRINHO,5717,17347,4375,29151,24776,223,1489
SC,82970,RODEIO,2212,4405,1041,8329,7288,123,548
SC,82996,ROMELÂNDIA,2008,1301,704,4294,3590,58,223
SC,83011,SALETE,1495,2930,905,5640,4735,37,273
SC,83038,SALTO VELOSO,1091,1273,490,3093,2603,24,215
SC,83054,SANTA CECÍLIA,1902,6468,2525,11712,9187,127,690
SC,83070,SANTA ROSA DE LIMA,834,663,105,1699,1594,28,69
SC,83097,SANTO AMARO DA IMPERATRIZ,4861,5909,1327,13038,11711,132,809
SC,83119,SÃO BENTO DO SUL,12806,29632,6279,51449,45170,428,2304
SC,83135,SÃO BONIFÁCIO,583,1495,350,2589,2239,39,122
SC,83151,SÃO CARLOS,2809,2923,1197,7361,6164,100,332
SC,83178,SÃO DOMINGOS,3074,2255,1529,7389,5860,120,411
SC,83194,SÃO FRANCISCO DO SUL,9867,11209,5665,28446,22781,321,1384
SC,83216,SÃO JOÃO BATISTA,4459,6198,1922,13625,11703,256,790
SC,83232,SÃO JOÃO DO SUL,2002,2349,371,5052,4681,81,249
SC,83259,SÃO JOAQUIM,5103,9390,3006,18756,15750,225,1032
SC,83275,SÃO JOSÉ,47480,54017,18365,129549,111184,1801,7886
SC,83291,SÃO JOSÉ DO CEDRO,4821,3398,2375,11198,8823,155,449
SC,83313,SÃO JOSÉ DO CERRITO,2907,2548,1705,7676,5971,78,438
SC,83330,SÃO LOURENÇO DO OESTE,5503,6648,3480,16752,13272,265,856
SC,83356,SÃO LUDGERO,2811,3100,917,7321,6404,96,397
SC,83372,SÃO MARTINHO,1021,1345,199,2718,2519,33,120
SC,83399,SÃO MIGUEL DO OESTE,10003,8825,4785,25060,20275,259,1188
SC,83410,SAUDADES,2603,2756,786,6546,5760,75,326
SC,83437,SCHROEDER,4687,2687,1032,8946,7914,78,462
SC,83453,SEARA,5606,4750,2018,13045,11027,141,530
SC,83470,SIDERÓPOLIS,4084,3552,1699,9871,8172,114,422
SC,83496,SOMBRIO,7759,6053,3073,17988,14915,225,878
SC,83518,TAIÓ,3173,6923,2304,13234,10930,126,708
SC,83534,TANGARÁ,2169,3084,763,6399,5636,66,317
SC,83550,TIJUCAS,7372,8574,3430,20764,17334,206,1182
SC,83577,TIMBÓ,5627,14986,2696,24707,22011,201,1197
SC,83593,TRÊS BARRAS,4549,5369,2348,13136,10788,112,758
SC,83615,TREZE DE MAIO,2097,2142,621,5183,4562,72,251
SC,83631,TREZE TÍLIAS,1026,1902,706,3905,3199,43,228
SC,83658,TROMBUDO CENTRAL,1202,2447,453,4407,3954,48,257
SC,83674,TUBARÃO,27584,25925,10177,68306,58129,821,3799
SC,83682,TUNÁPOLIS,1173,1747,489,3612,3123,35,168
SC,83690,TURVO,3174,4221,726,8636,7910,104,411
SC,83712,URUBICI,1925,3514,1587,7482,5895,54,402
SC,83739,URUSSANGA,5607,6282,2382,15253,12871,179,803
SC,83755,VARGEÃO,1225,715,381,2476,2095,32,123
SC,83771,VIDAL RAMOS,1440,2309,742,4808,4066,76,241
SC,83798,VIDEIRA,11514,12452,5243,31534,26291,448,1877
SC,83810,WITMARSUM,902,1201,426,2703,2277,54,120
SC,83836,XANXERÊ,13590,8649,4845,28779,23934,317,1378
SC,83852,XAVANTINA,1504,1294,258,3207,2949,40,111
SC,83879,XAXIM,7700,5882,2953,17838,14885,238,1065
SC,83895,BOM JARDIM DA SERRA,889,1633,440,3173,2733,21,190
SC,83917,MARACAJÁ,2753,1369,632,5053,4421,49,250
SC,83933,TIMBÉ DO SUL,1721,1820,571,4388,3817,68,208
SC,83950,CORREIA PINTO,3349,5468,1707,11285,9578,152,609
SC,83976,OTACÍLIO COSTA,3956,4746,1945,11309,9364,116,546
SE,31003,SANTANA DO SÃO FRANCISCO,2446,1075,668,4325,3657,41,95
SE,31011,AMPARO DO SÃO FRANCISCO,876,488,438,1869,1431,17,50
SE,31038,AQUIDABÃ,5479,4712,3718,14445,10727,115,421
SE,31054,ARACAJU,158770,121521,54779,347712,292933,3632,9010
SE,31070,ARAUÁ,3484,2530,1848,8137,6289,60,215
SE,31097,AREIA BRANCA,4210,3815,1475,9909,8434,95,314
SE,31119,BARRA DOS COQUEIROS,5322,6107,2501,14336,11835,164,242
SE,31135,BREJO GRANDE,2442,1072,833,4542,3709,52,143
SE,31151,BOQUIM,10174,4247,3976,18993,15017,159,437
SE,31194,CAMPO DO BRITO,5815,3401,2610,12298,9688,106,366
SE,31216,CANHOBA,1699,1073,695,3612,2917,27,118
SE,31232,CANINDÉ DO SÃO FRANCISCO,9552,2548,3329,15901,12572,79,393
SE,31259,CAPELA,7677,5795,4313,18645,14332,201,659
SE,31275,CARIRA,4806,5446,3523,14342,10819,103,464
SE,31291,CARMÓPOLIS,3450,3032,1596,8426,6830,130,218
SE,31313,CEDRO DE SÃO JOÃO,2144,1388,896,4562,3666,37,97
SE,31330,CRISTINÁPOLIS,6112,1549,3005,11002,7997,70,266
SE,31356,NOSSA SENHORA APARECIDA,2831,1728,989,5736,4747,47,141
SE,31372,CUMBE,1366,844,373,2698,2325,40,75
SE,31399,DIVINA PASTORA,1069,1194,335,2700,2365,37,65
SE,31410,ESTÂNCIA,21318,9380,7145,39424,32279,546,1035
SE,31437,FEIRA NOVA,1920,1237,713,4015,3302,41,104
SE,31453,FREI PAULO,3894,3441,1761,9479,7718,121,262
SE,31470,GENERAL MAYNARD,831,658,256,1802,1546,11,46
SE,31496,GARARU,3163,2948,1006,7418,6412,60,241
SE,31518,GRACCHO CARDOSO,2163,1273,1082,4708,3626,44,146
SE,31534,ILHA DAS FLORES,2872,1577,1611,6281,4670,67,154
SE,31550,INDIAROBA,5655,1117,1577,8673,7096,54,270
SE,31577,ITABAIANA,22316,21454,8686,54382,45696,499,1427
SE,31593,ITABAIANINHA,13233,5729,5524,25376,19852,209,681
SE,31615,ITABI,1783,1293,820,4048,3228,47,105
SE,31631,ITAPORANGA D'AJUDA,8163,7183,3073,19291,16218,185,687
SE,31658,JAPARATUBA,4949,3851,2393,11610,9217,96,321
SE,31674,JAPOATÃ,3893,3119,1814,9130,7316,69,235
SE,31690,LAGARTO,30809,16283,11890,61302,49412,566,1754
SE,31712,LARANJEIRAS,9322,5080,2251,17324,15073,214,457
SE,31739,MACAMBIRA,2270,1596,561,4636,4075,57,152
SE,31755,MALHADA DOS BOIS,1365,842,583,2900,2317,26,84
SE,31771,MALHADOR,4076,2484,1096,7996,6900,89,251
SE,31798,MARUIM,4992,3752,1673,10848,9175,153,278
SE,31810,MOITA BONITA,4006,2173,1169,7732,6563,112,272
SE,31836,MONTE ALEGRE DE SERGIPE,4056,2386,994,7778,6784,67,275
SE,31852,MURIBECA,1918,2108,1396,5636,4240,46,168
SE,31879,NEÓPOLIS,5953,4031,2382,12850,10468,143,341
SE,31895,NOSSA SENHORA DA GLÓRIA,8263,7119,3917,19973,16056,142,532
SE,31917,NOSSA SENHORA DAS DORES,6962,5799,3629,17292,13663,270,632
SE,31933,NOSSA SENHORA DE LOURDES,2277,1390,578,4418,3840,30,143
SE,31950,NOSSA SENHORA DO SOCORRO,29937,27804,12004,71757,59753,670,1342
SE,31976,PACATUBA,4141,2273,2976,9695,6719,61,244
SE,31992,PEDRA MOLE,948,832,391,2247,1856,19,57
SE,32018,PEDRINHAS,3352,1390,1499,6457,4958,41,175
SE,32034,PINHÃO,2324,1174,495,4141,3646,28,120
SE,32050,PIRAMBU,2780,2141,1276,6381,5105,45,139
SE,32077,POÇO REDONDO,7715,4235,2989,15583,12594,95,549
SE,32093,POÇO VERDE,8225,3800,3913,16480,12567,118,424
SE,32115,PORTO DA FOLHA,7454,5862,4031,18088,14057,190,551
SE,32131,PROPRIÁ,8188,6752,4343,19755,15412,146,326
SE,32158,RIACHÃO DO DANTAS,8169,2724,3201,14679,11478,127,458
SE,32174,RIACHUELO,2628,2392,584,5879,5295,91,184
SE,32190,RIBEIRÓPOLIS,5407,3673,1732,11291,9559,113,366
SE,32212,ROSÁRIO DO CATETE,2753,2465,1225,6651,5426,62,146
SE,32239,SALGADO,7000,2987,1977,12456,10479,119,373
SE,32255,SANTA LUZIA DO ITANHY,4417,1658,1967,8470,6503,109,319
SE,32298,SANTA ROSA DE LIMA,1164,1160,510,2940,2430,26,80
SE,32310,SANTO AMARO DAS BROTAS,4095,1621,1710,7704,5994,53,225
SE,32336,SÃO CRISTÓVÃO,20093,15169,6748,43675,36927,509,1156
SE,32352,SÃO DOMINGOS,2566,2514,1492,6868,5376,55,241
SE,32379,SÃO FRANCISCO,970,1011,300,2362,2062,15,66
SE,32395,SÃO MIGUEL DO ALEIXO,1377,703,504,2728,2224,43,101
SE,32417,SIMÃO DIAS,16533,5483,4493,27703,23210,297,897
SE,32433,SIRIRI,2174,1936,1091,5419,4328,72,146
SE,32450,TELHA,1024,869,390,2361,1971,17,61
SE,32476,TOBIAS BARRETO,21216,4737,7628,34579,26951,145,853
SE,32492,TOMAR DO GERU,4717,2107,2493,9724,7231,63,344
SE,32514,UMBAÚBA,7824,2557,2355,13200,10845,147,317
SP,61000,EUCLIDES DA CUNHA PAULISTA,3196,2076,2025,7477,5452,49,131
SP,61018,ADAMANTINA,7964,11465,5877,26284,20407,395,583
SP,61026,BOREBI,551,918,362,1877,1515,21,25
SP,61034,ADOLFO,1246,1054,586,3002,2416,37,79
SP,61042,TARUMÃ,4270,2867,1584,8927,7343,58,148
SP,61050,AGUAÍ,8283,8573,4249,21870,17621,191,574
SP,61069,MOTUCA,1465,1045,670,3258,2588,21,57
SP,61077,ÁGUAS DA PRATA,1623,2892,1185,5884,4699,49,135
SP,61085,IARAS,1064,958,695,2786,2091,22,47
SP,61093,ÁGUAS DE LINDÓIA,2090,7433,2244,12163,9919,106,290
SP,61107,GUATAPARÁ,2172,1254,959,4504,3545,45,74
SP,61115,ÁGUAS DE SÃO PEDRO,491,1780,689,3027,2338,19,48
SP,61123,DIRCE REIS,541,617,169,1391,1222,33,31
SP,61131,AGUDOS,9088,10579,5066,25969,20903,363,873
SP,61140,ESPÍRITO SANTO DO TURVO,1089,1085,316,2541,2225,12,39
SP,61158,ALFREDO MARCONDES,1299,1437,510,3366,2856,39,81
SP,61166,ROSANA,7732,3548,5596,17270,11674,123,271
SP,61174,ALTAIR,1229,895,789,3032,2243,39,80
SP,61182,EMBAÚBA,785,726,256,1864,1608,45,52
SP,61190,ALTINÓPOLIS,4888,4422,2687,12414,9727,149,268
SP,61204,ILHA SOLTEIRA,7569,6229,4932,19647,14715,200,717
SP,61212,ALTO ALEGRE,1292,1577,585,3576,2991,47,75
SP,61220,ALUMÍNIO,6028,3566,1205,11221,10016,130,292
SP,61239,ÁLVARES FLORENCE,776,1544,361,2792,2431,28,83
SP,61247,PEDRINHAS PAULISTA,737,1126,490,2412,1922,17,42
SP,61255,ÁLVARES MACHADO,6842,5167,2806,15308,12502,157,336
SP,61263,ARAÇARIGUAMA,3846,4047,2412,10546,8134,85,156
SP,61271,ÁLVARO DE CARVALHO,1124,974,671,2920,2249,33,118
SP,61280,BERTIOGA,10633,11085,7351,29775,22424,216,490
SP,61298,ALVINLÂNDIA,1104,720,507,2378,1871,16,31
SP,61301,SUZANÁPOLIS,1141,776,523,2536,2013,36,60
SP,61310,AMERICANA,63910,60844,21298,152445,131147,2001,4392
SP,61328,SANTO ANTÔNIO DO ARACANGUÁ,2453,1990,1298,5824,4526,19,64
SP,61336,AMÉRICO BRASILIENSE,10500,7235,3636,22314,18678,230,713
SP,61344,CANITAR,1250,1154,709,3196,2487,28,55
SP,61352,AMÉRICO DE CAMPOS,1099,2507,803,4548,3745,43,96
SP,61360,BARRA DO CHAPÉU,1695,1425,1062,4280,3218,22,76
SP,61379,AMPARO,10825,26404,7239,46246,39007,470,1308
SP,61387,EMILIANÓPOLIS,1186,802,363,2421,2058,21,49
SP,61395,ANALÂNDIA,675,2094,839,3698,2859,24,66
SP,61409,NOVAIS,1182,1009,447,2764,2317,31,95
SP,61417,ANDRADINA,15046,16353,9080,42016,32936,485,1052
SP,61425,NOVA CANAÃ PAULISTA,819,722,363,1971,1608,28,39
SP,61433,ANGATUBA,5502,6504,2675,15194,12519,153,360
SP,61441,SALTINHO,1319,3268,535,5295,4760,66,107
SP,61450,ANHEMBI,1220,1625,1125,4059,2934,30,59
SP,61468,UBARANA,1547,1219,737,3599,2862,37,59
SP,61476,ANHUMAS,1137,1073,399,2681,2282,31,41
SP,61484,CAJATI,8232,7497,5460,21725,16265,168,368
SP,61492,APARECIDA,8697,13015,3210,25577,22367,232,423
SP,61506,CAMPINA DO MONTE ALEGRE,1160,1982,762,4024,3262,31,89
SP,61514,APARECIDA D'OESTE,1522,1350,729,3743,3014,56,86
SP,61522,ASPÁSIA,539,661,228,1494,1266,20,46
SP,61530,APIAÍ,6541,7050,5486,19616,14130,166,373
SP,61549,VARGEM,1623,2614,1365,5788,4423,83,103
SP,61557,ARAÇATUBA,35548,63650,24721,127663,102942,976,2768
SP,61565,POTIM,3756,4031,1403,9371,7968,54,127
SP,61573,ARAÇOIABA DA SERRA,4762,8567,2134,15992,13858,148,381
SP,61581,ALAMBARI,814,1774,692,3346,2654,22,44
SP,61590,ARAMINA,2136,1064,532,3854,3322,42,80
SP,61603,ITAÓCA,889,853,462,2324,1862,32,88
SP,61611,ARANDU,1787,1843,772,4532,3760,41,89
SP,61620,TUIUTI,1219,2268,908,4536,3628,57,84
SP,61638,ARARAQUARA,47135,62287,22827,139101,116274,1483,5369
SP,61646,ARAPEÍ,874,808,453,2198,1745,16,47
SP,61654,ARARAS,23396,43193,11512,81552,70040,1007,2444
SP,61662,ESTIVA GERBI,3592,2421,1053,7356,6303,83,207
SP,61670,AREALVA,1508,2986,843,5548,4705,73,138
SP,61689,ENGENHEIRO COELHO,3552,3175,1755,8690,6935,74,134
SP,61697,AREIAS,1199,1130,661,3077,2416,23,64
SP,61700,RIBEIRÃO GRANDE,2638,2012,1217,6049,4832,58,124
SP,61719,AREIÓPOLIS,3281,2555,1455,7510,6055,84,135
SP,61727,HORTOLÂNDIA,64717,21130,16531,105448,88917,950,2120
SP,61735,ARIRANHA,2477,2650,1066,6436,5370,91,152
SP,61743,HOLAMBRA,3113,3679,1156,8133,6977,67,118
SP,61751,ARTUR NOGUEIRA,11226,9688,4147,25938,21791,284,593
SP,61760,ELISIÁRIO,1150,772,332,2325,1993,22,49
SP,61778,ARUJÁ,19904,20022,9471,51003,41532,465,1141
SP,61786,BOM SUCESSO DE ITARARÉ,740,1167,610,2549,1939,5,27
SP,61794,ASSIS,21369,27714,13277,64731,51454,669,1702
SP,61808,PONTALINDA,1228,1080,577,2981,2404,42,54
SP,61816,ATIBAIA,19798,46081,16088,84729,68641,881,1881
SP,61824,PARISI,475,947,257,1735,1478,18,38
SP,61832,AURIFLAMA,4011,4192,1564,10100,8536,127,206
SP,61840,TAQUARIVAÍ,965,1916,982,3915,2933,20,32
SP,61859,AVAÍ,1425,1361,953,3823,2870,27,57
SP,61867,MARAPOAMA,599,903,251,1829,1578,17,59
SP,61875,AVANHANDAVA,3089,2244,1417,6965,5548,76,139
SP,61883,SÃO JOÃO DE IRACEMA,665,416,309,1429,1120,16,23
SP,61891,AVARÉ,15650,27545,10296,55470,45174,542,1437
SP,61905,SÃO LOURENÇO DA SERRA,3047,3829,1724,8922,7198,119,203
SP,61913,BADY BASSIT,2957,4551,2002,9845,7843,99,236
SP,61921,ZACARIAS,916,545,234,1778,1544,17,66
SP,61930,BALBINOS,400,586,240,1265,1025,13,26
SP,61948,ITAPIRAPUÃ PAULISTA,1202,882,494,2661,2167,23,60
SP,61956,BÁLSAMO,1704,3087,619,5606,4987,102,94
SP,61964,MESÓPOLIS,444,664,341,1490,1149,14,27
SP,61972,BANANAL,2822,3113,1306,7551,6245,38,272
SP,61980,NOVA CAMPINA,1902,2762,1154,5914,4760,34,62
SP,61999,BARBOSA,1586,1963,1296,4983,3687,29,109
SP,62006,ILHA COMPRIDA,2232,2789,2540,7733,5193,51,121
SP,62014,BARÃO DE ANTONINA,649,1086,630,2435,1805,23,47
SP,62022,LOURDES,526,834,199,1604,1405,15,30
SP,62030,BARIRI,5175,11787,4299,22193,17894,308,624
SP,62049,TORRE DE PEDRA,560,1002,689,2300,1611,21,28
SP,62057,BARRA BONITA,7731,14884,5193,28704,23511,278,618
SP,62065,ARCO ÍRIS,560,850,193,1626,1433,8,15
SP,62073,BARRA DO TURVO,2564,1500,2450,6702,4252,37,151
SP,62081,BREJO ALEGRE,916,536,264,1791,1527,24,51
SP,62090,BARRETOS,27086,33048,15062,77684,62622,807,1681
SP,62103,CANAS,910,1382,495,2857,2362,16,54
SP,62111,BARRINHA,10504,3916,3887,18783,14896,180,296
SP,62120,PRACINHA,410,592,147,1181,1034,7,25
SP,62138,BARUERI,90392,55628,29395,181007,151612,1915,3677
SP,62146,PRATÂNIA,842,1796,725,3449,2724,28,58
SP,62154,BASTOS,4116,8486,3926,16904,12978,161,215
SP,62162,QUADRA,551,1366,593,2571,1978,23,38
SP,62170,BATATAIS,11485,19606,6315,38594,32279,391,797
SP,62189,SANTA CRUZ DA ESPERANÇA,480,619,285,1450,1165,10,56
SP,62197,BAURU,79403,97785,37578,225390,187812,2782,7842
SP,62200,SANTA SALETE,461,630,159,1316,1157,26,40
SP,62219,BEBEDOURO,16858,24835,10525,53868,43343,546,1104
SP,62227,VITÓRIA BRASIL,584,567,212,1422,1210,27,32
SP,62235,BENTO DE ABREU,683,865,233,1857,1624,24,52
SP,62243,IPIGUÁ,657,1588,403,2716,2313,23,45
SP,62251,BERNARDINO DE CAMPOS,2432,3747,1635,8083,6448,96,173
SP,62260,TAQUARAL,880,720,383,2041,1658,28,30
SP,62278,BILAC,1193,3106,839,5330,4491,58,134
SP,62286,FERNÃO,383,500,157,1070,913,11,19
SP,62294,BIRIGUI,20840,35203,11045,70504,59459,902,2514
SP,62308,GAVIÃO PEIXOTO,1460,1129,644,3320,2676,32,55
SP,62316,BIRITIBA MIRIM,4645,10238,3901,19389,15488,200,405
SP,62324,JUMIRIM,412,1059,324,1851,1527,12,44
SP,62332,BOA ESPERANÇA DO SUL,4827,2523,1971,9611,7640,84,206
SP,62340,NANTES,714,791,330,1869,1539,14,20
SP,62359,BOCAINA,2153,3796,1340,7548,6208,74,185
SP,62367,NOVA CASTILHO,275,574,205,1084,879,9,21
SP,62375,BOFETE,2138,2541,1873,6772,4899,88,132
SP,62383,OUROESTE,2206,2013,842,5250,4408,77,112
SP,62391,BOITUVA,7793,15175,5028,29211,24183,303,912
SP,62405,PAULISTÂNIA,351,713,174,1270,1096,8,24
SP,62413,BOM JESUS DOS PERDÕES,3254,6552,2171,12301,10130,95,229
SP,62421,RIBEIRÃO DOS ÍNDIOS,850,619,212,1759,1547,35,43
SP,62430,BORÁ,350,315,152,834,682,4,13
SP,62448,TRABIJU,524,472,160,1179,1019,6,17
SP,62456,BORACÉIA,1199,1190,367,2873,2506,43,74
SP,62472,BORBOREMA,3116,4978,2321,10757,8436,120,222
SP,62499,BOTUCATU,22897,40623,14106,81837,67731,987,3224
SP,62510,BRAGANÇA PAULISTA,24860,53948,16885,99523,82638,1151,2679
SP,62553,BRAÚNA,1140,1851,554,3682,3128,49,88
SP,62570,BRODOWSKI,4146,6482,2407,13641,11234,165,441
SP,62596,BROTAS,4093,7414,3358,15488,12130,190,433
SP,62618,BURI,4173,5714,2836,13080,10244,117,240
SP,62634,BURITAMA,3564,4831,2494,11316,8822,142,285
SP,62650,BURITIZAL,840,1621,522,3078,2556,33,62
SP,62677,CABRÁLIA PAULISTA,1580,1033,898,3587,2689,26,50
SP,62693,CABREÚVA,11673,8658,4512,25630,21118,269,518
SP,62715,CAÇAPAVA,19998,28781,8801,59647,50846,588,1479
SP,62731,CACHOEIRA PAULISTA,10529,6659,3931,21653,17722,184,350
SP,62758,CACONDE,3980,5751,3130,13278,10148,143,274
SP,62774,CAFELÂNDIA,4045,5367,2844,12636,9792,122,258
SP,62790,CAIABU,1666,1046,574,3384,2810,36,62
SP,62812,CAIEIRAS,24193,18343,7522,52286,44764,720,1508
SP,62839,CAIUÁ,1846,1036,778,3756,2978,30,66
SP,62855,CAJAMAR,22149,12437,5434,41301,35867,436,845
SP,62871,CAJOBI,3068,2643,1616,7582,5966,80,175
SP,62898,CAJURU,6454,6113,3407,16642,13235,205,463
SP,62910,CAMPINAS,293844,257031,110399,689904,579505,7079,21551
SP,62936,CAMPO LIMPO PAULISTA,25001,16143,8334,51403,43069,509,1416
SP,62952,CAMPOS DO JORDÃO,8360,18346,7404,35135,27731,344,681
SP,62979,CAMPOS NOVOS PAULISTA,1050,1428,419,3010,2591,40,73
SP,62995,CANANÉIA,2649,3921,2541,9334,6793,46,177
SP,63010,CÂNDIDO MOTA,8200,9970,4534,23449,18915,285,460
SP,63037,CÂNDIDO RODRIGUES,889,941,390,2321,1931,36,65
SP,63053,CAPÃO BONITO,9563,16256,8174,34949,26775,332,624
SP,63070,CAPELA DO ALTO,2747,6158,1903,11127,9224,127,192
SP,63096,CAPIVARI,8602,15822,5133,30672,25539,378,737
SP,63118,CARAGUATATUBA,20236,26476,13520,62241,48721,664,1345
SP,63134,CARAPICUÍBA,122967,73144,36189,239913,203724,2463,5150
SP,63150,CARDOSO,3696,3072,1732,8808,7076,98,210
SP,63177,CASA BRANCA,5003,9277,4179,19174,14995,211,504
SP,63193,CÁSSIA DOS COQUEIROS,538,1195,460,2295,1835,22,80
SP,63215,CASTILHO,6427,3208,3209,13239,10030,128,267
SP,63231,CATANDUVA,22078,38211,12367,76042,63675,844,2542
SP,63258,CATIGUÁ,2709,1454,534,4944,4410,78,169
SP,63274,CEDRAL,1830,2802,1177,6052,4875,61,182
SP,63290,CERQUEIRA CÉSAR,2987,6209,2640,12180,9540,150,194
SP,63312,CERQUILHO,6688,13335,3610,24615,21005,282,700
SP,63339,CESÁRIO LANGE,2205,5780,1984,10468,8484,156,343
SP,63355,CHARQUEADA,3926,5099,2091,11478,9387,123,239
SP,63371,CHAVANTES,3782,3180,1880,9201,7321,100,259
SP,63398,CLEMENTINA,1577,1976,1036,4772,3736,42,141
SP,63410,COLINA,5369,4736,2989,13530,10541,133,303
SP,63436,COLÔMBIA,1787,1559,839,4309,3470,45,79
SP,63452,CONCHAL,5714,8454,3266,18028,14762,268,326
SP,63479,CONCHAS,3222,6035,2804,12426,9622,109,256
SP,63495,CORDEIRÓPOLIS,5166,6282,1979,14011,12032,199,385
SP,63517,COROADOS,1091,1674,627,3501,2874,35,74
SP,63533,CORONEL MACEDO,1942,1473,1026,4554,3528,32,81
SP,63550,CORUMBATAÍ,598,1722,791,3227,2436,38,78
SP,63576,COSMÓPOLIS,16972,12043,6062,36353,30291,409,867
SP,63592,COSMORAMA,1585,2789,631,5174,4543,54,115
SP,63614,COTIA,50146,44454,17804,115678,97874,1040,2234
SP,63630,CRAVINHOS,5983,11121,3577,21510,17933,225,604
SP,63657,CRISTAIS PAULISTA,1410,2651,1012,5217,4205,41,103
SP,63673,CRUZÁLIA,627,1123,335,2118,1783,12,21
SP,63690,CRUZEIRO,23281,21222,8612,55014,46402,527,1372
SP,63711,CUBATÃO,50664,22269,14156,89380,75224,789,1502
SP,63738,CUNHA,6582,6735,4316,18189,13873,179,377
SP,63754,DESCALVADO,5491,12839,3967,23253,19286,301,655
SP,63770,DIADEMA,167347,70391,39441,286840,247399,2573,7088
SP,63797,DIVINOLÂNDIA,2161,5186,1966,9700,7734,145,242
SP,63819,DOBRADA,2396,2053,1140,5775,4635,50,136
SP,63835,DOIS CÓRREGOS,4507,8579,3319,17007,13688,240,362
SP,63851,DOLCINÓPOLIS,811,710,322,1912,1590,18,51
SP,63878,DOURADO,2323,2958,1369,6979,5610,123,206
SP,63894,DRACENA,10422,14265,7258,32996,25738,377,674
SP,63916,DUARTINA,3321,4343,2481,10487,8006,104,238
SP,63932,DUMONT,2002,2159,852,5197,4345,59,125
SP,63959,ECHAPORÃ,1635,2244,1301,5300,3999,28,92
SP,63975,ELDORADO,3641,4017,3221,11158,7937,71,208
SP,63991,ELIAS FAUSTO,4377,4411,2496,11661,9165,104,273
SP,64017,EMBU,70721,55775,22979,154495,131516,1625,3395
SP,64033,EMBU-GUAÇU,16586,17276,8224,43296,35072,396,814
SP,64050,ESTRELA D'OESTE,2263,3087,865,6456,5591,86,155
SP,64076,ESTRELA DO NORTE,652,980,510,2192,1682,19,31
SP,64092,FARTURA,3386,5492,2681,11851,9170,84,208
SP,64114,FERNANDÓPOLIS,15840,20307,9403,46945,37542,533,862
SP,64130,FERNANDO PRESTES,1744,1647,818,4428,3610,118,101
SP,64157,FERRAZ DE VASCONCELOS,51830,28220,16164,99735,83571,1104,2417
SP,64173,FLORA RICA,850,578,407,1876,1469,8,33
SP,64190,FLOREAL,842,1233,549,2713,2164,29,60
SP,64211,FLÓRIDA PAULISTA,3923,2562,1944,8715,6771,131,155
SP,64238,FLORÍNIA,1036,897,474,2481,2007,32,42
SP,64254,FRANCA,58826,108432,29088,202945,173857,2131,4468
SP,64270,FRANCISCO MORATO,46154,22059,14544,85695,71151,1009,1929
SP,64297,FRANCO DA ROCHA,41041,22525,11824,79030,67206,1071,2569
SP,64319,GABRIEL MONTEIRO,427,1370,376,2257,1881,21,63
SP,64335,GÁLIA,1748,2152,1398,5478,4080,54,126
SP,64351,GARÇA,7389,16696,7408,32589,25181,350,746
SP,64378,GASTÃO VIDIGAL,1099,1189,662,3031,2369,38,43
SP,64394,GENERAL SALGADO,3115,3633,2108,9086,6978,89,141
SP,64416,GETULINA,2740,3228,2028,8209,6181,70,143
SP,64432,GLICÉRIO,1383,1383,634,3497,2863,30,67
SP,64459,GUAIÇARA,3290,2116,1503,7081,5578,59,113
SP,64475,GUAIMBÊ,1600,1385,752,3866,3114,27,102
SP,64491,GUAÍRA,8224,13186,5355,27407,22052,248,394
SP,64513,GUAPIAÇU,4787,4927,2288,12426,10138,162,262
SP,64530,GUAPIARA,5364,4693,4317,14820,10503,98,348
SP,64556,GUARÁ,6833,4025,3003,14202,11199,126,215
SP,64572,GUARAÇAÍ,2782,2404,1535,6958,5423,92,145
SP,64599,GUARACI,2947,2286,1885,7300,5415,66,116
SP,64610,GUARANI D'OESTE,598,541,181,1351,1170,7,24
SP,64637,GUARANTÃ,1628,2114,1197,5090,3893,64,87
SP,64653,GUARARAPES,6588,10824,4856,22969,18113,197,504
SP,64670,GUARAREMA,5605,8249,2133,16423,14290,147,289
SP,64696,GUARATINGUETÁ,29369,36236,12801,80744,67943,725,1613
SP,64718,GUAREÍ,2366,3886,1547,8190,6643,162,229
SP,64734,GUARIBA,11659,7978,4337,24712,20375,281,457
SP,64750,GUARUJÁ,105106,54561,31480,197466,165986,2069,4250
SP,64777,GUARULHOS,305264,271927,95734,699876,604142,6978,19973
SP,64793,GUZOLÂNDIA,1283,1298,531,3209,2678,32,65
SP,64815,HERCULÂNDIA,2314,2491,1327,6350,5023,45,173
SP,64831,IACANGA,1748,3541,1678,7214,5536,99,148
SP,64858,IACRI,1399,2435,702,4647,3945,35,76
SP,64874,IBATÉ,8350,7709,3068,19921,16853,293,501
SP,64890,IBIRÁ,1839,3820,1581,7586,6005,129,217
SP,64912,IBIRAREMA,1329,2367,542,4372,3830,44,90
SP,64939,IBITINGA,12292,16260,6534,36363,29829,424,853
SP,64955,IBIÚNA,8721,28467,10692,49195,38503,342,973
SP,64971,ICÉM,2503,2042,1021,5715,4694,59,90
SP,64998,IEPÊ,1545,2823,872,5375,4503,32,103
SP,65013,IGARAÇU DO TIETÊ,7629,6021,3129,17642,14513,318,545
SP,65030,IGARAPAVA,8997,6864,4990,21498,16508,248,399
SP,65056,IGARATÁ,1945,3127,848,6096,5248,50,126
SP,65072,IGUAPE,7320,8624,5770,22308,16538,159,435
SP,65099,ILHABELA,4694,8470,3471,17020,13549,104,281
SP,65110,INDAIATUBA,51691,42256,17458,116477,99019,1488,3584
SP,65137,INDIANA,1349,1862,736,4096,3360,74,75
SP,65153,INDIAPORÃ,1039,1340,692,3165,2473,45,49
SP,65170,INÚBIA PAULISTA,861,1323,299,2566,2267,33,50
SP,65196,IPAUÇU,2968,4299,1819,9348,7529,86,176
SP,65218,IPERÓ,6362,4429,3198,14479,11281,138,352
SP,65234,IPEÚNA,1111,1659,747,3622,2875,27,78
SP,65250,IPORANGA,1525,701,961,3299,2338,23,89
SP,65277,IPUÃ,4216,3159,1586,9156,7570,64,131
SP,65293,IRACEMÁPOLIS,4975,5887,1538,12867,11329,126,341
SP,65315,IRAPUÃ,1559,2392,1244,5397,4153,68,134
SP,65331,IRAPURU,1821,2088,869,5035,4166,92,165
SP,65358,ITABERÁ,5452,4743,2703,13213,10510,114,201
SP,65374,ITAÍ,5453,6670,3290,15853,12563,147,293
SP,65390,ITAJOBI,2810,6279,2418,12062,9644,218,337
SP,65412,ITAJU,641,1267,523,2516,1993,28,57
SP,65439,ITANHAÉM,19377,21846,14733,57579,42846,479,1144
SP,65455,ITAPECERICA DA SERRA,42938,32059,14725,92471,77746,984,1765
SP,65471,ITAPETININGA,22835,48917,15165,89953,74788,868,2168
SP,65498,ITAPEVA,18614,28333,11517,59879,48362,523,892
SP,65510,ITAPEVI,63097,28065,17891,112391,94500,1126,2212
SP,65536,ITAPIRA,13968,25437,7608,49521,41913,786,1722
SP,65552,ITÁPOLIS,8352,13600,5969,29092,23123,404,767
SP,65579,ITAPORANGA,2749,5687,3079,11836,8757,121,200
SP,65595,ITAPUÍ,2893,3133,1261,7502,6241,84,131
SP,65617,ITAPURA,1510,633,912,3153,2241,24,74
SP,65633,ITAQUAQUECETUBA,88696,41257,28337,163658,135321,1642,3726
SP,65650,ITARARÉ,10116,16804,7392,35198,27806,331,555
SP,65676,ITARIRI,2232,3689,2215,8361,6146,69,156
SP,65692,ITATIBA,17338,32821,8950,61192,52242,660,1423
SP,65714,ITATINGA,3786,5327,2055,11507,9452,107,232
SP,65730,ITIRAPINA,2676,3696,1838,8575,6737,102,263
SP,65757,ITIRAPUÃ,1766,1649,836,4374,3538,39,84
SP,65773,ITOBI,1749,2750,1193,5865,4672,76,97
SP,65790,ITU,36725,44255,17399,101796,84397,919,2498
SP,65811,ITUPEVA,9481,9332,4406,23958,19552,217,522
SP,65838,ITUVERAVA,11149,10840,6001,28762,22761,250,522
SP,65854,JABORANDI,2644,1367,1024,5214,4190,83,96
SP,65870,JABOTICABAL,13039,24717,9870,49302,39432,562,1114
SP,65897,JACAREÍ,49824,65377,21704,141046,119342,1150,2991
SP,65919,JACI,1479,1759,593,3945,3352,36,78
SP,65935,JACUPIRANGA,3574,5439,3300,12605,9305,104,188
SP,65951,JAGUARIÚNA,10367,10460,4247,25954,21707,300,580
SP,65978,JALES,11490,15674,7727,36183,28456,450,842
SP,65994,JAMBEIRO,1044,1891,353,3363,3010,19,56
SP,66010,JANDIRA,31585,24407,10786,68585,57799,640,1167
SP,66036,JARDINÓPOLIS,7768,10041,4347,23041,18694,309,576
SP,66052,JARINU,4288,6785,3117,14601,11484,117,294
SP,66079,JAÚ,24766,45436,12754,86310,73556,1171,2183
SP,66095,JERIQUARA,1038,1046,792,2937,2145,26,35
SP,66117,JOANÓPOLIS,1798,4685,1585,8315,6730,80,167
SP,66133,JOÃO RAMALHO,1364,1105,826,3406,2580,32,79
SP,66150,JOSÉ BONIFÁCIO,6523,10546,3604,21526,17922,369,484
SP,66176,JÚLIO MESQUITA,1640,1192,757,3693,2936,36,68
SP,66192,JUNDIAÍ,101462,103735,35486,251398,215912,2225,8490
SP,66214,JUNQUEIRÓPOLIS,4750,5388,3271,13791,10520,136,246
SP,66230,JUQUIÁ,4691,6410,5150,16663,11513,123,289
SP,66257,JUQUITIBA,6768,8819,4874,21135,16261,213,461
SP,66273,LAGOINHA,1053,2713,903,4785,3882,32,84
SP,66290,LARANJAL PAULISTA,3952,10315,2901,17684,14783,178,338
SP,66311,LAVÍNIA,1656,1285,451,3552,3101,38,122
SP,66338,LAVRINHAS,2025,2133,876,5189,4313,37,118
SP,66354,LEME,24082,24662,9367,60532,51165,769,1652
SP,66370,LENÇÓIS PAULISTA,11851,20878,6225,40442,34217,459,1029
SP,66397,LIMEIRA,72911,73164,27336,181180,153844,2273,5496
SP,66419,LINDÓIA,746,2829,592,4318,3726,36,115
SP,66435,LINS,13254,25341,10508,50786,40278,492,1191
SP,66451,LORENA,20712,25281,10913,58674,47761,586,1182
SP,66478,LOUVEIRA,7887,10266,3565,22413,18848,211,484
SP,66494,LUCÉLIA,4875,5735,3419,14496,11077,142,325
SP,66516,LUCIANÓPOLIS,762,602,222,1653,1431,14,53
SP,66532,LUÍS ANTÔNIO,3362,1916,1482,7000,5518,64,176
SP,66559,LUISIÂNIA,1368,1412,632,3507,2875,25,70
SP,66575,LUPÉRCIO,1559,1025,748,3433,2685,32,69
SP,66591,LUTÉCIA,773,988,357,2192,1835,16,58
SP,66613,MACATUBA,5222,4373,2476,12449,9973,137,241
SP,66630,MACAUBAL,1197,3200,731,5362,4631,119,115
SP,66656,MACEDÔNIA,1034,1125,493,2765,2272,44,69
SP,66672,MAGDA,927,1211,513,2740,2227,43,46
SP,66699,MAIRINQUE,14859,10818,5654,32329,26675,372,626
SP,66710,MAIRIPORÃ,14569,21498,7546,45206,37660,526,1067
SP,66737,MANDURI,1986,3363,1380,6940,5560,85,126
SP,66753,MARABÁ PAULISTA,1173,1233,640,3142,2502,28,68
SP,66770,MARACAÍ,4622,3899,2307,11087,8780,97,162
SP,66796,MARIÁPOLIS,1318,1054,516,3008,2492,56,64
SP,66818,MARÍLIA,45705,68034,27624,146605,118981,1647,3595
SP,66834,MARINÓPOLIS,752,727,265,1817,1552,43,30
SP,66850,MARTINÓPOLIS,5368,7422,3512,16767,13255,136,329
SP,66877,MATÃO,22453,23542,8925,56968,48043,638,1410
SP,66893,MAUÁ,133435,82648,36158,263093,226935,2769,8083
SP,66915,MENDONÇA,1023,1403,401,2963,2562,67,69
SP,66931,MERIDIANO,1231,1282,620,3235,2615,40,62
SP,66958,MIGUELÓPOLIS,5782,5370,3502,15044,11542,135,255
SP,66974,MINEIROS DO TIETÊ,3047,3474,1528,8307,6779,96,162
SP,66990,MIRACATU,4994,6088,4305,15702,11397,97,218
SP,67016,MIRA ESTRELA,1075,767,432,2359,1927,20,65
SP,67032,MIRANDÓPOLIS,6918,7217,4434,19486,15052,283,634
SP,67059,MIRANTE DO PARANAPANEMA,5117,4198,3516,13184,9668,125,228
SP,67075,MIRASSOL,10803,17658,6373,36324,29951,496,994
SP,67091,MIRASSOLÂNDIA,855,1760,504,3211,2707,36,56
SP,67113,MOCOCA,11592,26359,10112,50075,39963,577,1435
SP,67130,MOGI DAS CRUZES,82173,116635,37266,244291,207025,2299,5918
SP,67156,MOJI-GUACU,41628,35868,13951,95527,81576,1201,2879
SP,67172,MOJI-MIRIM,16267,30842,9186,58874,49688,851,1728
SP,67199,MOMBUCA,916,1181,622,2824,2202,41,64
SP,67210,MONÇÕES,480,798,367,1757,1390,52,60
SP,67237,MONGAGUÁ,10523,10928,8208,30418,22210,254,505
SP,67253,MONTE ALEGRE DO SUL,1509,2851,1036,5613,4577,57,160
SP,67270,MONTE ALTO,11368,15211,6250,34243,27993,614,800
SP,67296,MONTE APRAZÍVEL,5210,6611,3174,15649,12475,230,424
SP,67318,MONTE AZUL PAULISTA,4734,6960,3053,15264,12211,188,329
SP,67334,MONTE CASTELO,1576,857,681,3243,2562,42,87
SP,67350,MONTEIRO LOBATO,1176,1653,642,3568,2926,21,76
SP,67377,MONTE MOR,15153,8360,5959,30524,24565,341,711
SP,67393,MORRO AGUDO,8828,5608,3254,18246,14992,168,388
SP,67415,MORUNGABA,2111,4789,890,8034,7144,69,175
SP,67431,MURUTINGA DO SUL,1162,1340,635,3264,2629,52,75
SP,67458,NARANDIBA,1318,1111,431,2936,2505,24,52
SP,67474,NATIVIDADE DA SERRA,2021,2393,1449,6039,4590,50,126
SP,67490,NAZARÉ PAULISTA,3055,5817,2391,11660,9269,122,275
SP,67512,NEVES PAULISTA,2420,3167,1341,7276,5935,158,190
SP,67539,NHANDEARA,1941,4335,1550,8107,6557,116,165
SP,67555,NIPOÃ,1103,1242,449,2876,2427,31,51
SP,67571,NOVA ALIANÇA,1265,2129,797,4394,3597,67,136
SP,67598,NOVA EUROPA,2688,2228,1368,6496,5128,54,158
SP,67610,NOVA GRANADA,4620,5814,2773,13704,10931,141,356
SP,67636,NOVA GUATAPORANGA,793,543,319,1721,1402,12,54
SP,67652,NOVA INDEPENDÊNCIA,782,749,252,1838,1586,13,42
SP,67679,NOVA LUZITÂNIA,801,1121,313,2289,1976,16,38
SP,67695,NOVA ODESSA,17890,10221,4905,34220,29315,367,837
SP,67717,NOVO HORIZONTE,9649,10148,4836,25430,20594,288,509
SP,67733,NUPORANGA,1462,2650,1074,5355,4281,62,107
SP,67750,OCAUÇU,1244,1224,496,3090,2594,43,83
SP,67776,ÓLEO,596,1321,476,2489,2013,44,52
SP,67792,OLÍMPIA,10882,15917,6876,34913,28037,467,771
SP,67814,ONDA VERDE,1331,1076,754,3261,2507,36,64
SP,67830,ORIENTE,1682,2257,834,4955,4121,50,132
SP,67857,ORINDIÚVA,1346,1629,722,3835,3113,29,109
SP,67873,ORLÂNDIA,8890,13196,4609,27748,23139,278,775
SP,67890,OSASCO,235911,167850,69901,490686,420785,4522,12502
SP,67911,OSCAR BRESSANE,525,1189,436,2205,1769,17,38
SP,67938,OSVALDO CRUZ,6352,11199,5409,23701,18292,242,499
SP,67954,OURINHOS,23212,30872,13493,69715,56222,675,1463
SP,67970,OURO VERDE,2900,1563,1384,6025,4641,45,133
SP,67997,PACAEMBU,2987,3527,1671,8474,6803,90,199
SP,68012,PALESTINA,2049,3799,1436,7587,6151,124,179
SP,68039,PALMARES PAULISTA,3213,1932,1155,6589,5434,109,180
SP,68055,PALMEIRA D'OESTE,2954,2925,1335,7498,6163,121,163
SP,68071,PALMITAL,5323,7216,3178,16103,12925,124,262
SP,68098,PANORAMA,3808,3252,2203,9543,7340,85,195
SP,68110,PARAGUAÇU PAULISTA,12899,9680,5907,29397,23490,351,560
SP,68136,PARAIBUNA,4431,5771,2218,12773,10555,91,262
SP,68152,PARAÍSO,1808,1700,762,4466,3704,60,136
SP,68179,PARANAPANEMA,4859,4887,2604,12670,10066,73,247
SP,68195,PARANAPUÃ,845,1439,510,2893,2383,42,57
SP,68217,PARAPUÃ,3190,2951,2000,8479,6479,95,243
SP,68233,PARDINHO,1286,1744,634,3766,3132,32,70
SP,68250,PARIQUERA-AÇU,4907,5381,3055,13683,10628,111,229
SP,68276,PATROCÍNIO PAULISTA,2582,4663,1604,9069,7465,68,152
SP,68292,PAULICÉIA,1785,1335,784,4013,3229,37,72
SP,68314,PAULÍNIA,24283,16852,7660,50566,42906,585,1186
SP,68330,PAULO DE FARIA,2420,2514,1744,6881,5137,46,157
SP,68357,PEDERNEIRAS,11750,9912,5095,27728,22633,340,631
SP,68373,PEDRA BELA,1360,1793,822,4152,3330,59,118
SP,68390,PEDRANÓPOLIS,850,890,404,2203,1799,29,30
SP,68411,PEDREGULHO,4681,4497,3092,12740,9648,192,278
SP,68438,PEDREIRA,10528,13109,3837,28723,24886,350,899
SP,68454,PEDRO DE TOLEDO,2500,2326,2018,7026,5008,63,119
SP,68470,PENÁPOLIS,15323,16832,8121,41823,33702,440,1107
SP,68497,PEREIRA BARRETO,6270,7653,5221,19690,14469,206,340
SP,68519,PEREIRAS,1711,2568,1315,5770,4455,57,119
SP,68535,PERUÍBE,13663,18379,11396,44599,33203,349,812
SP,68551,PIACATU,1149,1925,541,3737,3196,19,103
SP,68578,PIEDADE,8967,18181,6441,34639,28198,405,645
SP,68594,PILAR DO SUL,4480,9373,3156,17424,14268,135,280
SP,68616,PINDAMONHANGABA,30099,45431,14054,92311,78257,771,1956
SP,68632,PINDORAMA,4008,4468,1812,10694,8882,150,256
SP,68659,ESPÍRITO SANTO DO PINHAL,9048,15607,5864,31719,25855,412,788
SP,68675,PINHALZINHO,2520,4457,1750,9047,7297,101,219
SP,68691,PIQUEROBI,1506,672,413,2685,2272,27,67
SP,68713,PIQUETE,4203,5070,2841,12467,9626,98,255
SP,68730,PIRACAIA,4391,9958,3644,18501,14857,160,348
SP,68756,PIRACICABA,87260,109604,34061,240285,206224,2739,6621
SP,68772,PIRAJU,6071,9883,4898,21688,16790,271,565
SP,68799,PIRAJUÍ,4335,6453,3544,14843,11299,181,330
SP,68810,PIRANGI,2341,3412,1421,7488,6067,145,169
SP,68837,PIRAPORA DO BOM JESUS,3486,3364,1550,8632,7082,60,172
SP,68853,PIRAPOZINHO,6870,6987,3850,18246,14396,168,371
SP,68870,PIRASSUNUNGA,13813,24687,9820,50266,40446,671,1275
SP,68896,PIRATININGA,2424,4404,1905,9037,7132,95,209
SP,68918,PITANGUEIRAS,9090,8517,5081,23410,18329,228,494
SP,68934,PLANALTO,1084,1240,375,2837,2462,37,101
SP,68950,PLATINA,968,859,345,2234,1889,27,35
SP,68977,POÁ,36111,25074,12024,75691,63667,768,1714
SP,68993,POLONI,1034,2093,703,3987,3284,59,98
SP,69019,POMPÉIA,3479,8553,2791,15346,12555,136,387
SP,69035,PONGAÍ,811,1652,716,3277,2561,39,59
SP,69051,PONTAL,10818,7368,4838,23891,19053,299,568
SP,69078,PONTES GESTAL,825,831,431,2144,1713,24,33
SP,69094,POPULINA,1129,1518,763,3554,2791,37,107
SP,69116,PORANGABA,1935,2585,1028,5754,4726,48,158
SP,69132,PORTO FELIZ,11550,15340,5570,33449,27879,363,626
SP,69159,PORTO FERREIRA,10755,17864,5696,35699,30003,489,895
SP,69175,POTIRENDABA,3019,5330,2121,11024,8903,242,312
SP,69191,PRADÓPOLIS,5608,3620,1887,11523,9636,125,283
SP,69213,PRAIA GRANDE,57142,52370,29318,143327,114009,1356,3141
SP,69230,PRESIDENTE ALVES,1194,1461,758,3504,2746,26,65
SP,69256,PRESIDENTE BERNARDES,3870,4454,2492,11144,8652,145,183
SP,69272,PRESIDENTE EPITÁCIO,11951,9187,6263,28206,21943,232,573
SP,69299,PRESIDENTE PRUDENTE,52330,60534,30710,148705,117995,1752,3379
SP,69310,PRESIDENTE VENCESLAU,8199,13085,6015,28236,22221,315,622
SP,69337,PROMISSÃO,11322,7652,5104,24967,19863,329,560
SP,69353,QUATÁ,3613,3436,2170,9482,7312,102,161
SP,69370,QUEIROZ,937,649,340,1983,1643,16,41
SP,69396,QUELUZ,3300,2156,1552,7187,5635,46,133
SP,69418,QUINTANA,1599,1899,805,4479,3674,36,140
SP,69434,RAFARD,2136,3175,801,6338,5537,79,147
SP,69450,RANCHARIA,7465,9572,5120,22837,17717,230,450
SP,69477,REDENÇÃO DA SERRA,1084,1743,619,3547,2928,31,70
SP,69493,REGENTE FEIJÓ,4155,6599,2446,13575,11129,134,241
SP,69515,REGINÓPOLIS,971,2171,567,3876,3309,45,122
SP,69531,REGISTRO,12636,17087,9703,40357,30654,301,630
SP,69558,RESTINGA,2151,1679,694,4625,3931,31,70
SP,69574,RIBEIRA,1137,921,559,2684,2125,14,53
SP,69590,RIBEIRÃO BONITO,3297,3652,2251,9567,7316,101,266
SP,69612,RIBEIRÃO BRANCO,5097,4546,3597,13546,9949,85,221
SP,69639,RIBEIRÃO CORRENTE,987,1424,522,3007,2485,20,54
SP,69655,RIBEIRÃO DO SUL,1407,1376,420,3308,2888,49,56
SP,69671,RIBEIRÃO PIRES,33103,31002,12495,79843,67348,815,2428
SP,69698,RIBEIRÃO PRETO,122629,166991,61079,369696,308617,3943,15054
SP,69710,RIVERSUL,1887,1859,799,4691,3892,51,95
SP,69736,RIFAINA,1184,1246,857,3374,2517,38,49
SP,69752,RINCÃO,2953,2691,1473,7397,5924,64,216
SP,69779,RINÓPOLIS,1789,3824,1346,7203,5857,85,159
SP,69795,RIO CLARO,37576,60185,19706,124572,104866,1603,5502
SP,69817,RIO DAS PEDRAS,8605,8125,3700,21022,17322,229,363
SP,69833,RIO GRANDE DA SERRA,14516,9871,5315,30705,25390,309,694
SP,69850,RIOLÂNDIA,1883,2644,1737,6455,4718,63,128
SP,69876,ROSEIRA,2050,3287,1187,6670,5483,55,91
SP,69892,RUBIÁCEA,557,880,397,1905,1508,17,54
SP,69914,RUBINÉIA,940,747,584,2361,1777,26,64
SP,69930,SABINO,1962,1303,838,4284,3446,47,134
SP,69957,SAGRES,712,704,313,1764,1451,16,19
SP,69973,SALES,1061,1934,675,3801,3126,43,88
SP,69990,SALES OLIVEIRA,1972,3753,1045,7021,5976,86,165
SP,70017,SALESÓPOLIS,3120,6995,2438,12912,10474,119,240
SP,70033,SALMOURÃO,1147,1547,668,3479,2811,30,87
SP,70050,SALTO,33740,23808,10778,70660,59882,623,1711
SP,70076,SALTO DE PIRAPORA,8681,10311,4199,24099,19900,348,560
SP,70092,SALTO GRANDE,2063,2546,1425,6232,4807,70,128
SP,70114,SANDOVALINA,1099,1012,569,2740,2171,15,45
SP,70130,SANTA ADÉLIA,3959,4392,2058,10783,8725,117,257
SP,70157,SANTA ALBERTINA,1164,2066,890,4288,3398,68,100
SP,70173,SANTA BÁRBARA D'OESTE,61578,35644,16121,118046,101925,1514,3189
SP,70190,ÁGUAS DE SANTA BÁRBARA,1106,2030,1087,4344,3257,29,92
SP,70211,SANTA BRANCA,3354,5094,2166,10887,8721,92,181
SP,70238,SANTA CLARA D'OESTE,614,851,339,1882,1543,31,47
SP,70254,SANTA CRUZ DA CONCEIÇÃO,800,1518,322,2716,2394,25,51
SP,70270,SANTA CRUZ DAS PALMEIRAS,6151,9843,3585,20183,16598,246,358
SP,70297,SANTA CRUZ DO RIO PARDO,6876,17665,5870,31322,25452,351,560
SP,70319,SANTA ERNESTINA,2098,1141,497,3847,3350,38,73
SP,70335,SANTA FÉ DO SUL,6102,9895,4973,21734,16761,260,504
SP,70351,SANTA GERTRUDES,5718,5375,1988,13690,11702,205,404
SP,70378,SANTA ISABEL,12291,15581,5248,34220,28972,292,808
SP,70394,SANTA LÚCIA,3708,1721,1167,6907,5740,102,209
SP,70416,SANTA MARIA DA SERRA,1452,1533,886,4001,3115,42,88
SP,70432,SANTA MERCEDES,911,607,515,2090,1575,15,42
SP,70459,SANTANA DA PONTE PENSA,491,712,238,1523,1285,28,54
SP,70475,SANTANA DE PARNAÍBA,23558,20366,8287,53780,45493,489,1080
SP,70491,SANTA RITA D'OESTE,840,924,371,2207,1836,27,45
SP,70513,SANTA RITA DO PASSA QUATRO,5609,10193,3931,20507,16576,265,509
SP,70530,SANTA ROSA DE VITERBO,7433,6367,3331,17899,14568,274,494
SP,70556,SANTO ANASTÁCIO,6466,5599,3677,16500,12823,247,511
SP,70572,SANTO ANDRÉ,214088,202703,78635,519510,440875,5023,19061
SP,70599,SANTO ANTÔNIO DA ALEGRIA,1707,2048,945,4865,3920,50,115
SP,70610,SANTO ANTÔNIO DA POSSE,4688,6207,2456,13793,11337,162,280
SP,70637,SANTO ANTÔNIO DO JARDIM,1467,2308,669,4612,3943,53,115
SP,70653,SANTO ANTÔNIO DO PINHAL,1530,2723,1104,5496,4392,48,91
SP,70670,SANTO EXPEDITO,1056,830,370,2314,1944,17,41
SP,70696,SANTÓPOLIS DO AGUAPEÍ,1137,1174,460,2907,2447,49,87
SP,70718,SANTOS,107863,145172,33651,298696,265045,2899,9111
SP,70734,SÃO BENTO DO SAPUCAÍ,1832,4523,1541,8132,6591,70,166
SP,70750,SÃO BERNARDO DO CAMPO,255766,171700,73456,521882,448426,4498,16462
SP,70777,SÃO CAETANO DO SUL,34690,64468,14795,119002,104207,1102,3947
SP,70793,SÃO CARLOS,39141,78720,22500,147395,124895,1540,5494
SP,70815,SÃO FRANCISCO,897,862,374,2251,1877,54,64
SP,70831,SÃO JOÃO DA BOA VISTA,17533,30253,9526,59550,50024,554,1684
SP,70858,SÃO JOÃO DAS DUAS PONTES,817,804,273,1977,1704,30,53
SP,70874,SÃO JOÃO DO PAU D'ALHO,670,778,256,1762,1506,16,42
SP,70890,SÃO JOAQUIM DA BARRA,12986,13101,4933,31990,27057,331,639
SP,70912,SÃO JOSÉ DA BELA VISTA,2245,2145,1299,5901,4602,81,131
SP,70939,SÃO JOSÉ DO BARREIRO,1029,1504,549,3184,2635,26,76
SP,70955,SÃO JOSÉ DO RIO PARDO,11013,18526,6836,37595,30759,438,782
SP,70971,SÃO JOSÉ DO RIO PRETO,72908,136268,44664,265110,220446,2995,8275
SP,70998,SÃO JOSÉ DOS CAMPOS,146478,179483,59935,397310,337375,3223,8191
SP,71013,SÃO LUÍS DO PARAITINGA,2571,4642,1063,8561,7498,103,182
SP,71030,SÃO MANUEL,7854,13976,4924,27942,23018,379,809
SP,71056,SÃO MIGUEL ARCANJO,6383,10642,4657,22412,17755,197,533
SP,71072,SÃO PAULO,2918996,3485245,1200124,7953144,6753020,93155,255624
SP,71099,SÃO PEDRO,5106,11463,4874,22159,17285,194,522
SP,71110,SÃO PEDRO DO TURVO,1348,2456,584,4492,3908,31,73
SP,71137,SÃO ROQUE,16420,23257,8141,49635,41494,601,1216
SP,71153,SÃO SEBASTIÃO,19127,15664,9823,45942,36119,455,873
SP,71170,SÃO SEBASTIÃO DA GRAMA,2217,4238,2108,8892,6784,101,228
SP,71196,SÃO SIMÃO,3819,4382,2299,10945,8646,118,327
SP,71218,SÃO VICENTE,109534,74585,36029,228567,192538,2769,5650
SP,71234,SARAPUÍ,2028,2687,1393,6291,4898,47,136
SP,71250,SARUTAIÁ,1148,1032,624,2875,2251,22,49
SP,71277,SEBASTIANÓPOLIS DO SUL,636,1336,336,2379,2043,29,42
SP,71293,SERRA AZUL,2570,1883,1340,5994,4654,60,141
SP,71315,SERRANA,10838,9355,4561,25652,21091,291,607
SP,71331,SERRA NEGRA,3704,11480,4053,19773,15720,148,388
SP,71358,SERTÃOZINHO,34640,21762,11548,70958,59410,876,2132
SP,71374,SETE BARRAS,3964,3363,3035,10617,7582,52,203
SP,71390,SEVERÍNIA,4274,4098,2298,10977,8679,96,211
SP,71412,SILVEIRAS,1550,1989,665,4333,3668,34,95
SP,71439,SOCORRO,5691,14736,4648,26034,21386,258,701
SP,71455,SOROCABA,142402,156211,50230,364794,314564,3842,12109
SP,71471,SUD MENUCCI,2624,1856,789,5476,4687,97,110
SP,71498,SUMARÉ,75967,36362,20781,137298,116517,1293,2895
SP,71510,SUZANO,71970,62940,27176,167443,140267,1613,3744
SP,71536,TABAPUÃ,3130,3406,1233,8152,6919,136,247
SP,71552,TABATINGA,3462,4561,2223,10663,8440,145,272
SP,71579,TABOÃO DA SERRA,73544,60443,27737,167537,139800,1694,4119
SP,71595,TACIBA,1530,1905,758,4304,3546,41,70
SP,71617,TAGUAÍ,2383,2852,1148,6523,5375,55,85
SP,71633,TAIAÇU,1624,1632,821,4249,3428,66,106
SP,71650,TAIÚVA,1457,1954,970,4530,3560,56,93
SP,71676,TAMBAÚ,4405,8329,2694,15996,13302,186,382
SP,71692,TANABI,4950,9406,3599,18477,14878,191,331
SP,71714,TAPIRAÍ,1559,2675,1641,6050,4409,56,119
SP,71730,TAPIRATIBA,4476,3024,1865,9634,7769,85,184
SP,71757,TAQUARITINGA,16903,12317,7286,38246,30960,694,1046
SP,71773,TAQUARITUBA,5866,7297,3645,17276,13631,201,267
SP,71790,TARABAÍ,2101,1481,655,4348,3693,30,81
SP,71811,TATUÍ,14685,39790,12492,70364,57872,921,2476
SP,71838,TAUBATÉ,67492,80856,28874,183659,154785,1938,4499
SP,71854,TEJUPÁ,1484,1346,951,3895,2944,38,76
SP,71870,TEODORO SAMPAIO,6422,4514,3942,15250,11308,103,269
SP,71897,TERRA ROXA,2724,2231,1238,6342,5104,37,112
SP,71919,TIETÊ,4995,14598,3879,24303,20424,200,631
SP,71935,TIMBURI,762,995,488,2312,1824,18,49
SP,71951,TORRINHA,1770,3432,1224,6677,5453,98,153
SP,71978,TREMEMBÉ,6910,10564,3585,21818,18233,199,560
SP,71994,TRÊS FRONTEIRAS,1327,1813,826,4113,3287,65,82
SP,72010,TUPÃ,12007,24279,10022,47604,37582,382,914
SP,72036,TUPI PAULISTA,3548,4505,1507,9891,8384,95,236
SP,72052,TURIÚBA,518,834,266,1674,1408,16,40
SP,72079,TURMALINA,584,749,410,1826,1416,30,53
SP,72095,UBATUBA,18258,22284,10837,52808,41971,460,969
SP,72117,UBIRAJARA,1005,1605,683,3398,2715,42,63
SP,72133,UCHOA,2325,3412,1291,7334,6043,100,206
SP,72150,UNIÃO PAULISTA,430,592,313,1376,1063,16,25
SP,72176,URÂNIA,2434,2916,1588,7228,5640,97,193
SP,72192,URU,290,613,192,1134,942,23,16
SP,72214,URUPÊS,2516,4921,1890,9628,7738,96,205
SP,72230,VALENTIM GENTIL,2201,3877,1349,7634,6285,83,124
SP,72257,VALINHOS,26490,29734,11049,70317,59268,868,2176
SP,72273,VALPARAÍSO,5484,5416,2988,14271,11283,145,238
SP,72311,VARGEM GRANDE DO SUL,6582,14951,4708,27036,22328,314,481
SP,72338,VÁRZEA PAULISTA,39652,16783,9252,68005,58753,671,1647
SP,72354,VERA CRUZ,2743,3751,1880,8673,6793,71,228
SP,72370,VINHEDO,13599,21954,6748,43804,37056,494,1009
SP,72397,VIRADOURO,5095,4982,2237,12677,10440,150,213
SP,72419,VISTA ALEGRE DO ALTO,1515,1665,430,3818,3388,92,116
SP,72435,VOTORANTIM,34523,24330,10070,71464,61394,723,1818
SP,72451,VOTUPORANGA,15691,30476,10211,58360,48149,580,1402
SP,72737,VARGEM GRANDE PAULISTA,11935,10778,4977,28521,23544,301,530
TO,73008,ABREULÂNDIA,841,350,538,1760,1222,4,27
TO,73016,PIRAQUÊ,996,507,679,2241,1562,7,52
TO,73024,RIACHINHO,1677,427,812,2975,2163,14,45
TO,73032,DARCINÓPOLIS,1988,510,739,3339,2600,15,87
TO,73040,PALMEIRAS DO TOCANTINS,1715,757,823,3392,2569,25,72
TO,73059,MAURILÂNDIA DO TOCANTINS,1351,426,562,2410,1848,15,56
TO,73067,CACHOEIRINHA,865,268,379,1566,1187,5,49
TO,73075,ANGICO,1055,641,611,2366,1755,11,48
TO,73083,PALMEIRANTE,1178,573,704,2528,1824,12,61
TO,73091,CAMPOS LINDOS,1761,1159,1241,4297,3056,16,120
TO,73105,SÃO FÉLIX DO TOCANTINS,473,171,503,1187,684,3,37
TO,73113,LAGOA DO TOCANTINS,1497,82,641,2291,1650,9,62
TO,73121,BOM JESUS DO TOCANTINS,1226,487,511,2291,1780,6,61
TO,73130,SANTA MARIA DO TOCANTINS,915,531,466,1981,1515,8,61
TO,73148,NOVO ALEGRE,933,331,470,1786,1316,15,37
TO,73156,SANDOLÂNDIA,769,994,748,2570,1822,10,49
TO,73164,TAIPAS DO TOCANTINS,807,211,451,1519,1068,5,45
TO,73172,NOVO JARDIM,804,386,522,1778,1256,12,54
TO,73180,SÃO MIGUEL DO TOCANTINS,3377,492,1182,5167,3985,15,101
TO,73199,FORTALEZA DO TABOCÃO,805,471,319,1641,1322,9,37
TO,73202,ITAPIRATINS,938,629,760,2408,1648,13,68
TO,73210,CENTENÁRIO,868,351,537,1839,1302,5,78
TO,73229,RECURSOLÂNDIA,1070,671,566,2429,1863,11,111
TO,73237,TUPIRATINS,726,201,425,1427,1002,5,70
TO,73245,BRASILÂNDIA DO TOCANTINS,878,323,419,1651,1232,7,24
TO,73253,JUARINA,545,679,440,1691,1251,3,24
TO,73261,PAU D'ARCO,1343,761,900,3077,2177,11,62
TO,73270,MATEIROS,680,138,515,1380,865,5,42
TO,73288,SÃO BENTO DO TOCANTINS,1628,550,935,3186,2251,12,61
TO,73296,ESPERANTINA,3303,786,1331,5597,4266,35,142
TO,73300,CARIRI DO TOCANTINS,1405,536,714,2702,1988,11,36
TO,73318,ARAGUANÃ,2204,394,1028,3714,2686,15,73
TO,73326,CARMOLÂNDIA,1084,249,397,1762,1365,3,29
TO,73334,ARAGOMINAS,1638,871,1853,4449,2596,18,69
TO,73342,MURICILÂNDIA,899,533,539,2019,1480,6,42
TO,73350,SANTA FÉ DO ARAGUAIA,2260,909,1510,4776,3266,29,68
TO,73369,JAÚ DO TOCANTINS,1177,839,921,3002,2081,8,57
TO,73377,SUCUPIRA,513,520,299,1370,1071,7,31
TO,73385,LAGOA DA CONFUSÃO,2841,939,1478,5354,3876,14,82
TO,73393,SÃO SALVADOR DO TOCANTINS,1203,267,684,2213,1529,7,52
TO,73407,LAJEADO,968,363,407,1785,1378,5,42
TO,73415,RIO DOS BOIS,1024,344,523,1944,1421,14,39
TO,73423,CARRASCO BONITO,1426,270,571,2331,1760,5,59
TO,73431,RIO DA CONCEIÇÃO,773,244,333,1382,1049,3,29
TO,73440,PALMAS,67500,25815,26785,122343,95558,694,1549
TO,73458,TUPIRAMA,663,219,194,1109,915,7,26
TO,73466,OLIVEIRA DE FÁTIMA,586,292,302,1210,908,10,20
TO,73474,CHAPADA DE AREIA,500,386,410,1335,925,4,35
TO,73482,CHAPADA DA NATIVIDADE,1393,536,929,2933,2004,12,63
TO,73504,TALISMÃ,859,458,676,2038,1362,7,38
TO,73512,AGUIARNÓPOLIS,1785,366,512,2745,2233,6,76
TO,73520,LUZINÓPOLIS,1170,291,484,1988,1504,9,34
TO,73539,SANTA TEREZINHA DO TOCANTINS,863,452,361,1723,1362,9,38
TO,73547,SANTA RITA DO TOCANTINS,554,394,484,1453,969,4,17
TO,73555,CRIXÁS DO TOCANTINS,593,401,328,1344,1016,4,18
TO,73563,MONTE SANTO,906,533,446,1920,1474,7,28
TO,73571,PUGMIL,998,292,702,2030,1328,8,30
TO,73580,BANDEIRANTE DO TOCANTINS,1037,659,764,2501,1737,12,29
TO,73598,IPUEIRAS,587,316,250,1188,938,5,30
TO,73601,LAVANDEIRA,702,202,177,1118,941,8,29
TO,73610,BARRA DO OURO,1448,484,919,2928,2009,4,73
TO,92002,BERNARDO SAYÃO,1130,1101,709,3004,2295,14,50
TO,92045,BURITI DO TOCANTINS,3141,1108,1426,5838,4412,15,148
TO,92070,ALMAS,1772,1490,1629,5082,3453,24,167
TO,92088,CASEARA,1616,530,819,3026,2207,4,57
TO,92134,ALVORADA,2413,1941,1857,6387,4530,31,145
TO,92142,COMBINADO,1746,679,817,3362,2545,25,95
TO,92185,DIVINÓPOLIS DO TOCANTINS,2275,1097,1051,4545,3494,21,101
TO,92193,ANANÁS,3953,1121,2034,7280,5246,26,146
TO,92240,GOIANORTE,1413,1337,888,3738,2850,14,86
TO,92304,MARIANÓPOLIS DO TOCANTINS,1570,676,762,3071,2309,9,54
TO,92371,ARAGUACEMA,1888,993,1109,4100,2991,13,97
TO,92398,ARAGUAÇU,1950,2965,1974,7040,5066,37,114
TO,92401,NOVA ROSALÂNDIA,1170,583,511,2306,1795,12,30
TO,92410,ARAGUAÍNA,47084,16574,17895,83416,65521,371,1492
TO,92436,ARAGUATINS,9095,3535,4266,17328,13062,69,363
TO,92452,ARAPOEMA,2743,1030,1881,5804,3923,27,123
TO,92479,ARRAIAS,3822,947,2680,7705,5025,38,218
TO,92487,PEQUIZEIRO,1357,1100,1094,3627,2533,7,69
TO,92509,PORTO ALEGRE DO TOCANTINS,993,387,547,2007,1460,11,69
TO,92525,PRAIA NORTE,3154,291,1294,4849,3555,17,93
TO,92533,AURORA DO TOCANTINS,1452,478,491,2541,2050,16,104
TO,92541,SAMPAIO,1299,538,706,2596,1890,12,41
TO,92576,AXIXÁ DO TOCANTINS,4470,1324,1250,7340,6090,28,268
TO,92584,SANTA ROSA DO TOCANTINS,1393,944,864,3307,2443,12,94
TO,92592,BABAÇULÂNDIA,3321,826,1367,5698,4331,34,150
TO,92606,SANTA TEREZA DO TOCANTINS,1171,230,505,1944,1439,9,29
TO,92681,SÃO VALÉRIO DO TOCANTINS,1501,1001,1090,3689,2599,15,82
TO,92738,BREJINHO DE NAZARÉ,2309,583,884,3890,3006,18,96
TO,93114,COLINAS DO TOCANTINS,8687,6024,4533,19665,15132,85,336
TO,93130,CONCEIÇÃO DO TOCANTINS,1307,482,1117,3024,1907,16,102
TO,93211,COUTO DE MAGALHÃES,1319,872,1208,3466,2258,15,52
TO,93238,CRISTALÂNDIA,2685,1111,1423,5344,3921,26,99
TO,93416,DIANÓPOLIS,5281,2017,2887,10500,7613,50,265
TO,93459,DOIS IRMÃOS DO TOCANTINS,2292,973,1298,4690,3392,20,107
TO,93475,DUERÉ,1391,1066,1102,3644,2542,20,65
TO,93556,FILADÉLFIA,2958,1185,1660,5990,4330,39,148
TO,93653,FORMOSO DO ARAGUAIA,5340,4043,4262,13926,9664,44,237
TO,93858,GURUPI,23112,13169,10528,47918,37390,237,872
TO,94056,ITACAJÁ,2453,1242,1760,5633,3873,25,153
TO,94099,ITAGUATINS,2422,683,1469,4691,3222,15,102
TO,94170,ITAPORÃ DO TOCANTINS,921,571,463,1993,1530,9,29
TO,94617,MIRACEMA DO TOCANTINS,8079,1764,3694,13955,10261,75,343
TO,94633,MIRANORTE,4564,2344,2393,9560,7167,45,214
TO,94692,MONTE DO CARMO,1789,1043,1386,4350,2964,15,117
TO,94811,NATIVIDADE,2342,1885,2018,6433,4415,16,172
TO,94838,NAZARÉ,1891,646,943,3593,2650,22,91
TO,94994,NOVO ACORDO,1542,476,777,2873,2096,13,65
TO,95192,PARAÍSO DO TOCANTINS,12882,8332,5840,27592,21752,156,382
TO,95214,PARANÃ,2967,896,2516,6584,4068,18,187
TO,95257,PEDRO AFONSO,3228,1734,1616,6727,5111,24,125
TO,95273,PEIXE,3377,1532,2375,7467,5092,25,158
TO,95290,COLMÉIA,2534,2129,1971,6791,4820,26,131
TO,95338,GOIATINS,3552,1111,2236,7162,4926,26,237
TO,95370,PINDORAMA DO TOCANTINS,1547,749,862,3240,2378,16,66
TO,95478,PIUM,2102,1163,1381,4762,3381,22,94
TO,95516,PONTE ALTA DO BOM JESUS,1501,681,1078,3392,2314,17,115
TO,95532,PONTE ALTA DO TOCANTINS,2088,1135,1319,4697,3378,27,128
TO,95591,PORTO NACIONAL,16845,5296,6269,29183,22914,202,571
TO,95699,LIZARDA,1215,346,1245,2900,1655,11,83
TO,96032,SÃO SEBASTIÃO DO TOCANTINS,1832,303,627,2835,2208,8,65
TO,96130,SÍTIO NOVO DO TOCANTINS,4621,558,1928,7322,5394,26,189
TO,96156,TAGUATINGA,5155,1698,2580,9750,7170,56,261
TO,96199,TOCANTÍNIA,2374,521,1084,4089,3005,11,99
TO,96210,TOCANTINÓPOLIS,8952,1681,3312,14360,11048,65,350
TO,96270,GUARAÍ,8159,3507,3520,15560,12040,75,299
TO,96296,PRESIDENTE KENNEDY,1472,565,824,2949,2125,18,70
TO,96431,XAMBIOÁ,4459,1402,3066,9162,6096,44,191
TO,96490,PALMEIRÓPOLIS,1920,1762,1606,5422,3816,27,107
TO,96598,SILVANÓPOLIS,1466,1111,998,3702,2704,24,103
TO,96636,NOVA OLINDA,2957,1688,1711,6569,4858,35,178
TO,96652,WANDERLÂNDIA,3310,1529,1905,6979,5074,37,198
TO,96679,FIGUEIRÓPOLIS,2033,1098,1135,4362,3227,21,75
TO,96792,RIO SONO,1738,966,1049,3849,2800,14,82
TO,96830,FÁTIMA,1226,921,706,2935,2229,24,58
TO,96857,AUGUSTINÓPOLIS,6039,1376,2396,10124,7728,56,257
TO,96954,ALIANÇA DO TOCANTINS,2168,892,1373,4519,3146,12,74
TO,96970,APARECIDA DO RIO NEGRO,1579,619,816,3109,2293,16,79
TO,96997,BARROLÂNDIA,2404,948,945,4387,3442,12,78