STATE,CD_MUN,NM_MUN,VOTES_INCUMBENT,VOTES_CHALLENGER,QT_ABST,QT_APT,QT_ATTEND,QT_BLANK,QT_NULL
AC,1007,BUJARI,1534,2241,843,5140,4297,63,307
AC,1015,CAPIXABA,1274,2290,1009,4983,3974,44,230
AC,1023,PORTO ACRE,1931,3617,1162,7473,6311,61,447
AC,1031,SANTA ROSA,607,464,330,1594,1264,16,146
AC,1040,MARECHAL THAUMATURGO,1649,2891,1550,6539,4989,17,352
AC,1058,BRASILÉIA,4787,5405,2417,13674,11257,126,611
AC,1066,PORTO WALTER,1499,1457,1331,4612,3281,14,226
AC,1074,CRUZEIRO DO SUL,10038,19755,10783,43781,32998,268,1933
AC,1082,RODRIGUES ALVES,2356,2302,1820,7039,5219,43,417
AC,1090,MÂNCIO LIMA,2848,3201,1658,8366,6708,50,476
AC,1104,JORDÃO,1488,717,793,3231,2438,9,184
AC,1112,EPITACIOLÂNDIA,3022,2925,1436,8148,6712,111,369
AC,1120,ACRELÂNDIA,2079,3471,1409,7548,6139,73,292
AC,1139,FEIJÓ,6195,3440,3950,15049,11099,103,987
AC,1392,RIO BRANCO,66466,77090,30127,193549,163422,2191,6188
AC,1457,SENA MADUREIRA,6124,7915,4408,20416,16008,176,1043
AC,1473,TARAUACÁ,5864,5762,4981,18876,13895,270,1366
AC,1490,XAPURI,3200,3631,1884,9628,7744,72,539
AC,1511,PLÁCIDO DE CASTRO,3424,4545,2237,11128,8891,79,480
AC,1538,SENADOR GUIOMARD,3961,5691,2651,13641,10990,157,670
AC,1554,MANUEL URBANO,1221,1659,1059,4371,3312,51,274
AC,1570,ASSIS BRASIL,1654,1420,584,4054,3470,24,257
AL,27006,PARIPUEIRA,2088,1992,895,6560,5665,214,485
AL,27014,ÁGUA BRANCA,5833,2145,3256,13550,10294,256,1085
AL,27022,PARICONHA,3530,858,1629,7167,5538,107,618
AL,27030,ANADIA,4514,2880,3307,12769,9462,315,1001
AL,27049,ESTRELA DE ALAGOAS,4679,1411,3056,10672,7616,195,951
AL,27057,ARAPIRACA,33429,39010,18025,110124,92099,2579,6151
AL,27065,JEQUIÁ DA PRAIA,2410,1820,1605,7376,5771,177,579
AL,27073,ATALAIA,7773,9024,5719,27003,21284,711,2371
AL,27081,CAMPESTRE,1874,845,1038,4321,3283,65,252
AL,27090,BARRA DE SANTO ANTÔNIO,3256,1606,1186,7694,6508,242,589
AL,27111,BARRA DE SÃO MIGUEL,1672,1357,641,4716,4075,97,324
AL,27138,BATALHA,5408,1460,1548,9944,8396,129,752
AL,27154,BELÉM,1853,920,887,4571,3684,131,439
AL,27170,BELO MONTE,1707,562,723,3965,3242,63,362
AL,27197,BOCA DA MATA,5440,6074,3836,18414,14578,714,1315
AL,27219,BRANQUINHA,2610,1147,1627,7048,5421,154,781
AL,27235,CACIMBINHAS,2752,1959,1594,7474,5880,78,628
AL,27251,CAJUEIRO,4141,4422,2596,13389,10793,421,1018
AL,27278,CAMPO ALEGRE,8470,4345,4805,20616,15811,492,1414
AL,27294,CAMPO GRANDE,3219,1448,953,6599,5646,157,589
AL,27316,CANAPI,6086,1071,2927,11747,8820,185,985
AL,27332,CAPELA,2998,4512,2587,12352,9765,358,1028
AL,27359,CARNEIROS,2336,990,814,4838,4024,77,327
AL,27375,CHÃ PRETA,2705,881,717,5240,4523,153,542
AL,27391,COITÉ DO NÓIA,3331,1314,1734,7715,5981,169,699
AL,27413,COLÔNIA LEOPOLDINA,3755,4236,3052,13215,10163,480,968
AL,27430,COQUEIRO SECO,1331,1096,543,3723,3180,134,289
AL,27456,CORURIPE,11116,11583,6034,34573,28539,843,1889
AL,27472,DELMIRO GOUVEIA,15117,3553,7458,31831,24373,680,1990
AL,27499,DOIS RIACHOS,3452,1579,1745,7965,6220,139,622
AL,27510,FEIRA GRANDE,6429,2301,2356,13337,10981,477,1235
AL,27537,FELIZ DESERTO,1347,566,450,2815,2365,88,200
AL,27553,FLEXEIRAS,2939,1638,1471,7239,5768,141,777
AL,27570,GIRAU DO PONCIANO,10396,2838,4968,21364,16396,475,1810
AL,27596,IBATEGUARA,3703,2145,2402,9806,7404,264,832
AL,27618,IGACI,7690,3051,4827,18907,14080,433,1604
AL,27634,IGREJA NOVA,5452,3617,3341,15560,12219,823,1358
AL,27650,INHAPI,5642,964,2922,11398,8476,181,1132
AL,27677,JACARÉ DOS HOMENS,2239,655,654,4152,3498,37,286
AL,27693,JACUÍPE,2311,886,1155,4992,3837,142,304
AL,27715,JAPARATINGA,1531,1477,1036,5001,3965,208,371
AL,27731,JARAMATAIA,1717,997,740,4286,3546,75,376
AL,27758,JOAQUIM GOMES,4286,3184,4003,13934,9931,436,1380
AL,27774,JUNDIÁ,931,952,819,3418,2599,68,331
AL,27790,JUNQUEIRO,6305,3714,4119,17109,12990,527,1300
AL,27812,LAGOA DA CANOA,5141,2183,2625,11666,9041,285,888
AL,27839,LIMOEIRO DE ANADIA,6895,2636,3204,15294,12090,347,1215
AL,27855,MACEIÓ,115687,160157,63909,476691,412782,12297,21726
AL,27871,MAJOR ISIDORO,6038,2739,2741,13436,10695,207,1066
AL,27898,MARAGOGI,5236,3729,2975,14463,11488,730,1016
AL,27910,MARAVILHA,2150,2233,2184,8097,5913,157,599
AL,27936,MARECHAL DEODORO,7810,8212,4058,25915,21857,901,1866
AL,27952,MARIBONDO,3860,3025,2220,10964,8744,258,933
AL,27979,MAR VERMELHO,1318,698,338,2929,2591,66,246
AL,27995,MATA GRANDE,7827,1608,3693,15945,12252,526,1589
AL,28010,MATRIZ DE CAMARAGIBE,4913,4665,3755,15526,11771,432,1000
AL,28037,MESSIAS,3221,3171,1951,10223,8272,299,828
AL,28053,MINADOR DO NEGRÃO,1848,624,907,4062,3155,74,401
AL,28070,MONTEIRÓPOLIS,2453,707,1041,4989,3948,111,353
AL,28096,MURICI,6729,3811,2775,17083,14308,427,1756
AL,28118,NOVO LINO,1973,2913,1217,7520,6303,207,628
AL,28134,OLHO D'ÁGUA DAS FLORES,5258,3155,2621,13028,10407,237,901
AL,28150,OLHO D'ÁGUA DO CASADO,3024,828,1351,6220,4869,112,608
AL,28177,OLHO D'ÁGUA GRANDE,1494,833,851,3865,3014,143,359
AL,28193,OLIVENÇA,3284,1398,1655,7783,6128,130,743
AL,28215,OURO BRANCO,3717,1276,1579,7513,5934,101,412
AL,28231,PALESTINA,2036,332,508,3365,2857,29,284
AL,28258,PALMEIRA DOS ÍNDIOS,15282,12952,9767,46607,36840,991,2854
AL,28274,PÃO DE AÇÚCAR,7258,2537,3396,16328,12932,244,1068
AL,28290,PASSO DE CAMARAGIBE,4534,1747,1981,9678,7697,265,610
AL,28312,PAULO JACINTO,3013,933,641,5383,4742,120,377
AL,28339,PENEDO,8858,12605,7372,34998,27626,773,1902
AL,28355,PIAÇABUÇU,4192,2431,2882,11693,8811,329,945
AL,28371,PILAR,4868,9769,4916,24036,19120,826,1493
AL,28398,PINDOBA,1221,417,250,2211,1961,27,194
AL,28410,PIRANHAS,6318,1988,3239,14303,11064,221,1283
AL,28436,POÇO DAS TRINCHEIRAS,4039,2019,1788,9094,7306,125,722
AL,28452,PORTO CALVO,5002,5891,4521,18487,13966,672,1367
AL,28479,PORTO DE PEDRAS,2131,1306,1410,6042,4632,227,420
AL,28495,PORTO REAL DO COLÉGIO,3644,4284,2526,12870,10344,599,953
AL,28517,QUEBRÂNGULO,4711,1442,1245,8791,7546,202,807
AL,28533,RIO LARGO,14740,13771,7817,45986,38169,1490,2542
AL,28550,ROTEIRO,1549,977,1230,4525,3295,125,411
AL,28576,SANTA LUZIA DO NORTE,1722,1494,871,5055,4184,132,331
AL,28592,SANTANA DO IPANEMA,11269,6624,5269,27851,22582,461,1857
AL,28614,SANTANA DO MUNDAÚ,3527,1180,1242,7222,5980,183,793
AL,28630,SÃO BRÁS,1283,1645,868,4888,4020,357,329
AL,28657,SÃO JOSÉ DA LAJE,5472,3754,1793,13772,11979,341,1360
AL,28673,SÃO JOSÉ DA TAPERA,5501,4660,4223,17836,13613,398,1401
AL,28690,SÃO LUÍS DO QUITUNDE,7976,4618,4406,20694,16288,749,1738
AL,28711,SÃO MIGUEL DOS CAMPOS,7035,13910,4377,32036,27659,884,2139
AL,28738,SÃO MIGUEL DOS MILAGRES,1927,1167,749,4945,4196,205,418
AL,28754,SÃO SEBASTIÃO,10074,3781,4612,21598,16986,771,1501
AL,28770,SATUBA,1836,3170,1373,8327,6954,351,558
AL,28797,TANQUE D'ARCA,1851,730,1308,4889,3581,153,370
AL,28819,TAQUARANA,4887,2611,2544,12134,9590,300,1170
AL,28835,TRAIPÚ,7805,2939,3923,17734,13811,216,1611
AL,28851,UNIÃO DOS PALMARES,12748,8589,8555,36702,28147,851,2729
AL,28878,VIÇOSA,8172,3671,3603,18459,14856,499,1507
AL,28894,CRAÍBAS,5232,3543,2685,13808,11123,357,1145
AL,28916,SENADOR RUI PALMEIRA,3133,748,1404,7066,5662,85,675
AL,28932,SENADOR TEOTÔNIO VILELA,8637,6801,6993,26373,19380,525,1679
AM,2003,APUÍ,3198,1705,1891,7532,5641,53,409
AM,2011,NOVO AIRÃO,3539,744,1772,6592,4820,32,344
AM,2020,GUAJARÁ,2046,1927,3009,7698,4689,45,548
AM,2038,ANORI,4067,980,1817,7427,5610,33,326
AM,2046,CAREIRO DA VÁRZEA,7689,876,2924,12667,9743,70,735
AM,2054,ATALAIA DO NORTE,1795,784,1208,4194,2986,15,279
AM,2070,AUTAZES,9689,1110,4260,16443,12183,70,983
AM,2097,BARCELOS,3657,809,1810,6894,5084,28,330
AM,2119,BARREIRINHA,8125,997,3087,13344,10257,79,774
AM,2135,BENJAMIN CONSTANT,8774,779,3154,13966,10812,70,863
AM,2151,BOCA DO ACRE,5722,4134,4119,15584,11465,147,996
AM,2178,BORBA,9393,816,3810,15315,11505,65,992
AM,2194,CANUTAMA,2604,667,1522,5314,3792,26,401
AM,2216,CARAUARI,6730,1412,4821,13939,9118,75,659
AM,2232,CAREIRO,9080,993,4048,15470,11422,123,861
AM,2259,COARI,22248,2598,8339,36863,28524,171,2299
AM,2275,CODAJÁS,6161,1151,3334,11505,8171,43,441
AM,2291,EIRUNEPÉ,8374,977,4686,15612,10926,164,1164
AM,2313,ENVIRA,2324,2625,2930,8621,5691,53,589
AM,2330,FONTE BOA,4521,2265,2917,10839,7922,45,831
AM,2356,HUMAITÁ,10605,3544,4466,20604,16138,167,938
AM,2372,SANTA ISABEL DO RIO NEGRO,2058,979,1794,5318,3524,42,366
AM,2399,IPIXUNA,2352,1788,2872,7738,4866,62,578
AM,2410,ITACOATIARA,31909,4610,11075,51125,40050,231,1476
AM,2437,ITAPIRANGA,3101,413,1020,4902,3882,18,229
AM,2453,JAPURÁ,1100,330,886,2524,1638,9,147
AM,2470,JURUÁ,1558,1182,1652,4900,3248,27,410
AM,2496,JUTAÍ,3166,1946,2204,8205,6001,43,659
AM,2518,LÁBREA,9289,1052,5302,17173,11871,81,1143
AM,2534,MANACAPURU,30295,3555,10710,48544,37834,298,2146
AM,2550,MANAUS,632681,87407,119303,995870,876567,14408,32636
AM,2577,MANICORÉ,10174,2893,5250,19894,14644,88,989
AM,2593,MARAÃ,3056,340,2100,6000,3900,31,392
AM,2615,MAUÉS,15462,1420,6163,25107,18944,113,1346
AM,2631,NHAMUNDÁ,5771,1495,2640,10701,8061,57,488
AM,2658,NOVA OLINDA DO NORTE,6534,857,3158,11612,8454,44,743
AM,2674,NOVO ARIPUANÃ,5268,715,2721,9494,6773,60,486
AM,2690,PARINTINS,30846,5067,10607,50214,39607,319,1608
AM,2712,PAUINI,3337,1094,2663,7730,5067,26,487
AM,2739,SANTO ANTONIO DO IÇÁ,4018,1675,1927,8531,6604,90,660
AM,2755,SÃO PAULO DE OLIVENÇA,6550,1117,1590,10068,8478,48,564
AM,2771,SILVES,3504,364,934,5059,4125,23,136
AM,2798,TAPAUÁ,4807,970,2303,9056,6753,60,692
AM,2810,TEFÉ,16777,1844,8283,29448,21165,146,1639
AM,2836,SÃO GABRIEL DA CACHOEIRA,11079,1945,5675,19913,14238,89,731
AM,2852,URUCARÁ,5710,596,2034,8866,6832,41,332
AM,2879,URUCURITUBA,5601,677,2154,8972,6818,40,347
AM,2895,ALVARÃES,3947,534,1662,6804,5142,33,482
AM,2917,AMATURÁ,2052,322,727,3623,2896,38,416
AM,2933,ANAMÃ,2571,932,1492,5434,3942,29,321
AM,2950,BERURI,3128,1143,1580,6476,4896,26,480
AM,2976,BOA VISTA DO RAMOS,4700,582,1643,7445,5802,21,360
AM,2992,CAAPIRANGA,3247,313,1744,5683,3939,25,247
AM,98353,IRANDUBA,13042,1135,2665,18682,16017,144,1117
AM,98370,ITAMARATI,2182,473,1426,4515,3089,17,337
AM,98396,MANAQUIRI,5982,280,1931,8798,6867,25,435
AM,98418,PRESIDENTE FIGUEIREDO,8428,1013,3643,14271,10628,91,545
AM,98434,RIO PRETO DA EVA,6640,906,2726,11235,8509,63,451
AM,98450,SÃO SEBASTIÃO DO UATUMÃ,2314,716,1052,4410,3358,29,201
AM,98477,TABATINGA,11026,2431,4172,19747,15575,139,1273
AM,98493,UARINI,2699,419,1649,5181,3532,9,340
AM,98515,TONANTINS,2354,1362,1214,5555,4341,35,479
AP,6009,PRACUÚBA,1168,362,211,1974,1763,7,64
AP,6017,AMAPÁ,2943,873,724,5105,4381,33,192
AP,6025,PORTO GRANDE,4369,1536,986,7693,6707,34,308
AP,6033,CALÇOENE,2697,1025,967,5340,4373,36,216
AP,6041,ITAUBAL,1452,711,381,2896,2515,10,126
AP,6050,MACAPÁ,86446,60960,28560,212539,183979,1552,5947
AP,6068,CUTIAS,1330,642,503,2798,2295,10,102
AP,6076,MAZAGÃO,4661,2801,1273,9806,8533,24,374
AP,6084,AMAPARI,1804,537,422,3111,2689,18,165
AP,6092,OIAPOQUE,5746,1629,3799,12481,8682,156,534
AP,6106,SERRA DO NAVIO,1321,542,390,2525,2135,7,67
AP,6114,FERREIRA GOMES,1516,868,357,3238,2881,16,137
AP,6122,VITÓRIA DO JARÍ,4100,1562,1487,7883,6396,51,297
AP,6130,LARANJAL DO JARÍ,12117,4219,4194,22696,18502,172,872
AP,6157,SANTANA,26088,15472,6300,54750,48450,324,1652
AP,6173,TARTARUGALZINHO,2917,1331,933,5779,4846,24,221
BA,30007,LUIS EDUARDO MAGALHÃES,7233,8183,2611,19995,17384,375,867
BA,30058,EUNÁPOLIS,28809,10478,14841,61111,46270,938,3091
BA,30660,IUIU,3460,1271,1764,7453,5689,99,671
BA,30678,JABORANDI,3073,1627,1758,7324,5566,192,545
BA,30694,JUSSARI,2127,905,1680,5356,3676,48,378
BA,30716,AMÉRICA DOURADA,4636,2433,2816,11293,8477,234,859
BA,30732,ARATACA,2595,1321,2768,7368,4600,55,418
BA,30759,BARRO ALTO,4003,2507,1938,9438,7500,156,577
BA,30775,BARROCAS,5522,1592,1655,9777,8122,139,644
BA,30791,BURITIRAMA,5518,2763,2594,12363,9769,78,1222
BA,30813,CAPELA DO ALTO ALEGRE,3688,1695,1527,8213,6686,268,670
BA,30830,CAPIM GROSSO,7610,4426,2701,16980,14279,406,1178
BA,30856,CANUDOS,5095,2039,2358,10655,8297,127,727
BA,30872,DIAS D'ÁVILA,18131,4350,3447,29760,26313,805,1591
BA,30899,FÁTIMA,6352,2048,2670,12843,10173,321,970
BA,30910,FILADÉLFIA,5339,2689,2615,12214,9599,274,932
BA,30937,GAVIÃO,1613,972,665,3772,3107,93,279
BA,30953,GUAJERU,2162,1679,2028,6746,4718,92,641
BA,30970,HELIÓPOLIS,4592,1544,2540,9969,7429,220,797
BA,30996,JOÃO DOURADO,6459,3924,2674,14663,11989,207,876
BA,33014,ABAÍRA,2777,1482,1917,7138,5221,191,546
BA,33030,ABARÉ,6182,1259,1783,10732,8949,125,1146
BA,33057,ACAJUTIBA,4866,1872,2556,10463,7907,205,642
BA,33065,ADUSTINA,5045,1998,2055,10567,8512,177,1022
BA,33073,ÁGUA FRIA,4899,1987,3225,11720,8495,210,1027
BA,33090,ÉRICO CARDOSO,3125,1312,2756,8356,5600,191,765
BA,33111,AIQUARA,1948,512,670,3670,3000,61,342
BA,33138,ALAGOINHAS,38938,20147,17581,90414,72833,2089,4341
BA,33154,ALCOBAÇA,6474,1648,4023,13937,9914,384,966
BA,33170,ALMADINA,1882,934,431,3731,3300,35,316
BA,33197,AMARGOSA,10132,4655,6450,24439,17989,524,1721
BA,33219,AMÉLIA RODRIGUES,8423,2823,4329,17915,13586,549,891
BA,33235,ANAGÉ,4283,4387,1697,12893,11196,250,1401
BA,33251,ANDARAÍ,4829,1077,2165,9201,7036,121,742
BA,33260,ANDORINHA,6683,1138,2112,10914,8802,155,537
BA,33278,ANGICAL,5199,2753,2361,11297,8936,121,597
BA,33294,ANGUERA,4167,971,1465,7737,6272,214,664
BA,33316,ANTAS,4372,2370,1934,10238,8304,201,1009
BA,33332,ANTÔNIO CARDOSO,4601,1604,654,7888,7234,171,608
BA,33359,ANTÔNIO GONÇALVES,3039,1421,933,6330,5397,134,572
BA,33375,APORÁ,4877,2312,2872,11734,8862,259,1106
BA,33383,ARAÇÁS,4053,1430,1935,8434,6499,190,584
BA,33391,ARACATU,3157,2996,2922,10510,7588,185,1000
BA,33405,APUAREMA,1690,1687,622,4816,4194,54,595
BA,33413,ARACI,15803,4302,8193,32372,24179,570,2386
BA,33430,ARAMARI,3624,1358,1562,7674,6112,141,655
BA,33456,ARATUÍPE,3275,972,1702,6997,5295,124,670
BA,33472,AURELINO LEAL,5028,928,3558,10392,6834,127,449
BA,33499,BAIANÓPOLIS,4720,1322,799,7920,7121,186,663
BA,33510,BAIXA GRANDE,5274,3628,4223,15232,11009,448,1186
BA,33529,BANZAÊ,4395,1563,1227,8260,7033,110,699
BA,33537,BARRA,11991,6341,6673,28808,22135,306,2789
BA,33553,BARRA DA ESTIVA,6480,3135,2681,14440,11759,466,1279
BA,33570,BARRA DO CHOÇA,8177,4964,5343,21649,16306,377,2013
BA,33596,BARRA DO MENDES,5406,1654,1513,9796,8283,194,751
BA,33618,BARRA DO ROCHA,1819,778,352,3451,3099,43,291
BA,33634,BARREIRAS,38384,14518,14725,74585,59860,1055,2382
BA,33650,GOVERNADOR LOMANTO JÚNIOR,2464,1014,1729,5777,4048,72,291
BA,33677,BELMONTE,5777,1591,1362,10325,8963,231,917
BA,33693,BELO CAMPO,3987,3839,3238,12743,9505,237,1110
BA,33715,BIRITINGA,5761,1037,2595,11094,8499,221,1030
BA,33731,BOA NOVA,5274,1318,3713,11954,8241,233,1126
BA,33758,BOA VISTA DO TUPIM,5560,2875,3517,13819,10302,194,1174
BA,33774,BOM JESUS DA LAPA,18545,6439,9360,38615,29255,784,2201
BA,33782,BOM JESUS DA SERRA,2687,1362,1885,6877,4992,51,764
BA,33790,BONINAL,4250,1603,2746,9712,6966,141,754
BA,33804,BONITO,3762,2209,1819,8880,7061,155,671
BA,33812,BOQUIRA,8125,1617,4578,16027,11449,225,1120
BA,33839,BOTUPORÃ,4340,858,1939,8341,6402,147,769
BA,33855,BREJÕES,4963,1548,2504,10514,8010,225,953
BA,33871,BREJOLÂNDIA,3617,1190,1187,6853,5666,155,500
BA,33898,BROTAS DE MACAÚBAS,3830,1868,2747,9631,6884,135,707
BA,33910,BRUMADO,21739,8190,9076,44021,34945,784,2742
BA,33936,BUERAREMA,4778,3674,1682,11784,10102,136,836
BA,33952,CAATIBA,2743,1042,1992,6657,4665,86,626
BA,33960,CABACEIRAS DO PARAGUAÇU,5565,2192,2448,11549,9101,159,901
BA,33979,CACHOEIRA,12813,2428,5412,23594,18182,470,1421
BA,33995,CACULÉ,5551,4036,3931,15442,11511,308,1138
BA,34010,CAEM,3957,1505,1199,8055,6856,179,932
BA,34029,CAETANOS,2967,1410,2201,7689,5488,134,827
BA,34037,CAETITÉ,12057,8929,8244,34409,26165,628,3151
BA,34053,CAFARNAUM,2926,4048,2741,11161,8420,192,937
BA,34070,CAIRU,4343,1376,1838,8564,6726,218,464
BA,34096,CALDEIRÃO GRANDE,2883,1375,1822,7171,5349,169,655
BA,34118,CAMACÃ,8205,4324,7085,22186,15101,391,1329
BA,34134,CAMAÇARI,63346,17009,12006,107846,95840,3436,4983
BA,34150,CAMAMU,7935,3640,5850,20533,14683,450,1890
BA,34177,CAMPO ALEGRE DE LOURDES,8819,3328,4982,19386,14404,214,1567
BA,34193,CAMPO FORMOSO,18849,10874,10144,46246,36102,1049,3685
BA,34215,CANÁPOLIS,3737,922,1639,7429,5790,194,713
BA,34231,CANARANA,7458,3481,3621,16407,12786,290,1107
BA,34258,CANAVIEIRAS,11662,3654,7601,25227,17626,284,1124
BA,34274,CANDEAL,4063,1338,1674,8097,6423,184,579
BA,34290,CANDEIAS,30557,4139,3828,43564,39736,1157,2056
BA,34312,CANDIBA,4202,1903,2225,9914,7689,380,894
BA,34339,CÂNDIDO SALES,8538,3918,5106,19837,14731,275,1519
BA,34355,CANSANÇÃO,11867,3228,5624,22837,17213,333,1301
BA,34363,CARAÍBAS,2110,2365,3186,8668,5482,94,726
BA,34371,CARAVELAS,6673,1598,4346,14486,10140,245,1029
BA,34398,CARDEAL DA SILVA,2712,704,1680,5863,4183,127,451
BA,34410,CARINHANHA,7185,4980,4245,18302,14057,178,1351
BA,34436,CASA NOVA,20322,7176,8752,42966,34214,1029,4459
BA,34452,CASTRO ALVES,9972,3035,2768,18181,15413,383,1344
BA,34479,CATOLÂNDIA,1882,218,309,2804,2495,52,253
BA,34495,CATU,22586,4129,6808,38121,31313,1150,1679
BA,34509,CATURAMA,2929,1058,2204,7089,4885,175,511
BA,34517,CENTRAL,6535,2170,2178,12194,10016,210,688
BA,34533,CHORROCHÓ,3895,1518,1551,8078,6527,89,872
BA,34550,CÍCERO DANTAS,9987,5213,5943,24778,18835,641,2276
BA,34576,CIPÓ,4803,2656,3148,11892,8744,140,786
BA,34592,COARACI,7857,3186,5457,18490,13033,195,1112
BA,34614,COCOS,5025,2567,3161,12757,9596,320,1411
BA,34630,CONCEIÇÃO DA FEIRA,7349,1933,2339,12982,10643,325,616
BA,34657,CONCEIÇÃO DO ALMEIDA,7095,1537,2745,12945,10200,273,926
BA,34673,CONCEIÇÃO DO COITÉ,22590,8493,8184,44797,36613,1097,2914
BA,34690,CONCEIÇÃO DO JACUÍPE,10268,4189,4218,21125,16907,450,1130
BA,34711,CONDE,6569,1977,3023,13452,10429,290,1178
BA,34738,CONDEÚBA,4965,3152,4523,14777,10254,306,1492
BA,34754,CONTENDAS DO SINCORÁ,1484,856,465,3221,2756,57,314
BA,34770,CORAÇÃO DE MARIA,9945,2754,4374,19407,15033,519,1173
BA,34797,CORDEIROS,1496,1897,1100,5383,4283,86,617
BA,34819,CORIBE,5535,1687,2683,11411,8728,346,865
BA,34835,CORONEL JOÃO SÁ,4279,2666,2428,11101,8673,237,1165
BA,34851,CORRENTINA,9661,3931,5254,22019,16765,468,1864
BA,34878,COTEGIPE,4456,1360,2186,9184,6998,140,820
BA,34894,CRAVOLÂNDIA,2380,432,959,4404,3445,144,388
BA,34916,CRISÓPOLIS,7018,1876,3556,14411,10855,282,1365
BA,34932,CRISTÓPOLIS,5421,1558,2068,10367,8299,112,971
BA,34959,CRUZ DAS ALMAS,19497,8768,7730,40440,32710,918,1729
BA,34975,CURAÇÁ,11578,3730,3893,21470,17577,249,1363
BA,34991,DÁRIO MEIRA,3887,942,2077,8228,6151,94,917
BA,35017,DOM BASÍLIO,3997,1832,976,7766,6790,222,508
BA,35033,DOM MACEDO COSTA,1645,569,425,3087,2662,64,265
BA,35050,ELÍSIO MEDRADO,3222,1375,1073,6537,5464,99,582
BA,35076,ENCRUZILHADA,5383,3787,4445,16023,11578,257,1677
BA,35092,ENTRE RIOS,11473,4146,6600,25612,19012,793,1672
BA,35114,ESPLANADA,8942,3220,1532,16076,14544,498,1190
BA,35130,EUCLIDES DA CUNHA,17764,7083,10332,40138,29806,844,3068
BA,35149,FEIRA DA MATA,1796,1065,943,4315,3372,55,358
BA,35157,FEIRA DE SANTANA,162397,68832,51616,329582,277966,7619,14907
BA,35173,FIRMINO ALVES,1638,706,294,3183,2889,80,387
BA,35190,FLORESTA AZUL,3657,1830,1803,8165,6362,90,529
BA,35211,FORMOSA DO RIO PRETO,4890,4126,3091,14005,10914,242,1257
BA,35238,GANDU,6439,6294,5755,21230,15475,342,1501
BA,35254,GENTIO DO OURO,3451,2121,2000,8495,6495,165,592
BA,35270,GLÓRIA,5581,1789,2012,10782,8770,189,908
BA,35297,GONGOGI,2404,1080,2432,6543,4111,54,408
BA,35319,GOVERNADOR MANGABEIRA,7409,2254,2086,13336,11250,279,892
BA,35335,GUANAMBI,20984,12999,10359,50840,40481,1100,3421
BA,35351,GUARATINGA,7838,1775,6042,16972,10930,171,764
BA,35378,IAÇU,8271,2954,6038,19723,13685,426,1502
BA,35394,IBIASSUCÊ,2933,2202,1882,7823,5941,75,552
BA,35416,IBICARAÍ,8056,3831,6543,20364,13821,248,1005
BA,35432,IBICOARA,3438,2302,1500,8536,7036,195,859
BA,35459,IBICUÍ,4293,2134,3261,11171,7910,236,875
BA,35475,IBIPEBA,6776,1715,1686,11366,9680,228,538
BA,35491,SANTA RITA DE CÁSSIA,8878,4152,4246,19055,14809,325,922
BA,35513,IBIPITANGA,4040,2093,2000,9343,7343,257,725
BA,35530,IBIQUERA,1764,423,564,3180,2616,36,306
BA,35556,IBIRAPITANGA,6412,2069,5885,16293,10408,212,1072
BA,35572,IBIRAPUÃ,2383,1011,762,4917,4155,87,532
BA,35599,IBIRATAIA,5625,3730,4826,16429,11603,223,1478
BA,35610,IBITIARA,3832,3116,3134,11492,8358,165,1015
BA,35637,IBITITÁ,6977,3005,2808,13908,11100,160,594
BA,35653,IBOTIRAMA,7781,4149,4781,18576,13795,293,1061
BA,35670,ICHU,2793,855,559,4740,4181,88,228
BA,35696,IGAPORÃ,4208,2658,2837,11339,8502,281,1028
BA,35700,IGRAPIÚNA,3518,1157,2138,8261,6123,261,842
BA,35718,IGUAÍ,7801,2467,5463,18352,12889,371,1529
BA,35734,ILHÉUS,54562,21341,28572,122076,93504,2739,4907
BA,35750,INHAMBUPE,11812,3702,5528,24132,18604,514,1823
BA,35777,IPECAETÁ,5318,2977,3887,13897,10010,280,1130
BA,35793,IPIAÚ,14212,4812,8368,31426,23058,454,1875
BA,35815,IPIRÁ,18188,8677,13036,45589,32553,1008,3417
BA,35831,IPUPIARA,2794,1827,950,6259,5309,158,369
BA,35858,IRAJUBA,2710,801,1168,5463,4295,122,510
BA,35874,IRAMAIA,3632,2045,2431,9005,6574,123,582
BA,35890,IRAQUARA,7714,1715,3164,14136,10972,239,930
BA,35912,IRARÁ,8958,2595,1516,15439,13923,344,1411
BA,35939,IRECÊ,17364,8762,8782,39008,30226,787,1824
BA,35947,ITABELA,8133,3569,5473,19367,13894,302,1378
BA,35955,ITABERABA,18815,6620,11242,42770,31528,943,2885
BA,35971,ITABUNA,49430,46766,30420,142770,112350,2201,5327
BA,35998,ITACARÉ,5259,1490,3122,11266,8144,205,735
BA,36013,ITAETÊ,4269,2126,2636,10003,7367,123,658
BA,36030,ITAGI,4530,2191,2396,10549,8153,106,996
BA,36056,ITAGIBÁ,5716,1381,3782,12351,8569,138,851
BA,36072,ITAGIMIRIM,1664,1032,537,3957,3420,91,467
BA,36080,ITAGUAÇU DA BAHIA,4293,765,658,6682,6024,121,678
BA,36099,ITAJU DO COLÔNIA,2578,772,2004,5853,3849,58,259
BA,36110,ITAJUÍPE,5538,3747,1105,11944,10839,206,725
BA,36137,ITAMARAJU,17693,10903,15527,48961,33434,870,2343
BA,36153,ITAMARI,2737,1134,479,4986,4507,79,396
BA,36170,ITAMBÉ,6467,4223,5009,18055,13046,223,1572
BA,36196,ITANAGRA,1954,874,1660,5056,3396,64,383
BA,36218,ITANHÉM,6924,1871,1915,12633,10718,279,1221
BA,36234,ITAPARICA,7560,1128,2825,12635,9810,210,405
BA,36250,ITAPÉ,3061,1661,1867,7569,5702,104,608
BA,36277,ITAPEBI,3236,1380,2884,8476,5592,129,669
BA,36293,ITAPETINGA,18393,10784,9992,44215,34223,760,2544
BA,36315,ITAPICURU,8758,2171,5174,18988,13814,398,2054
BA,36331,ITAPITANGA,3051,916,2216,6867,4651,66,439
BA,36358,ITAQUARA,3377,716,1434,6400,4966,62,610
BA,36374,ITARANTIM,5772,2456,3348,13151,9803,159,1079
BA,36382,ITATIM,3282,3386,2331,10441,8110,260,887
BA,36390,ITIRUÇU,4052,2092,1294,8743,7449,151,771
BA,36412,ITIÚBA,11386,5363,6036,25572,19536,613,1584
BA,36439,ITORORÓ,5587,3386,3336,14160,10824,224,1063
BA,36455,ITUAÇU,4073,5345,2645,13940,11295,225,1268
BA,36471,ITUBERÁ,7298,3641,4179,17263,13084,431,1149
BA,36498,JACARACI,3862,2061,1907,9301,7394,195,969
BA,36510,JACOBINA,25015,10277,13933,56220,42287,1143,3581
BA,36536,JAGUAQUARA,14677,5291,7495,31649,24154,679,2428
BA,36552,JAGUARARI,10733,2566,1413,17233,15820,499,1411
BA,36579,JAGUARIPE,5428,929,2846,10547,7701,270,815
BA,36595,JANDAÍRA,3107,776,1745,6420,4675,116,524
BA,36617,JEQUIÉ,51825,14796,24369,103514,79145,2007,4543
BA,36633,JEREMOABO,10989,4711,5889,24818,18929,375,2141
BA,36650,JIQUIRIÇÁ,2437,3638,2206,9949,7743,261,1091
BA,36676,JITAÚNA,4561,2184,4001,12547,8546,149,1202
BA,36692,JUAZEIRO,56431,24840,20254,113326,93072,1735,4495
BA,36706,JUCURUÇU,3307,725,4460,9325,4865,102,567
BA,36714,JUSSARA,5618,1427,2931,11395,8464,158,977
BA,36730,JUSSIAPE,2344,2144,1987,7279,5292,160,453
BA,36757,LAFAIETE COUTINHO,1807,381,359,3095,2736,83,351
BA,36765,LAGOA REAL,3044,2241,1950,8454,6504,83,862
BA,36773,LAJE,8490,1975,3372,16186,12814,315,1522
BA,36790,LAJEDÃO,1666,733,607,3442,2835,28,313
BA,36811,LAJEDINHO,1516,423,272,2636,2364,37,336
BA,36820,LAJEDO DO TABOCAL,3179,738,1358,6154,4796,107,598
BA,36838,LAMARÃO,2985,730,1956,6446,4490,131,483
BA,36854,LAURO DE FREITAS,45419,11600,13211,82646,69435,2279,3668
BA,36870,LENÇÓIS,3152,682,1385,5926,4541,123,384
BA,36897,LICÍNIO DE ALMEIDA,2978,2301,857,7157,6300,160,611
BA,36919,LIVRAMENTO DE NOSSA SENHORA,13141,6149,6929,29450,22521,548,1887
BA,36935,MACAJUBA,4170,1103,1947,8600,6653,225,933
BA,36951,MACARANI,5196,2128,1282,10514,9232,214,1346
BA,36978,MACAÚBAS,11973,6082,7161,28703,21542,481,2279
BA,36994,MACURURÉ,2465,1467,1255,6057,4802,71,599
BA,37010,MAIQUINIQUE,2445,1268,671,5250,4579,81,613
BA,37036,MAIRI,5246,3142,4377,14943,10566,370,1260
BA,37052,MALHADA,5371,1748,2626,11004,8378,159,852
BA,37079,MALHADA DE PEDRAS,2921,1170,1543,6659,5116,80,786
BA,37095,MANOEL VITORINO,5369,1415,3668,11747,8079,164,818
BA,37117,MARACÁS,7605,3275,4611,17654,13043,320,1296
BA,37133,MARAGOGIPE,15385,4498,8417,32410,23993,894,2084
BA,37150,MARAÚ,5076,1493,3478,11623,8145,225,990
BA,37176,MARCIONÍLIO SOUZA,3365,760,810,5693,4883,122,483
BA,37192,MASCOTE,3048,1850,796,6548,5752,91,476
BA,37214,MATA DE SÃO JOÃO,12682,3361,2129,21617,19488,877,1514
BA,37222,MATINA,2874,1808,1633,7627,5994,192,904
BA,37230,MEDEIROS NETO,8162,2174,2203,14639,12436,194,1461
BA,37257,MIGUEL CALMON,9376,3494,4670,20577,15907,314,2014
BA,37273,MILAGRES,2844,2670,2089,8593,6504,81,733
BA,37290,MIRANGABA,3732,2838,2484,10599,8115,224,1047
BA,37303,MIRANTE,2256,1651,1587,6301,4714,73,620
BA,37311,MONTE SANTO,14703,8040,9081,36634,27553,812,3239
BA,37338,MORPARÁ,3193,1355,1992,7239,5247,61,492
BA,37354,MORRO DO CHAPÉU,10429,4750,6484,24880,18396,411,2022
BA,37370,MORTUGABA,3076,2026,3431,9835,6404,131,971
BA,37397,MUCUGÊ,2168,2565,1259,7038,5779,141,686
BA,37419,MUCURI,10503,3602,6428,22945,16517,372,1109
BA,37427,MULUNGU DO MORRO,3238,2337,1691,8207,6516,168,545
BA,37435,MUNDO NOVO,6679,2784,3530,15088,11558,306,1287
BA,37451,MUNIZ FERREIRA,3035,1267,744,5888,5144,156,441
BA,37460,MUQUÉM DO SÃO FRANCISCO,2907,1193,1284,5984,4700,69,404
BA,37478,MURITIBA,9223,3725,4500,20233,15733,519,1302
BA,37494,MUTUÍPE,5650,5067,3701,16410,12709,227,1294
BA,37516,NAZARÉ,10484,2219,1729,16366,14637,435,860
BA,37532,NILO PEÇANHA,3169,1562,1859,7924,6065,315,663
BA,37559,NOVA CANAÃ,4901,1770,3137,11426,8289,187,1032
BA,37567,NOVA FÁTIMA,2593,1246,487,5129,4642,132,502
BA,37575,NOVA ITARANA,2300,1063,1324,5407,4083,93,513
BA,37583,NOVA REDENÇÃO,3076,715,1667,6295,4628,82,544
BA,37591,NOVA SOURE,9798,1785,5063,18704,13641,276,1251
BA,37613,NOVA VIÇOSA,10014,3582,6087,22223,16136,389,1474
BA,37621,NOVO TRIUNFO,2521,1850,1783,7036,5253,111,596
BA,37630,OLINDINA,9776,1685,4782,18793,14011,454,1623
BA,37656,OLIVEIRA DOS BREJINHOS,6983,2988,4398,16754,12356,419,1562
BA,37672,OURIÇANGAS,2742,1131,760,5622,4862,114,657
BA,37680,OUROLÂNDIA,3319,3552,3034,11646,8612,178,1315
BA,37699,PALMAS DO MONTE ALTO,7114,2410,3836,15429,11593,221,1360
BA,37710,PALMEIRAS,2752,1051,1372,5989,4617,80,549
BA,37737,PARAMIRIM,6260,2515,4076,14692,10616,380,1003
BA,37753,PARATINGA,11898,2216,5531,21321,15790,187,1128
BA,37770,PARIPIRANGA,7721,5689,4365,20510,16145,466,1649
BA,37796,PAU BRASIL,3419,991,663,5767,5104,84,426
BA,37818,PAULO AFONSO,34761,10609,13550,65867,52317,1061,3547
BA,37834,PEDRÃO,2402,760,444,4290,3846,135,380
BA,37850,PEDRO ALEXANDRE,2134,2412,1770,7980,6210,188,1246
BA,37877,PIATÃ,6485,2109,4154,14957,10803,293,1390
BA,37893,PILÃO ARCADO,8657,4990,6489,22753,16264,197,1841
BA,37915,PINDAÍ,3247,3258,3377,11690,8313,278,1213
BA,37931,PINDOBAÇU,5365,4146,3649,15046,11397,440,1005
BA,37940,PIRAÍ DO NORTE,1578,2034,1559,5780,4221,114,358
BA,37958,PIRIPÁ,2474,1825,2840,8142,5302,76,692
BA,37974,PIRITIBA,6494,2028,3233,13332,10099,177,1061
BA,37990,PLANALTINO,2439,1178,420,5117,4697,151,815
BA,38016,PLANALTO,6841,3512,4007,16476,12469,275,1402
BA,38032,POÇÕES,12928,5580,8717,30953,22236,523,1975
BA,38059,POJUCA,11181,3501,1496,19478,17982,818,1275
BA,38067,PONTO NOVO,4439,2224,2480,10440,7960,198,860
BA,38075,PORTO SEGURO,29181,9739,14887,60950,46063,1103,2695
BA,38091,POTIRAGUÁ,3311,1145,2589,8054,5465,125,624
BA,38113,PRADO,6508,3694,5453,17698,12245,364,1022
BA,38130,PRESIDENTE DUTRA,6320,1062,2242,10581,8339,175,502
BA,38156,PRESIDENTE JÂNIO QUADROS,3234,2098,3389,10291,6902,133,1214
BA,38164,PRESIDENTE TANCREDO NEVES,3769,5898,2819,14927,12108,323,1775
BA,38172,QUEIMADAS,8485,3438,5271,19448,14177,367,1377
BA,38199,QUINJINGUE,9961,3448,4452,20234,15782,245,1589
BA,38210,REMANSO,14172,3614,7519,28331,20812,304,1881
BA,38237,RETIROLÂNDIA,5700,1440,1109,9368,8259,208,631
BA,38253,RIACHÃO DAS NEVES,7849,3121,5270,18565,13295,339,1484
BA,38270,RIACHÃO DO JACUÍPE,11689,5612,2762,22672,19910,445,1358
BA,38296,RIACHO DE SANTANA,7605,5957,5235,22303,17068,789,2054
BA,38318,RIBEIRA DO AMPARO,3971,1927,1779,9054,7275,140,943
BA,38334,RIBEIRA DO POMBAL,14109,7700,7821,33645,25824,539,2166
BA,38342,RIBEIRÃO DO LARGO,3197,1527,1859,7704,5845,93,796
BA,38350,RIO DE CONTAS,4975,2059,2084,10459,8375,263,765
BA,38377,RIO DO ANTÔNIO,4082,2068,2881,10497,7616,184,935
BA,38393,RIO DO PIRES,2997,2430,2044,8542,6498,208,686
BA,38415,RIO REAL,12281,3865,4870,24015,19145,506,1805
BA,38431,RODELAS,2572,951,773,4740,3967,47,285
BA,38458,RUY BARBOSA,11279,2498,5727,21934,16207,278,1537
BA,38474,SALINAS DA MARGARIDA,4421,993,1784,8007,6223,165,388
BA,38490,SALVADOR,872600,227685,246810,1657559,1410749,54594,79872
BA,38512,SANTA BÁRBARA,6897,2725,1226,12572,11346,226,1102
BA,38539,SANTA BRÍGIDA,3914,2200,1903,9752,7849,168,1268
BA,38555,SANTA CRUZ DE CABRÁLIA,5763,2527,3349,13119,9770,227,612
BA,38571,SANTA CRUZ DA VITÓRIA,1815,556,1405,4224,2819,59,262
BA,38598,SANTA INÊS,4298,810,2713,8881,6168,204,648
BA,38610,SANTALUZ,13005,4613,3131,23584,20453,377,1700
BA,38636,SANTA MARIA DA VITÓRIA,11543,5490,6660,27003,20343,410,1973
BA,38652,SANTANA,8790,3443,4467,19079,14612,287,1568
BA,38679,SANTANÓPOLIS,3744,1275,1232,7289,6057,204,635
BA,38695,SANTA TEREZINHA,2971,1276,1338,6671,5333,187,678
BA,38717,SANTO AMARO,26139,3203,9048,43565,34517,1148,1670
BA,38733,SANTO ANTÔNIO DE JESUS,28974,9810,9908,56299,46391,1392,3096
BA,38750,SANTO ESTEVÃO,16149,4100,7283,30689,23406,488,1847
BA,38776,SÃO DESIDÉRIO,7697,2782,1683,13775,12092,236,984
BA,38792,SÃO FÉLIX,5361,1546,1920,10105,8185,201,718
BA,38806,SÃO DOMINGOS,3285,1429,543,5979,5436,115,395
BA,38814,SÃO FELIPE,6230,3138,1497,12659,11162,333,1065
BA,38822,SÃO FÉLIX DO CORIBE,3333,2454,1216,8017,6801,186,541
BA,38830,SÃO FRANCISCO DO CONDE,13808,4240,3222,23696,20474,436,996
BA,38857,SÃO GONÇALO DOS CAMPOS,13092,2465,3138,21278,18140,565,1146
BA,38865,SÃO JOSÉ DO JACUÍPE,2880,1552,1302,6711,5409,187,545
BA,38873,SÃO MIGUEL DAS MATAS,3749,1624,1750,8130,6380,119,652
BA,38890,SÃO SEBASTIÃO DO PASSÉ,18148,3172,5710,30381,24671,667,1370
BA,38911,SAPEAÇU,7176,2196,3383,14429,11046,286,993
BA,38938,SÁTIRO DIAS,4138,2732,2925,11490,8565,227,1170
BA,38946,SAUBARA,4703,1179,1920,8835,6915,251,482
BA,38954,SAÚDE,3878,1697,1855,8952,7097,248,853
BA,38970,SEABRA,15702,2749,6194,27271,21077,434,1461
BA,38997,SEBASTIÃO LARANJEIRAS,2981,1161,1978,6984,5006,184,474
BA,39012,SENHOR DO BONFIM,19702,13186,10204,48603,38399,949,2438
BA,39039,SENTO SÉ,9279,8116,5688,25374,19686,248,1434
BA,39047,SERRA DO RAMALHO,10362,3036,5989,21708,15719,291,1517
BA,39055,SERRA DOURADA,6860,2342,3015,13270,10255,198,604
BA,39071,SERRA PRETA,6782,1863,1773,12320,10547,346,1117
BA,39098,SERRINHA,29316,5663,10751,51783,41032,934,3131
BA,39110,SERROLÂNDIA,3062,2377,2151,8964,6813,183,915
BA,39136,SIMÕES FILHO,43053,6513,10867,68264,57397,1644,2840
BA,39144,SÍTIO DO MATO,4255,1234,1905,8216,6311,103,504
BA,39152,SOUTO SOARES,4250,2782,2710,10870,8160,271,679
BA,39179,TABOCAS DO BREJO VELHO,4671,1127,2149,8997,6848,176,639
BA,39195,TANHAÇU,5373,5104,3532,15810,12278,155,1195
BA,39217,TANQUINHO,3090,627,325,4638,4313,78,316
BA,39233,TAPEROÁ,4025,2298,1132,9288,8156,376,1003
BA,39250,TAPIRAMUTÁ,4740,1555,2435,9977,7542,108,846
BA,39276,TEODORO SAMPAIO,2786,642,608,4739,4131,160,372
BA,39292,TEOFILÂNDIA,7260,1894,1592,12333,10741,266,1005
BA,39314,TEOLÂNDIA,4051,2246,2225,9775,7550,146,867
BA,39330,TERRA NOVA,4755,1467,2311,9747,7436,222,638
BA,39357,TREMEDAL,4128,4225,5940,16280,10340,161,1396
BA,39373,TUCANO,15583,6051,7711,34000,26289,658,2795
BA,39390,UAUÁ,8354,5177,5049,20779,15730,326,1259
BA,39411,UBAÍRA,5693,3531,4091,15159,11068,240,1185
BA,39438,UBAITABA,6152,3026,4506,15730,11224,211,1056
BA,39454,UBATÃ,4965,3334,2877,13070,10193,350,964
BA,39470,UIBAÍ,5300,1756,1219,9218,7999,138,574
BA,39489,UMBURANAS,2303,3493,2004,8848,6844,98,722
BA,39497,UNA,6305,3770,6246,18686,12440,279,1426
BA,39519,URANDI,5084,1950,3590,12209,8619,312,978
BA,39535,URUÇUCA,6470,3363,2509,14394,11885,269,1145
BA,39551,UTINGA,5853,1694,3007,11962,8955,147,844
BA,39578,VALENÇA,23171,9281,10572,51418,40846,1982,3799
BA,39594,VALENTE,7702,4135,1160,14696,13536,343,897
BA,39616,VÁRZEA DO POÇO,2563,1502,814,5700,4886,138,439
BA,39624,VARZEDO,3948,641,1416,6853,5437,116,503
BA,39632,VERA CRUZ,14357,1726,5260,23160,17900,432,558
BA,39640,VEREDAS,2454,1127,1077,5328,4251,75,488
BA,39659,VITÓRIA DA CONQUISTA,58758,62463,37207,184110,146903,3778,10721
BA,39675,WAGNER,3171,900,1690,6416,4726,79,435
BA,39691,WENCESLAU GUIMARÃES,4637,3348,3663,13597,9934,220,1278
BA,39713,XIQUE-XIQUE,14630,5278,8875,33275,24400,411,3260
BA,39730,LAPÃO,9587,3114,3522,18372,14850,383,1168
BA,39748,MADRE DE DEUS,7330,1350,1058,10732,9674,159,369
BA,39756,MAETINGA,1572,1498,2050,6028,3978,61,672
BA,39772,MANSIDÃO,2614,2830,2069,8342,6273,86,497
BA,39799,NORDESTINA,4097,1065,1797,8305,6508,98,1037
BA,39810,PÉ DE SERRA,3595,2995,1529,9502,7973,186,917
BA,39837,PINTADAS,3155,1924,2475,8430,5955,88,587
BA,39845,QUIXABEIRA,2526,1798,804,5996,5192,162,502
BA,39853,RAFAEL JAMBEIRO,7088,2770,4987,16876,11889,263,1300
BA,39870,SANTA LUZIA,3191,1834,3145,9140,5995,96,579
BA,39896,SÃO GABRIEL,6321,3003,2984,14032,11048,276,880
BA,39900,SÍTIO DO QUINTO,3939,1359,1627,8051,6424,145,782
BA,39918,TANQUE NOVO,5384,1730,2131,10802,8671,299,911
BA,39926,SÃO JOSÉ DA VITÓRIA,1995,860,642,3968,3326,39,303
BA,39934,TEIXEIRA DE FREITAS,39445,12870,19852,79861,60009,1241,3527
BA,39942,NOVO HORIZONTE,3767,1176,1343,7163,5820,120,586
BA,39950,VÁRZEA NOVA,3582,2095,1896,9001,7105,225,878
BA,39969,NOVA IBIÁ,2043,1398,765,4835,4070,91,382
BA,39977,VÁRZEA DA ROÇA,4010,1822,2720,10287,7567,372,966
BA,39985,SOBRADINHO,8259,2651,3923,16453,12530,256,696
BA,39993,WANDERLEY,4354,2401,2628,10317,7689,108,572
CE,13005,JIJOCA DE JERICOACOARA,4441,2457,1759,9501,7742,100,576
CE,13013,ABAIARA,3059,820,1230,5950,4720,162,537
CE,13021,MADALENA,6233,1390,2222,11091,8869,122,849
CE,13030,ACARAÚ,19731,3958,7660,34730,27070,500,2193
CE,13048,PIRES FERREIRA,3790,669,727,5835,5108,51,515
CE,13056,ACOPIARA,18050,6576,7293,36466,29173,917,2859
CE,13064,GRAÇA,5456,1238,3052,11176,8124,174,961
CE,13072,AIUABA,4159,2868,1484,9664,8180,128,861
CE,13080,TURURU,6753,1186,1576,10630,9054,158,755
CE,13099,ALCÂNTARAS,3931,1126,1583,7536,5953,102,556
CE,13102,QUITERIANÓPOLIS,7309,2762,3182,14885,11703,277,1158
CE,13110,ALTANEIRA,2424,975,848,4834,3986,72,426
CE,13129,BARREIRA,7529,2895,2310,14571,12261,257,1082
CE,13137,ALTO SANTO,6844,937,1974,10909,8935,197,801
CE,13145,ACARAPE,5819,1109,1438,9372,7934,194,534
CE,13153,ANTONINA DO NORTE,2502,1184,1367,5694,4327,79,421
CE,13161,CHOROZINHO,8091,1922,1687,13272,11585,231,918
CE,13170,APUIARÉS,5913,1492,1913,10388,8475,114,642
CE,13188,HORIZONTE,17034,4677,3427,27652,24225,424,1484
CE,13196,AQUIRAZ,24832,6475,7413,43803,36390,829,2683
CE,13200,ERERÊ,1702,1495,779,4368,3589,49,277
CE,13218,ARACATI,23192,9693,7255,45415,38160,1424,2166
CE,13226,EUSÉBIO,17613,3201,3763,27542,23779,432,1574
CE,13234,ARACOIABA,10297,3540,1947,18074,16127,272,1525
CE,13242,GUAIÚBA,8010,3655,2714,15846,13132,182,966
CE,13250,ARARIPE,7478,2474,3298,15270,11972,173,1589
CE,13269,POTIRETAMA,2990,397,654,4434,3780,35,302
CE,13277,ARATUBA,4423,1366,1203,8169,6966,146,755
CE,13285,PINDORETAMA,7470,1894,1448,12089,10641,134,820
CE,13293,ARNEIROZ,2899,1336,1130,5977,4847,78,433
CE,13307,OCARA,10861,3009,2979,18771,15792,242,1340
CE,13315,ASSARÉ,8050,2166,3720,16044,12324,369,1422
CE,13323,TEJUÇUOCA,5630,3082,1607,11391,9784,117,742
CE,13331,AURORA,9158,4097,3862,19218,15356,312,1381
CE,13340,IPAPORANGA,3047,2870,2050,8987,6937,104,752
CE,13358,BAIXIO,2831,460,845,4679,3834,94,323
CE,13366,TARRAFAS,3768,641,1084,6255,5171,82,519
CE,13374,BARBALHA,18143,6999,6488,35308,28820,506,2201
CE,13382,BANABUIÚ,6821,1569,2462,11947,9485,166,669
CE,13390,BARRO,8345,1306,3661,15426,11765,305,1227
CE,13404,BARROQUINHA,5383,2656,1744,11093,9349,141,867
CE,13412,BATURITÉ,13109,3344,4847,23965,19118,510,1446
CE,13420,ARARENDÁ,3997,1439,1047,7299,6252,70,647
CE,13439,BEBERIBE,16039,7615,5940,33252,27312,729,2109
CE,13447,CATUNDA,4214,891,1092,6943,5851,109,522
CE,13455,BELA CRUZ,10451,3183,4071,19859,15788,337,1398
CE,13463,CHORÓ,5330,1105,2197,9496,7299,109,619
CE,13471,BOA VIAGEM,20012,4648,9405,37915,28510,589,2573
CE,13480,ITAITINGA,13065,2573,2920,20745,17825,334,1350
CE,13498,BREJO SANTO,16782,4615,5220,29823,24603,287,2163
CE,13501,FORTIM,6639,1397,2018,11097,9079,159,621
CE,13510,CAMOCIM,19932,6723,6800,37947,31147,649,2372
CE,13536,CAMPOS SALES,8014,4286,3668,18237,14569,240,1555
CE,13552,CANINDÉ,25058,7069,11200,49044,37844,657,3614
CE,13579,CAPISTRANO,7718,1115,1495,11810,10315,290,899
CE,13595,CARIDADE,6091,3231,1832,12396,10564,169,884
CE,13617,CARIRÉ,6079,3557,1795,12888,11093,180,984
CE,13633,CARIRIAÇU,8554,4567,5536,20828,15292,248,1542
CE,13650,CARIÚS,7447,2185,3346,14834,11488,375,1132
CE,13676,CARNAUBAL,5607,1533,3497,11821,8324,156,801
CE,13692,CASCAVEL,22358,8526,7038,43539,36501,990,3100
CE,13714,CATARINA,3220,1630,1880,7641,5761,106,639
CE,13730,CAUCAIA,93339,18727,20955,151422,130467,2718,8430
CE,13757,CEDRO,9428,4377,3557,19760,16203,313,1508
CE,13773,CHAVAL,5256,1280,1939,9585,7646,186,746
CE,13811,COREAÚ,7405,3122,3442,16187,12745,318,1534
CE,13838,CRATEÚS,23842,10617,12983,53855,40872,1164,3634
CE,13854,CRATO,36836,15741,13670,75645,61975,1223,4745
CE,13870,FARIAS BRITO,6671,3848,2377,14895,12518,389,1282
CE,13897,FORTALEZA,769155,240652,195431,1421936,1226505,25974,61702
CE,13919,FRECHEIRINHA,4294,1665,1566,8784,7218,153,923
CE,13935,GENERAL SAMPAIO,2586,1096,612,4827,4215,42,388
CE,13951,GRANJA,13919,8106,6117,32049,25932,565,2823
CE,13978,GRANJEIRO,1619,1384,911,4407,3496,78,312
CE,13994,GROAÍRAS,3636,1355,1157,7058,5901,170,544
CE,14010,GUARACIABA DO NORTE,11818,5047,6932,26721,19789,300,2155
CE,14036,GUARAMIRANGA,2641,518,611,4392,3781,87,384
CE,14052,HIDROLÂNDIA,7891,1571,2969,13789,10820,134,914
CE,14060,IBARETAMA,5208,1851,1584,9867,8283,177,799
CE,14079,IBIAPINA,6478,3774,4074,16227,12153,296,1199
CE,14095,ICÓ,24746,5597,11992,47725,35733,727,3425
CE,14117,IGUATU,36511,7935,13304,63958,50654,903,3791
CE,14133,INDEPENDÊNCIA,8600,4933,4012,19897,15885,405,1453
CE,14150,IPAUMIRIM,4540,1187,1055,7934,6879,190,655
CE,14176,IPU,15693,2934,8159,30099,21940,437,2256
CE,14192,IPUEIRAS,14432,2903,8648,29434,20786,444,2483
CE,14214,IRACEMA,5885,1004,1258,9182,7924,104,724
CE,14230,IRAUÇUBA,9527,1427,2772,15120,12348,148,963
CE,14257,ITAIÇABA,2889,1287,507,5032,4525,49,205
CE,14273,ITAPAGÉ,19524,4308,5388,32636,27248,583,1970
CE,14290,ITAPIPOCA,40617,8277,13002,68892,55890,843,4581
CE,14311,ITAPIÚNA,7725,1658,2152,13338,11186,240,1198
CE,14338,ITATIRA,7249,1337,2333,12514,10181,133,1218
CE,14354,JAGUARETAMA,7923,1687,2744,13857,11113,204,1007
CE,14370,JAGUARIBARA,4051,1425,1235,7437,6202,122,473
CE,14397,JAGUARIBE,14657,3177,6081,26614,20533,401,1633
CE,14419,JAGUARUANA,12044,4139,4345,23676,19331,985,1382
CE,14435,JARDIM,7423,5854,4607,19933,15326,212,1517
CE,14451,JATI,3291,858,1032,5859,4827,61,454
CE,14478,JUAZEIRO DO NORTE,66014,30295,29273,142716,113443,2537,7673
CE,14494,JUCÁS,6895,3926,3840,16916,13076,414,1450
CE,14516,LAVRAS DA MANGABEIRA,11463,3117,6275,23670,17395,366,1939
CE,14532,LIMOEIRO DO NORTE,23544,4599,6503,38739,32236,935,1890
CE,14559,MARANGUAPE,37003,8180,9117,60874,51757,1010,3342
CE,14575,MARCO,8507,4215,2353,16677,14324,230,1100
CE,14591,MARTINÓPOLE,3797,1138,967,6759,5792,122,523
CE,14613,MASSAPÊ,9783,6572,4311,23117,18806,423,1665
CE,14630,MAURITI,13085,6922,6570,29445,22875,363,2050
CE,14656,MERUOCA,5832,1080,1475,9693,8218,194,880
CE,14672,MILAGRES,11998,2613,4703,21419,16716,207,1458
CE,14680,MIRAÍMA,5358,1271,2203,9692,7489,79,642
CE,14699,MISSÃO VELHA,12492,5198,4580,24724,20144,311,1678
CE,14710,MOMBAÇA,12181,7823,6728,30697,23969,680,2672
CE,14737,MONSENHOR TABOSA,6380,2327,2656,12703,10047,198,941
CE,14753,MORADA NOVA,31149,5128,10519,52416,41897,918,3270
CE,14770,MORAÚJO,3245,911,939,5820,4881,122,503
CE,14796,MORRINHOS,5826,3470,2843,13401,10558,143,878
CE,14818,MUCAMBO,4635,2330,2468,10644,8176,127,892
CE,14834,MULUNGU,3923,965,1359,7097,5738,123,545
CE,14850,NOVA OLINDA,3895,2921,1560,9669,8109,184,799
CE,14877,NOVA RUSSAS,11872,2419,3160,20072,16912,355,1582
CE,14893,NOVO ORIENTE,8467,5135,3874,19534,15660,392,1359
CE,14915,ORÓS,9605,2354,3468,17118,13650,211,1227
CE,14931,PACAJUS,18487,5430,4712,32551,27839,846,1889
CE,14958,PACATUBA,20650,5721,5042,35103,30061,560,1815
CE,14974,PACOTI,5379,908,1122,8454,7332,161,678
CE,14990,PACUJÁ,2689,673,1029,5014,3985,89,381
CE,15016,PALHANO,3496,2036,1094,7350,6256,124,428
CE,15032,PALMÁCIA,4671,785,1605,8102,6497,147,668
CE,15059,PARACURU,12563,2819,3935,21651,17716,321,1347
CE,15075,PARAMBU,12154,3447,4849,23363,18514,457,2044
CE,15091,PARAMOTI,4279,1837,1474,8532,7058,100,685
CE,15113,PEDRA BRANCA,15602,2786,9075,31074,21999,424,2577
CE,15130,PENAFORTE,3280,1070,1000,5962,4962,82,378
CE,15156,PENTECOSTE,17006,2525,4168,26261,22093,265,1648
CE,15172,PEREIRO,5548,2434,3093,12286,9193,140,832
CE,15199,PIQUET CARNEIRO,5335,1620,2139,10616,8477,208,1156
CE,15210,PORANGA,4116,1695,1844,8730,6886,90,799
CE,15237,PORTEIRAS,6701,1484,2219,11763,9544,118,1026
CE,15253,POTENGI,3258,1241,1169,6531,5362,123,555
CE,15270,QUIXADÁ,22992,11723,9541,48552,39011,746,2392
CE,15296,QUIXERAMOBIM,22748,10623,8763,46474,37711,529,2889
CE,15318,QUIXERÉ,8015,1914,1876,13424,11548,266,873
CE,15334,REDENÇÃO,11477,2766,3577,20405,16828,439,1530
CE,15350,RERIUTABA,6801,2470,3821,14807,10986,244,1071
CE,15377,RUSSAS,21180,9385,6402,42485,36083,1055,2463
CE,15393,SABOEIRO,6031,1485,2732,12036,9304,217,1231
CE,15415,SANTANA DO ACARAÚ,11837,3041,1711,19100,17389,351,1675
CE,15431,SANTANA DO CARIRI,5901,2228,2897,12394,9497,133,1004
CE,15440,SALITRE,4984,1937,1815,9914,8099,156,827
CE,15458,SANTA QUITÉRIA,14491,6645,7083,31347,24264,433,2066
CE,15474,SÃO BENEDITO,14612,6436,8644,33438,24794,577,2449
CE,15490,SÃO GONÇALO DO AMARANTE,15773,5897,5158,29636,24478,401,1602
CE,15512,SÃO JOÃO DO JAGUARIBE,4740,646,927,7069,6142,139,422
CE,15539,SÃO LUÍS DO CURU,6550,1067,1347,10039,8692,204,643
CE,15555,SENADOR POMPEU,9022,4270,3750,19175,15425,271,1437
CE,15571,SENADOR SÁ,2665,844,959,5081,4122,74,421
CE,15598,SOBRAL,63229,15342,15017,109404,94387,3007,7357
CE,15610,SOLONÓPOLE,6934,2051,3154,13551,10397,177,937
CE,15636,TABULEIRO DO NORTE,12852,2878,2874,20856,17982,408,1120
CE,15652,TAMBORIL,9037,4191,2249,17554,15305,254,1450
CE,15679,TAUÁ,19859,7586,7574,39787,32213,702,3072
CE,15695,TIANGUÁ,20085,8124,7142,40877,33735,1124,3255
CE,15717,TRAIRI,18591,4918,6479,33383,26904,562,2128
CE,15733,UBAJARA,10547,3641,4396,21505,17109,518,1754
CE,15750,UMARI,2727,1444,1180,5980,4800,74,424
CE,15776,URUBURETAMA,8600,2278,2269,15035,12766,403,1082
CE,15792,URUOCA,4895,1383,1859,9246,7387,102,778
CE,15814,VÁRZEA ALEGRE,14620,4337,3515,25840,22325,578,2029
CE,15830,VIÇOSA DO CEARÁ,10487,15415,6793,36209,29416,458,2583
CE,15857,MARACANAÚ,77607,14438,17238,122649,105411,2304,5607
CE,15873,AMONTADA,13227,4160,5676,25499,19823,288,1602
CE,15881,CROATÁ,6222,1301,3628,12686,9058,172,1186
CE,15890,CRUZ,7642,3871,3386,16419,13033,156,1123
CE,15911,FORQUILHA,7807,2440,2564,14808,12244,360,1223
CE,15920,IBICUITINGA,5324,1471,742,8436,7694,168,576
CE,15938,ICAPUÍ,5435,4477,2411,13339,10928,220,548
CE,15954,ITAREMA,12569,2760,4816,22187,17371,251,1360
CE,15970,MILHÃ,5606,1598,1853,9984,8131,156,605
CE,15989,DEPUTADO IRAPUAN PINHEIRO,3246,1743,1455,7215,5760,89,588
CE,15997,PARAIPABA,11576,2274,2772,18573,15801,320,1215
CE,98531,QUIXELÔ,6862,2183,2169,12878,10709,322,1038
CE,98558,UMIRIM,7444,1562,2636,12805,10169,156,802
CE,98574,VARJOTA,6807,1551,2655,12361,9706,206,837
DF,97012,BRASÍLIA,499407,594521,229750,1655050,1425300,21237,56258
ES,56006,SÃO DOMINGOS DO NORTE,2798,1820,543,5725,5182,95,264
ES,56014,AFONSO CLÁUDIO,8009,8082,4918,23894,18976,508,1217
ES,56022,ÁGUA DOCE DO NORTE,4011,1944,2166,9069,6903,130,605
ES,56030,ALEGRE,8753,7207,5298,24601,19303,521,1335
ES,56049,IRUPI,2867,2747,1427,7725,6298,142,342
ES,56057,ALFREDO CHAVES,3407,3806,1436,10000,8564,324,495
ES,56065,ALTO RIO NOVO,2400,1185,824,5033,4209,97,349
ES,56073,ANCHIETA,6037,4887,2261,15393,13132,450,682
ES,56081,VILA PAVÃO,3390,1875,1191,6961,5770,89,233
ES,56090,APIACÁ,2549,1427,1386,6149,4763,95,363
ES,56103,MARECHAL FLORIANO,3409,4615,1702,11252,9550,355,508
ES,56111,ARACRUZ,24757,12812,6524,49916,43392,946,2011
ES,56120,MARATAÍZES,10077,5702,5052,23235,18183,400,862
ES,56138,ATÍLIO VIVACQUA,3114,2544,909,7293,6384,110,349
ES,56146,BREJETUBA,2855,2533,1910,8296,6386,164,568
ES,56154,BAIXO GUANDU,9358,6322,3872,22459,18587,448,1106
ES,56162,SÃO ROQUE DO CANAÃ,3116,2696,1446,8215,6769,249,396
ES,56170,BARRA DE SÃO FRANCISCO,11715,8409,7208,30737,23529,508,1557
ES,56189,SOORETAMA,7065,3582,2981,15297,12316,379,848
ES,56197,BOA ESPERANÇA,4718,2703,2802,11322,8520,215,518
ES,56200,PONTO BELO,2716,1335,1088,5670,4582,89,279
ES,56219,BOM JESUS DO NORTE,3184,1979,1317,7572,6255,127,409
ES,56227,VILA VALÉRIO,5814,2052,1832,10545,8713,188,440
ES,56235,CACHOEIRO DE ITAPEMIRIM,45183,39571,18558,118666,100108,3066,4049
ES,56251,CARIACICA,105926,51609,27553,214580,187027,4720,6950
ES,56278,CASTELO,10031,8995,4588,26868,22280,688,1057
ES,56294,COLATINA,27145,28364,13390,79664,66274,2097,3070
ES,56308,GOVERNADOR LINDENBERG,3816,2069,1372,7985,6613,167,340
ES,56316,CONCEIÇÃO DA BARRA,8424,3651,5115,19765,14650,415,1248
ES,56332,CONCEIÇÃO DO CASTELO,2171,3432,996,7743,6747,286,524
ES,56359,DIVINO DE SÃO LOURENÇO,1352,1305,564,3670,3106,91,215
ES,56375,DOMINGOS MARTINS,7978,10082,4258,25168,20910,671,1003
ES,56391,DORES DO RIO PRETO,2176,1531,1083,5386,4303,90,304
ES,56413,ECOPORANGA,7243,5104,4826,18987,14161,293,908
ES,56430,FUNDÃO,5022,3054,1300,10753,9453,246,441
ES,56456,GUAÇUÍ,6273,6723,4044,19677,15633,492,1051
ES,56472,GUARAPARI,24555,23738,14059,72218,58159,1682,2865
ES,56499,IBIRAÇU,3490,2557,1117,8324,7207,225,442
ES,56502,IBITIRAMA,2939,1949,1651,7285,5634,127,393
ES,56510,ICONHA,3397,4356,1392,9972,8580,208,307
ES,56537,ITAGUAÇU,5060,3270,2406,12160,9754,263,565
ES,56553,ITAPEMIRIM,10345,6042,5051,23958,18907,436,992
ES,56570,ITARANA,3075,3073,1621,9038,7417,252,461
ES,56596,IÚNA,6940,7100,4049,20287,16238,399,962
ES,56618,JERÔNIMO MONTEIRO,3742,2440,1524,8952,7428,213,554
ES,56626,JOÃO NEIVA,5421,3590,1666,12192,10526,292,516
ES,56634,LINHARES,31307,31608,15017,88712,73695,2348,3791
ES,56650,MANTENÓPOLIS,3145,3294,2350,10018,7668,175,755
ES,56677,MIMOSO DO SUL,7970,6040,4175,20763,16588,468,1253
ES,56693,MONTANHA,5563,3104,3892,14206,10314,305,859
ES,56715,MUCURICI,1927,1181,759,4279,3520,54,205
ES,56731,MUNIZ FREIRE,6115,3655,3009,14248,11239,242,754
ES,56758,MUQUI,4129,3788,1705,10976,9271,290,540
ES,56774,NOVA VENÉCIA,14053,8290,6453,32131,25678,626,1289
ES,56790,PANCAS,6518,3364,4025,15465,11440,189,757
ES,56812,PINHEIROS,8060,3534,4086,17236,13150,279,671
ES,56839,PIÚMA,4198,3476,2540,11642,9102,275,462
ES,56855,PRESIDENTE KENNEDY,3348,2353,1630,8081,6451,104,427
ES,56871,RIO NOVO DO SUL,3501,3349,1654,9517,7863,242,378
ES,56898,SANTA LEOPOLDINA,3832,2789,1541,9287,7746,232,410
ES,56910,SANTA TERESA,5278,6523,2559,16778,14219,549,859
ES,56936,SÃO GABRIEL DA PALHA,9298,6461,3942,21536,17594,397,793
ES,56952,SÃO JOSÉ DO CALÇADO,3684,2322,1528,8632,7104,180,504
ES,56979,SÃO MATEUS,32491,12553,13180,65034,51854,980,2501
ES,56995,SERRA,107574,44356,33758,222031,188273,5070,6285
ES,57010,VIANA,19141,8701,5217,37298,32081,811,1132
ES,57037,VILA VELHA,99564,73798,39704,258441,218737,5845,7850
ES,57053,VITÓRIA,82987,74521,36086,237554,201468,4625,7260
ES,57070,MARILÂNDIA,3447,2803,979,8304,7325,302,403
ES,57096,IBATIBA,5098,6289,2990,15852,12862,210,764
ES,57118,RIO BANANAL,6066,3286,2680,13313,10633,361,567
ES,57134,JAGUARÉ,8763,3086,2707,16265,13558,430,699
ES,57150,PEDRO CANÁRIO,6314,3398,3049,14732,11683,345,1022
ES,57916,LARANJA DA TERRA,3017,3520,1306,8757,7451,187,428
ES,57932,SANTA MARIA DO JETIBÁ,7807,9412,2313,21620,19307,483,860
ES,57959,VARGEM ALTA,4642,4379,2271,12646,10375,322,504
ES,57975,VENDA NOVA DO IMIGRANTE,3149,5984,2139,13272,11133,402,752
ES,57991,ÁGUIA BRANCA,3800,1706,1764,7850,6086,100,292
GO,92010,ABADIÂNIA,2543,3671,1797,9099,7302,213,463
GO,92029,BONFINÓPOLIS,1587,2387,1134,5825,4691,85,308
GO,92037,ÁGUA LIMPA,694,727,322,1974,1652,34,122
GO,92053,ALEXÂNIA,3771,7334,3434,16644,13210,344,934
GO,92061,CAMPOS VERDES,2354,1377,1244,5369,4125,19,299
GO,92096,ALOÂNDIA,553,760,177,1734,1557,24,127
GO,92100,CEZARINA,2234,2570,1164,6680,5516,81,293
GO,92118,ALTO PARAÍSO DE GOIÁS,1216,1584,1229,4606,3377,63,252
GO,92126,COLINAS DO SUL,903,927,561,2697,2136,21,192
GO,92150,ALVORADA DO NORTE,1323,2688,1550,6285,4735,89,436
GO,92169,MORRO AGUDO DE GOIÁS,636,902,285,2110,1825,29,150
GO,92177,AMORINÓPOLIS,954,1556,393,3269,2876,32,189
GO,92207,EDEALINA,903,1498,426,3201,2775,53,191
GO,92215,ANÁPOLIS,51082,94883,33090,206218,173128,4628,8207
GO,92223,FAINA,2192,2147,1297,6190,4893,77,304
GO,92231,ANHANGÜERA,230,325,138,855,717,12,43
GO,92258,ANICUNS,5563,5461,2522,15248,12726,257,711
GO,92266,GOUVELÂNDIA,1048,1445,412,3297,2885,42,225
GO,92274,APARECIDA DE GOIÂNIA,81483,67305,35914,218323,182409,4823,10569
GO,92282,ITAGUARI,1667,1056,396,3508,3112,54,240
GO,92290,APORÉ,724,955,829,2777,1948,36,158
GO,92312,ARAÇU,1070,1741,392,3615,3223,65,200
GO,92320,MATRINCHÃ,1047,1548,908,3843,2935,29,198
GO,92339,ARAGARÇAS,4915,3342,2547,11930,9383,183,446
GO,92347,MIMOSO DE GOIÁS,900,908,352,2435,2083,20,158
GO,92355,ARAGOIÂNIA,1766,2502,831,5845,5014,87,330
GO,92363,MONTIVIDIU,1586,3997,1320,7429,6109,77,282
GO,92444,NOVO PLANALTO,1105,1159,527,3058,2531,27,156
GO,92460,PALESTINA DE GOIÁS,661,1298,569,2780,2211,24,135
GO,92495,ARUANÃ,1591,1566,1354,4880,3526,52,187
GO,92517,AURILÂNDIA,1426,990,542,3392,2850,60,201
GO,92550,AVELINÓPOLIS,686,1285,369,2631,2262,40,131
GO,92568,SANTA FÉ DE GOIÁS,1561,976,737,3552,2815,35,156
GO,92614,BALIZA,1144,528,472,2304,1832,19,88
GO,92622,SÃO JOÃO DA PARAÚNA,538,629,385,1729,1344,14,79
GO,92630,BARRO ALTO,1644,1829,732,4911,4179,89,386
GO,92649,SÃO LUIZ DO NORTE,1088,1141,408,3031,2623,64,206
GO,92657,BELA VISTA DE GOIÁS,3691,7539,2756,16136,13380,348,921
GO,92665,SÃO MIGUEL DO PASSA QUATRO,808,1368,450,2882,2432,32,120
GO,92673,BOM JARDIM DE GOIÁS,2416,2267,1380,6632,5252,84,318
GO,92690,BOM JESUS DE GOIÁS,3768,5565,2385,13053,10668,279,646
GO,92703,SENADOR CANEDO,17748,11114,7396,41827,34431,814,1873
GO,92711,BRAZABRANTES,804,1071,467,2638,2171,34,131
GO,92720,SIMOLÂNDIA,1582,1938,852,4966,4114,53,417
GO,92754,BRITÂNIA,1451,1599,668,4186,3518,59,279
GO,92762,TERESINA DE GOIÁS,859,546,538,2228,1690,14,193
GO,92770,BURITI ALEGRE,1667,3465,1154,7113,5959,146,408
GO,92789,TROMBAS,905,1065,506,2785,2279,42,207
GO,92797,CABECEIRAS,1986,2026,1149,5677,4528,79,235
GO,92800,TURVELÂNDIA,948,1172,881,3312,2431,29,194
GO,92819,CACHOEIRA ALTA,1685,2394,1431,6226,4795,129,321
GO,92827,RIO QUENTE,626,1116,344,2324,1980,33,86
GO,92835,CACHOEIRA DE GOIÁS,433,607,312,1523,1211,22,83
GO,92851,CAÇU,1943,4306,1879,8942,7063,98,405
GO,92860,GUARINOS,704,755,275,1970,1695,24,149
GO,92878,CAIAPÔNIA,3273,4613,1892,10998,9106,140,598
GO,92886,COCALZINHO DE GOIÁS,3132,3955,2159,10601,8442,227,668
GO,92894,CALDAS NOVAS,10366,17947,8137,42021,33884,1098,1957
GO,92908,SANTO ANTÔNIO DE GOIÁS,1167,981,296,2819,2523,58,123
GO,92916,CAMPESTRE DE GOIÁS,748,1266,428,2668,2240,34,125
GO,92924,CHAPADÃO DO CÉU,1033,1502,790,3654,2864,47,122
GO,92932,CAMPINORTE,2303,2838,1652,7453,5801,134,314
GO,92940,ALTO HORIZONTE,719,1012,341,2282,1941,38,111
GO,92959,CAMPO ALEGRE DE GOIÁS,855,2225,408,3834,3426,43,169
GO,92967,CASTELÂNDIA,1110,1196,693,3262,2569,29,146
GO,92975,CAMPOS BELOS,5246,3599,3205,13700,10495,173,1053
GO,92983,JESÚPOLIS,611,682,268,1800,1532,31,117
GO,92991,CARMO DO RIO VERDE,2100,2744,1240,6780,5540,120,337
GO,93009,APARECIDA DO RIO DOCE,903,906,498,2582,2084,43,162
GO,93017,CATALÃO,15424,23750,7011,53729,46718,1238,2582
GO,93025,CIDADE OCIDENTAL,12399,6657,5030,28080,23050,476,1178
GO,93033,CATURAÍ,1129,1615,593,3727,3134,49,203
GO,93041,PROFESSOR JAMIL,1109,915,678,3046,2368,32,178
GO,93050,CAVALCANTE,2344,1122,2234,6535,4301,48,591
GO,93068,PEROLÂNDIA,985,731,445,2408,1963,18,148
GO,93076,CERES,4921,6072,2391,15201,12810,306,641
GO,93084,NOVA IGUAÇU DE GOIÁS,717,822,479,2215,1736,22,117
GO,93092,DIVINÓPOLIS DE GOIÁS,1286,1520,1106,4587,3481,55,454
GO,93106,BURITI DE GOIÁS,1051,872,430,2675,2245,42,124
GO,93122,CALDAZINHA,761,1051,343,2464,2121,42,136
GO,93149,GUARAÍTA,765,689,242,1961,1719,49,134
GO,93157,CÓRREGO DO OURO,616,1215,310,2380,2070,25,95
GO,93165,INACIOLÂNDIA,1203,1631,740,4027,3287,61,250
GO,93173,CORUMBÁ DE GOIÁS,1451,3289,1287,7023,5736,156,492
GO,93181,MONTIVIDIU DO NORTE,1050,935,551,2827,2276,32,191
GO,93190,CORUMBAÍBA,1933,2455,1296,6391,5095,82,408
GO,93203,SANTO ANTÔNIO DA BARRA,1189,1604,628,3763,3135,39,231
GO,93220,TEREZÓPOLIS DE GOIÁS,1536,1837,927,4886,3959,75,327
GO,93246,UIRAPURU,996,810,500,2520,2020,19,130
GO,93254,CRISTALINA,5201,12491,4861,25220,20359,419,1248
GO,93262,BURITINÓPOLIS,450,1287,696,2798,2102,33,228
GO,93270,CRISTIANÓPOLIS,515,1504,405,2756,2351,59,124
GO,93289,VILA BOA,1071,954,624,2885,2261,23,147
GO,93297,CRIXÁS,5036,2594,2235,10861,8626,151,493
GO,93300,VALPARAÍSO DE GOIÁS,20332,12068,8020,47596,39576,1011,2006
GO,93319,CROMÍNIA,1005,1370,358,3142,2784,53,150
GO,93327,NOVO GAMA,16982,10329,6639,38908,32269,826,1870
GO,93335,CUMARI,864,940,360,2420,2060,35,99
GO,93343,ÁGUAS LINDAS DE GOIÁS,19685,12386,10341,49077,38736,1299,2067
GO,93351,DAMIANÓPOLIS,467,1724,611,3127,2516,24,202
GO,93360,ABADIA DE GOIÁS,1210,2030,731,4515,3784,75,209
GO,93378,DAMOLÂNDIA,792,1220,240,2632,2392,52,161
GO,93386,AMARALINA,775,894,489,2380,1891,24,139
GO,93394,DAVINÓPOLIS,713,705,145,1794,1649,35,79
GO,93408,BONÓPOLIS,825,858,380,2313,1933,25,186
GO,93424,PORTEIRÃO,698,804,393,2117,1724,26,117
GO,93432,DIORAMA,821,861,267,2145,1878,22,98
GO,93440,SANTA RITA DO NOVO DESTINO,1210,864,328,2703,2375,28,195
GO,93483,SÃO PATRÍCIO,529,723,157,1685,1528,36,130
GO,93491,EDÉIA,2337,3509,1263,7764,6501,107,309
GO,93505,VILA PROPÍCIO,1436,1345,1262,4517,3255,40,308
GO,93513,ESTRELA DO NORTE,828,1171,583,2924,2341,42,194
GO,93530,FAZENDA NOVA,1718,2002,1135,5557,4422,101,344
GO,93548,IPIRANGA DE GOIÁS,912,908,391,2495,2104,47,161
GO,93564,GAMELEIRA DE GOIÁS,657,1019,394,2295,1901,29,122
GO,93572,FIRMINÓPOLIS,2180,3236,1332,7688,6356,114,421
GO,93580,CAMPO LIMPO DE GOIÁS,1302,2124,847,4795,3948,95,235
GO,93599,FLORES DE GOIÁS,1437,1858,1165,5076,3911,53,353
GO,93602,LAGOA SANTA,283,483,210,1127,917,12,64
GO,93610,FORMOSA,16128,24173,9532,57659,48127,1035,2912
GO,93637,FORMOSO,1264,1572,678,3943,3265,43,220
GO,93670,GOIANÁPOLIS,2329,3831,1982,8980,6998,171,405
GO,93696,GOIANDIRA,1259,1724,562,4040,3478,51,203
GO,93718,GOIANÉSIA,13523,13968,6897,38981,32084,767,2307
GO,93734,GOIÂNIA,222146,339556,119287,819655,700368,15370,35164
GO,93750,GOIANIRA,5436,5283,2858,15593,12735,294,747
GO,93777,GOIÁS,6430,7599,5040,21326,16286,309,842
GO,93793,GOIATUBA,6217,11325,4626,24725,20099,506,1224
GO,93815,GUAPÓ,2967,3899,1792,9913,8121,183,535
GO,93831,GUARANI DE GOIÁS,1094,1237,804,3595,2791,28,342
GO,93874,HEITORAÍ,1158,1260,602,3363,2761,46,201
GO,93890,HIDROLÂNDIA,3074,5015,1960,11744,9784,240,644
GO,93912,HIDROLINA,1209,1377,394,3313,2919,40,191
GO,93939,IACIARA,2228,2736,1832,7654,5822,77,618
GO,93955,INHUMAS,10212,14913,5545,34985,29440,575,1677
GO,93971,IPAMERI,3591,9138,3415,18445,15030,274,949
GO,93998,IPORÁ,7465,9485,4587,23916,19329,353,1059
GO,94013,ISRAELÂNDIA,729,1033,363,2405,2042,27,151
GO,94030,ITABERAÍ,7315,8604,3632,22088,18456,380,1243
GO,94072,ITAGUARU,2155,1469,589,4806,4217,92,263
GO,94110,ITAJÁ,1063,1697,895,4155,3260,41,253
GO,94137,ITAPACI,4010,4272,2084,11764,9680,193,700
GO,94153,ITAPIRAPUÃ,1777,2906,1667,7076,5409,57,360
GO,94196,ITAPURANGA,8168,6887,4214,21526,17312,411,1003
GO,94218,ITARUMÃ,889,2021,1073,4370,3297,50,208
GO,94234,ITAUÇU,2399,2818,1085,7021,5936,106,360
GO,94250,ITUMBIARA,18493,28059,11187,65111,53924,1338,2876
GO,94277,IVOLÂNDIA,990,852,453,2520,2067,24,128
GO,94293,JANDAIA,2108,2170,685,5524,4839,54,295
GO,94315,JARAGUÁ,8351,10456,4457,26332,21875,565,1310
GO,94331,JATAÍ,15571,25909,9342,56540,47198,881,2362
GO,94358,JAUPACI,1284,739,569,2835,2266,16,148
GO,94374,JOVIÂNIA,1532,2448,932,5519,4587,105,306
GO,94390,JUSSARA,3983,6652,3545,15639,12094,220,726
GO,94439,LEOPOLDO DE BULHÕES,1704,2203,881,5498,4617,98,384
GO,94455,LUZIÂNIA,33406,32610,15317,92346,77029,1801,4425
GO,94471,MAIRIPOTABA,425,1141,303,2149,1846,36,143
GO,94498,MAMBAÍ,777,2102,867,4251,3384,51,344
GO,94510,MARA ROSA,2330,3213,1893,8435,6542,122,565
GO,94536,MARZAGÃO,434,766,193,1575,1382,16,83
GO,94552,PARANAIGUARA,2652,2221,1539,6999,5460,92,317
GO,94579,MAURILÂNDIA,2998,2435,1793,7999,6206,144,408
GO,94595,MINEIROS,10140,13023,4738,31193,26455,549,1478
GO,94650,MOIPORÁ,528,885,274,1937,1663,39,90
GO,94676,MONTE ALEGRE DE GOIÁS,1892,1469,1342,5413,4071,50,485
GO,94714,MONTES CLAROS DE GOIÁS,2056,2148,1028,5789,4761,107,301
GO,94730,MORRINHOS,9131,12669,5047,30210,25163,577,1205
GO,94757,MOSSÂMEDES,1478,1665,598,4242,3644,63,213
GO,94773,MOZARLÂNDIA,3227,3617,1996,9855,7859,156,601
GO,94790,MUTUNÓPOLIS,1109,1207,550,3178,2628,23,176
GO,94854,NAZÁRIO,2074,2588,891,6203,5312,119,294
GO,94870,NERÓPOLIS,5118,6558,2953,16646,13693,379,866
GO,94897,NIQUELÂNDIA,10289,9505,6726,29664,22938,432,1591
GO,94919,NOVA AMÉRICA,542,872,213,1994,1781,44,157
GO,94935,NOVA AURORA,499,888,164,1772,1608,27,95
GO,94951,NOVA ROMA,764,982,526,2606,2080,32,228
GO,94978,NOVA VENEZA,1825,2543,862,5828,4966,88,281
GO,95010,NOVO BRASIL,1065,1302,452,3119,2667,39,194
GO,95036,ORIZONA,2427,5303,1664,10876,9212,209,595
GO,95052,OURO VERDE DE GOIÁS,839,1624,441,3342,2901,82,211
GO,95079,OUVIDOR,1499,1776,374,4143,3769,77,175
GO,95095,PADRE BERNARDO,4088,4960,3346,14194,10848,185,930
GO,95117,PALMEIRAS DE GOIÁS,3855,8136,2339,15741,13402,195,644
GO,95133,PALMELO,412,910,233,1787,1554,17,100
GO,95150,PALMINÓPOLIS,831,1585,529,3375,2846,32,165
GO,95176,PANAMÁ,595,1014,327,2224,1897,45,137
GO,95230,PARAÚNA,2771,3050,1547,8199,6652,78,467
GO,95311,PETROLINA DE GOIÁS,1920,3821,1276,7866,6590,118,409
GO,95354,PILAR DE GOIÁS,841,861,323,2317,1994,47,182
GO,95397,PIRACANJUBA,5617,7546,3704,18573,14869,264,764
GO,95419,PIRANHAS,3517,3018,1635,9129,7494,125,535
GO,95435,PIRENÓPOLIS,4994,7971,3380,18295,14915,349,898
GO,95451,PIRES DO RIO,4599,9911,3687,20896,17209,471,1047
GO,95494,PONTALINA,4220,5362,2565,13889,11324,241,760
GO,95559,PORANGATU,11329,8968,6681,29654,22973,313,1332
GO,95575,PORTELÂNDIA,911,1106,404,2747,2343,73,147
GO,95613,POSSE,5107,8837,4286,20455,16169,231,1354
GO,95630,QUIRINÓPOLIS,8625,11794,4741,28256,23515,606,1431
GO,95656,RIALMA,2493,2927,1547,7823,6276,152,388
GO,95672,RIANÁPOLIS,820,1550,412,3328,2916,64,296
GO,95710,RIO VERDE,24143,44785,13594,91810,78216,1555,4209
GO,95737,RUBIATABA,4260,5817,2581,14518,11937,266,787
GO,95753,SANCLERLÂNDIA,2468,2232,792,6095,5303,87,262
GO,95770,SANTA BÁRBARA DE GOIÁS,1395,1793,609,4128,3519,40,157
GO,95796,SANTA CRUZ DE GOIÁS,576,1406,504,2793,2289,36,130
GO,95818,SANTA HELENA DE GOIÁS,8890,12651,4428,28558,24130,394,1455
GO,95834,SANTA RITA DO ARAGUAIA,1029,1575,809,3799,2990,54,184
GO,95850,SANTA ROSA DE GOIÁS,909,1219,341,2897,2556,96,192
GO,95877,SANTA TEREZA DE GOIÁS,922,1318,550,3139,2589,47,194
GO,95893,SANTA TEREZINHA DE GOIÁS,3215,3076,2546,9492,6946,100,362
GO,95915,SÃO DOMINGOS,1881,2156,2041,7115,5074,70,741
GO,95931,SÃO FRANCISCO DE GOIÁS,1340,1880,822,4532,3710,69,252
GO,95958,PLANALTINA,17387,11792,7326,42153,34827,932,2197
GO,95974,SÃO JOÃO D'ALIANÇA,1319,2169,1284,5529,4245,77,385
GO,95990,SÃO LUÍS DE MONTES BELOS,6066,8459,4210,21466,17256,488,1092
GO,96016,SÃO MIGUEL DO ARAGUAIA,4225,7172,3906,17010,13104,190,904
GO,96059,SÃO SIMÃO,4469,2860,1540,10011,8471,129,564
GO,96075,SERRANÓPOLIS,1469,2004,939,5048,4109,95,228
GO,96091,SILVÂNIA,3345,6492,1933,13147,11214,225,478
GO,96113,SÍTIO D'ABADIA,643,966,495,2333,1838,14,174
GO,96172,TAQUARAL DE GOIÁS,919,1177,356,2937,2581,67,250
GO,96237,TRÊS RANCHOS,1018,1007,293,2565,2272,24,97
GO,96253,TRINDADE,20898,23988,10311,62885,52574,1171,2641
GO,96318,TURVÂNIA,1327,1995,553,4297,3744,41,220
GO,96334,URUAÇU,8161,8105,5569,24022,18453,379,1077
GO,96350,URUANA,3747,3844,2249,11102,8853,218,595
GO,96377,URUTAÍ,702,1069,359,2455,2096,51,120
GO,96393,VARJÃO,598,1625,428,3062,2634,41,203
GO,96415,VIANÓPOLIS,1434,4494,1209,8037,6828,115,417
GO,96458,ACREÚNA,3969,6786,2825,14972,12147,199,698
GO,96474,MINAÇU,8788,7949,6829,25828,18999,261,918
GO,96512,MUNDO NOVO,1627,1571,1233,4858,3625,61,297
GO,96539,NOVA CRIXÁS,2009,3215,1718,7601,5883,62,456
GO,96555,NOVA GLÓRIA,2815,2072,1554,7164,5610,123,365
GO,96571,VICENTINÓPOLIS,1763,2127,782,5161,4379,57,220
GO,96610,AMERICANO DO BRASIL,1539,1567,519,4137,3618,65,262
GO,96695,ARAGUAPAZ,1760,2301,1284,5857,4573,72,274
GO,96717,ARENÓPOLIS,1249,942,419,2869,2450,28,142
GO,96733,CACHOEIRA DOURADA,2212,2789,1524,7266,5742,112,414
GO,96750,DOVERLÂNDIA,1978,2408,1144,6117,4973,50,306
GO,96776,SANTO ANTÔNIO DO DESCOBERTO,11251,11080,6234,33286,27052,707,1860
GO,96814,INDIARA,3444,2843,1513,8822,7309,194,506
GO,96873,CAMPINAÇU,1219,1031,615,3199,2584,52,183
GO,96890,SANTA ISABEL,655,1353,520,2939,2419,54,205
GO,96911,ADELÂNDIA,856,814,269,2183,1914,20,129
GO,96938,ÁGUA FRIA DE GOIÁS,799,1700,1051,4015,2964,44,247
MA,7005,ÁGUA DOCE,4178,1150,1776,8189,6413,244,651
MA,7013,AFONSO CUNHA,2994,291,991,5023,4032,83,528
MA,7021,ALTO ALEGRE DO MARANHÃO,7132,775,2774,12155,9381,133,1132
MA,7030,ALCÂNTARA,9309,928,2622,14070,11448,238,612
MA,7048,ALTO ALEGRE DO PINDARÉ,11052,1134,4273,18245,13972,137,1284
MA,7056,ALDEIAS ALTAS,7523,752,2664,12995,10331,191,1599
MA,7064,APICUM-AÇU,4597,1277,1245,7822,6577,92,436
MA,7072,ALTAMIRA DO MARANHÃO,2706,896,1145,5464,4319,66,391
MA,7080,AMAPÁ DO MARANHÃO,1852,875,921,4188,3267,44,400
MA,7099,ALTO PARNAÍBA,2488,1577,1676,6645,4969,100,622
MA,7102,ARAGUANÃ,3484,424,1731,6210,4479,56,378
MA,7110,AMARANTE DO MARANHÃO,9126,4436,3357,19245,15888,235,1658
MA,7129,BACABEIRA,5768,1071,1581,9431,7850,154,561
MA,7137,ANAJATUBA,10053,922,4104,17106,13002,305,1239
MA,7145,BACURITUBA,2433,124,1030,3958,2928,33,260
MA,7153,ANAPURUS,5656,899,1123,8923,7800,275,730
MA,7161,BELÁGUA,3022,191,699,4389,3690,26,357
MA,7170,ARAIÓSES,12338,3631,6035,25768,19733,872,2268
MA,7188,BELA VISTA,3803,832,1801,7095,5294,58,387
MA,7196,ARARI,10371,3100,3851,19524,15673,458,1065
MA,7200,BERNARDO DO MEARIM,2446,379,789,4011,3222,43,257
MA,7218,AXIXÁ,5186,578,1553,7933,6380,61,349
MA,7226,CACHOEIRA GRANDE,3300,224,1314,5404,4090,37,350
MA,7234,BACABAL,32848,7620,14226,60551,46325,697,3001
MA,7242,DAVINÓPOLIS,4651,1053,2202,8535,6333,58,289
MA,7250,BACURI,5604,1503,2217,10424,8207,148,700
MA,7269,BOM JESUS DAS SELVAS,5247,3364,3437,13640,10203,167,1097
MA,7277,BALSAS,16898,13667,7446,41977,34531,651,2044
MA,7285,BOM LUGAR,4941,900,2157,8806,6649,79,511
MA,7293,BARÃO DE GRAJAÚ,6507,1141,2245,11290,9045,206,914
MA,7307,BREJO DE AREIA,3441,930,1319,6577,5258,86,496
MA,7315,BARRA DO CORDA,25616,6290,10319,48241,37922,904,3878
MA,7323,BOA VISTA DO GURUPI,1672,909,776,3684,2908,29,185
MA,7331,BARREIRINHAS,19826,2434,5664,30724,25060,268,1819
MA,7340,BURITICUPU,18747,4492,6618,33303,26685,333,1970
MA,7358,BENEDITO LEITE,1124,1568,1062,4274,3212,33,432
MA,7366,BURITIRANA,4026,2028,2063,9278,7215,127,779
MA,7374,BEQUIMÃO,9753,701,3479,15848,12369,389,920
MA,7382,CAMPESTRE DO MARANHÃO,4511,1176,1789,8198,6409,80,455
MA,7390,BREJO,11410,2690,4014,20512,16498,242,1553
MA,7404,CAPINZAL DO NORTE,3901,714,1107,6580,5473,108,588
MA,7412,BURITI,9476,1662,3560,16896,13336,336,1447
MA,7420,CENTRAL DO MARANHÃO,3445,156,1104,5341,4237,56,387
MA,7439,BURITI BRAVO,8912,995,2873,14067,11194,115,706
MA,7447,CENTRO DO GUILHERME,2633,280,1144,4569,3425,35,410
MA,7455,CAJAPIÓ,4553,458,1408,7356,5948,107,599
MA,7463,CENTRO NOVO DO MARANHÃO,4446,642,1377,7233,5856,54,502
MA,7471,CAJARI,7063,583,2438,11284,8846,181,645
MA,7480,CIDELÂNDIA,4005,1572,2013,8363,6350,108,433
MA,7498,CÂNDIDO MENDES,5609,1742,2791,11359,8568,127,781
MA,7501,CONCEIÇÃO DO LAGO AÇU,4527,725,1547,7797,6250,98,604
MA,7510,CANTANHEDE,5401,1237,2195,9944,7749,104,737
MA,7528,FEIRA NOVA DO MARANHÃO,2113,1494,719,4801,4082,30,364
MA,7536,CAROLINA,7499,3187,4031,16257,12226,184,818
MA,7544,FERNANDO FALCÃO,3394,559,938,5806,4868,79,753
MA,7552,CARUTAPERA,6844,2367,2562,13076,10514,87,747
MA,7560,FORMOSA DA SERRA NEGRA,2379,4234,1242,8729,7487,89,546
MA,7579,CAXIAS,51762,7500,21253,91158,69905,1130,6884
MA,7595,CEDRAL,4645,451,1298,7037,5739,146,355
MA,7609,GOVERNADOR EDSON LOBÃO,3731,1873,1519,7734,6215,54,307
MA,7617,CHAPADINHA,25096,3190,8405,41605,33200,803,2904
MA,7625,GOVERNADOR LUIZ ROCHA,3424,822,1042,5965,4923,114,365
MA,7633,CODÓ,35129,6740,22484,73067,50583,978,4863
MA,7641,GOVERNADOR NEWTON BELLO,3707,696,1897,7221,5324,96,600
MA,7650,COELHO NETO,16179,4166,7926,32246,24320,616,2425
MA,7668,GOVERNADOR NUNES FREIRE,6782,1809,2343,12098,9755,88,835
MA,7676,COLINAS,12069,2329,4909,22063,17154,297,2033
MA,7684,IGARAPÉ DO MEIO,3796,725,1664,7052,5388,96,580
MA,7692,COROATÁ,23251,2583,9016,39450,30434,416,2911
MA,7706,ITAIPAVA DO GRAJAÚ,3761,1363,1548,7377,5829,71,520
MA,7714,CURURUPU,13467,1684,4811,22200,17389,373,1133
MA,7722,ITINGA DO MARANHÃO,6874,4317,3699,16252,12553,171,717
MA,7730,DOM PEDRO,8171,2333,3036,14734,11698,176,633
MA,7749,JATOBÁ,2861,643,824,4920,4096,104,433
MA,7757,DUQUE BACELAR,3755,715,1615,7138,5523,135,665
MA,7765,JENIPAPO DOS VIEIRAS,5484,1006,1704,9569,7865,156,993
MA,7773,ESPERANTINÓPOLIS,7868,854,2405,12599,10194,160,901
MA,7781,JUNCO DO MARANHÃO,1904,649,976,3947,2971,44,301
MA,7790,FORTALEZA DOS NOGUEIRAS,3893,1910,1365,8066,6701,112,576
MA,7803,LAGO DOS RODRIGUES,4214,966,1564,7357,5793,82,376
MA,7811,FORTUNA,6430,962,2413,11135,8722,229,751
MA,7820,LAGOA DO MATO,4289,426,1381,6720,5339,58,455
MA,7838,GODOFREDO VIANA,2449,947,1337,5369,4032,82,409
MA,7846,LAGOA GRANDE DO MARANHÃO,3994,1192,1314,7177,5863,78,451
MA,7854,GONÇALVES DIAS,6601,765,2435,10751,8316,149,615
MA,7862,LAJEADO NOVO,1777,1578,838,4698,3860,49,334
MA,7870,GOVERNADOR ARCHER,4297,325,1359,6437,5078,48,359
MA,7889,MARACAÇUMÉ,4833,1996,2442,10352,7910,103,732
MA,7897,GOVERNADOR EUGÊNIO BARROS,5261,976,1583,9072,7489,160,864
MA,7900,MARAJÁ DO SENA,2863,1024,1404,6290,4886,120,628
MA,7919,GRAÇA ARANHA,3170,366,932,4924,3992,40,310
MA,7927,MARANHÃOZINHO,3147,775,1215,5566,4351,32,300
MA,7935,GRAJAÚ,15400,5448,6189,30508,24319,446,2042
MA,7943,MATÕES DO NORTE,3350,310,1517,5707,4190,28,409
MA,7951,GUIMARÃES,5496,655,1964,9081,7117,202,484
MA,7960,MILAGRES DO MARANHÃO,2443,400,701,4019,3318,57,323
MA,7978,HUMBERTO DE CAMPOS,10830,758,2633,16086,13453,139,1300
MA,7986,NOVA COLINAS,1651,877,512,3432,2920,40,259
MA,7994,ICATU,11926,912,2925,17365,14440,157,1118
MA,8001,NOVA OLINDA DO MARANHÃO,6050,1069,1971,10243,8272,102,778
MA,8010,IGARAPÉ GRANDE,4537,780,1736,7759,6023,76,375
MA,8028,OLINDA NOVA DO MARANHÃO,4495,421,1703,7598,5895,181,532
MA,8036,IMPERATRIZ,63970,38303,30292,145265,114973,1524,3504
MA,8044,PAULINO NEVES,3910,1881,2015,8940,6925,177,715
MA,8052,SÃO LUIS GONZAGA DO MARANHÃO,10128,1113,4144,17225,13081,218,1222
MA,8060,PEDRO DO ROSÁRIO,6663,579,2352,10872,8520,86,695
MA,8079,ITAPECURU-MIRIM,20368,2595,7228,33425,26197,325,1953
MA,8087,PERITORÓ,7934,758,2598,12766,10168,138,1097
MA,8095,JOÃO LISBOA,8655,2377,4310,17044,12734,218,925
MA,8109,PORTO RICO DO MARANHÃO,3103,606,1128,5474,4346,165,282
MA,8117,JOSELÂNDIA,6327,678,2055,10273,8218,190,799
MA,8125,PRESIDENTE MEDICI,2565,533,743,4160,3417,34,216
MA,8133,LAGO DA PEDRA,14293,4884,7407,30423,23016,611,2321
MA,8141,PRESIDENTE SARNEY,6023,409,2178,9675,7497,88,786
MA,8150,LAGO DO JUNCO,3529,979,1472,6779,5307,99,552
MA,8168,RAPOSA,8837,1282,2928,14474,11546,148,705
MA,8176,LAGO VERDE,6170,480,2477,10224,7747,129,767
MA,8184,RIBAMAR FIQUENE,2015,1439,1081,5051,3970,67,272
MA,8192,LIMA CAMPOS,4288,1705,1802,9000,7198,177,682
MA,8206,SANTA FILOMENA DO MARANHÃO,2921,453,550,4324,3774,46,278
MA,8214,LORETO,3213,1317,1352,6699,5347,83,647
MA,8222,SANTANA DO MARANHÃO,2902,469,1352,5498,4146,81,582
MA,8230,LUIS DOMINGUES DO MARANHÃO,1836,1215,871,4373,3502,24,329
MA,8249,SANTO AMARO DO MARANHÃO,5072,533,1647,8153,6506,83,510
MA,8257,MAGALHÃES DE ALMEIDA,5601,1522,2323,10586,8263,145,813
MA,8265,SÃO DOMINGOS DO AZEITÃO,2507,769,856,4779,3923,67,476
MA,8273,MATA ROMA,5757,1578,1187,9785,8598,214,821
MA,8281,SÃO FRANCISCO DO BREJÃO,2189,1683,984,5346,4362,63,264
MA,8290,MATINHA,9406,1605,2420,14989,12569,299,675
MA,8303,SÃO JOÃO DO CARU,3661,1360,1926,8064,6138,134,679
MA,8311,MATÕES,10587,1323,3982,18610,14628,258,2066
MA,8320,SÃO JOÃO DO PARAÍSO,2976,2242,1417,7230,5813,60,376
MA,8338,MIRADOR,6901,1432,2693,12612,9919,149,1147
MA,8346,SÃO JOÃO DO SÓTER,5365,816,2787,10288,7501,93,1003
MA,8354,MIRINZAL,5547,618,2085,9107,7022,178,417
MA,8362,SÃO JOSÉ DOS BASILIOS,3688,363,1230,5979,4749,82,467
MA,8370,MONÇÃO,9137,1579,3498,16186,12688,160,1439
MA,8389,SÃO PEDRO DA ÁGUA BRANCA,3638,941,1869,7005,5136,58,377
MA,8397,MONTES ALTOS,3475,1242,1207,6674,5467,90,394
MA,8400,SÃO PEDRO DOS CRENTES,870,1555,513,3214,2701,20,154
MA,8419,MORROS,6934,517,2127,10857,8730,73,793
MA,8427,SÃO RAIMUNDO DA DOCA BEZERRA,2581,545,849,4492,3643,44,339
MA,8435,NINA RODRIGUES,4135,856,1252,6883,5631,33,407
MA,8443,SÃO ROBERTO,2353,264,675,3646,2971,30,202
MA,8451,NOVA IORQUE,1498,745,642,3351,2709,46,335
MA,8460,SATUBINHA,2524,418,929,4388,3459,70,322
MA,8478,OLHO D`ÁGUA DAS CUNHÃS,6739,1838,3113,13044,9931,237,865
MA,8486,SENADOR ALEXANDRE COSTA,3726,593,2029,7186,5157,53,690
MA,8494,PAÇO DO LUMIAR,25458,5638,6729,42531,35802,708,1256
MA,8508,SENADOR LA ROQUE,7600,2245,3226,14791,11565,204,1084
MA,8516,PALMEIRÂNDIA,7097,633,2972,12257,9285,245,1036
MA,8524,SERRANO DO MARANHÃO,4305,316,1676,7158,5482,98,557
MA,8532,PARAIBANO,7286,1379,3404,13693,10289,198,995
MA,8540,SUCUPIRA DO RIACHÃO,2225,381,756,3907,3151,52,415
MA,8559,PARNARAMA,12265,2063,4543,21663,17120,330,1878
MA,8567,TRIZIDELA DO VALE,7314,1573,3389,13878,10489,184,877
MA,8575,PASSAGEM FRANCA,6308,1771,3147,12836,9689,221,1140
MA,8583,TUFILÂNDIA,2793,191,1016,4395,3379,23,309
MA,8591,PASTOS BONS,6382,1508,2176,11453,9277,150,1001
MA,8605,TURILÂNDIA,6478,631,2862,11201,8339,92,767
MA,8613,PEDREIRAS,14520,3692,6432,27587,21155,346,1466
MA,8621,VILA NOVA DOS MARTÍRIOS,2602,965,781,4791,4010,45,255
MA,8630,PENALVA,13283,1224,4989,21673,16684,131,1498
MA,8656,PERI MIRIM,5334,671,2442,9396,6954,201,510
MA,8672,PINDARÉ-MIRIM,11628,1441,3776,19058,15282,226,1404
MA,8699,PINHEIRO,27907,4517,10804,47900,37096,546,2255
MA,8710,PIO XII,8325,2112,3662,16023,12361,194,1151
MA,8737,PIRAPEMAS,5933,719,2263,10336,8073,138,972
MA,8753,POÇÃO DE PEDRAS,8415,1522,3471,14896,11425,262,861
MA,8770,PORTO FRANCO,5827,3282,2311,12499,10188,107,515
MA,8796,PRESIDENTE DUTRA,15409,2909,5995,26847,20852,423,1514
MA,8818,PRESIDENTE JUSCELINO,4832,347,1508,7376,5868,21,427
MA,8834,PRESIDENTE VARGAS,5429,449,1227,7815,6588,81,430
MA,8850,PRIMEIRA CRUZ,5160,495,1363,8138,6775,143,743
MA,8877,RIACHÃO,6622,1986,2863,12644,9781,103,794
MA,8893,SÃO JOSÉ DE RIBAMAR,33872,5277,9232,53511,44279,713,1862
MA,8915,ROSÁRIO,15058,1729,5002,24148,19146,306,1141
MA,8931,SAMBAÍBA,2294,823,765,4294,3529,26,305
MA,8958,SANTA HELENA,11662,1136,4641,19298,14657,251,1107
MA,8974,SANTA LUZIA,23391,5076,10200,42951,32751,433,2357
MA,8990,SANTA QUITÉRIA DO MARANHÃO,10263,826,2720,15779,13059,328,1275
MA,9016,SANTA RITA,9157,2241,3741,16909,13168,245,1080
MA,9032,SANTO ANTÔNIO DOS LOPES,6481,845,1942,10273,8331,109,717
MA,9059,SÃO BENEDITO DO RIO PRETO,7086,515,1598,10414,8816,91,862
MA,9075,SÃO BENTO,13101,2128,5879,23571,17692,435,1351
MA,9091,SÃO BERNARDO,7650,3209,3196,16215,13019,211,1392
MA,9113,SÃO DOMINGOS DO MARANHÃO,12104,4361,5064,24222,19158,242,1972
MA,9130,SÃO FÉLIX DE BALSAS,2147,335,589,3389,2800,58,224
MA,9156,SÃO FRANCISCO DO MARANHÃO,4360,670,1886,8151,6265,189,782
MA,9172,SÃO JOÃO BATISTA,10685,683,4082,17101,13019,152,1082
MA,9199,SÃO JOÃO DOS PATOS,7329,3032,4187,16718,12531,402,1327
MA,9210,SÃO LUÍS,328701,98749,103775,615977,512202,10115,15962
MA,9237,SÃO MATEUS DO MARANHÃO,13646,2127,6664,25140,18476,247,1860
MA,9253,SÃO RAIMUNDO DAS MANGABEIRAS,4566,3002,2286,10955,8669,114,733
MA,9270,SÃO VICENTE FERRER,8249,622,3919,14363,10444,207,819
MA,9296,SÍTIO NOVO,4631,3386,2343,11579,9236,132,773
MA,9318,SUCUPIRA DO NORTE,4041,799,1429,7297,5868,171,707
MA,9334,TASSO FRAGOSO,1733,1423,971,4671,3700,54,413
MA,9350,TIMBIRAS,8364,1263,5096,16765,11669,187,1473
MA,9377,TIMON,53700,8083,17560,89866,72306,1205,5303
MA,9393,TUNTUM,14693,2209,5409,24758,19349,320,1774
MA,9415,TURIAÇU,10994,2858,4871,20865,15994,305,1418
MA,9431,TUTÓIA,12038,5656,6249,27908,21659,728,2142
MA,9458,URBANO SANTOS,9669,1019,3048,15737,12689,286,1366
MA,9474,VARGEM GRANDE,13896,2588,5388,24667,19279,271,1686
MA,9490,VIANA,17174,4480,6314,31081,24767,408,1748
MA,9512,VITÓRIA DO MEARIM,10408,2910,6048,21861,15813,495,1319
MA,9539,VITORINO FREIRE,11100,2549,4544,20645,16101,352,1360
MA,9555,BOM JARDIM,11861,3427,5738,23856,18118,399,1404
MA,9571,SANTA INÊS,27227,7767,9677,49452,39775,631,2719
MA,9598,PAULO RAMOS,7301,1669,2515,13295,10780,295,1131
MA,9610,AÇAILÂNDIA,26489,16207,13107,61029,47922,879,2355
MA,9636,ESTREITO,8311,4057,3330,17205,13875,228,728
MA,9652,SANTA LUZIA DO PARUÁ,7762,2272,2870,14345,11475,175,936
MA,9679,ARAME,7692,4258,3591,17475,13884,232,1159
MA,9695,MIRANDA DO NORTE,7309,791,3024,12133,9109,105,691
MA,9717,ZÉ DOCA,15703,3630,7289,29322,22033,276,1705
MG,40002,ALFREDO VASCONCELOS,2097,1187,457,4224,3767,107,162
MG,40010,ABADIA DOS DOURADOS,1880,2107,666,5293,4627,164,244
MG,40029,ARAPORÃ,1858,1668,594,4618,4024,70,134
MG,40037,ABAETÉ,4691,7621,3464,17615,14151,530,501
MG,40045,BRASILÂNDIA DE MINAS,3221,2991,1732,8571,6839,130,284
MG,40053,ABRE CAMPO,3842,3432,2002,10533,8531,321,583
MG,40061,CAPITÃO ANDRADE,1438,986,771,3590,2819,66,235
MG,40070,ACAIACA,1400,809,809,3335,2526,71,149
MG,40088,CARNEIRINHO,3342,2638,1489,7895,6406,85,170
MG,40096,AÇUCENA,3564,1373,2757,8772,6015,301,545
MG,40100,CATUJI,2660,1471,1579,6503,4924,135,474
MG,40118,ÁGUA BOA,4404,2137,3480,11258,7778,170,798
MG,40126,DIVISA ALEGRE,1451,1270,953,4131,3178,55,291
MG,40134,ÁGUA COMPRIDA,403,938,360,1900,1540,51,71
MG,40142,DIVISÓPOLIS,2071,1757,1393,5779,4386,67,370
MG,40150,AGUANIL,1407,792,388,2959,2571,124,144
MG,40169,DURANDÉ,2061,1526,1174,5305,4131,115,237
MG,40177,ÁGUAS FORMOSAS,5735,2699,3804,13636,9832,198,804
MG,40185,ENTRE FOLHAS,2454,801,668,4435,3767,107,266
MG,40193,ÁGUAS VERMELHAS,2628,2708,2671,9107,6436,265,632
MG,40207,FERVEDOURO,3122,1949,1398,7261,5863,193,358
MG,40215,AIMORÉS,7459,5838,5076,20056,14980,430,660
MG,40223,FRANCISCÓPOLIS,1622,599,1441,4204,2763,50,394
MG,40231,AIURUOCA,1395,1822,1036,4867,3831,131,294
MG,40240,ICARAÍ DE MINAS,2731,1970,2148,7311,5163,55,299
MG,40258,ALAGOA,601,1067,440,2339,1899,63,82
MG,40266,IPABA,5810,1911,2364,10914,8550,138,356
MG,40274,ALBERTINA,571,1068,435,2292,1857,36,126
MG,40282,JAÍBA,7503,5379,3852,18299,14447,300,797
MG,40290,ALÉM PARAÍBA,13069,5883,5323,27734,22411,534,837
MG,40304,JAMPRUCA,1910,617,1029,3975,2946,80,272
MG,40312,ALFENAS,13836,21585,9023,50575,41552,1618,1571
MG,40320,JUATUBA,5706,3094,2042,12757,10715,437,608
MG,40339,ALMENARA,12024,4571,7455,26867,19412,382,1550
MG,40347,LAGOA GRANDE,2090,2147,1172,5836,4664,91,236
MG,40355,ALPERCATA,2459,1179,920,5046,4126,92,231
MG,40363,LIMEIRA DO OESTE,2380,1383,937,5086,4149,67,133
MG,40371,ALPINÓPOLIS,5101,4595,2220,13523,11303,426,527
MG,40380,LONTRA,3289,924,1735,6632,4897,125,434
MG,40398,ALTEROSA,2963,4857,1534,10161,8627,245,343
MG,40401,MAMONAS,1718,1711,792,4631,3839,98,243
MG,40410,ALTO RIO DOCE,3462,3184,3337,11205,7868,242,577
MG,40428,MATA VERDE,2011,1449,1401,5540,4139,56,481
MG,40436,ALVARENGA,1668,1215,734,3893,3159,51,176
MG,40444,MATIAS CARDOSO,2655,1341,1716,6260,4544,91,288
MG,40452,ALVINÓPOLIS,6047,2538,2421,12519,10098,317,726
MG,40460,MONTEZUMA,1753,974,1474,4784,3310,47,394
MG,40479,ALVORADA DE MINAS,1365,376,1024,3163,2139,65,224
MG,40487,NAQUE,2142,842,999,4438,3439,119,241
MG,40495,AMPARO DO SERRA,2064,938,1012,4525,3513,100,258
MG,40509,NOVO ORIENTE DE MINAS,3120,1458,2765,8226,5461,115,568
MG,40517,ANDRADAS,5565,13458,3446,25278,21832,956,993
MG,40525,PALMÓPOLIS,2011,1287,1935,6038,4103,99,569
MG,40533,CACHOEIRA DE PAJEÚ,2739,1715,1748,7021,5273,140,537
MG,40541,PEDRAS DE MARIA DA CRUZ,3528,699,1799,6567,4768,75,360
MG,40550,ANDRELÂNDIA,2550,3957,1720,9315,7595,219,409
MG,40568,PERIQUITO,2687,1035,1452,5687,4235,103,281
MG,40576,ANTÔNIO CARLOS,4304,2131,1444,8997,7553,316,385
MG,40584,PONTO DOS VOLANTES,2143,2339,1729,7144,5415,102,641
MG,40592,ANTÔNIO DIAS,3233,2259,1651,8091,6440,245,363
MG,40606,RIACHINHO,2252,1259,1157,5088,3931,69,275
MG,40614,ANTÔNIO PRADO DE MINAS,617,592,191,1543,1352,23,54
MG,40622,ROSÁRIO DA LIMEIRA,1773,1345,554,4142,3588,88,210
MG,40630,ARAÇAÍ,766,763,409,2221,1812,43,97
MG,40649,SANTA BÁRBARA DO LESTE,3016,1490,1134,6369,5235,155,370
MG,40657,ARACITABA,737,564,263,1820,1557,41,113
MG,40665,SANTA RITA DE MINAS,2181,1077,769,4491,3722,116,212
MG,40673,ARAÇUAÍ,8306,7106,8509,26022,17513,413,1100
MG,40681,SANTANA DO PARAÍSO,6077,2533,2302,11973,9671,194,514
MG,40690,ARAGUARI,21684,33162,12327,78603,66276,1947,2644
MG,40703,SÃO JOÃO DA LAGOA,1567,819,802,3573,2771,65,197
MG,40711,ARANTINA,1026,682,441,2447,2006,52,89
MG,40720,SÃO JOÃO DO MANHUAÇU,2889,2352,1088,6834,5746,155,233
MG,40738,ARAPONGA,2441,1168,1172,5716,4544,232,500
MG,40746,SÃO JOÃO DO MANTENINHA,1906,1067,604,3879,3275,70,181
MG,40754,ARAPUÁ,414,1412,322,2529,2207,107,123
MG,40762,SÃO JOÃO DO PACUÍ,1702,449,808,3292,2484,52,204
MG,40770,ARAÚJOS,960,2881,759,5147,4388,195,178
MG,40789,SÃO JOSÉ DA LAPA,6310,3410,1783,13367,11584,402,439
MG,40797,ARAXÁ,17197,29328,9383,64723,55340,1830,2658
MG,40800,SARZEDO,5070,3350,1535,11831,10296,479,484
MG,40819,ARCEBURGO,1507,3329,1264,6786,5522,198,318
MG,40827,SEM PEIXE,1141,857,511,2881,2370,92,168
MG,40835,ARCOS,8873,9375,3613,26237,22624,1345,1270
MG,40843,SENADOR AMARAL,1846,1340,856,4367,3511,92,119
MG,40851,AREADO,2951,4906,1696,10426,8730,247,322
MG,40860,UBAPORANGA,3007,2703,2084,8670,6586,198,390
MG,40878,ARGIRITA,1452,582,452,2786,2334,54,88
MG,40886,URUCUIA,2551,1518,1361,5821,4460,44,266
MG,40894,ARINOS,4689,3478,3122,12485,9363,182,738
MG,40908,VARGEM ALEGRE,2688,1033,1465,5722,4257,93,299
MG,40916,ASTOLFO DUTRA,4190,3097,1373,9549,8176,201,385
MG,40924,JOSENÓPOLIS,1591,371,990,3295,2305,20,264
MG,40932,ATALÉIA,5175,1674,4057,11942,7885,144,627
MG,40940,JUVENÍLIA,2129,1097,1335,4968,3633,73,266
MG,40959,AUGUSTO DE LIMA,1689,1018,952,4007,3055,87,154
MG,40967,LEME DO PRADO,1175,926,1171,3574,2403,35,181
MG,40975,BAEPENDI,4142,6335,2151,14304,12153,378,620
MG,40983,LUISBURGO,1167,2095,802,4496,3694,122,207
MG,40991,BALDIM,2892,1607,1672,6831,5159,155,225
MG,41009,LUISLÂNDIA,2530,539,1464,4987,3523,90,285
MG,41017,BAMBUÍ,4589,7504,3548,17700,14152,553,690
MG,41025,MÁRIO CAMPOS,3206,2062,1211,7545,6334,322,325
MG,41033,BANDEIRA,1671,787,810,3731,2921,64,286
MG,41041,MARTINS SOARES,2153,1414,861,4924,4063,104,240
MG,41050,BANDEIRA DO SUL,1385,1920,769,4481,3712,150,160
MG,41068,MIRAVÂNIA,1625,635,946,3445,2499,31,175
MG,41076,BARÃO DE COCAIS,9530,4130,2755,18974,16219,699,798
MG,41084,MONTE FORMOSO,1511,802,965,3598,2633,28,226
MG,41092,BARÃO DE MONTE ALTO,1722,1737,1131,5251,4120,100,342
MG,41106,NATALÂNDIA,1245,719,508,2668,2160,32,92
MG,41114,BARBACENA,39755,22237,12202,87811,75609,2489,4465
MG,41122,NINHEIRA,1481,2373,1949,6664,4715,177,548
MG,41130,BARRA LONGA,2042,1512,893,5180,4287,157,382
MG,41149,NOVA BELÉM,1249,750,1165,3526,2361,62,221
MG,41157,TRÊS MARIAS,7818,5847,4006,19559,15553,435,609
MG,41165,NOVA PORTEIRINHA,2957,1116,1016,5533,4517,93,256
MG,41173,BARROSO,7296,3537,2257,15272,13015,619,759
MG,41181,NOVORIZONTE,1601,995,1144,4156,3012,40,305
MG,41190,BELA VISTA DE MINAS,4570,1325,1584,8255,6671,171,303
MG,41203,OLHOS D'ÁGUA,2051,628,1024,4092,3068,60,231
MG,41211,BELMIRO BRAGA,1191,933,289,2727,2438,38,104
MG,41220,ORATÓRIOS,1904,788,780,3838,3058,69,185
MG,41238,BELO HORIZONTE,588898,521072,276369,1742843,1466474,58821,85288
MG,41246,ORIZÂNIA,2519,1247,960,5182,4222,84,252
MG,41254,BELO ORIENTE,8430,2855,3189,16161,12972,401,698
MG,41262,PADRE CARVALHO,1553,854,1224,4045,2821,37,303
MG,41270,BELO VALE,2765,2082,1003,6732,5729,296,285
MG,41289,PAI PEDRO,2296,477,1372,4617,3245,59,345
MG,41297,BERILO,3359,1714,3300,9358,6058,151,628
MG,41300,PATIS,2238,811,1339,4565,3226,37,80
MG,41319,BERTÓPOLIS,1385,605,542,2971,2429,105,241
MG,41327,PEDRA BONITA,1883,1594,738,4628,3890,69,255
MG,41335,BETIM,102075,51167,29662,212206,182544,6373,8227
MG,41343,PIEDADE DE CARATINGA,2300,1252,1277,5288,4011,107,255
MG,41351,BIAS FORTES,1606,1008,537,3552,3015,77,162
MG,41360,PINGO D'ÁGUA,1645,679,477,3135,2658,42,215
MG,41378,BICAS,3765,3253,1869,10786,8917,205,651
MG,41386,PINTÓPOLIS,2584,930,1460,5329,3869,75,207
MG,41394,BIQUINHAS,711,889,400,2293,1893,113,106
MG,41408,PONTO CHIQUE,1303,786,766,3137,2371,46,184
MG,41416,BOA ESPERANÇA,10517,9775,5377,28122,22745,715,797
MG,41424,REDUTO,1852,1393,865,4542,3677,70,185
MG,41432,BOCAINA DE MINAS,896,1886,642,4016,3374,109,251
MG,41440,SANTA BÁRBARA DO MONTE VERDE,1100,663,372,2503,2131,44,133
MG,41459,BOCAIÚVA,15789,5157,7255,31736,24481,699,1637
MG,41467,SANTA CRUZ DE MINAS,2061,2049,713,5681,4968,204,240
MG,41475,BOM DESPACHO,9075,13858,5172,32621,27449,1149,998
MG,41483,SANTA CRUZ DE SALINAS,1913,461,1006,3843,2837,58,335
MG,41491,BOM JARDIM DE MINAS,2031,1689,803,5151,4348,151,253
MG,41505,SANTA HELENA DE MINAS,1558,1286,1431,4738,3307,64,314
MG,41513,BOM JESUS DA PENHA,803,1312,431,2872,2441,91,124
MG,41521,SANTO ANTÔNIO DO RETIRO,2109,946,1117,4916,3799,110,499
MG,41530,BOM JESUS DO AMPARO,1669,1271,829,4391,3562,133,274
MG,41548,SÃO DOMINGOS DAS DORES,1325,1478,802,4013,3211,87,163
MG,41556,BOM JESUS DO GALHO,4942,3469,3094,12649,9555,247,621
MG,41564,SÃO FÉLIX DE MINAS,1318,540,457,2511,2054,49,102
MG,41572,BOM REPOUSO,2508,3132,1056,7373,6317,202,296
MG,41580,SÃO GERALDO DO BAIXIO,1108,611,429,2364,1935,56,112
MG,41599,BOM SUCESSO,3640,5892,2631,13919,11288,564,590
MG,41602,SÃO JOÃO DAS MISSÕES,2802,1017,1548,6114,4566,115,469
MG,41610,BONFIM,2088,2038,685,5705,5020,352,286
MG,41629,SÃO JOAQUIM DE BICAS,6756,2706,2340,13404,11064,458,584
MG,41637,BONFINÓPOLIS DE MINAS,1809,1624,1317,5044,3727,51,119
MG,41645,SÃO JOSÉ DA BARRA,2227,1592,1059,5446,4387,162,155
MG,41653,BORDA DA MATA,3549,5003,1747,11834,10087,383,629
MG,41661,ALTO CAPARAÓ,782,1816,676,3608,2932,81,126
MG,41670,BOTELHOS,4198,4305,2448,11947,9499,262,402
MG,41688,ANGELÂNDIA,1571,1884,1580,5672,4092,114,336
MG,41696,BOTUMIRIM,2243,785,1398,4875,3477,56,238
MG,41700,ARICANDUVA,1189,1220,889,3737,2848,110,243
MG,41718,BRASÍLIA DE MINAS,11852,3311,6575,23695,17120,384,960
MG,41726,BERIZAL,1638,796,781,3574,2793,29,234
MG,41734,BRÁS PIRES,1395,1048,884,3693,2809,91,168
MG,41742,BONITO DE MINAS,2965,673,1525,5720,4195,49,399
MG,41750,BRAÚNAS,1638,769,774,3811,3037,155,360
MG,41769,BUGRE,1245,1177,611,3454,2843,81,223
MG,41777,BRASÓPOLIS,2409,6162,2354,12001,9647,247,385
MG,41785,CABECEIRA GRANDE,1626,1519,875,4482,3607,101,232
MG,41793,BRUMADINHO,8059,6330,2859,20487,17628,788,911
MG,41807,CAMPO AZUL,1591,619,548,3012,2464,40,160
MG,41815,BUENO BRANDÃO,1695,4050,1396,8129,6733,346,349
MG,41823,CANTAGALO,970,999,920,3316,2396,67,248
MG,41831,BUENÓPOLIS,2565,1897,2737,7925,5188,225,320
MG,41840,CATAS ALTAS,1547,1059,531,3551,3020,85,168
MG,41858,BURITIS,4302,5891,3554,15058,11504,259,615
MG,41866,CATUTI,2000,689,1391,4572,3181,72,329
MG,41874,BURITIZEIRO,7854,4019,4680,18372,13692,360,778
MG,41882,CHAPADA GAÚCHA,2792,1338,1687,6340,4653,57,354
MG,41890,CABO VERDE,3379,3583,1701,9489,7788,240,347
MG,41904,CÔNEGO MARINHO,2412,948,1656,5574,3918,63,368
MG,41912,CACHOEIRA DA PRATA,1031,1169,414,3180,2766,107,115
MG,41920,CONFINS,1945,1114,333,4024,3691,143,174
MG,41939,CACHOEIRA DE MINAS,2283,3968,1210,8247,7037,223,237
MG,41947,CÓRREGO FUNDO,1588,1544,470,4299,3829,177,176
MG,41955,CACHOEIRA DOURADA,889,575,612,2247,1635,21,95
MG,41963,CRISÓLITA,2005,860,1381,4694,3313,47,307
MG,41971,CAETANÓPOLIS,2168,2369,1017,6661,5644,262,385
MG,41980,CUPARAQUE,1130,1195,642,3248,2606,58,175
MG,41998,CAETÉ,12723,7601,4920,29640,24720,1044,1286
MG,42005,CURRAL DE DENTRO,2176,1160,1228,5176,3948,62,483
MG,42013,CAIANA,1719,953,669,3742,3073,96,160
MG,42021,DELTA,2059,666,525,3600,3075,109,111
MG,42030,CAJURI,1775,946,659,3859,3200,119,191
MG,42048,DOM BOSCO,918,1215,528,2838,2310,19,92
MG,42056,CALDAS,2529,4999,1203,9735,8532,227,418
MG,42064,FREI LAGONEGRO,1050,689,427,2566,2139,40,306
MG,42072,CAMACHO,1041,1182,468,3031,2563,115,146
MG,42080,FRUTA DE LEITE,2119,419,1714,4827,3113,59,435
MG,42099,CAMANDUCAIA,4394,5801,2547,14499,11952,569,659
MG,42102,GAMELEIRAS,1370,1317,1316,4433,3117,53,297
MG,42110,CAMBUÍ,5245,7885,3108,18337,15229,442,712
MG,42129,GLAUCILÂNDIA,1539,573,396,2760,2364,52,125
MG,42137,CAMBUQUIRA,2055,4431,1627,9341,7714,220,439
MG,42145,GOIABEIRA,1047,708,338,2339,2001,44,148
MG,42153,CAMPANÁRIO,1400,571,630,2902,2272,34,195
MG,42161,GOIANÁ,1206,895,487,3064,2577,80,158
MG,42170,CAMPANHA,2042,5495,1918,10757,8839,291,400
MG,42188,GUARACIAMA,2881,614,674,4610,3936,65,255
MG,42196,CAMPESTRE,3441,7710,2682,15317,12635,489,540
MG,42200,IBIRACATU,2122,961,1348,5050,3702,70,409
MG,42218,CAMPINA VERDE,4559,6071,3399,14945,11546,156,382
MG,42226,IMBÉ DE MINAS,2056,1262,1224,5005,3781,53,331
MG,42234,CAMPO BELO,14847,11287,6652,37437,30785,1315,1893
MG,42242,INDAIABIRA,1396,1752,1348,5089,3741,65,378
MG,42250,CAMPO DO MEIO,3948,2509,1772,9137,7365,252,347
MG,42269,JAPONVAR,3331,820,1790,6603,4813,148,373
MG,42277,CAMPO FLORIDO,1061,1698,465,3442,2977,43,62
MG,42285,JENIPAPO DE MINAS,1178,1275,2070,4913,2843,51,251
MG,42293,CAMPOS ALTOS,2666,4209,1866,9584,7718,266,294
MG,42307,JOSÉ GONÇALVES DE MINAS,1007,1028,996,3378,2382,32,220
MG,42315,CAMPOS GERAIS,6711,6918,3766,19581,15815,640,828
MG,42323,JOSÉ RAYDAN,1370,636,858,3302,2444,69,274
MG,42331,CANAÃ,1723,1002,361,3648,3287,118,260
MG,42340,SÃO SEBASTIÃO DA VARGEM ALEGRE,999,721,287,2284,1997,43,122
MG,42358,CANÁPOLIS,4077,2108,1348,8128,6780,114,272
MG,42366,SÃO SEBASTIÃO DO ANTA,1500,1369,905,4146,3241,80,226
MG,42374,CANA VERDE,2018,1335,839,4650,3811,139,203
MG,42382,SERRANÓPOLIS DE MINAS,1305,890,546,3121,2575,86,231
MG,42390,CANDEIAS,3621,4317,1869,11389,9520,571,591
MG,42404,SETUBINHA,2185,1560,1990,6788,4798,125,679
MG,42412,CAPARAÓ,1284,1575,625,3841,3216,49,153
MG,42420,TAPARUBA,806,1070,554,2800,2246,92,173
MG,42439,CAPELA NOVA,1202,1501,638,4010,3372,246,209
MG,42447,UNIÃO DE MINAS,1497,1119,860,3665,2805,45,92
MG,42455,CAPELINHA,6624,6471,5799,21484,15685,525,1307
MG,42463,URUANA DE MINAS,1251,768,658,2903,2245,36,125
MG,42471,CAPETINGA,1844,2098,1274,5725,4451,131,237
MG,42480,VARGEM GRANDE DO RIO PARDO,1054,1252,764,3444,2680,29,264
MG,42498,CAPIM BRANCO,2672,1812,859,6051,5192,204,215
MG,42501,VARJÃO DE MINAS,975,2260,994,4555,3561,93,132
MG,42510,CAPINÓPOLIS,4383,4338,1651,11134,9483,175,341
MG,42528,VERDELÂNDIA,2489,999,1120,5135,4015,112,299
MG,42536,CAPITÃO ENÉAS,5280,1859,2496,10546,8050,155,480
MG,42544,VEREDINHA,1929,778,998,4138,3140,68,251
MG,42552,CAPITÓLIO,2312,2340,1272,6481,5209,152,193
MG,42560,VERMELHO NOVO,1626,1188,481,3714,3233,121,182
MG,42579,CAPUTIRA,2821,1902,1160,6755,5595,258,450
MG,42587,TOCOS DO MOJI,1136,1320,221,2974,2753,104,124
MG,42595,CARAÍ,5353,2012,4024,13181,9157,211,1195
MG,42617,CARANAÍBA,908,1180,357,2858,2501,129,161
MG,42633,CARANDAÍ,5992,6043,1968,17104,15136,1095,1003
MG,42650,CARANGOLA,10342,5905,4846,23856,19010,483,1115
MG,42676,CARATINGA,24818,14202,11673,57538,45865,1469,2444
MG,42692,CARBONITA,2803,1904,1924,7082,5158,114,193
MG,42714,CAREAÇU,1230,2001,849,4502,3653,109,161
MG,42730,CARLOS CHAGAS,5798,4398,4791,16478,11687,273,776
MG,42757,CARMÉSIA,901,394,265,1743,1478,33,97
MG,42773,CARMO DA CACHOEIRA,3574,2497,1619,8645,7026,270,378
MG,42790,CARMO DA MATA,2437,3430,900,7983,7083,280,506
MG,42811,CARMO DE MINAS,1847,4344,1310,8514,7204,237,351
MG,42838,CARMO DO CAJURU,5054,5189,1975,14303,12328,556,562
MG,42854,CARMO DO PARANAÍBA,4901,9600,4249,21116,16867,811,913
MG,42870,CARMO DO RIO CLARO,5032,5402,2689,14542,11853,301,440
MG,42897,CARMÓPOLIS DE MINAS,3710,4647,1652,11238,9586,306,536
MG,42919,CARRANCAS,780,1540,433,3030,2597,42,130
MG,42935,CARVALHÓPOLIS,794,1153,402,2617,2215,52,113
MG,42951,CARVALHOS,963,1612,545,3608,3063,114,234
MG,42978,CASA GRANDE,677,777,285,2133,1848,97,122
MG,42994,CASCALHO RICO,693,1020,325,2233,1908,12,78
MG,43010,CÁSSIA,4259,5001,2519,13082,10563,305,526
MG,43036,CONCEIÇÃO DA BARRA DE MINAS,985,1331,575,3298,2723,82,176
MG,43052,CATAGUASES,25896,9974,7879,50247,42368,1224,2123
MG,43079,CATAS ALTAS DA NORUEGA,1122,882,408,2815,2407,124,154
MG,43095,CAXAMBU,4721,6928,3457,17298,13841,400,667
MG,43117,CEDRO DO ABAETÉ,250,519,216,1096,880,28,62
MG,43133,CENTRAL DE MINAS,2168,1606,1088,5361,4273,106,262
MG,43150,CENTRALINA,3301,1857,1643,7377,5734,117,234
MG,43176,CHÁCARA,802,602,188,1823,1635,38,58
MG,43192,CHALÉ,1599,1520,1118,4738,3620,137,235
MG,43214,CHAPADA DO NORTE,3114,1673,3863,9485,5622,109,557
MG,43230,CHIADOR,1061,770,320,2452,2132,38,114
MG,43257,CIPOTÂNEA,1781,1202,1126,4859,3733,309,324
MG,43273,CLARAVAL,707,2313,624,3870,3246,41,101
MG,43290,CLARO DOS POÇÕES,2981,1529,1397,6600,5203,143,275
MG,43311,CLÁUDIO,5174,7440,2043,16773,14730,742,627
MG,43338,COIMBRA,1943,2053,807,5578,4771,189,316
MG,43354,COLUNA,2231,1656,1776,6502,4726,136,486
MG,43370,COMENDADOR GOMES,473,1274,412,2280,1868,28,30
MG,43397,COMERCINHO,2894,1249,1930,6767,4837,115,418
MG,43419,CONCEIÇÃO DA APARECIDA,2750,2584,1444,7402,5958,183,209
MG,43435,CONCEIÇÃO DAS PEDRAS,836,882,273,2268,1995,64,84
MG,43451,CONCEIÇÃO DAS ALAGOAS,5874,4758,3229,14848,11619,226,395
MG,43478,CONCEIÇÃO DE IPANEMA,1393,1252,619,3597,2978,67,192
MG,43494,CONCEIÇÃO DO MATO DENTRO,6053,2158,3926,13864,9938,270,1041
MG,43516,CONCEIÇÃO DO PARÁ,1533,1356,545,3958,3413,147,147
MG,43532,CONCEIÇÃO DO RIO VERDE,3274,3385,1771,9391,7620,246,415
MG,43559,CONCEIÇÃO DOS OUROS,1770,3694,1063,7202,6139,144,219
MG,43575,CONGONHAL,1432,3738,673,6561,5888,227,209
MG,43591,CONGONHAS,14844,9022,3584,32868,29284,1212,1511
MG,43613,CONGONHAS DO NORTE,1840,358,1018,3687,2669,57,349
MG,43630,CONQUISTA,1433,2197,643,4762,4119,107,189
MG,43656,CONSELHEIRO LAFAIETE,36575,20740,9463,80086,70623,2432,3705
MG,43672,CONSELHEIRO PENA,6626,4210,2998,15127,12129,330,504
MG,43699,CONSOLAÇÃO,400,758,186,1503,1317,32,62
MG,43710,CONTAGEM,180123,88832,53674,389262,335588,13086,18497
MG,43737,COQUEIRAL,2297,2724,1482,7123,5641,186,274
MG,43753,CORAÇÃO DE JESUS,9934,3152,4646,19530,14884,398,905
MG,43770,CORDISBURGO,2806,1622,1450,6571,5121,224,229
MG,43796,CORDISLÂNDIA,1093,895,585,2791,2206,32,132
MG,43818,CORINTO,7312,4919,4914,18859,13945,351,582
MG,43834,COROACI,2540,2417,2395,8270,5875,178,531
MG,43850,COROMANDEL,6447,8830,4137,21473,17336,542,704
MG,43877,CORONEL FABRICIANO,37132,14619,13431,73207,59776,1534,2129
MG,43893,CORONEL MURTA,3254,1375,1998,7277,5279,118,355
MG,43915,CORONEL PACHECO,1164,456,173,2210,2037,59,131
MG,43931,CORONEL XAVIER CHAVES,901,867,376,2536,2160,72,118
MG,43958,CÓRREGO DANTA,755,1224,509,2752,2243,52,116
MG,43974,CÓRREGO DO BOM JESUS,945,1421,443,3245,2802,100,157
MG,43990,CÓRREGO NOVO,1388,647,643,2962,2319,63,162
MG,44016,COUTO DE MAGALHÃES DE MINAS,1695,518,748,3305,2557,72,165
MG,44032,CRISTAIS,3118,2108,1141,7288,6147,294,441
MG,44059,CRISTÁLIA,1857,633,1124,4005,2881,32,289
MG,44075,CRISTIANO OTONI,1469,1386,484,3935,3451,169,215
MG,44091,CRISTINA,1641,3713,1525,7666,6141,177,324
MG,44113,CRUCILÂNDIA,1365,1514,643,4047,3404,185,168
MG,44130,CRUZEIRO DA FORTALEZA,1032,1350,616,3247,2631,71,70
MG,44156,CRUZÍLIA,3232,4731,1725,10672,8947,232,396
MG,44172,CURVELO,20860,14023,9827,49667,39840,1141,1703
MG,44199,DATAS,2021,601,1059,4079,3020,90,217
MG,44210,DELFIM MOREIRA,1625,2964,1138,6319,5181,157,168
MG,44237,DELFINÓPOLIS,1547,1944,770,4678,3908,97,167
MG,44253,DESCOBERTO,1257,1587,485,3941,3456,112,190
MG,44270,DESTERRO DE ENTRE RIOS,1535,2384,1082,5707,4625,310,239
MG,44296,DESTERRO DO MELO,746,1419,312,2811,2499,65,155
MG,44318,DIAMANTINA,14133,7150,7019,31973,24954,667,1556
MG,44334,DIOGO DE VASCONCELOS,1373,722,658,3237,2579,79,287
MG,44350,DIONÍSIO,3326,1442,2013,7513,5500,176,298
MG,44377,DIVINÉSIA,1344,973,386,3047,2661,43,168
MG,44393,DIVINO,5689,3723,2972,13614,10642,263,606
MG,44415,DIVINO DAS LARANJEIRAS,1320,1230,753,3821,3068,84,314
MG,44431,DIVINOLÂNDIA DE MINAS,1724,1327,1411,5082,3671,123,352
MG,44458,DIVINÓPOLIS,56292,43379,17171,143843,126672,6137,6978
MG,44474,DIVISA NOVA,1718,1366,754,4233,3479,91,177
MG,44490,DOM CAVATI,1594,1481,557,3944,3387,71,152
MG,44512,DOM JOAQUIM,1415,734,622,3312,2690,92,324
MG,44539,DOM SILVÉRIO,1542,1532,673,4352,3679,154,238
MG,44555,DOM VIÇOSO,679,1112,253,2287,2034,67,82
MG,44571,DONA EUSÉBIA,2198,1334,660,4745,4085,153,194
MG,44598,DORES DE CAMPOS,2031,2580,676,6687,6011,462,418
MG,44610,DORES DE GUANHÃES,1951,1003,887,4310,3423,59,288
MG,44636,DORES DO INDAIÁ,2925,4725,1920,10753,8833,300,434
MG,44652,DORES DO TURVO,1567,1171,825,4009,3184,116,200
MG,44679,DORESÓPOLIS,467,532,236,1396,1160,43,58
MG,44695,DOURADOQUARA,736,589,226,1658,1432,25,28
MG,44717,ELÓI MENDES,5229,7427,2246,16575,14329,458,499
MG,44733,ENGENHEIRO CALDAS,2880,1792,1547,6824,5277,151,300
MG,44750,ENGENHEIRO NAVARRO,3087,860,910,5455,4545,71,375
MG,44776,ENTRE RIOS DE MINAS,4169,3458,2082,11055,8973,402,407
MG,44792,ERVÁLIA,5609,4327,3025,14994,11969,451,955
MG,44814,ESMERALDAS,13899,7679,5670,30978,25308,945,1244
MG,44830,ESPERA FELIZ,7253,4080,3261,16179,12918,338,694
MG,44857,ESPINOSA,7306,6613,7988,24211,16223,499,1217
MG,44873,ESPÍRITO SANTO DO DOURADO,1158,1545,287,3453,3166,133,208
MG,44890,ESTIVA,2451,3537,1087,7928,6841,246,287
MG,44911,ESTRELA DALVA,1073,440,460,2255,1795,38,148
MG,44938,ESTRELA DO INDAIÁ,890,1094,466,2729,2263,78,91
MG,44954,ESTRELA DO SUL,1946,1767,620,4838,4218,126,227
MG,44970,EUGENÓPOLIS,3477,2196,899,7472,6573,209,345
MG,44997,EWBANK DA CÂMARA,1688,599,537,3156,2619,56,131
MG,45012,EXTREMA,5441,7368,2864,17912,15048,531,669
MG,45039,FAMA,694,911,338,2170,1832,46,82
MG,45055,FARIA LEMOS,1365,743,480,2972,2492,50,149
MG,45071,FELÍCIO DOS SANTOS,1606,965,1329,4339,3010,90,248
MG,45098,SÃO GONÇALO DO RIO PRETO,1028,589,521,2501,1980,72,219
MG,45110,FELISBURGO,1897,1093,1405,4845,3440,42,321
MG,45136,FELIXLÂNDIA,3918,3099,2229,10448,8219,328,443
MG,45152,FERNANDES TOURINHO,916,760,461,2323,1862,23,109
MG,45179,FERROS,3508,2231,2730,9656,6926,234,652
MG,45195,FLORESTAL,1876,1530,725,4760,4035,179,193
MG,45217,FORMIGA,14345,20693,7326,49699,42373,1840,2172
MG,45233,FORMOSO,1671,1564,1406,5007,3601,50,235
MG,45250,FORTALEZA DE MINAS,714,1259,416,2904,2488,211,181
MG,45276,FORTUNA DE MINAS,853,709,360,2193,1833,47,92
MG,45292,FRANCISCO BADARÓ,1700,2380,2750,7384,4634,112,310
MG,45314,FRANCISCO DUMONT,1228,1039,995,3789,2794,73,250
MG,45330,FRANCISCO SÁ,9549,2533,4571,18435,13864,301,995
MG,45357,FREI GASPAR,2120,725,1102,4546,3444,69,386
MG,45373,FREI INOCÊNCIO,2958,1191,1642,6415,4773,104,392
MG,45390,FRONTEIRA,3251,2284,1226,7882,6656,221,256
MG,45411,FRUTAL,9984,15830,6492,35393,28901,785,810
MG,45438,FUNILÂNDIA,1233,917,510,3028,2518,52,123
MG,45454,GALILÉIA,2366,1135,963,4923,3960,131,235
MG,45470,GONÇALVES,673,1644,556,3212,2656,66,166
MG,45497,GONZAGA,1148,1371,1492,4577,3085,94,380
MG,45519,GOUVEIA,4343,1432,2248,9106,6858,281,575
MG,45535,GOVERNADOR VALADARES,77467,49200,42204,185247,143043,3171,4782
MG,45551,GRÃO MOGOL,3688,2457,2840,10108,7268,167,726
MG,45578,GRUPIARA,426,592,231,1364,1133,31,37
MG,45594,GUANHÃES,6046,6053,5764,20906,15142,660,1544
MG,45616,GUAPÉ,3226,3488,1848,9579,7731,379,378
MG,45632,GUARACIABA,2771,2612,1401,7810,6409,211,550
MG,45659,GUARANÉSIA,6127,3599,2162,13476,11314,418,649
MG,45675,GUARANI,2656,2165,1384,7206,5822,181,380
MG,45691,GUARARÁ,1176,1064,483,3237,2754,70,200
MG,45713,GUARDA-MOR,1286,1976,1154,4916,3762,117,181
MG,45730,GUAXUPÉ,12320,12016,6101,35187,29086,1230,1664
MG,45756,GUIDOVAL,3010,1507,1016,6256,5240,224,302
MG,45772,GUIMARÂNIA,1312,2480,1021,5394,4373,153,212
MG,45799,GUIRICEMA,3200,2096,1149,7377,6228,227,383
MG,45810,GURINHATÃ,1606,2332,1546,5880,4334,55,132
MG,45837,HELIODORA,1949,1400,652,4418,3766,122,182
MG,45853,IAPU,2861,2192,1754,7579,5825,182,342
MG,45870,IBERTIOGA,1957,1197,592,4229,3637,125,189
MG,45896,IBIÁ,4470,6876,3261,16469,13208,441,624
MG,45918,IBIAÍ,2962,774,1275,5410,4135,62,216
MG,45934,IBIRACI,1968,3728,918,7199,6281,135,254
MG,45950,IBIRITÉ,43796,16482,11600,83362,71762,2833,3330
MG,45977,IBITIÚRA DE MINAS,748,1310,308,2690,2382,115,141
MG,45993,IBITURUNA,567,1141,323,2186,1863,29,79
MG,46019,IGARAPÉ,9177,4879,3645,20300,16655,754,893
MG,46035,IGARATINGA,2409,1539,760,5515,4755,361,218
MG,46051,IGUATAMA,2134,2693,1355,6938,5583,157,257
MG,46078,IJACI,979,2382,641,4573,3932,150,209
MG,46094,ILICÍNEA,3024,2987,1322,7908,6586,233,201
MG,46116,INCONFIDENTES,1581,2540,593,5235,4642,188,159
MG,46132,INDIANÓPOLIS,1781,1389,796,4387,3591,94,135
MG,46159,INGAÍ,513,993,371,2100,1729,64,100
MG,46175,INHAPIM,7524,5577,3080,18030,14950,405,940
MG,46191,INHAÚMA,1887,1253,748,4293,3545,96,131
MG,46213,INIMUTABA,2179,1278,982,4904,3922,119,230
MG,46230,IPANEMA,4095,4905,3499,14030,10531,368,681
MG,46256,IPATINGA,72024,42739,28693,162969,134276,3628,4867
MG,46272,IPIAÇU,1220,1207,680,3473,2793,61,120
MG,46299,IPUIÚNA,2015,3440,963,7019,6056,150,269
MG,46310,IRAÍ DE MINAS,1653,1888,691,4645,3954,94,178
MG,46337,ITABIRA,31955,25043,10724,79453,68729,2007,3253
MG,46353,ITABIRINHA,3115,1897,1573,7345,5772,136,376
MG,46370,ITABIRITO,10324,11302,3636,31238,27602,1217,1336
MG,46396,ITACAMBIRA,2197,493,918,3958,3040,55,208
MG,46418,ITACARAMBI,6583,1259,3250,12133,8883,172,629
MG,46434,ITAGUARA,2802,3588,1383,9234,7851,603,457
MG,46450,ITAIPÉ,2698,1715,2199,7439,5240,102,526
MG,46477,ITAJUBÁ,14437,29242,10550,64768,54218,1585,2426
MG,46493,ITAMARANDIBA,8521,6045,4993,21547,16554,570,980
MG,46515,ITAMARATI DE MINAS,1604,918,462,3345,2883,79,174
MG,46531,ITAMBACURI,7467,3002,5384,17808,12424,265,1252
MG,46558,ITAMBÉ DO MATO DENTRO,837,607,317,2034,1717,52,142
MG,46574,ITAMOGI,2818,3113,1745,8656,6911,226,433
MG,46590,ITAMONTE,2949,4221,1369,9658,8289,260,381
MG,46612,ITANHANDU,2724,4865,1533,10494,8961,291,365
MG,46639,ITANHOMI,3558,2606,1879,8878,6999,216,424
MG,46655,ITAOBIM,4429,5255,4626,16108,11482,452,878
MG,46671,ITAPAGIPE,2728,4077,1696,9117,7421,124,185
MG,46698,ITAPECERICA,4894,6256,1816,15398,13582,620,959
MG,46710,ITAPEVA,1766,3022,1261,6756,5495,171,233
MG,46736,ITATIAIUÇU,2955,1732,1109,6740,5631,268,300
MG,46752,ITAÚNA,21577,21462,6635,59642,53007,2049,2583
MG,46779,ITAVERAVA,2032,1582,899,5167,4268,264,210
MG,46795,ITINGA,4622,1707,3093,10308,7215,121,606
MG,46817,ITUETA,1630,1851,781,4554,3773,86,101
MG,46833,ITUIUTABA,26734,24216,14370,70705,56335,1096,1617
MG,46850,ITUMIRIM,1255,2465,902,5217,4315,161,194
MG,46876,ITURAMA,11126,6841,4274,23772,19498,317,613
MG,46892,ITUTINGA,992,1233,635,3250,2615,101,142
MG,46914,JABOTICATUBAS,4668,3396,2348,11957,9609,278,666
MG,46930,JACINTO,2641,2899,3003,9675,6672,186,576
MG,46957,JACUÍ,741,3397,971,5771,4800,215,236
MG,46973,JACUTINGA,3618,8222,3107,16637,13530,356,581
MG,46990,JAGUARAÇU,1105,563,260,2200,1940,57,107
MG,47015,JANAÚBA,21964,8413,9245,43864,34619,945,1900
MG,47031,JANUÁRIA,20998,7652,12329,45120,32791,784,1995
MG,47058,JAPARAÍBA,815,1475,381,2938,2557,96,70
MG,47074,JECEABA,1899,1402,872,4731,3859,190,191
MG,47090,JEQUERI,4158,2420,2563,10701,8138,445,742
MG,47112,JEQUITAÍ,2932,1064,1863,6529,4666,161,329
MG,47139,JEQUITIBÁ,1509,1556,849,4434,3585,140,157
MG,47155,JEQUITINHONHA,7031,3465,4895,16997,12102,228,928
MG,47171,JESUÂNIA,1454,1370,662,3893,3231,69,219
MG,47198,JOAÍMA,4687,1869,2872,10650,7778,173,821
MG,47210,JOANÉSIA,1918,810,874,4273,3399,162,397
MG,47236,JOÃO MONLEVADE,22987,14999,9327,53785,44458,1420,1673
MG,47252,JOÃO PINHEIRO,11142,11897,6763,32353,25590,584,912
MG,47279,JOAQUIM FELÍCIO,1247,821,872,3307,2435,93,175
MG,47295,JORDÂNIA,2791,2149,1952,7547,5595,108,393
MG,47317,NOVA UNIÃO,2086,1124,1015,4806,3791,179,179
MG,47333,JUIZ DE FORA,152757,76091,49511,354929,305418,9953,21169
MG,47350,JURAMENTO,1662,664,483,3249,2766,79,214
MG,47376,JURUAIA,1560,2980,985,6196,5211,198,256
MG,47392,LADAINHA,4474,1825,3202,11031,7829,147,1104
MG,47414,LAGAMAR,1724,2642,852,5773,4921,97,256
MG,47430,LAGOA DA PRATA,9150,12477,4199,29255,25056,919,1006
MG,47457,LAGOA DOS PATOS,1407,1009,967,3670,2703,42,180
MG,47473,LAGOA DOURADA,2308,3606,1064,8343,7279,496,433
MG,47490,LAGOA FORMOSA,3147,6377,2585,13544,10959,610,427
MG,47511,LAGOA SANTA,10661,10648,4916,31430,26514,1170,1354
MG,47538,LAJINHA,4858,4466,2061,12920,10859,331,720
MG,47554,LAMBARI,5340,5309,2433,14787,12354,357,694
MG,47570,LAMIM,1214,889,466,3051,2585,176,201
MG,47597,LARANJAL,1928,2016,645,5273,4628,110,205
MG,47619,LASSANCE,2222,894,1141,4715,3574,70,254
MG,47635,LAVRAS,14826,27450,9379,62116,52737,2108,3293
MG,47651,LEANDRO FERREIRA,876,1071,354,2594,2240,90,95
MG,47678,LEOPOLDINA,16439,9823,6862,37685,30823,934,1162
MG,47694,LIBERDADE,1320,1736,600,4172,3572,120,173
MG,47716,LIMA DUARTE,5448,3061,2564,12784,10220,341,654
MG,47732,LUMINÁRIAS,1135,1800,560,3962,3402,150,169
MG,47759,LUZ,2964,6390,2838,13505,10667,403,450
MG,47775,MACHACALIS,2456,1107,1766,5884,4118,84,316
MG,47791,MACHADO,5944,13068,4132,26298,22166,851,1175
MG,47813,MADRE DE DEUS DE MINAS,1168,1711,785,4082,3297,81,135
MG,47830,MALACACHETA,5252,3056,4798,15331,10533,324,1489
MG,47856,MANGA,6640,2811,4052,14655,10603,194,594
MG,47872,MANHUAÇU,19618,15349,8518,49325,40807,1524,1879
MG,47899,MANHUMIRIM,5231,4996,3079,15259,12180,368,690
MG,47910,MANTENA,7418,6130,5995,21323,15328,434,850
MG,47937,MARAVILHAS,1914,2133,690,5144,4454,88,135
MG,47953,MAR DE ESPANHA,2486,3462,1431,8558,7127,205,471
MG,47970,MARIA DA FÉ,2808,5447,1624,11141,9517,298,367
MG,47996,MARIANA,15479,10033,5747,37629,31882,1573,2174
MG,48011,MARILAC,1558,680,677,3266,2589,69,223
MG,48038,MARIPÁ DE MINAS,1015,891,385,2661,2276,42,141
MG,48054,MARLIÉRIA,1601,754,433,3262,2829,112,166
MG,48070,MARMELÓPOLIS,1349,691,608,2856,2248,50,85
MG,48097,MARTINHO CAMPOS,2731,3302,1972,9354,7382,383,410
MG,48119,MATERLÂNDIA,1511,761,1171,3930,2759,116,291
MG,48135,MATEUS LEME,6865,4870,2831,17497,14666,827,1031
MG,48151,MATIAS BARBOSA,4404,2696,1399,9995,8596,255,432
MG,48178,MATIPÓ,4483,4144,2135,12243,10108,454,729
MG,48194,MATO VERDE,5158,1983,1591,9712,8121,219,521
MG,48216,MATOZINHOS,11404,6846,3732,25253,21521,811,999
MG,48232,MATUTINA,734,1276,559,2927,2368,75,191
MG,48259,MEDEIROS,484,1338,482,2565,2083,78,89
MG,48275,MEDINA,5860,3675,5965,17464,11499,395,1105
MG,48291,MENDES PIMENTEL,2301,1117,945,4949,4004,131,232
MG,48313,MERCÊS,3360,2029,1791,8178,6387,264,419
MG,48330,MESQUITA,2031,1160,1287,5065,3778,188,293
MG,48356,MINAS NOVAS,6994,3629,7782,20642,12860,445,1322
MG,48372,MINDURI,827,1365,491,3051,2560,53,146
MG,48399,MIRABELA,5261,1170,2710,9765,7055,112,251
MG,48410,MIRADOURO,3651,2255,1399,8293,6894,239,442
MG,48437,MIRAÍ,3397,3138,1453,9311,7858,244,553
MG,48453,MOEDA,1500,1271,602,3847,3245,110,162
MG,48470,MOEMA,1457,2646,1067,5666,4599,110,186
MG,48496,MONJOLOS,696,611,421,1922,1501,50,89
MG,48518,MONSENHOR PAULO,1563,2444,855,5526,4671,188,283
MG,48534,MONTALVÂNIA,4612,2821,3537,12298,8761,183,855
MG,48550,MONTE ALEGRE DE MINAS,4522,5400,3151,14428,11277,301,481
MG,48577,MONTE AZUL,7986,4139,5217,19122,13905,334,1063
MG,48593,MONTE BELO,3345,3782,1679,9966,8287,397,410
MG,48615,MONTE CARMELO,13281,10930,5662,33441,27779,906,1279
MG,48631,MONTE SANTO DE MINAS,3514,7319,3081,15802,12721,552,807
MG,48658,MONTES CLAROS,99155,50109,32650,214886,182236,5508,11020
MG,48674,MONTE SIÃO,1777,8822,2511,14667,12156,415,644
MG,48690,MORADA NOVA DE MINAS,2177,2140,1205,6095,4890,153,257
MG,48712,MORRO DA GARÇA,840,860,486,2379,1893,39,82
MG,48739,MORRO DO PILAR,995,989,323,2677,2354,43,241
MG,48755,MUNHOZ,1422,2559,882,5375,4493,105,263
MG,48771,MURIAÉ,30642,18845,12129,70471,58342,1601,2992
MG,48798,MUTUM,7428,6881,4823,21241,16418,525,1092
MG,48810,MUZAMBINHO,4465,7157,2743,16071,13328,523,432
MG,48836,NACIP RAYDAN,745,651,533,2136,1603,25,139
MG,48852,NANUQUE,11943,8086,8865,31465,22600,605,1130
MG,48879,NATÉRCIA,780,1995,582,3871,3289,187,169
MG,48895,NAZARENO,2247,1946,1111,5946,4835,153,250
MG,48917,NEPOMUCENO,5902,7489,3297,18903,15606,649,945
MG,48933,NOVA ERA,6981,3030,2671,14148,11477,292,537
MG,48950,NOVA LIMA,23073,13287,6061,51153,45092,1532,2186
MG,48976,NOVA MÓDICA,1463,645,661,3178,2517,35,316
MG,48992,NOVA PONTE,3372,2874,1284,8202,6918,134,244
MG,49018,NOVA RESENDE,3734,3939,1386,10199,8813,420,439
MG,49034,NOVA SERRANA,7363,15871,4678,32093,27415,1708,1110
MG,49050,NOVO CRUZEIRO,7597,3229,7829,20913,13084,352,1491
MG,49077,OLARIA,863,616,297,2054,1757,68,108
MG,49093,OLÍMPIO NORONHA,737,895,244,2102,1858,33,105
MG,49115,OLIVEIRA,8534,11604,4249,28798,24549,927,1317
MG,49131,OLIVEIRA FORTES,875,330,184,1687,1503,84,114
MG,49158,ONÇA DE PITANGUI,832,1114,429,2617,2188,62,85
MG,49174,OURO BRANCO,10106,6849,3383,23978,20595,673,948
MG,49190,OURO FINO,4385,12241,3653,22752,19099,647,813
MG,49212,OURO PRETO,23467,12812,7609,52441,44832,1797,2619
MG,49239,OURO VERDE DE MINAS,1981,1326,1139,5110,3971,86,405
MG,49255,PADRE PARAÍSO,4831,3561,4151,14017,9866,216,882
MG,49271,PAINEIRAS,1379,1499,848,4139,3291,129,140
MG,49298,PAINS,1605,3180,669,6019,5350,116,218
MG,49310,PAIVA,755,258,158,1396,1238,45,74
MG,49336,PALMA,2156,1490,757,4989,4232,125,226
MG,49352,FRONTEIRA DOS VALES,1726,863,1231,4206,2975,73,228
MG,49379,PAPAGAIOS,4638,2989,1257,9764,8507,265,312
MG,49395,PARACATU,16542,23704,8822,53837,45015,1352,1470
MG,49417,PARÁ DE MINAS,15156,23290,6585,54135,47550,2189,2724
MG,49433,PARAGUAÇU,4526,6891,2265,14924,12659,338,400
MG,49450,PARAISÓPOLIS,2977,7446,2216,14342,12126,367,499
MG,49476,PARAOPEBA,6681,4748,2456,15698,13242,526,612
MG,49492,PASSABÉM,521,526,268,1505,1237,34,101
MG,49514,PASSA QUATRO,4295,4201,1766,11784,10018,319,530
MG,49530,PASSA TEMPO,2259,2238,1368,6814,5446,287,343
MG,49557,PASSA VINTE,582,728,187,1746,1559,39,78
MG,49573,PASSOS,29335,23435,11393,71791,60398,1714,2080
MG,49590,PATOS DE MINAS,24311,44453,16401,95320,78919,2532,2829
MG,49611,PATROCÍNIO,17072,20675,8965,54733,45768,2014,2605
MG,49638,PATROCÍNIO DO MURIAÉ,1539,1453,597,4095,3498,86,192
MG,49654,PAULA CÂNDIDO,3007,1696,1355,6950,5595,157,407
MG,49670,PAULISTAS,1523,994,812,3746,2934,67,253
MG,49697,PAVÃO,2521,1579,1194,5946,4752,88,395
MG,49719,PEÇANHA,3702,3481,4091,12722,8631,304,791
MG,49735,PEDRA AZUL,7510,3672,5179,18413,13234,276,1270
MG,49751,PEDRA DO ANTA,1331,914,649,3331,2682,103,222
MG,49778,PEDRA DO INDAIÁ,825,1589,370,3141,2771,115,137
MG,49794,PEDRA DOURADA,836,439,224,1667,1443,22,61
MG,49816,PEDRALVA,2328,3975,1562,8851,7289,265,312
MG,49832,PEDRINÓPOLIS,736,1330,405,2716,2311,59,93
MG,49859,PEDRO LEOPOLDO,16284,12337,4808,39855,35047,1336,1877
MG,49875,PEDRO TEIXEIRA,805,470,194,1675,1481,34,62
MG,49891,PEQUERI,850,951,403,2612,2209,43,125
MG,49913,PEQUI,1056,1122,347,2959,2612,66,160
MG,49930,PERDIGÃO,1034,2602,794,5197,4403,237,279
MG,49956,PERDIZES,2061,4632,2270,9682,7412,168,281
MG,49972,PERDÕES,5319,5117,2206,14751,12545,645,794
MG,49999,PESCADOR,1533,577,715,3141,2426,34,209
MG,50016,PIAU,1140,815,316,2685,2369,109,114
MG,50032,PIEDADE DE PONTE NOVA,1537,785,430,3132,2702,81,179
MG,50059,PIEDADE DO RIO GRANDE,1203,1258,852,3986,3134,132,266
MG,50075,PIEDADE DOS GERAIS,1200,1529,511,3699,3188,191,140
MG,50091,PIMENTA,1644,2575,927,5954,5027,363,243
MG,50113,PIRACEMA,2050,1760,506,5126,4620,277,289
MG,50130,PIRAJUBA,993,1116,550,2833,2283,50,78
MG,50156,PIRANGA,4076,3541,3563,13213,9650,444,1049
MG,50172,PIRANGUÇU,956,2075,722,4116,3394,82,161
MG,50199,PIRANGUINHO,1961,2448,876,5859,4983,116,211
MG,50210,PIRAPETINGA,4469,2119,1361,8948,7587,245,427
MG,50237,PIRAPORA,14378,8516,8078,35941,27863,905,1444
MG,50253,PIRAÚBA,3686,2542,1427,8451,7024,166,357
MG,50270,PITANGUI,5602,7159,2925,18288,15363,545,688
MG,50296,PIUMHI,7115,8590,4021,22577,18556,770,997
MG,50318,PLANURA,2676,2264,1444,6989,5545,145,194
MG,50334,POÇO FUNDO,3382,5343,1757,11802,10045,532,392
MG,50350,POÇOS DE CALDAS,27956,44841,16041,100865,84824,2307,3929
MG,50377,POCRANE,2614,2411,1300,7006,5706,159,371
MG,50393,POMPÉU,6802,6452,3540,19663,16123,869,1049
MG,50415,PONTE NOVA,19788,9797,8132,42979,34847,1110,1344
MG,50431,PORTEIRINHA,12830,5552,7566,28818,21252,691,1429
MG,50458,PORTO FIRME,2840,1674,1198,6583,5385,217,423
MG,50474,POTÉ,4242,2677,3154,11418,8264,177,873
MG,50490,POUSO ALEGRE,27484,32626,11722,82301,70579,2112,3057
MG,50512,POUSO ALTO,1275,2410,827,5091,4264,136,191
MG,50539,PRADOS,1912,2463,719,6141,5422,319,400
MG,50555,PRATA,7172,6338,4081,18986,14905,383,450
MG,50571,PRATÁPOLIS,2201,2878,968,6821,5853,215,286
MG,50598,PRATINHA,378,1367,423,2483,2060,87,102
MG,50610,PRESIDENTE BERNARDES,1647,1646,941,4793,3852,87,290
MG,50636,PRESIDENTE JUSCELINO,1694,734,1041,3778,2737,53,191
MG,50652,PRESIDENTE KUBITSCHEK,1154,541,465,2449,1984,47,187
MG,50679,PRESIDENTE OLEGÁRIO,3690,6601,2870,14540,11670,308,588
MG,50695,ALTO JEQUITIBÁ,1732,2832,1182,6347,5165,127,258
MG,50717,PRUDENTE DE MORAIS,2342,2444,980,6620,5640,285,303
MG,50733,QUARTEL GERAL,813,1094,410,2639,2229,112,97
MG,50750,QUELUZITO,860,563,251,1981,1730,62,106
MG,50776,RAPOSOS,6801,1969,1380,11509,10129,288,399
MG,50792,RAUL SOARES,7413,4701,4884,19147,14263,646,873
MG,50814,RECREIO,3114,2268,922,6992,6070,134,278
MG,50830,RESENDE COSTA,2684,2949,1335,8029,6694,247,307
MG,50857,RESPLENDOR,4699,4217,2120,11856,9736,229,279
MG,50873,RESSAQUINHA,1719,1231,370,3773,3403,86,145
MG,50890,RIACHO DOS MACHADOS,3538,926,1768,6835,5067,100,351
MG,50911,RIBEIRÃO DAS NEVES,73395,31439,24220,149990,125770,5427,6306
MG,50938,RIBEIRÃO VERMELHO,1106,1065,428,3083,2655,70,155
MG,50954,RIO ACIMA,2759,1909,861,6548,5687,206,226
MG,50970,RIO CASCA,4966,2769,1989,11069,9080,328,625
MG,50997,RIO DOCE,966,520,281,1969,1688,41,87
MG,51012,RIO DO PRADO,1996,654,1191,4327,3136,88,311
MG,51039,RIO ESPERA,1239,2465,1253,5553,4300,158,269
MG,51055,RIO MANSO,1357,1208,432,3494,3062,142,201
MG,51071,RIO NOVO,2538,2267,1307,7168,5861,223,341
MG,51098,RIO PARANAÍBA,2220,3356,1649,8331,6682,355,444
MG,51110,RIO PARDO DE MINAS,8650,3585,4025,18428,14403,355,1436
MG,51136,RIO PIRACICABA,5356,2580,2208,11467,9259,323,511
MG,51152,RIO POMBA,4998,3584,2392,13078,10686,470,663
MG,51179,RIO PRETO,1821,1524,691,4602,3911,52,185
MG,51195,RIO VERMELHO,4088,2103,3391,10962,7571,245,868
MG,51217,RITÁPOLIS,1148,1736,542,4017,3475,142,212
MG,51233,ROCHEDO DE MINAS,805,560,213,1792,1579,28,79
MG,51250,RODEIRO,2325,1124,583,4615,4032,135,252
MG,51276,ROMARIA,1135,1032,583,3012,2429,78,93
MG,51292,RUBELITA,2672,1305,2296,7206,4910,97,718
MG,51314,RUBIM,1862,2402,2414,7741,5327,155,643
MG,51330,SABARÁ,33643,17712,10152,76523,66371,3640,3820
MG,51357,SABINÓPOLIS,4338,2373,3373,11666,8293,384,857
MG,51373,SACRAMENTO,3887,8545,3099,17015,13916,227,452
MG,51390,SALINAS,10649,7320,6872,27668,20796,543,1632
MG,51411,SALTO DA DIVISA,1855,1125,1663,5189,3526,47,388
MG,51438,SANTA BÁRBARA,10748,3463,3046,19520,16474,528,741
MG,51454,SANTA BÁRBARA DO TUGÚRIO,1509,1484,420,3825,3405,87,185
MG,51470,SANTA CRUZ DO ESCALVADO,2182,723,773,4151,3378,84,283
MG,51497,SANTA EFIGÊNIA DE MINAS,1132,921,1205,3784,2579,112,331
MG,51519,SANTA FÉ DE MINAS,1508,544,1047,3265,2218,25,87
MG,51535,SANTA JULIANA,2069,3087,1182,6899,5717,203,207
MG,51551,SANTA LUZIA,57901,31968,19790,130422,110632,4770,5076
MG,51578,SANTA MARGARIDA,4118,3859,1648,10646,8998,314,495
MG,51594,SANTA MARIA DE ITABIRA,2898,2402,1509,7683,6174,172,419
MG,51616,SANTA MARIA DO SALTO,1822,970,958,4203,3245,104,267
MG,51632,SANTA MARIA DO SUAÇUÍ,4011,2441,3932,11663,7731,181,777
MG,51659,SANTANA DA VARGEM,2607,1841,1088,6110,5022,186,200
MG,51675,SANTANA DE CATAGUASES,943,1287,260,2777,2517,52,139
MG,51691,SANTANA DE PIRAPAMA,3254,1402,1296,6632,5336,159,287
MG,51713,SANTANA DO DESERTO,1348,799,387,2967,2580,71,127
MG,51730,SANTANA DO GARAMBÉU,690,746,220,1826,1606,45,79
MG,51756,SANTANA DO JACARÉ,1464,876,510,3479,2969,179,287
MG,51772,SANTANA DO MANHUAÇU,2409,1974,1565,6456,4891,200,185
MG,51799,SANTANA DO RIACHO,1456,817,784,3529,2745,99,184
MG,51810,SANTANA DOS MONTES,898,1450,449,3255,2806,164,178
MG,51837,SANTA RITA DE CALDAS,2124,3268,1074,7083,6009,134,259
MG,51853,SANTA RITA DE JACUTINGA,1443,1691,558,4167,3609,89,196
MG,51870,SANTA RITA DO IBITIPOCA,1105,1040,515,3006,2491,61,162
MG,51896,SANTA RITA DO ITUETO,1769,1596,1229,4824,3595,45,108
MG,51918,SANTA RITA DO SAPUCAÍ,5235,13648,3759,25588,21829,790,949
MG,51934,SANTA ROSA DA SERRA,1003,763,451,2477,2026,70,80
MG,51950,SANTA VITÓRIA,5951,3791,1962,12669,10707,193,356
MG,51977,SANTO ANTÔNIO DO AMPARO,6144,2700,1783,11931,10148,451,523
MG,51993,SANTO ANTÔNIO DO AVENTUREIRO,1024,1243,364,3026,2662,90,148
MG,52019,SANTO ANTÔNIO DO GRAMA,1217,1221,808,3573,2765,80,164
MG,52035,SANTO ANTÔNIO DO ITAMBÉ,1327,523,1103,3395,2292,58,264
MG,52051,SANTO ANTÔNIO DO JACINTO,3378,2532,3314,10260,6946,180,662
MG,52078,SANTO ANTÔNIO DO MONTE,3500,8432,2425,16451,14026,648,689
MG,52094,SANTO ANTÔNIO DO RIO ABAIXO,668,442,307,1599,1292,45,81
MG,52116,SANTO HIPÓLITO,1371,526,844,2981,2137,58,109
MG,52132,SANTOS DUMONT,19118,7657,5792,37077,31285,826,1500
MG,52159,SÃO BENTO ABADE,804,1600,528,3235,2707,82,147
MG,52175,SÃO BRÁS DO SUAÇUÍ,1025,892,282,2595,2313,103,140
MG,52191,SÃO DOMINGOS DO PRATA,6257,3269,2980,14235,11255,295,838
MG,52213,SÃO FRANCISCO,16405,5395,9793,34420,24627,484,1522
MG,52230,SÃO FRANCISCO DE PAULA,1623,2209,934,5340,4406,131,254
MG,52256,SÃO FRANCISCO DE SALES,2008,1195,987,4473,3486,107,126
MG,52272,SÃO FRANCISCO DO GLÓRIA,1933,1037,806,4276,3470,82,252
MG,52299,SÃO GERALDO,2460,1590,951,5866,4915,157,380
MG,52310,SÃO GERALDO DA PIEDADE,1368,812,719,3359,2640,95,277
MG,52337,SÃO GONÇALO DO ABAETÉ,1355,1625,964,4246,3282,69,107
MG,52353,SÃO GONÇALO DO PARÁ,2081,2719,950,6581,5631,266,313
MG,52370,SÃO GONÇALO DO RIO ABAIXO,3588,1526,1073,7036,5963,260,305
MG,52396,SÃO GONÇALO DO SAPUCAÍ,5426,6896,2998,17210,14212,404,764
MG,52418,SÃO GOTARDO,3184,11485,4733,21878,17145,798,1048
MG,52434,SÃO JOÃO BATISTA DO GLÓRIA,2050,1771,815,5108,4293,153,149
MG,52450,SÃO JOÃO DA MATA,636,1139,328,2384,2056,84,75
MG,52477,SÃO JOÃO DA PONTE,8471,3691,5859,20096,14237,312,1344
MG,52493,SÃO JOÃO DEL REI,19523,22360,9638,62955,53317,1957,3037
MG,52515,SÃO JOÃO DO ORIENTE,2773,1677,1711,6971,5260,157,461
MG,52531,SÃO JOÃO DO PARAÍSO,3908,5525,4024,15711,11687,551,1189
MG,52558,SÃO JOÃO EVANGELISTA,4761,2582,3988,12580,8592,185,723
MG,52574,SÃO JOÃO NEPOMUCENO,7045,5739,2911,18832,15921,495,912
MG,52590,SÃO JOSÉ DA SAFIRA,1298,693,937,3169,2232,47,147
MG,52612,SÃO JOSÉ DA VARGINHA,891,1113,427,2825,2398,99,164
MG,52639,SÃO JOSÉ DO ALEGRE,787,1545,500,3174,2674,117,120
MG,52655,SÃO JOSÉ DO DIVINO,1484,720,445,2918,2473,20,187
MG,52671,SÃO JOSÉ DO GOIABAL,2032,1133,733,4494,3761,128,298
MG,52698,SÃO JOSÉ DO JACURI,1732,1168,1448,5036,3588,119,440
MG,52710,SÃO JOSÉ DO MANTIMENTO,677,833,412,2155,1743,76,98
MG,52736,SÃO LOURENÇO,4688,15326,4760,29486,24726,755,1292
MG,52752,SÃO MIGUEL DO ANTA,1998,1649,600,5076,4476,173,411
MG,52779,SÃO PEDRO DA UNIÃO,880,1835,837,4127,3290,253,209
MG,52795,SÃO PEDRO DOS FERROS,2890,1688,1219,6501,5282,124,368
MG,52817,SÃO PEDRO DO SUAÇUÍ,1667,983,732,3923,3191,57,372
MG,52833,SÃO ROMÃO,3027,748,1857,6137,4280,69,308
MG,52850,SÃO ROQUE DE MINAS,885,2649,981,4998,4017,129,206
MG,52876,SÃO SEBASTIÃO DA BELA VISTA,1302,1367,400,3374,2974,79,126
MG,52892,SÃO SEBASTIÃO DO MARANHÃO,2656,1894,2877,8405,5528,209,555
MG,52914,SÃO SEBASTIÃO DO OESTE,1440,1390,364,3656,3292,120,197
MG,52930,SÃO SEBASTIÃO DO PARAÍSO,12935,17529,7098,43237,36139,1213,1854
MG,52957,SÃO SEBASTIÃO DO RIO PRETO,435,503,248,1360,1112,37,89
MG,52973,SÃO SEBASTIÃO DO RIO VERDE,571,803,196,1775,1579,45,85
MG,52990,SÃO TIAGO,2277,3041,1328,7898,6570,319,323
MG,53015,SÃO TOMÁS DE AQUINO,1466,2390,916,5295,4379,129,209
MG,53031,SÃO THOMÉ DAS LETRAS,1571,1861,1002,4944,3942,130,207
MG,53058,SÃO VICENTE DE MINAS,1377,2416,1180,5474,4294,91,195
MG,53074,SAPUCAÍ MIRIM,1449,1791,736,4223,3487,45,90
MG,53090,SARDOÁ,1327,1023,1086,3878,2792,120,226
MG,53112,SENADOR CORTES,782,606,281,1935,1654,36,89
MG,53139,SENADOR FIRMINO,2869,1421,1179,6233,5054,135,391
MG,53155,SENADOR JOSÉ BENTO,476,818,329,1805,1476,44,76
MG,53171,SENADOR MODESTINO GONÇALVES,1821,1095,776,4131,3355,70,258
MG,53198,SENHORA DE OLIVEIRA,2155,1000,891,4722,3831,167,279
MG,53210,SENHORA DO PORTO,874,1088,1054,3535,2481,79,316
MG,53236,SENHORA DOS REMÉDIOS,2977,2460,1622,7758,6136,123,384
MG,53252,SERICITA,2084,2019,863,5502,4639,136,272
MG,53279,SERITINGA,611,565,200,1587,1387,28,118
MG,53295,SERRA AZUL DE MINAS,1013,941,987,3340,2353,59,261
MG,53317,SERRA DA SAUDADE,206,445,209,935,726,17,23
MG,53333,SERRA DOS AIMORÉS,2616,982,884,4898,4014,63,230
MG,53350,SERRA DO SALITRE,1994,3121,1408,7065,5657,163,191
MG,53376,SERRANIA,2002,2019,1123,5566,4443,118,192
MG,53392,SERRANOS,622,750,309,1885,1576,35,107
MG,53414,SERRO,6586,2291,4091,14616,10525,302,917
MG,53430,SETE LAGOAS,54138,40817,18474,138200,119726,5632,6867
MG,53457,SILVEIRÂNIA,1028,503,217,1989,1772,33,117
MG,53473,SILVIANÓPOLIS,1075,2374,944,4820,3876,107,182
MG,53490,SIMÃO PEREIRA,997,745,372,2433,2061,49,107
MG,53511,SIMONÉSIA,4383,4515,2723,12831,10108,379,527
MG,53538,SOBRÁLIA,1747,1173,839,4198,3359,61,281
MG,53554,SOLEDADE DE MINAS,1068,2105,627,4245,3618,92,146
MG,53570,TABULEIRO,1205,1333,681,3696,3015,106,228
MG,53597,TAIOBEIRAS,7163,7825,5508,22694,17186,366,1274
MG,53619,TAPIRA,571,1746,541,3182,2641,53,130
MG,53635,TAPIRAÍ,560,891,380,2012,1632,39,60
MG,53651,TAQUARAÇU DE MINAS,1284,1123,474,3236,2762,85,146
MG,53678,TARUMIRIM,4188,3231,3050,11375,8325,206,500
MG,53694,TEIXEIRAS,3547,2746,1372,8964,7592,297,580
MG,53716,TEÓFILO OTONI,40000,24328,25119,99603,74484,2107,4410
MG,53732,TIMÓTEO,26873,12813,8689,55222,46533,1227,1579
MG,53759,TIRADENTES,1348,2237,840,5333,4493,206,290
MG,53775,TIROS,834,2690,1953,6112,4159,139,369
MG,53791,TOCANTINS,4717,4209,1692,11955,10263,363,563
MG,53813,TOLEDO,1173,1916,687,4145,3458,92,171
MG,53830,TOMBOS,2302,2690,1512,7213,5701,120,285
MG,53856,TRÊS CORAÇÕES,13827,20507,7285,49427,42142,1585,2145
MG,53872,TRÊS PONTAS,13732,13272,6076,37769,31693,1450,1291
MG,53899,TUMIRITINGA,1951,977,1030,4256,3226,52,144
MG,53910,TUPACIGUARA,7682,6149,3057,18538,15481,432,575
MG,53937,TURMALINA,5070,2842,3124,12262,9138,289,578
MG,53953,TURVOLÂNDIA,724,1655,556,3405,2849,158,159
MG,53970,UBÁ,32761,12353,8292,61222,52930,1715,2405
MG,53996,UBAÍ,3619,1847,2503,8690,6187,96,468
MG,54011,UBERABA,68375,68390,32884,198520,165636,5301,9330
MG,54038,UBERLÂNDIA,157774,101945,54228,373744,319516,9957,18039
MG,54054,UMBURATIBA,1028,469,393,2108,1715,53,113
MG,54070,UNAÍ,12334,24630,11092,52858,41766,1145,1770
MG,54097,URUCÂNIA,3086,2298,1567,7906,6339,176,512
MG,54119,VARGEM BONITA,757,766,361,2055,1694,52,66
MG,54135,VARGINHA,23645,36865,10732,83598,72866,2505,3031
MG,54151,VÁRZEA DA PALMA,10763,6269,5411,25186,19775,662,1187
MG,54178,VARZELÂNDIA,4507,3488,3866,13311,9445,335,797
MG,54194,VAZANTE,5976,4486,3363,15684,12321,532,512
MG,54216,WENCESLAU BRAZ,681,915,249,2159,1910,57,97
MG,54232,VERÍSSIMO,750,930,464,2377,1913,72,88
MG,54259,VESPASIANO,26834,13458,9193,57328,48135,1997,2187
MG,54275,VIÇOSA,20982,11671,8044,49231,41187,1802,2269
MG,54291,VIEIRAS,1559,860,354,3134,2780,56,166
MG,54313,MATHIAS LOBATO,1330,604,480,2663,2183,31,156
MG,54330,VIRGEM DA LAPA,3764,1881,3350,9920,6570,132,587
MG,54356,VIRGÍNIA,2600,2200,1267,6620,5353,127,223
MG,54372,VIRGINÓPOLIS,2666,2174,2494,8405,5911,253,517
MG,54399,VIRGOLÂNDIA,2181,691,1392,4682,3290,69,256
MG,54410,VISCONDE DO RIO BRANCO,11498,7745,3532,26682,23150,1039,1100
MG,54437,VOLTA GRANDE,1723,857,914,3974,3060,96,198
MG,54453,ITAÚ DE MINAS,3070,5054,1848,11524,9676,352,478
MS,55000,NOVA ALVORADA DO SUL,2837,3501,1530,8385,6855,80,207
MS,55018,ALCINÓPOLIS,503,1731,500,2987,2487,24,125
MS,55026,LAGUNA CARAPÃ,1044,1840,524,3699,3175,12,141
MS,55034,JAPORÃ,1555,1513,1034,4482,3448,60,233
MS,55042,NOVO HORIZONTE DO SUL,1171,1679,1080,4311,3231,67,199
MS,55069,FIGUEIRÃO,289,1018,316,1775,1459,9,92
MS,90034,ÁGUA CLARA,2306,3624,2180,8835,6655,84,332
MS,90115,AMAMBAÍ,6450,8656,4313,21232,16919,205,705
MS,90131,ANASTÁCIO,6076,6016,3272,16890,13618,154,500
MS,90158,ANAURILÂNDIA,1535,2886,1181,6045,4864,36,230
MS,90174,ANTÔNIO JOÃO,1878,2450,972,5829,4857,40,239
MS,90190,APARECIDA DO TABOADO,3966,6442,2501,14253,11752,225,592
MS,90212,AQUIDAUANA,11146,10888,6908,32245,25337,278,880
MS,90298,BANDEIRANTES,1202,2158,558,4423,3865,37,242
MS,90379,BATAGUASSU,4022,5317,2499,13106,10607,165,494
MS,90395,BATAIPORÃ,2398,3221,1592,7970,6378,134,330
MS,90417,BELA VISTA,4668,6249,3145,15164,12019,104,390
MS,90433,BONITO,4427,5666,2732,13843,11111,92,413
MS,90450,BRASILÂNDIA,2267,3586,2409,9076,6667,122,332
MS,90492,CAMAPUÃ,2836,5702,2170,11363,9193,63,323
MS,90514,CAMPO GRANDE,122762,238025,73441,496172,422731,5604,13911
MS,90530,CARACOL,1298,1590,513,3607,3094,25,92
MS,90557,CAARAPÓ,4956,5988,2192,14352,12160,210,490
MS,90573,CASSILÂNDIA,3024,8295,3082,16206,13124,230,720
MS,90611,CORGUINHO,732,1385,418,2832,2414,19,113
MS,90638,CORUMBÁ,27269,17112,12170,63241,51071,590,1260
MS,90654,COXIM,5783,10823,4826,23871,19045,229,936
MS,90735,DOURADOS,31869,63701,21130,129683,108553,1507,3714
MS,90751,FÁTIMA DO SUL,3242,7939,2171,14760,12589,192,482
MS,90794,GLÓRIA DE DOURADOS,1615,3481,784,6640,5856,128,303
MS,90816,GUIA LOPES DA LAGUNA,2086,3280,1550,7562,6012,96,270
MS,90859,IGUATEMI,2109,4543,2100,9600,7500,77,339
MS,90875,INOCÊNCIA,1044,2968,1528,6012,4484,60,217
MS,90891,ITAPORÃ,3136,5798,1925,11816,9891,149,336
MS,90930,IVINHEMA,3926,7540,3281,16408,13127,256,645
MS,90972,JARAGUARI,1129,1946,790,4261,3471,39,197
MS,90999,JARDIM,5478,7113,3325,17393,14068,163,555
MS,91014,JATEÍ,853,1779,632,3451,2819,19,68
MS,91030,LADÁRIO,4379,2550,1906,9926,8020,98,235
MS,91073,MARACAJU,7597,8579,3489,21333,17844,197,443
MS,91111,MIRANDA,6388,6144,3277,17108,13831,131,651
MS,91138,NAVIRAÍ,9205,12987,5750,30885,25135,506,925
MS,91154,NIOAQUE,3002,3947,2057,9822,7765,74,309
MS,91235,NOVA ANDRADINA,7093,13149,5472,28061,22589,386,848
MS,91251,PARANAÍBA,5771,14336,5564,28762,23198,429,1101
MS,91278,PEDRO GOMES,1523,3049,1314,6456,5142,69,308
MS,91316,PONTA PORÃ,15638,19457,9725,49303,39578,577,1519
MS,91375,PORTO MURTINHO,2621,2785,1478,7398,5920,44,201
MS,91413,RIBAS DO RIO PARDO,2888,4075,1652,9583,7931,98,409
MS,91430,RIO BRILHANTE,5565,7100,2458,16381,13923,180,486
MS,91456,RIO NEGRO,1091,1737,481,3663,3182,22,175
MS,91472,RIO VERDE DE MATO GROSSO,3173,6454,2629,13300,10671,84,503
MS,91499,ROCHEDO,576,1978,707,3655,2948,32,139
MS,91570,SIDROLÂNDIA,6902,7932,3089,19762,16673,206,569
MS,91596,TERENOS,2345,4400,1538,9074,7536,92,291
MS,91650,TRÊS LAGOAS,20414,19903,10780,58479,47699,956,1871
MS,91693,ANGÉLICA,1745,2437,1041,5772,4731,63,227
MS,91715,ARAL MOREIRA,1783,2279,895,5427,4532,29,286
MS,91731,ELDORADO,2074,3843,1823,8543,6720,94,331
MS,91758,DEODÁPOLIS,1790,4023,857,7535,6678,134,409
MS,91782,CHAPADÃO DO SUL,2144,5132,1840,9991,8151,121,225
MS,91790,MUNDO NOVO,2895,4927,1448,10308,8860,121,480
MS,91804,DOIS IRMÃOS DO BURITI,2574,2368,1617,7131,5514,61,245
MS,91820,JUTI,1282,1831,858,4338,3480,45,206
MS,91847,PARANHOS,2236,2275,1397,6482,5085,33,373
MS,91863,SANTA RITA DO PARDO,1287,1954,885,4472,3587,37,187
MS,91880,SONORA,3322,3193,2068,9282,7214,92,273
MS,91901,VICENTINA,1207,2204,720,4552,3832,82,169
MS,98019,BODOQUENA,2142,2455,1378,6542,5164,70,204
MS,98035,COSTA RICA,3091,6736,2653,13685,11032,123,576
MS,98051,DOURADINA,1076,1910,538,3899,3361,32,169
MS,98078,ITAQUIRAÍ,3266,4661,2770,11544,8774,140,387
MS,98094,SÃO GABRIEL DO OESTE,3470,7301,2780,14715,11935,137,356
MS,98116,SELVÍRIA,1868,1369,850,4480,3630,54,169
MS,98132,SETE QUEDAS,2499,3213,1191,7645,6454,81,384
MS,98159,TACURU,2400,1584,1260,5671,4411,26,253
MS,98175,TAQUARUSSU,721,1352,512,2871,2359,43,130
MS,98590,CORONEL SAPUCAIA,4035,2525,2212,9565,7353,39,395
MT,89788,COLNIZA,5153,5685,4072,16761,12689,461,1027
MT,89796,COLÍDER,2618,12075,4152,20962,16810,354,1217
MT,89800,CURVELÂNDIA,1048,1648,862,4008,3146,57,261
MT,89818,NOVA BRASILÂNDIA,675,1866,671,3610,2939,45,262
MT,89826,NOVA SANTA HELENA,649,1206,636,2717,2081,34,144
MT,89834,PARANATINGA,2427,6372,2952,12828,9876,123,632
MT,89843,SANTO ANTÔNIO DO LESTE,384,949,760,2248,1488,22,53
MT,89850,SINOP,13113,33459,13618,66421,52803,949,2282
MT,89877,ALTA FLORESTA,8531,17457,6615,34990,28375,455,1238
MT,89893,ARAPUTANGA,3453,4280,1642,10603,8961,211,604
MT,89915,JAURU,2051,2979,2530,8405,5875,114,496
MT,89931,SÃO JOSÉ DOS QUATRO MARCOS,5095,4401,3357,14176,10819,341,540
MT,89958,RIO BRANCO,1382,1366,1028,4205,3177,57,252
MT,89960,RONDOLÂNDIA,1082,613,545,2423,1878,13,115
MT,89974,SALTO DO CÉU,776,1185,923,3217,2294,65,178
MT,89990,PONTES E LACERDA,6802,11634,6945,28131,21186,488,1379
MT,90018,ACORIZAL,2329,1479,1097,5445,4348,35,352
MT,90026,SÃO JOSÉ DO POVO,900,1164,431,2838,2407,73,166
MT,90042,ALTO BOA VISTA,425,1659,844,3265,2421,37,209
MT,90050,ALTO ARAGUAIA,2862,4327,2375,10448,8073,141,386
MT,90069,QUERÊNCIA,1516,2970,1811,6940,5129,95,344
MT,90077,ALTO GARÇAS,1398,3504,1293,6837,5544,81,362
MT,90085,CANABRAVA DO NORTE,579,1770,946,3595,2649,60,177
MT,90093,ALTO PARAGUAI,1952,2176,1459,6160,4701,66,309
MT,90107,SANTA CARMEM,549,1481,650,2952,2302,33,131
MT,90123,NOVA MARINGÁ,690,1729,1139,3803,2664,33,128
MT,90140,NOVA GUARITA,1233,1247,656,3466,2810,72,154
MT,90166,NOVA MARILÂNDIA,461,812,502,1950,1448,22,106
MT,90182,PORTO ESTRELA,1247,875,944,3376,2432,26,227
MT,90204,GLÓRIA D'OESTE,771,917,410,2328,1918,40,104
MT,90220,TABAPORÃ,1192,2716,1470,5881,4411,84,240
MT,90239,ARAGUAINHA,384,336,137,976,839,20,53
MT,90247,SÃO JOSÉ DO XINGU,588,1777,1255,3907,2652,33,143
MT,90255,ARENÁPOLIS,1914,3023,1848,7556,5708,111,439
MT,90263,APIACÁS,1226,2523,1345,5575,4230,78,304
MT,90271,ARIPUANÃ,2414,5350,3045,11701,8656,199,464
MT,90280,CONFRESA,3032,5680,3692,13492,9800,212,633
MT,90301,LAMBARI D'OESTE,987,1622,1139,4141,3002,69,230
MT,90310,BARÃO DE MELGAÇO,2452,1405,1199,5653,4454,83,351
MT,90328,SANTO AFONSO,632,910,596,2347,1751,24,139
MT,90336,BARRA DO BUGRES,6865,7245,4921,21183,16262,385,990
MT,90344,PLANALTO DA SERRA,583,841,386,2041,1655,15,151
MT,90352,BARRA DO GARÇAS,12126,14582,9111,39887,30776,641,1545
MT,90360,NOVA MONTE VERDE,1290,2412,1118,5348,4230,86,304
MT,90387,NOVA BANDEIRANTE,1813,3455,1727,7804,6077,177,395
MT,90409,SÃO PEDRO DA CIPA,1071,1299,518,3231,2713,67,181
MT,90425,COTRIGUAÇU,2850,3288,1832,8811,6979,144,481
MT,90441,RIBEIRÃOZINHO,548,594,404,1762,1358,22,100
MT,90468,BRASNORTE,1829,3870,2105,8603,6498,101,436
MT,90476,CÁCERES,21258,18316,12354,57087,44733,625,2096
MT,90484,CAMPO NOVO DO PARECIS,3674,6832,4502,16427,11925,243,550
MT,90506,CAMPO VERDE,6012,7583,3716,18846,15130,237,559
MT,90522,CLÁUDIA,995,4308,1609,7521,5912,99,290
MT,90549,CASTANHEIRA,1617,2264,1147,5604,4457,102,362
MT,90565,JANGADA,2002,1866,1137,5564,4427,52,344
MT,90581,JURUENA,1421,2378,1260,5679,4419,114,336
MT,90590,CHAPADA DOS GUIMARÃES,4509,3966,1989,11845,9856,114,672
MT,90603,LUCAS DO RIO VERDE,5451,8150,3323,18508,15185,316,492
MT,90620,MATUPÁ,2273,4594,2135,9776,7641,123,386
MT,90646,NOVA MUTUM,3173,6146,2620,13241,10621,277,345
MT,90662,RIBEIRÃO CASCALHEIRA,916,3449,1562,6567,5005,68,400
MT,90670,CUIABÁ,113226,137736,54599,356495,301896,5035,10885
MT,90689,TAPURAH,1251,2406,1343,5403,4060,67,190
MT,90697,DIAMANTINO,3874,5689,2124,12854,10730,114,457
MT,90700,PONTAL DO ARAGUAIA,1375,1357,684,3795,3111,56,173
MT,90719,DOM AQUINO,1915,2642,1456,6713,5257,80,397
MT,90727,SAPEZAL,1968,3639,2219,8519,6300,120,278
MT,90743,CAMPOS DE JÚLIO,622,1514,1003,3407,2404,58,106
MT,90760,CARLINDA,2158,3567,1815,8295,6480,118,421
MT,90778,GENERAL CARNEIRO,1485,1295,1033,4212,3179,61,209
MT,90786,FELIZ NATAL,1500,2825,1606,6315,4709,53,209
MT,90808,NOVO MUNDO,1762,1727,1136,4851,3715,40,104
MT,90824,GAÚCHA DO NORTE,447,1825,894,3406,2512,45,128
MT,90832,GUIRATINGA,2371,4629,2326,10273,7947,123,487
MT,90840,UNIÃO DO SUL,561,1200,710,2701,1991,41,114
MT,90867,NOVA LACERDA,890,1203,885,3205,2320,24,137
MT,90883,NOVA UBIRATÃ,1539,1761,1182,4810,3628,56,183
MT,90905,BOM JESUS DO ARAGUAIA,602,1148,883,2851,1968,34,130
MT,90913,ITIQUIRA,1624,3543,2451,8417,5966,133,375
MT,90921,SERRA NOVA DOURADA,134,453,337,1055,718,12,72
MT,90948,NOVO SANTO ANTONIO,223,714,284,1359,1075,11,95
MT,90956,JACIARA,4880,7751,3362,17964,14602,300,734
MT,90964,NOVA NAZARÉ,377,590,597,1744,1147,18,116
MT,90980,SANTA CRUZ DO XINGU,215,870,538,1747,1209,15,84
MT,91006,CONQUISTA D'OESTE,524,1060,485,2239,1754,29,99
MT,91022,VALE DE SÃO DOMINGOS,597,1283,497,2629,2132,38,142
MT,91049,SANTA RITA DO TRIVELATO,211,766,500,1589,1089,8,44
MT,91057,LUCIARA,464,759,486,1979,1493,25,143
MT,91081,IPIRANGA DO NORTE,531,1224,572,2544,1972,36,85
MT,91090,VILA BELA DA SANTÍSSIMA TRINDADE,2221,3175,2134,8285,6151,71,449
MT,91103,ITANHANGÁ,816,1566,1040,3693,2653,46,102
MT,91170,NOBRES,2155,5380,1465,9847,8382,88,455
MT,91197,NORTELÂNDIA,1674,1927,1352,5544,4192,67,359
MT,91219,NOSSA SENHORA DO LIVRAMENTO,4213,2391,1134,8743,7609,82,617
MT,91294,POCONÉ,9307,6304,3481,20812,17331,241,955
MT,91332,PONTE BRANCA,438,761,272,1615,1343,12,88
MT,91359,PORTO DOS GAÚCHOS,651,2121,931,4017,3086,48,142
MT,91391,POXORÉU,4203,4879,3461,14013,10552,203,743
MT,91510,RONDONÓPOLIS,40764,41478,19727,115025,95298,2134,4391
MT,91537,ROSÁRIO OESTE,3681,5121,3204,13245,10041,138,679
MT,91553,SANTO ANTÔNIO DO LEVERGER,5245,3986,1770,12275,10505,130,559
MT,91618,TESOURO,534,973,715,2491,1776,30,142
MT,91634,TORIXORÉU,1185,1447,555,3537,2982,36,196
MT,91677,VÁRZEA GRANDE,59572,51538,25596,154436,128840,2446,5812
MT,91774,MIRASSOL D'OESTE,5175,6295,4104,17161,13057,367,750
MT,91812,PEDRA PRETA,3159,4922,1447,10567,9120,193,499
MT,91839,SÃO FÉLIX DO ARAGUAIA,1582,2573,2170,6962,4792,53,374
MT,91855,TANGARÁ DA SERRA,10204,25046,10258,49906,39648,738,1737
MT,91898,JUSCIMEIRA,2996,3385,1972,9266,7294,144,435
MT,91910,ÁGUA BOA,2383,6433,3401,13332,9931,147,570
MT,91936,CANARANA,2309,5520,2893,11999,9106,174,684
MT,91952,NOVA XAVANTINA,3633,5448,3109,13390,10281,138,557
MT,91979,SANTA TEREZINHA,1241,1397,1365,4460,3095,55,316
MT,91995,SÃO JOSÉ DO RIO CLARO,1969,4487,2351,9774,7423,121,495
MT,98191,JUARA,3688,11018,4683,21357,16674,375,837
MT,98310,JUÍNA,6599,12766,5556,27395,21839,472,1263
MT,98337,DENISE,1641,2070,1145,5384,4239,106,261
MT,98612,ALTO TAQUARI,834,2365,1144,4616,3472,47,113
MT,98639,ARAGUAIANA,619,1002,528,2442,1914,33,173
MT,98655,CAMPINÁPOLIS,2086,3492,1915,8044,6129,103,287
MT,98671,COCALINHO,1467,992,936,3791,2855,63,240
MT,98698,ITAÚBA,682,1955,957,3877,2920,41,157
MT,98710,MARCELÂNDIA,991,5679,2708,10239,7531,133,526
MT,98736,NOVA OLÍMPIA,5333,2780,1878,11120,9242,245,512
MT,98752,NOVA CANAÃ DO NORTE,1550,4260,1629,8222,6593,139,493
MT,98779,NOVO SÃO JOAQUIM,926,2820,1578,5687,4109,51,216
MT,98795,NOVO HORIZONTE DO NORTE,651,1525,579,2977,2398,31,105
MT,98817,PEIXOTO DE AZEVEDO,6005,7400,5361,20360,14999,248,877
MT,98833,PARANAÍTA,1592,3991,1566,7864,6298,147,396
MT,98850,PORTO ALEGRE DO NORTE,1397,2914,1741,6612,4871,80,355
MT,98876,PORTO ESPERIDIÃO,2114,2557,1391,6756,5365,113,408
MT,98892,PRIMAVERA DO LESTE,6307,14721,6023,29571,23548,433,885
MT,98914,RESERVA DO CABAÇAL,626,604,329,1776,1447,47,111
MT,98930,SORRISO,9516,16188,6862,35605,28743,494,1281
MT,98957,TERRA NOVA DO NORTE,3115,3058,1922,8916,6994,144,358
MT,98973,VERA,1330,3105,1536,6489,4953,88,263
MT,98990,VILA RICA,2946,5943,3240,13503,10263,254,731
MT,99015,COMODORO,2646,5812,3234,12663,9429,133,499
MT,99031,FIGUEIRÓPOLIS D'OESTE,567,1501,785,3234,2449,77,220
MT,99058,GUARANTÃ DO NORTE,3435,9410,4083,18457,14374,275,769
MT,99074,INDIAVAÍ,697,598,364,1875,1511,27,120
PA,4006,GOIANÉSIA DO PARÁ,7453,5357,4550,18543,13993,240,556
PA,4014,ABAETETUBA,41624,19608,10613,75816,65203,650,1406
PA,4022,TAILÂNDIA,10427,9566,8016,30314,22298,514,1135
PA,4030,ACARÁ,8947,9526,5523,25988,20465,226,1110
PA,4049,BOM JESUS DO TOCANTINS,2622,2699,2708,8601,5893,100,327
PA,4057,AFUÁ,4195,4940,3863,14197,10334,87,809
PA,4065,SÃO JOÃO DE PIRABAS,5647,2674,2938,12285,9347,152,542
PA,4073,ALENQUER,9440,13346,7689,31880,24191,136,625
PA,4081,TUCUMÃ,6563,6503,5457,19726,14269,258,524
PA,4090,ALMEIRIM,10238,3539,2067,17097,15030,187,582
PA,4103,MÃE DO RIO,7538,6908,4478,20251,15773,203,733
PA,4111,ALTAMIRA,11998,24501,10659,50996,40337,714,1813
PA,4120,ELDORADO DOS CARAJÁS,6399,3114,3325,13882,10557,175,530
PA,4138,ANAJÁS,1601,5776,3149,11060,7911,53,312
PA,4146,SANTA LUZIA DO PARÁ,4931,3996,2514,12171,9657,107,466
PA,4154,ANANINDEUA,89162,61863,29996,214460,184464,4429,6917
PA,4162,PALESTINA DO PARÁ,1717,1867,1462,5330,3868,41,149
PA,4170,AUGUSTO CORRÊA,10361,7500,5580,25707,20127,244,1169
PA,4189,IPIXUNA DO PARÁ,5376,3597,3008,12787,9779,121,488
PA,4197,AVEIRO,3651,2173,1936,8189,6253,58,237
PA,4200,JACAREACANGA,1846,2396,2201,6742,4541,43,172
PA,4219,BAGRE,3341,2114,2759,8691,5932,45,296
PA,4227,BRASIL NOVO,1841,5913,2249,10565,8316,113,276
PA,4235,BAIÃO,8666,3352,2603,15578,12975,215,410
PA,4243,SANTA BÁRBARA DO PARÁ,4563,3025,1475,9832,8357,100,309
PA,4251,BARCARENA,23349,10291,3155,40578,37423,524,1143
PA,4260,ÁGUA AZUL DO NORTE,2297,2232,1870,6983,5113,76,357
PA,4278,BELÉM,337382,307106,135326,927758,792432,16866,25760
PA,4286,TRAIRÃO,1440,3483,1730,7035,5305,40,220
PA,4294,BENEVIDES,11643,7792,3428,24832,21404,347,571
PA,4308,PAU D'ARCO,1701,1922,1429,5447,4018,53,203
PA,4316,BONITO,3668,2851,1693,8782,7089,79,319
PA,4324,ULIANÓPOLIS,4318,2880,3289,11330,8041,154,458
PA,4332,BRAGANÇA,29056,15333,13230,62053,48823,522,2036
PA,4340,AURORA DO PARÁ,5475,4129,3246,13866,10620,111,599
PA,4359,BREVES,16120,10820,12699,42161,29462,261,1480
PA,4367,TERRA SANTA,4057,2416,2013,9023,7010,73,343
PA,4375,BUJARU,6307,4019,2526,13619,11093,102,412
PA,4383,NOVO PROGRESSO,2463,6894,3404,13495,10091,109,239
PA,4391,CACHOEIRA DO ARARI,5655,3109,3034,12481,9447,81,322
PA,4405,VITÓRIA DO XINGU,2111,3029,1978,7557,5579,63,239
PA,4413,CAMETÁ,32341,16486,10391,62636,52245,502,1608
PA,4421,NOVO REPARTIMENTO,12930,10914,7958,33962,26004,385,1197
PA,4430,CAPANEMA,19366,11469,9037,42858,33821,667,1005
PA,4448,BREU BRANCO,9941,6475,4706,22576,17870,225,872
PA,4456,CAPITÃO POÇO,9309,11598,6355,29574,23219,386,1221
PA,4464,SÃO DOMINGOS DO ARAGUAIA,4964,4176,3842,14134,10292,188,651
PA,4472,CASTANHAL,34087,31992,14177,88372,74195,1363,2542
PA,4480,NOVA ESPERANÇA DO PIRIÁ,3484,3615,2098,9817,7719,110,370
PA,4499,CHAVES,2284,3757,3316,9998,6682,83,370
PA,4502,ABEL FIGUEIREDO,1840,1933,1357,5438,4081,42,180
PA,4510,COLARES,3295,1936,1366,7248,5882,117,245
PA,4529,CUMARU DO NORTE,1198,1506,1731,4634,2903,20,98
PA,4537,CONCEIÇÃO DO ARAGUAIA,9270,10183,7498,29176,21678,423,905
PA,4545,TERRA ALTA,3601,1919,1287,7294,6007,71,233
PA,4553,CURRALINHO,6413,2406,2700,12111,9411,51,364
PA,4561,FLORESTA DO ARAGUAIA,3550,3304,2747,10381,7634,147,442
PA,4570,CURUÇÁ,13151,3368,3971,21636,17665,191,583
PA,4588,BANNACH,710,1081,696,2617,1921,15,67
PA,4596,FARO,2799,632,986,4639,3653,16,117
PA,4600,NOVA IPIXUNA,2963,3801,2643,9949,7306,85,261
PA,4618,GURUPÁ,5062,3244,2619,11449,8830,25,354
PA,4626,PLACAS,1518,5073,1677,8773,7096,102,266
PA,4634,IGARAPÉ-AÇU,10726,5653,3071,21237,18166,306,812
PA,4642,MARITUBA,22329,13135,6797,47759,40962,808,1464
PA,4650,IGARAPÉ-MIRI,18504,8275,7209,36101,28892,306,1099
PA,4669,TRACUATEUA,8804,3375,3282,16841,13559,170,908
PA,4677,INHANGAPI,2278,2541,768,5981,5213,49,221
PA,4685,QUATIPURU,2636,2724,2091,8063,5972,154,236
PA,4693,IRITUIA,9436,5397,4021,20200,16179,240,610
PA,4707,CANAÃ DOS CARAJÁS,4364,4519,4514,14289,9775,187,344
PA,4715,ITAITUBA,15866,22446,17918,59715,41797,424,1547
PA,4723,ANAPU,1585,5796,2650,10545,7895,67,340
PA,4731,ITUPIRANGA,11524,6114,7358,26916,19558,270,1128
PA,4740,CURUÁ,2615,2541,1150,6660,5510,39,221
PA,4758,JACUNDÁ,10731,11971,8646,33242,24596,384,773
PA,4766,CACHOEIRA DO PIRIÁ,3805,2937,2402,9923,7521,92,557
PA,4774,JURUTI,7023,5992,3615,17794,14179,95,783
PA,4782,PIÇARRA,2215,2886,2468,7972,5504,60,215
PA,4790,LIMOEIRO DO AJURU,6495,3409,2251,12816,10565,96,341
PA,4804,BELTERRA,4535,3849,2195,11171,8976,74,315
PA,4812,MAGALHÃES BARATA,2820,1713,1494,6398,4904,45,195
PA,4820,SÃO JOÃO DA PONTA,1737,899,449,3298,2849,42,80
PA,4839,MARABÁ,46535,31918,23933,111481,87548,1478,2881
PA,4847,SAPUCAIA,725,1372,609,2958,2349,51,122
PA,4855,MARACANÃ,7455,4871,2233,16091,13858,252,692
PA,4871,MARAPANIM,7711,5189,3695,17811,14116,166,504
PA,4898,MELGAÇO,2403,3193,5250,11308,6058,54,272
PA,4910,MOCAJUBA,8755,3429,2973,16122,13149,140,518
PA,4936,MOJU,16623,8326,7889,34775,26886,253,1191
PA,4952,MONTE ALEGRE,11107,16091,6666,35490,28824,166,796
PA,4979,MUANÁ,8349,3449,3243,16015,12772,116,611
PA,4995,NOVA TIMBOTEUA,4479,2565,1668,9516,7848,179,425
PA,5010,ÓBIDOS,14610,5427,6889,28380,21491,228,761
PA,5037,OEIRAS DO PARÁ,6383,3960,2367,13590,11223,94,580
PA,5053,ORIXIMINÁ,14570,10537,7458,34824,27366,287,1101
PA,5070,OURÉM,4927,3104,2307,11280,8973,142,463
PA,5096,PARAGOMINAS,20491,16796,12103,52540,40437,538,1697
PA,5118,PEIXE-BOI,2813,1871,1140,6329,5189,62,270
PA,5134,PONTA DE PEDRAS,6778,3100,3071,13824,10753,114,425
PA,5150,PORTEL,7384,7617,7931,24435,16504,155,889
PA,5177,PORTO DE MOZ,2915,5948,2529,12110,9581,60,461
PA,5193,PRAINHA,6251,5570,3451,16055,12604,67,546
PA,5215,PRIMAVERA,3041,2721,2080,8463,6383,89,342
PA,5231,SALINÓPOLIS,9595,6352,4056,21765,17709,216,785
PA,5258,SALVATERRA,5711,2820,2259,11421,9162,101,295
PA,5274,SANTA CRUZ DO ARARI,2339,1106,1494,5141,3647,25,124
PA,5290,SANTA IZABEL DO PARÁ,13496,8386,4437,29287,24850,639,1014
PA,5312,SANTA MARIA DO PARÁ,6425,4808,3274,15869,12595,298,705
PA,5339,SANTANA DO ARAGUAIA,4382,6065,4300,16317,12017,178,1028
PA,5355,SANTARÉM,57533,71459,36476,179938,143462,1470,4616
PA,5371,SANTARÉM NOVO,1957,1301,543,4153,3610,47,219
PA,5398,SANTO ANTÔNIO DO TAUÁ,7482,4776,2706,16247,13541,183,618
PA,5410,SÃO CAETANO DE ODIVELAS,5511,2839,2285,11295,9010,132,247
PA,5436,SÃO DOMINGOS DO CAPIM,6486,5705,4055,17694,13639,202,742
PA,5452,SÃO FÉLIX DO XINGU,7917,9167,7086,26176,19090,411,1009
PA,5479,SÃO FRANCISCO DO PARÁ,3968,3551,1562,9766,8204,132,323
PA,5495,SÃO JOÃO DO ARAGUAIA,3412,2266,2480,8905,6425,113,428
PA,5517,SÃO MIGUEL DO GUAMÁ,11778,8360,5730,27772,22042,256,953
PA,5533,SÃO SEBASTIÃO DA BOA VISTA,6588,2824,2954,12963,10009,84,340
PA,5550,SENADOR JOSÉ PORFÍRIO,2236,2585,2111,7265,5154,51,187
PA,5576,SOURE,8727,2200,3390,15183,11793,121,344
PA,5592,TOMÉ-AÇU,15285,6581,7514,31372,23858,344,1071
PA,5614,TUCURUÍ,29785,13677,12488,59978,47490,652,1620
PA,5630,VIGIA,14317,5930,6213,28729,22516,500,769
PA,5657,VISEU,15439,6107,8513,32538,24025,281,1693
PA,5673,REDENÇÃO,15769,16479,10940,46438,35498,573,1404
PA,5690,RIO MARIA,3703,4286,2257,11289,9032,146,582
PA,5711,XINGUARA,7201,8349,6084,23292,17208,281,777
PA,5738,RONDON DO PARÁ,10288,7880,8122,28224,20102,313,990
PA,5754,URUARÁ,3545,12078,4982,22105,17123,306,784
PA,5770,MEDICILÂNDIA,2366,8019,3180,14540,11360,148,604
PA,5797,SÃO GERALDO DO ARAGUAIA,6349,5859,5683,19182,13499,196,675
PA,5819,CONCÓRDIA DO PARÁ,5712,4930,3264,14722,11458,120,445
PA,5835,PARAUAPEBAS,32164,17351,14789,70098,55309,1566,1641
PA,5851,CURIONÓPOLIS,5203,2566,1838,10395,8557,146,391
PA,5878,GARRAFÃO DO NORTE,4888,6167,3531,15746,12215,183,725
PA,5894,RURÓPOLIS,3637,6622,3197,14433,11236,148,498
PA,5916,PACAJÁ,4329,9116,4072,18512,14440,182,536
PA,5932,BREJO GRANDE DO ARAGUAIA,1883,1867,1710,5916,4206,66,286
PA,5959,OURILÂNDIA DO NORTE,4274,3405,3233,11627,8394,139,292
PA,5975,DOM ELISEU,11633,5644,6566,25463,18897,269,896
PA,5991,SANTA MARIA DAS BARREIRAS,2658,2701,2824,8701,5877,78,283
PB,19003,RIACHÃO DO POÇO,1851,693,390,3345,2955,71,262
PB,19011,ÁGUA BRANCA,3062,898,1370,6226,4856,169,548
PB,19020,SOBRADO,2640,1108,1057,5496,4439,118,424
PB,19038,AGUIAR,2826,459,664,4514,3850,69,398
PB,19046,SÃO JOSÉ DOS RAMOS,1924,870,479,3727,3248,68,315
PB,19054,ALAGOA GRANDE,9332,3849,4639,21229,16590,627,1959
PB,19062,CAPIM,1806,968,777,4068,3291,111,319
PB,19070,ALAGOA NOVA,6501,3114,2439,14149,11710,308,1148
PB,19089,CUITÉ DE MAMANGUAPE,2714,782,1305,5469,4164,101,480
PB,19097,ALAGOINHA,5225,1312,1798,9644,7846,267,813
PB,19100,CURRAL DE CIMA,1781,1235,529,4164,3635,121,369
PB,19119,ALHANDRA,7101,2783,1264,12881,11617,395,978
PB,19127,RIACHÃO DO BACAMARTE,1711,637,379,3217,2838,80,285
PB,19135,SÃO JOÃO DO RIO DO PEIXE,7835,1584,2342,13607,11265,444,1001
PB,19143,MATINHAS,1658,754,360,3210,2850,90,276
PB,19151,ARAÇAGI,6211,1941,3560,13336,9776,333,993
PB,19160,LOGRADOURO,1420,647,403,2861,2458,31,290
PB,19178,ARARA,4330,1253,1594,8111,6517,123,593
PB,19186,SERTÃOZINHO,1385,780,282,2939,2657,77,254
PB,19194,ARARUNA,5171,3332,2058,12252,10194,217,1058
PB,19208,RIACHÃO,1329,598,275,2453,2178,23,156
PB,19216,AREIA,8114,3049,2987,17369,14382,698,1561
PB,19224,SÃO DOMINGOS DO CARIRI,820,818,400,2241,1841,32,111
PB,19232,AREIAL,2344,1229,784,4802,4018,79,223
PB,19240,CARAÚBAS,1635,635,409,3023,2614,44,223
PB,19259,AROEIRAS,5620,3675,2583,13920,11337,390,1187
PB,19267,SANTO ANDRÉ,1195,469,346,2302,1956,46,158
PB,19275,DAMIÃO,1796,707,381,3273,2892,29,298
PB,19283,SOSSÊGO,1121,567,271,2332,2061,51,204
PB,19291,BAIA DA TRAIÇÃO,2902,434,822,4822,4000,126,420
PB,19305,BARAÚNAS,1667,428,296,2794,2498,82,249
PB,19313,BANANEIRAS,7470,3433,2964,15939,12975,337,1184
PB,19321,ASSUNÇÃO,1274,727,277,2640,2363,42,165
PB,19330,BARRA DE SANTA ROSA,4275,2588,1454,9390,7936,94,761
PB,19348,ZABELÊ,852,344,220,1664,1444,42,156
PB,19356,BARRA DE SÃO MIGUEL,2298,719,776,4382,3606,129,320
PB,19364,CACIMBAS,2107,805,1433,5045,3612,161,455
PB,19372,BAYEUX,37546,10307,9231,65908,56677,1746,3708
PB,19380,CAJAZEIRINHAS,2005,515,455,3420,2965,59,313
PB,19399,BELÉM,5638,2708,2102,11960,9858,247,854
PB,19402,SÃO BENTINHO,1436,663,404,2905,2501,34,273
PB,19410,BELÉM DO BREJO DO CRUZ,2971,649,863,5157,4294,92,472
PB,19429,SÃO DOMINGOS DE POMBAL,1695,446,295,2784,2489,46,242
PB,19437,BOA VENTURA,2506,570,1019,4655,3636,50,395
PB,19445,SÃO JOSÉ DE PRINCESA,1643,228,769,3143,2374,49,378
PB,19453,BOM JESUS,1259,273,314,2098,1784,42,149
PB,19461,MARIZÓPOLIS,3121,547,763,5154,4391,78,459
PB,19470,BOM SUCESSO,2492,593,836,4424,3588,83,301
PB,19488,MATO GROSSO,1341,201,407,2109,1702,25,117
PB,19496,BONITO DE SANTA FÉ,3341,1158,1555,7152,5597,108,653
PB,19500,BERNARDINO BATISTA,1317,324,427,2262,1835,13,133
PB,19518,BOQUEIRÃO,6207,2988,2455,13241,10786,280,906
PB,19526,POÇO DE JOSÉ DE MOURA,2233,429,440,3509,3069,81,205
PB,19534,IGARACY,2772,566,1200,5211,4011,75,447
PB,19542,SÃO JOSÉ DO BREJO CRUZ,829,259,135,1429,1294,29,126
PB,19550,BORBOREMA,1518,968,675,3718,3043,67,347
PB,19569,SANTA INÊS,1677,620,587,3270,2683,32,288
PB,19577,BREJO DO CRUZ,4441,1813,2155,9658,7503,235,792
PB,19585,AMPARO,1180,192,257,1862,1605,23,144
PB,19593,BREJO DOS SANTOS,2673,1147,646,5000,4354,164,298
PB,19607,CASSERENGUE,2450,1033,929,4994,4065,91,398
PB,19615,CAAPORÃ,8868,1705,2586,14845,12259,433,899
PB,19623,GADO BRAVO,2429,1800,1651,6857,5206,222,537
PB,19631,CABACEIRAS,2114,916,547,4076,3529,74,250
PB,19640,POÇO DANTAS,1818,247,486,2946,2460,38,293
PB,19658,CABEDELO,17400,6263,5010,33866,28856,809,1550
PB,19666,SANTARÉM,1191,399,264,2083,1819,34,115
PB,19674,CACHOEIRA DOS ÍNDIOS,4053,715,1243,6894,5651,104,603
PB,19682,TENÓRIO,1007,528,322,2132,1810,57,150
PB,19690,CACIMBA DE AREIA,1565,336,315,2496,2181,41,167
PB,19704,COXIXOLA,719,262,99,1312,1213,62,130
PB,19712,CACIMBA DE DENTRO,5332,3327,2819,13134,10315,160,1106
PB,19720,PARARI,747,433,172,1518,1346,20,93
PB,19739,CAIÇARA,2914,1200,998,5883,4885,61,539
PB,19747,PEDRO RÉGIS,1719,824,769,3804,3035,98,284
PB,19755,CAJAZEIRAS,20619,6294,8303,40147,31844,1020,2326
PB,19763,ALCANTIL,1579,1236,444,3703,3259,83,244
PB,19771,CALDAS BRANDÃO,2322,646,657,4205,3548,106,348
PB,19780,BARRA DE SANTANA,2682,1767,940,6341,5401,198,472
PB,19798,CAMALAÚ,2584,574,597,4316,3719,86,376
PB,19801,CATURITÉ,1873,765,385,3554,3169,99,274
PB,19810,CAMPINA GRANDE,105435,81205,32513,253683,221170,4367,11126
PB,19828,RIACHO DE SANTO ANTÔNIO,639,564,112,1468,1356,26,82
PB,19836,CARRAPATEIRA,1264,100,423,1935,1512,12,117
PB,19844,APARECIDA,2836,1196,636,5436,4800,154,482
PB,19852,CATINGUEIRA,1733,797,298,3308,3010,65,297
PB,19860,SÃO FRANCISCO,1796,635,353,3179,2826,89,213
PB,19879,CATOLÉ DO ROCHA,11187,3411,2999,19584,16585,377,1074
PB,19887,VIEIRÓPOLIS,2325,716,561,4165,3604,109,314
PB,19895,CONCEIÇÃO,6986,1616,2867,13309,10442,208,1240
PB,19909,AREIA DE BARAÚNAS,737,381,212,1547,1335,21,149
PB,19917,CONDADO,3049,771,825,5363,4538,89,474
PB,19925,ALGODÃO DE JANDAIRA,1288,289,216,2055,1839,19,182
PB,19933,CONDE,6420,1585,795,10335,9540,332,836
PB,19941,BOA VISTA,2041,1629,294,4437,4143,52,205
PB,19950,CONGO,2336,496,569,3820,3251,89,248
PB,19968,MARCAÇÃO,2437,717,844,4578,3734,125,367
PB,19976,COREMAS,6083,1330,2174,11033,8859,210,862
PB,19984,MATURÉIA,2371,594,487,3959,3472,65,342
PB,19992,CRUZ DO ESPÍRITO SANTO,6824,1858,1434,11836,10402,453,993
PB,20001,SANTA CECILIA DE UMBUZEIRO,1784,1788,1204,5272,4068,85,281
PB,20010,CUBATI,2322,1305,670,5263,4593,155,495
PB,20036,CUITÉ,6857,2959,3276,15176,11900,250,1317
PB,20052,CUITEGI,2404,936,826,4875,4049,157,412
PB,20079,CURRAL VELHO,750,526,568,2083,1515,20,161
PB,20095,DESTERRO,3016,1245,1148,6053,4905,102,399
PB,20117,VISTA SERRANA,1095,644,577,2560,1983,26,156
PB,20133,DIAMANTE,2802,447,1121,5037,3916,67,466
PB,20150,DONA INÊS,3468,1910,1435,7825,6390,92,697
PB,20176,DUAS ESTRADAS,1488,680,374,3048,2674,74,302
PB,20192,EMAS,1290,808,338,2688,2350,15,176
PB,20214,ESPERANÇA,10727,4544,4708,22783,18075,542,1494
PB,20230,FAGUNDES,3912,2238,2339,9670,7331,143,765
PB,20257,FREI MARTINHO,1201,670,244,2431,2187,43,198
PB,20273,GUARABIRA,18273,7589,5264,35784,30520,879,2068
PB,20290,GURINHÉM,4974,2102,2246,10470,8224,266,653
PB,20311,GURJÃO,1271,655,259,2547,2288,48,183
PB,20338,IBIARA,2516,633,1106,5000,3894,76,497
PB,20354,IMACULADA,3531,1574,1412,7524,6112,158,689
PB,20370,INGÁ,6798,1662,3674,13978,10304,296,1136
PB,20397,ITABAIANA,10574,2531,1822,17375,15553,411,1349
PB,20419,ITAPORANGA,8214,2095,3541,15719,12178,268,1163
PB,20435,ITAPOROROCA,5411,2078,1536,10603,9067,301,979
PB,20451,ITATUBA,3530,1668,1749,7905,6156,157,550
PB,20478,JACARAÚ,4799,2426,2066,10745,8679,249,869
PB,20494,JERICÓ,3707,764,968,6053,5085,103,369
PB,20516,JOÃO PESSOA,204367,93451,56024,430643,374619,8970,20335
PB,20532,JUAREZ TAVORA,3081,889,919,5789,4870,202,475
PB,20559,JUAZEIRINHO,5993,1828,1537,10821,9284,239,808
PB,20575,JUNCO DO SERIDÓ,2194,1258,584,4740,4156,95,364
PB,20591,JURIPIRANGA,4399,1346,747,7423,6676,126,634
PB,20613,JURU,3643,796,2344,7757,5413,143,664
PB,20630,LAGOA,2387,435,555,3915,3360,106,337
PB,20656,LAGOA DE DENTRO,2638,1006,1177,5686,4509,146,474
PB,20672,LAGOA SECA,7027,5180,1775,16336,14561,630,1098
PB,20699,LASTRO,1994,296,309,2883,2574,39,203
PB,20710,LIVRAMENTO,2537,1063,869,5089,4220,101,402
PB,20737,LUCENA,4628,1003,1630,8394,6764,225,602
PB,20753,MÃE D'ÁGUA,1647,645,424,3063,2639,62,230
PB,20770,MALTA,2257,808,1040,4676,3636,114,320
PB,20796,MAMANGUAPE,12457,6283,5568,28138,22570,821,2005
PB,20818,MANAÍRA,4240,616,2128,7993,5865,129,703
PB,20834,MARI,7338,2428,2467,14099,11632,412,1009
PB,20850,MASSARANDUBA,3791,2328,1809,9180,7371,316,708
PB,20877,MATARACA,2919,870,846,5355,4509,142,373
PB,20893,MOGEIRO,4434,1971,2473,9727,7254,174,511
PB,20915,MONTADAS,1536,966,573,3511,2938,75,258
PB,20931,MONTE HOREBE,1882,319,901,3500,2599,36,283
PB,20958,MONTEIRO,11539,2937,3502,21338,17836,585,1964
PB,20974,MULUNGU,4285,1228,1261,7765,6504,214,537
PB,20990,NATUBA,2770,1273,1224,6415,5191,185,754
PB,21016,NAZAREZINHO,3393,757,1091,6095,5004,154,520
PB,21032,NOVA FLORESTA,2578,2172,1050,6626,5576,99,467
PB,21059,NOVA OLINDA,2343,602,859,4454,3595,97,464
PB,21075,NOVA PALMEIRA,1331,876,341,2932,2591,83,218
PB,21091,OLHO D'ÁGUA,2933,1354,825,5960,5135,103,579
PB,21113,OLIVEDOS,1460,599,302,2798,2496,77,233
PB,21130,OURO VELHO,1433,542,271,2521,2250,35,147
PB,21156,PASSAGEM,865,461,331,1831,1500,20,112
PB,21172,PATOS,30586,13979,10997,62371,51374,1283,3194
PB,21199,PAULISTA,4224,1733,1495,8667,7172,234,754
PB,21210,PEDRA BRANCA,1465,639,589,3147,2558,53,276
PB,21237,PEDRA LAVRADA,2166,1970,519,5398,4879,121,427
PB,21253,PEDRAS DE FOGO,11054,3003,4350,20813,16463,406,1550
PB,21270,PIANCÓ,5955,2456,1898,11794,9896,151,1059
PB,21296,PICUÍ,6457,3018,2319,13544,11225,325,967
PB,21318,PILAR,4839,1179,1114,8278,7164,201,701
PB,21334,PILÕES,2487,1527,1080,5946,4866,189,485
PB,21350,PILÕEZINHOS,1930,989,954,4527,3573,144,386
PB,21377,PIRPIRITUBA,3129,1759,1322,7157,5835,192,542
PB,21393,PITIMBU,4916,1089,1471,8456,6985,233,531
PB,21415,POCINHOS,4985,3663,1717,11920,10203,280,777
PB,21431,POMBAL,11701,4400,3584,22342,18758,357,1574
PB,21458,PRATA,1733,589,406,3183,2777,50,253
PB,21474,PRINCESA ISABEL,6345,2650,2835,13664,10829,233,1006
PB,21490,PUXINANÃ,4465,2275,996,8860,7864,260,603
PB,21512,QUEIMADAS,11678,6801,4946,27345,22399,935,1878
PB,21539,QUIXABÁ,659,444,89,1370,1281,26,101
PB,21555,REMÍGIO,6528,1886,2045,11841,9796,226,757
PB,21571,RIACHO DOS CAVALOS,3918,998,970,6646,5676,168,468
PB,21598,RIO TINTO,8946,2714,3486,17038,13552,390,1066
PB,21610,SALGADINHO,1066,580,364,2307,1943,41,189
PB,21636,SALGADO DE SÃO FÉLIX,4269,1433,2426,9398,6972,174,700
PB,21652,SANTA CRUZ,3282,593,700,5128,4428,79,347
PB,21679,SANTA HELENA,2804,596,816,4773,3957,85,346
PB,21695,SANTA LUZIA,3991,3877,1717,11043,9326,282,677
PB,21717,SANTANA DE MANGUEIRA,2630,361,887,4410,3523,60,379
PB,21733,SANTANA DOS GARROTES,2815,1087,1276,6060,4784,97,619
PB,21750,SANTA RITA,40321,14252,12526,78716,66190,2587,5375
PB,21776,SANTA TERESINHA,1742,1021,488,3786,3298,69,321
PB,21792,SÃO BENTO,8732,6296,3033,20325,17292,368,1386
PB,21814,SÃO JOÃO DO CARIRI,1762,890,552,3632,3080,79,214
PB,21830,SÃO JOÃO DO TIGRE,1600,532,452,3128,2676,100,357
PB,21857,SÃO JOSÉ DA LAGOA TAPADA,3154,1077,757,5847,5090,124,546
PB,21873,SÃO JOSÉ DE CAIANA,2155,502,1215,4550,3335,79,465
PB,21890,SÃO JOSÉ DE ESPINHARAS,2117,776,452,3811,3359,71,292
PB,21911,SÃO JOSÉ DE PIRANHAS,8116,1276,2582,13490,10908,241,989
PB,21938,SÃO JOSÉ DO BONFIM,1484,574,290,2717,2427,51,238
PB,21954,SÃO JOSÉ DO SABUGI,1326,1122,330,3258,2928,82,281
PB,21970,SÃO JOSÉ DOS CORDEIROS,1778,526,519,3185,2666,62,220
PB,21997,SÃO MAMEDE,2700,2122,1239,6640,5401,62,352
PB,22012,SÃO MIGUEL DE TAIPU,2452,871,595,4445,3850,92,355
PB,22039,SÃO SEBASTIÃO DE LAGOA DE ROÇA,3271,2259,1336,7914,6578,196,589
PB,22055,SÃO SEBASTIÃO DO UMBUZEIRO,1454,333,193,2348,2155,47,243
PB,22071,SAPÉ,17238,5251,8320,35303,26983,937,2532
PB,22098,SÃO VICENTE DO SERIDÓ,3261,1498,1282,6939,5657,166,522
PB,22110,SERRA BRANCA,4312,2176,1429,9045,7616,195,586
PB,22136,SERRA DA RAIZ,1139,673,518,2661,2143,52,176
PB,22152,SERRA GRANDE,1359,365,453,2565,2112,55,224
PB,22179,SERRA REDONDA,2961,1045,1090,5838,4748,101,484
PB,22195,SERRARIA,2298,798,715,4655,3940,105,516
PB,22217,SOLÂNEA,7921,5228,5782,21553,15771,500,1313
PB,22233,SOLEDADE,4070,2777,1309,9585,8276,272,705
PB,22250,SOUSA,24044,6421,7982,43828,35846,985,2717
PB,22276,SUMÉ,6691,1422,1940,11552,9612,218,896
PB,22292,CAMPO DE SANTANA,3210,1380,1226,6677,5451,169,534
PB,22314,TAPEROÁ,4285,2523,1854,9857,8003,212,706
PB,22330,TAVARES,4621,1299,2446,9736,7290,290,887
PB,22357,TEIXEIRA,4636,2035,1524,9344,7820,210,713
PB,22373,TRIUNFO,3688,773,1747,7084,5337,165,526
PB,22390,UIRAÚNA,5757,1513,1829,10444,8615,186,731
PB,22411,UMBUZEIRO,2668,1961,1340,6920,5580,174,611
PB,22438,VÁRZEA,1046,576,168,2041,1873,25,138
PE,23000,QUIXABA,3068,178,919,4934,4015,109,569
PE,23019,AFOGADOS DA INGAZEIRA,11383,4224,6260,24912,18652,661,1885
PE,23027,LAGOA DO CARRO,5193,2620,1877,11107,9230,339,876
PE,23035,AFRÂNIO,8301,964,1824,13107,11283,284,1521
PE,23043,SANTA CRUZ DA BAIXA VERDE,5964,386,1988,9368,7380,173,697
PE,23051,AGRESTINA,9453,1666,1921,15494,13573,550,1508
PE,23060,XEXÉU,4699,1291,3117,10460,7343,245,882
PE,23078,ÁGUA PRETA,9678,2274,5420,19944,14524,624,1471
PE,23086,VERTENTE DO LÉRIO,2768,1278,794,5809,5015,201,667
PE,23094,ÁGUAS BELAS,13542,4233,7581,28881,21300,409,2634
PE,23108,SANTA CRUZ,5333,1000,1854,9559,7705,153,1022
PE,23116,ALAGOINHA,4557,2167,1098,9078,7980,188,888
PE,23124,JUCATI,4588,581,1896,8428,6532,399,801
PE,23132,ALIANÇA,13967,2850,7088,27565,20477,963,2082
PE,23140,DORMENTES,6469,1948,2056,12243,10187,336,1223
PE,23159,ALTINHO,7282,2903,3564,16640,13076,777,1733
PE,23167,CARNAUBEIRA DA PENHA,5194,382,1933,8732,6799,188,828
PE,23175,AMARAJI,7509,2352,4048,16361,12313,812,1258
PE,23183,LAGOA GRANDE,8925,1432,3448,15751,12303,233,1470
PE,23191,ANGELIM,3322,1960,1353,7428,6075,119,548
PE,23205,ARAÇOIABA,7017,1874,2322,12670,10348,343,908
PE,23213,ARARIPINA,25065,6532,11075,48522,37447,975,3824
PE,23221,CASINHAS,5370,1148,2519,10655,8136,233,1168
PE,23230,ARCOVERDE,22774,6243,9309,42913,33604,985,2426
PE,23248,MANARI,4519,1186,1939,9076,7137,195,1090
PE,23256,BARRA DE GUABIRABA,4295,1251,2029,8806,6777,302,749
PE,23264,JATOBÁ,6211,848,2149,10145,7996,95,550
PE,23272,BARREIROS,14821,3449,8342,30213,21871,924,1777
PE,23280,TAMANDARÉ,6407,1978,3148,13050,9902,336,857
PE,23299,BELÉM DE MARIA,4031,1178,983,7241,6258,243,614
PE,23302,JAQUEIRA,3404,1979,2143,8433,6290,138,632
PE,23310,BELÉM DE SÃO FRANCISCO,8328,1325,3509,14961,11452,195,1206
PE,23329,SANTA FILOMENA,4412,1492,1877,8964,7087,178,801
PE,23337,BELO JARDIM,24077,10645,10463,52292,41829,1376,4620
PE,23353,BETÂNIA,4697,384,1776,8444,6668,234,1237
PE,23370,BEZERROS,20247,7194,8011,42164,34153,2221,3376
PE,23396,BODOCÓ,10183,4468,3586,21011,17425,393,2016
PE,23418,BOM CONSELHO,15750,2768,8137,30612,22475,638,2603
PE,23434,BOM JARDIM,11680,5847,7100,28424,21324,808,2472
PE,23450,BONITO,14485,2824,5819,26857,21038,751,2397
PE,23477,BREJÃO,4480,876,1079,7847,6768,280,984
PE,23493,BREJINHO,3205,503,849,5488,4639,178,656
PE,23515,BREJO DA MADRE DE DEUS,11005,5093,5049,25077,20028,1027,2243
PE,23531,BUENOS AIRES,5419,1229,1086,9197,8111,244,1030
PE,23558,BUÍQUE,16860,1805,7830,31688,23858,883,3530
PE,23574,CABO DE SANTO AGOSTINHO,74516,16447,18942,125865,106923,4775,7147
PE,23590,CABROBÓ,11512,2086,4235,19886,15651,314,1352
PE,23612,CACHOEIRINHA,6868,2435,3078,14278,11200,392,1260
PE,23639,CAETÉS,8413,1407,3985,15948,11963,426,1498
PE,23655,CALÇADO,3564,921,1562,7104,5542,245,675
PE,23671,CALUMBI,3364,206,813,5208,4395,153,564
PE,23698,CAMOCIM DE SÃO FÉLIX,7133,1119,2607,12772,10165,515,1079
PE,23710,CAMUTANGA,3522,1035,750,6244,5494,201,534
PE,23736,CANHOTINHO,7344,3305,4435,17543,13108,365,1775
PE,23752,CAPOEIRAS,7397,1760,3812,14825,11013,595,1002
PE,23779,CARNAÍBA,6624,1967,1973,12451,10478,233,1484
PE,23795,CARPINA,19712,13035,7697,46238,38541,1579,2805
PE,23817,CARUARU,86905,40507,24868,174680,149812,7448,9372
PE,23833,CATENDE,12754,2449,6213,24184,17971,499,1542
PE,23850,CEDRO,4130,801,1877,7814,5937,138,686
PE,23876,CHÃ DE ALEGRIA,5273,1031,932,8506,7574,273,834
PE,23892,CHÃ GRANDE,5649,3636,2141,13684,11543,711,1209
PE,23914,CONDADO,8880,1942,3897,16705,12808,500,1179
PE,23930,CORRENTES,6692,909,3213,12273,9060,260,1012
PE,23957,CORTÊS,5811,1305,1297,9865,8568,222,853
PE,23973,CUMARU,7218,1706,3453,14361,10908,503,1239
PE,23990,CUPIRA,9112,1345,5082,17806,12724,456,1341
PE,24015,CUSTÓDIA,13057,1724,6634,24493,17859,581,2090
PE,24031,ESCADA,24009,6730,8779,44363,35584,945,2491
PE,24058,EXU,11826,3068,7058,25596,18538,421,2603
PE,24074,FEIRA NOVA,7312,2595,3528,15764,12236,683,1266
PE,24090,FERREIROS,4367,1363,2068,9253,7185,380,828
PE,24112,FLORES,8936,1116,5183,17472,12289,394,1627
PE,24139,FLORESTA,12409,1359,3752,19585,15833,238,1352
PE,24155,FREI MIGUELINHO,4774,2486,1925,10890,8965,430,1069
PE,24171,GAMELEIRA,7685,1766,3886,15077,11191,300,1094
PE,24198,GARANHUNS,48252,6253,15223,77949,62726,2053,4106
PE,24210,GLÓRIA DO GOITÁ,9213,3361,4415,19879,15464,763,1764
PE,24236,GOIANA,32062,5367,8626,51100,42474,1539,2098
PE,24252,GRANITO,2715,376,760,4309,3549,68,306
PE,24279,GRAVATÁ,19333,13317,9120,49991,40871,2341,4066
PE,24295,IATI,7269,842,3829,13829,10000,251,1401
PE,24317,IBIMIRIM,10218,899,4978,18177,13199,316,1486
PE,24333,IBIRAJUBA,2641,905,880,5446,4566,228,665
PE,24350,IGARASSU,33270,9242,8824,58250,49426,1969,2647
PE,24376,IGUARACI,4155,1288,2515,9279,6764,220,949
PE,24392,INAJÁ,5469,417,1736,8884,7148,156,808
PE,24414,INGAZEIRA,1800,345,378,3057,2679,137,342
PE,24430,IPOJUCA,26008,7408,8376,48334,39958,1841,3412
PE,24457,IPUBI,8633,1992,4143,16943,12800,254,1594
PE,24473,ITACURUBA,2168,215,335,3131,2796,42,276
PE,24490,ITAÍBA,7872,2807,4058,17097,13039,241,1747
PE,24511,ITAMARACÁ,7468,2227,2532,13649,11117,313,507
PE,24538,ITAPETIM,6480,727,3213,11797,8584,221,997
PE,24554,ITAQUITINGA,6892,936,2536,11589,9053,210,786
PE,24570,JABOATÃO DOS GUARARAPES,196633,66711,53466,372803,319337,13726,16754
PE,24597,JATAÚBA,4814,2864,2348,11341,8993,206,943
PE,24619,JOÃO ALFREDO,10127,3413,5724,22992,17268,763,2489
PE,24635,JOAQUIM NABUCO,6025,1260,1548,10247,8699,310,862
PE,24651,JUPI,5423,658,1071,8660,7589,386,934
PE,24678,JUREMA,4979,1238,1809,9505,7696,176,1149
PE,24694,LAGOA DE ITAENGA,6564,4378,1531,14607,13076,542,1344
PE,24716,LAGOA DO OURO,4916,1072,1162,8502,7340,191,1018
PE,24732,LAGOA DOS GATOS,5574,1217,2867,11426,8559,260,1241
PE,24759,LAJEDO,12046,5141,6320,27532,21212,908,2382
PE,24775,LIMOEIRO,19679,8463,9347,43993,34646,1984,3137
PE,24791,MACAPARANA,8783,2388,2381,16188,13807,516,1699
PE,24813,MACHADOS,4410,1197,1123,7905,6782,275,713
PE,24830,MARAIAL,4055,1415,2996,9875,6879,233,886
PE,24856,MIRANDIBA,5259,1464,2731,10907,8176,283,960
PE,24872,MORENO,18656,6641,5970,37083,31113,1713,2424
PE,24899,NAZARÉ DA MATA,10278,5374,4685,24227,19542,1509,1570
PE,24910,OLINDA,157610,46818,38227,283834,245607,8122,11931
PE,24937,OROBÓ,7560,2742,4960,17385,12425,591,1231
PE,24953,OROCÓ,4174,2083,1875,9440,7565,202,890
PE,24970,OURICURI,18617,5372,9319,38700,29381,689,3871
PE,24996,PALMARES,21115,4802,10781,42017,31236,1127,2574
PE,25011,PALMEIRINA,3771,311,1675,6706,5031,124,694
PE,25038,PANELAS,6095,5443,5616,19734,14118,253,2030
PE,25054,PARANATAMA,5225,540,999,7846,6847,224,724
PE,25070,PARNAMIRIM,8820,1502,2852,14633,11781,306,903
PE,25097,PASSIRA,11210,2801,5339,22733,17394,904,1996
PE,25119,PAUDALHO,11647,9552,4899,30653,25754,1389,2303
PE,25135,PAULISTA,97012,28790,24534,174476,149942,5130,6387
PE,25151,PEDRA,8081,1804,3667,16045,12378,504,1567
PE,25178,PESQUEIRA,24471,4507,10220,44571,34351,1182,3020
PE,25194,PETROLÂNDIA,12508,2074,4030,20600,16570,348,1164
PE,25216,PETROLINA,80457,22607,24162,144394,120232,3184,8010
PE,25232,POÇÃO,4296,1239,1522,8464,6942,294,916
PE,25259,POMBOS,8272,2938,1516,15182,13666,841,1287
PE,25275,PRIMAVERA,4244,1523,1897,8890,6993,333,614
PE,25291,QUIPAPÁ,7124,1516,5564,16642,11078,449,1645
PE,25313,RECIFE,518634,227913,158727,1075408,916681,31728,41776
PE,25330,RIACHO DAS ALMAS,7664,1868,1420,13496,12076,780,1471
PE,25356,RIBEIRÃO,15907,3146,8084,30391,22307,627,1747
PE,25372,RIO FORMOSO,8243,2699,4496,17119,12623,322,1038
PE,25399,SAIRÉ,5235,1196,1185,9465,8280,579,1034
PE,25410,SALGADINHO,2099,1234,756,5004,4248,151,673
PE,25437,SALGUEIRO,16749,7017,6926,34329,27403,640,2126
PE,25453,SALOÁ,6065,1094,2965,11806,8841,369,1109
PE,25470,SANHARÓ,7980,1176,1509,12528,11019,254,1337
PE,25496,SANTA CRUZ DO CAPIBARIBE,19003,12019,5860,42624,36764,1734,2399
PE,25518,SANTA MARIA DA BOA VISTA,14401,2736,4486,23798,19312,230,1667
PE,25534,SANTA MARIA DO CAMBUCÁ,4195,1933,1125,8714,7589,326,924
PE,25550,SANTA TEREZINHA,4009,986,1906,7805,5899,69,651
PE,25577,SÃO BENEDITO DO SUL,2668,1104,2493,7480,4987,207,871
PE,25593,SÃO BENTO DO UNA,15329,4031,7142,30865,23723,1074,2702
PE,25615,SÃO CAITANO,11903,3819,5215,25910,20695,1583,2672
PE,25631,SÃO JOÃO,9142,768,3413,15181,11768,259,1366
PE,25658,SÃO JOAQUIM DO MONTE,8772,1548,3561,16280,12719,440,1517
PE,25674,SÃO JOSÉ DA COROA GRANDE,5176,1918,1493,10016,8523,425,726
PE,25690,SÃO JOSÉ DO BELMONTE,12197,2493,6838,24224,17386,426,1857
PE,25712,SÃO JOSÉ DO EGITO,11108,2617,5519,22169,16650,644,1821
PE,25739,SÃO LOURENÇO DA MATA,33386,12592,10838,66341,55503,2712,3721
PE,25755,SÃO VICENTE FERRER,6241,1597,3122,12783,9661,314,1273
PE,25771,SERRA TALHADA,30104,3602,11923,51276,39353,877,3581
PE,25798,SERRITA,5970,2265,2965,13120,10155,180,1468
PE,25810,SERTÂNIA,11535,3929,6743,25480,18737,603,2145
PE,25836,SIRINHAÉM,13372,4094,6136,26541,20405,550,1838
PE,25852,MOREILÂNDIA,4868,650,2328,8941,6613,130,783
PE,25879,SOLIDÃO,2699,258,672,4224,3552,83,419
PE,25895,SURUBIM,17929,6542,7546,36926,29380,1654,2328
PE,25917,TABIRA,10817,1383,4251,18751,14500,490,1475
PE,25933,TACAIMBÓ,4599,1533,2218,9911,7693,408,918
PE,25950,TACARATU,5499,1503,2924,11787,8863,292,1187
PE,25976,ITAMBÉ,10839,3926,5269,22623,17354,498,1659
PE,25992,TAQUARITINGA DO NORTE,6720,4225,2357,15644,13287,603,1211
PE,26018,TEREZINHA,2871,657,852,5342,4490,154,717
PE,26034,TERRA NOVA,4376,691,829,6816,5987,163,637
PE,26050,TIMBAÚBA,21955,5935,10437,42736,32299,1118,2249
PE,26077,TORITAMA,7507,4167,2736,16753,14017,860,968
PE,26093,TRACUNHAÉM,4791,1910,2110,10198,8088,358,810
PE,26115,TRINDADE,8777,2215,4140,16870,12730,356,1120
PE,26131,TRIUNFO,6876,746,1918,10832,8914,245,735
PE,26158,TUPANATINGA,6506,1481,4065,14347,10282,453,1572
PE,26174,TUPARETAMA,4114,523,933,6485,5552,186,596
PE,26190,VENTUROSA,6656,1246,2370,11835,9465,301,1036
PE,26212,VERDEJANTE,3506,1349,1957,7859,5902,163,771
PE,26239,VERTENTES,5265,2840,1796,12036,10240,616,1102
PE,26255,VICÊNCIA,10374,2969,5569,22004,16435,766,1832
PE,26271,VITÓRIA DE SANTO ANTÃO,43018,18033,14629,87573,72944,3388,5581
PE,26298,CAMARAGIBE,53151,19369,12938,99675,86737,3974,4654
PE,26310,ABREU E LIMA,43225,9869,10870,71978,61108,2130,2959
PE,26336,ITAPISSUMA,9697,1811,2546,15749,13203,595,719
PE,30015,FERNANDO DE NORONHA,743,354,383,1752,1369,49,79
PI,10006,BRASILEIRA,2037,1920,1276,5848,4572,98,397
PI,10014,AGRICOLÂNDIA,2585,707,620,4385,3765,63,286
PI,10022,ALEGRETE DO PIAUÍ,2234,319,634,3490,2856,28,219
PI,10030,ÁGUA BRANCA,6413,1424,1911,11083,9172,199,813
PI,10049,BAIXA GRANDE DO RIBEIRO,2538,1474,775,5323,4548,70,358
PI,10057,ALTO LONGÁ,4813,2136,1640,9793,8153,127,859
PI,10065,BOM PRINCÍPIO DO PIAUÍ,2151,1259,936,4911,3975,66,426
PI,10073,ALTOS,15188,4555,4196,26512,22316,378,1459
PI,10081,BONFIM DO PIAUÍ,2566,247,687,3904,3217,49,272
PI,10090,AMARANTE,7464,1735,2396,12909,10513,215,704
PI,10103,BURITI DOS MONTES,3034,793,664,5137,4473,65,439
PI,10111,ANGICAL DO PIAUÍ,3547,876,911,5994,5083,81,359
PI,10120,CABECEIRAS DO PIAUÍ,4227,801,1263,7025,5762,86,505
PI,10138,ANÍSIO DE ABREU,3679,610,774,5548,4774,54,308
PI,10146,CALDEIRÃO GRANDE DO PIAUÍ,1934,1043,564,3982,3418,67,307
PI,10154,ANTÔNIO ALMEIDA,1068,775,486,2613,2127,39,181
PI,10162,CANAVIEIRA,1226,793,537,2905,2368,43,262
PI,10170,AROAZES,2694,614,1092,4875,3783,58,347
PI,10189,COIVARAS,1870,950,450,3608,3158,34,186
PI,10197,ARRAIAL,1828,648,653,3544,2891,49,268
PI,10200,COLÔNIA DO GURGUÉIA,2583,504,707,4228,3521,47,328
PI,10219,AVELINO LOPES,4207,1260,1050,7323,6273,152,544
PI,10227,COLÔNIA DO PIAUÍ,3387,392,942,5276,4334,70,405
PI,10235,BARRAS,11123,6330,3888,24540,20652,373,2090
PI,10243,CORONEL JOSÉ DIAS,2517,603,463,4111,3648,74,279
PI,10251,BARREIRAS DO PIAUÍ,1424,413,572,2699,2127,39,191
PI,10260,FARTURA DO PIAUÍ,2590,363,689,3990,3301,34,237
PI,10278,BARRO DURO,2607,965,1078,5266,4188,43,400
PI,10286,JACOBINA DO PIAUÍ,2884,275,624,4134,3510,57,232
PI,10294,BATALHA,8048,4879,3646,18507,14861,262,1322
PI,10308,JARDIM DO MULATO,1939,498,660,3545,2885,71,273
PI,10316,BENEDITINOS,4569,1158,1299,7987,6688,134,597
PI,10324,LAGOA ALEGRE,3314,1109,875,5948,5073,72,441
PI,10332,BERTOLÍNIA,1755,945,648,3793,3145,59,329
PI,10340,LAGOA DO BARRO DO PIAUÍ,1892,400,540,3257,2717,106,253
PI,10359,BOCAINA,2346,1524,510,4879,4369,86,278
PI,10367,MARCOLÂNDIA,2823,804,432,4730,4298,114,461
PI,10375,BOM JESUS,5385,3648,1759,12052,10293,182,811
PI,10383,PATOS DO PIAUÍ,2232,1030,623,4817,4194,105,651
PI,10391,BURITI DOS LOPES,5289,4184,1616,12627,11011,190,1013
PI,10405,PASSAGEM FRANCA DO PIAUÍ,1938,329,762,3388,2626,35,263
PI,10413,CAMPINAS DO PIAUÍ,1806,1303,484,4211,3727,76,426
PI,10421,QUEIMADA NOVA,3584,569,928,5822,4894,122,543
PI,10430,CAMPO MAIOR,17329,6928,5108,32955,27847,526,1853
PI,10448,SANTA CRUZ DOS MILAGRES,1610,353,704,2984,2280,28,204
PI,10456,CANTO DO BURITI,6407,3343,2391,13943,11552,328,1075
PI,10464,SANTA ROSA DO PIAUÍ,1635,1059,725,3807,3082,64,264
PI,10472,CAPITÃO DE CAMPOS,3414,1861,1787,8271,6484,187,728
PI,10480,SANTANA DO PIAUÍ,2321,403,499,3639,3140,52,255
PI,10499,CARACOL,4174,686,583,6280,5697,75,609
PI,10502,SÃO BRAZ DO PIAUÍ,2172,206,485,3173,2688,38,214
PI,10510,CASTELO DO PIAUÍ,7437,2437,2770,14488,11718,244,1222
PI,10529,SÃO JOSÉ DO DIVINO,2027,1049,587,4184,3597,77,333
PI,10537,COCAL,5628,5620,3890,18060,14170,644,1798
PI,10545,SIGEFREDO PACHECO,3550,1413,850,6528,5678,117,459
PI,10553,CONCEIÇÃO DO CANINDÉ,1889,715,632,3852,3220,75,438
PI,10561,SÃO LOURENÇO DO PIAUÍ,2593,427,753,4268,3515,61,316
PI,10570,CORRENTE,6785,3467,2802,14951,12149,236,1244
PI,10588,VÁRZEA BRANCA,2088,352,652,3454,2802,51,248
PI,10596,CRISTALÂNDIA DO PIAUÍ,2330,1258,1141,5383,4242,54,506
PI,10600,BARRA D'ALCÂNTARA,1078,657,824,2932,2108,26,240
PI,10618,CRISTINO CASTRO,3756,626,1175,6325,5150,137,502
PI,10626,BELA VISTA DO PIAUÍ,1764,202,181,2526,2345,89,217
PI,10634,CURIMATÁ,3310,2114,1279,7484,6205,142,446
PI,10642,BREJO DO PIAUÍ,2088,221,420,3061,2641,48,240
PI,10650,DEMERVAL LOBÃO,4984,1888,1355,9363,8008,130,743
PI,10669,BOA HORA,1846,1233,576,4176,3600,51,361
PI,10677,DOM EXPEDITO LOPES,3228,938,773,5537,4764,63,395
PI,10685,DOM INOCÊNCIO,4307,347,1000,6495,5495,83,621
PI,10693,ELESBÃO VELOSO,6145,1897,2887,12360,9473,142,1001
PI,10707,CAPITÃO GERVÁSIO OLIVEIRA,1781,488,394,3061,2667,47,300
PI,10715,ELISEU MARTINS,1930,653,539,3535,2996,83,250
PI,10723,CAMPO GRANDE DO PIAUÍ,2350,427,407,3686,3279,90,313
PI,10731,ESPERANTINA,12560,5800,4717,25716,20999,389,1716
PI,10740,CAMPO LARGO DO PIAUÍ,2318,595,631,4082,3451,98,356
PI,10758,FLORES DO PIAUÍ,1259,1133,622,3522,2900,90,349
PI,10766,CURRAIS,2275,774,547,4037,3490,42,346
PI,10774,FLORIANO,18813,8198,6501,37174,30673,606,1832
PI,10782,GEMINIANO,2294,778,551,4185,3634,95,386
PI,10790,FRANCINÓPOLIS,1960,836,1052,4354,3302,88,336
PI,10804,GUARIBAS,2100,214,575,3214,2639,40,241
PI,10812,FRANCISCO AYRES,2028,701,828,3913,3085,63,239
PI,10820,ILHA GRANDE,2606,1075,567,4916,4349,109,386
PI,10839,FRANCISCO SANTOS,2946,1287,869,5932,5063,171,439
PI,10847,JUREMA,1838,819,530,3614,3084,53,308
PI,10855,FRONTEIRAS,4248,1371,1367,7985,6618,163,502
PI,10863,LAGOA DE SÃO FRANCISCO,1704,1182,556,3897,3341,33,340
PI,10871,GILBUÉS,3516,1163,1445,6778,5333,104,425
PI,10880,MORRO CABEÇA NO TEMPO,1264,918,499,3146,2647,79,320
PI,10898,GUADALUPE,3353,1664,1458,7175,5717,106,458
PI,10901,NOVO SANTO ANTÔNIO,1740,357,412,2841,2429,48,225
PI,10910,HUGO NAPOLEÃO,1775,550,607,3329,2722,56,260
PI,10928,NOSSA SENHORA DE NAZARÉ,2371,644,580,3924,3344,52,182
PI,10936,INHUMA,5940,1320,2253,10907,8654,164,896
PI,10944,PAQUETÁ,2158,462,531,3551,3020,39,304
PI,10952,IPIRANGA DO PIAUÍ,3794,669,1169,6461,5292,133,567
PI,10960,NOVA SANTA RITA,2001,404,412,3261,2849,57,310
PI,10979,ISAÍAS COELHO,2562,1296,943,5705,4762,112,657
PI,10987,SÃO JOÃO DO ARRAIAL,2501,1396,704,5083,4379,52,383
PI,10995,ITAINÓPOLIS,4294,1778,1090,8374,7284,233,804
PI,11010,ITAUEIRA,3123,2668,1399,8254,6855,182,727
PI,11037,JAICÓS,5121,2123,2234,11170,8936,336,1007
PI,11053,JERUMENHA,1517,1028,676,3644,2968,76,272
PI,11070,JOAQUIM PIRES,4835,1884,1414,9199,7785,110,782
PI,11088,SÃO JOÃO DA CANABRAVA,1850,904,554,3734,3180,57,305
PI,11096,JOSÉ DE FREITAS,14543,3907,3844,24845,21001,431,1465
PI,11118,LANDRI SALES,2073,654,1009,4178,3169,75,297
PI,11134,LUIS CORREIA,8041,6202,3467,20186,16719,330,1539
PI,11150,LUZILÂNDIA,8652,3433,2535,16726,14191,292,1479
PI,11177,MANOEL EMÍDIO,2345,513,623,3887,3264,53,287
PI,11193,MARCOS PARENTE,1338,1218,754,3700,2946,64,255
PI,11215,MATIAS OLÍMPIO,2723,2370,1244,7321,6077,191,665
PI,11231,MIGUEL ALVES,9816,4092,3507,20010,16503,407,1698
PI,11258,MIGUEL LEÃO,532,215,121,960,839,7,58
PI,11274,MONSENHOR GIL,5091,1078,1304,8309,7005,103,461
PI,11290,MONSENHOR HIPÓLITO,2329,1792,638,5626,4988,94,591
PI,11312,MONTE ALEGRE DO PIAUÍ,3283,1479,1417,6963,5546,83,551
PI,11339,NAZARÉ DO PIAUÍ,3350,842,1039,5978,4939,99,507
PI,11355,NOSSA SENHORA DOS REMÉDIOS,2798,1422,913,5837,4924,103,495
PI,11371,NOVO ORIENTE DO PIAUÍ,2754,487,1135,4883,3748,63,364
PI,11398,OEIRAS,11183,5494,3438,23117,19679,400,1953
PI,11410,DOMINGOS MOURÃO,1486,571,473,2927,2454,57,266
PI,11436,PADRE MARCOS,2376,1264,903,5296,4393,89,480
PI,11452,PAES LANDIM,1602,855,510,3333,2823,64,218
PI,11479,PALMEIRA DO PIAUÍ,1807,842,549,3712,3163,76,354
PI,11495,PALMEIRAIS,5547,1565,1023,9323,8300,190,642
PI,11517,PARNAGUÁ,3592,676,1002,5784,4782,83,322
PI,11533,PARNAÍBA,39614,21443,16903,86242,69339,1198,3739
PI,11550,PAULISTANA,8677,1138,1781,13050,11269,191,1042
PI,11576,PEDRO II,10840,4958,4069,22415,18346,367,1561
PI,11592,PICOS,21570,10915,6076,43774,37698,923,2742
PI,11614,PIMENTEIRAS,4252,1580,1384,8095,6711,90,662
PI,11630,PIO IX,6589,2304,1725,12079,10354,163,951
PI,11657,PIRACURUCA,8642,4614,3041,18377,15336,276,1396
PI,11673,PIRIPIRI,17112,11029,8272,40961,32689,1023,2152
PI,11690,PORTO,3935,1195,1256,7297,6041,110,643
PI,11711,PRATA DO PIAUÍ,1407,654,760,3198,2438,50,252
PI,11738,REDENÇÃO DO GURGUÉIA,2560,1444,896,5492,4596,67,406
PI,11754,REGENERAÇÃO,6747,1264,2613,12039,9426,174,904
PI,11770,RIBEIRO GONÇALVES,1796,1629,765,4753,3988,40,425
PI,11797,RIO GRANDE DO PIAUÍ,2234,1500,1159,5564,4405,65,501
PI,11819,SANTA CRUZ DO PIAUÍ,2684,735,634,4715,4081,66,426
PI,11835,SANTA FILOMENA,1227,1313,654,3839,3185,91,401
PI,11851,SANTA LUZ,2114,798,480,3843,3363,88,282
PI,11878,SANTO ANTÔNIO DE LISBOA,2263,977,534,4383,3849,106,275
PI,11894,SANTO INÁCIO DO PIAUÍ,1560,548,354,2740,2386,26,193
PI,11916,SÃO FÉLIX DO PIAUÍ,1830,485,595,3230,2635,29,187
PI,11932,SÃO FRANCISCO DO PIAUÍ,2394,840,868,4787,3919,71,532
PI,11959,SÃO GONÇALO DO PIAUÍ,2147,604,482,3677,3195,54,254
PI,11975,SÃO JOÃO DA SERRA,2345,1559,1195,5854,4659,171,442
PI,11991,SÃO JOÃO DO PIAUÍ,5207,3304,1836,11859,10023,203,1006
PI,12009,SÃO JOÃO DA FRONTEIRA,1896,773,673,3822,3149,39,355
PI,12017,SÃO JOSÉ DO PEIXE,1271,728,379,2713,2334,33,212
PI,12025,SÃO JOÃO DA VARJOTA,1893,394,485,3211,2726,83,300
PI,12033,SÃO JOSÉ DO PIAUÍ,3089,734,724,5158,4434,113,437
PI,12041,SEBASTIÃO BARROS,1738,688,820,3675,2855,42,336
PI,12050,SÃO JULIÃO,2285,935,652,4487,3835,28,387
PI,12068,SEBASTIÃO LEAL,1605,691,268,2849,2581,59,200
PI,12076,SÃO MIGUEL DO TAPUIO,6435,3243,2748,14172,11424,231,1267
PI,12084,ALVORADA DO GURGUÉIA,2174,221,477,3259,2782,32,280
PI,12092,SÃO PEDRO DO PIAUÍ,4723,2224,1605,9626,8021,125,679
PI,12106,ASSUNÇÃO DO PIAUÍ,1583,1733,1219,5461,4242,267,553
PI,12114,SÃO RAIMUNDO NONATO,10578,3289,2525,18284,15759,312,1148
PI,12122,BETÂNIA DO PIAUÍ,2739,462,722,4383,3661,54,319
PI,12130,SIMÕES,5262,980,1881,9642,7761,270,950
PI,12149,BOQUEIRÃO DO PIAUÍ,2220,512,1104,4293,3189,79,279
PI,12157,SIMPLÍCIO MENDES,3949,2199,1402,8523,7121,172,570
PI,12165,CARIDADE DO PIAUÍ,2319,333,509,3606,3097,54,320
PI,12173,SOCORRO DO PIAUÍ,1828,833,552,3688,3136,65,304
PI,12181,CURRAL NOVO DO PIAUÍ,1827,297,585,3146,2561,73,302
PI,12190,TERESINA,244347,105522,65291,470213,404922,6594,16708
PI,12203,JÚLIO BORGES,2397,319,614,3703,3089,35,291
PI,12211,UNIÃO,16848,4319,4512,28970,24458,392,2110
PI,12220,LAGOA DO SÍTIO,2396,311,574,3656,3082,54,273
PI,12238,URUÇUÍ,3369,5420,2097,12495,10398,225,1115
PI,12246,MILTON BRANDÃO,1671,1931,1075,5194,4119,55,372
PI,12254,VALENÇA DO PIAUÍ,7750,2655,3027,15252,12225,247,1196
PI,12262,PAJEÚ DO PIAUÍ,1051,810,649,2865,2216,44,264
PI,12270,VÁRZEA GRANDE,1404,877,734,3604,2870,55,357
PI,12289,PAVUSSU,2019,388,639,3419,2780,52,248
PI,12297,DIRCEU ARCOVERDE,2810,751,869,4801,3932,64,229
PI,12300,RIACHO FRIO,2521,446,572,3846,3274,34,222
PI,12319,ALAGOINHA,2145,1893,775,5660,4885,126,586
PI,12327,ACAUÃ,3320,373,469,4658,4189,110,303
PI,12335,BELÉM DO PIAUÍ,1071,619,254,2313,2059,57,250
PI,12343,CAJAZEIRAS DO PIAUÍ,1218,587,334,2483,2149,73,219
PI,12351,CAMPO ALEGRE DO FIDALGO,1742,775,514,3503,2989,35,333
PI,12360,COCAL DE TELHA,2234,349,872,3884,3012,68,307
PI,12378,FRANCISCO MACEDO,833,596,249,1908,1659,26,174
PI,12386,JOÃO COSTA,1517,439,311,2681,2370,53,287
PI,12394,JATOBÁ DO PIAUÍ,2362,907,611,4310,3699,55,266
PI,12408,JOCA MARQUES,1307,1056,530,3283,2753,55,287
PI,12416,JUAZEIRO DO PIAUÍ,3081,969,754,5456,4702,79,424
PI,12424,LAGOA DO PIAUÍ,1668,618,391,3006,2615,33,229
PI,12432,LAGOINHA DO PIAUÍ,1328,209,387,2105,1718,19,121
PI,12440,MADEIRO,1963,1552,894,4917,4023,58,371
PI,12459,MORRO DO CHAPÉU DO PIAUÍ,2124,1452,799,4838,4039,47,354
PI,12467,MASSAPÊ DO PIAUÍ,2643,827,606,4848,4242,121,557
PI,12475,MURICI DOS PORTELAS,2291,1284,963,5167,4204,92,456
PI,12483,OLHO D'ÁGUA DO PIAUÍ,1286,224,439,2167,1728,39,135
PI,12491,PEDRO LAURENTINO,1259,379,315,2210,1895,36,164
PI,12505,SÃO FRANCISCO DE ASSIS DO PIAUÍ,1738,896,463,3557,3094,42,307
PI,12513,SUSSUAPARA,2439,1165,608,4868,4260,133,401
PI,12521,TANQUE DO PIAUÍ,1114,315,293,1992,1699,36,154
PI,12530,TAMBORIL DO PIAUÍ,659,1059,446,2408,1962,21,196
PI,12548,VILA NOVA DO PIAUÍ,1433,289,235,2273,2038,33,219
PI,12556,VERA MENDES,1242,444,443,2637,2194,95,361
PI,12564,WALL FERRAZ,2126,349,466,3434,2968,36,328
PI,12572,CAJUEIRO DA PRAIA,2637,953,870,5057,4187,74,416
PI,12580,CURRALINHOS,2105,514,302,3214,2912,24,222
PI,12599,PORTO ALEGRE DO PIAUÍ,909,395,228,1702,1474,16,139
PI,12602,RIBEIRA DO PIAUÍ,1876,489,473,3263,2790,33,332
PI,12610,SÃO GONÇALO DO GURGUÉIA,1195,259,425,2029,1604,28,84
PI,12629,SÃO LUIS DO PIAUÍ,954,654,269,2134,1865,33,162
PI,12637,FLORESTA DO PIAUÍ,1233,329,310,2129,1819,17,194
PI,12653,SANTO ANTÔNIO DOS MILAGRES,1065,115,217,1555,1338,24,96
PI,12661,SÃO MIGUEL DA BAIXA GRANDE,1144,402,305,2071,1766,21,149
PI,12670,CARAÚBAS DO PIAUÍ,1707,1411,691,4296,3605,55,364
PI,12688,CAXINGÓ,1603,1294,697,4097,3400,56,357
PI,12696,COCAL DOS ALVES,1623,1250,772,4184,3412,112,331
PI,12700,SÃO MIGUEL DO FIDALGO,1343,328,276,2211,1935,45,186
PI,12718,PAU D'ARCO DO PIAUÍ,1931,404,474,3132,2658,40,208
PI,12726,NAZÁRIA,4074,1237,1233,7239,6006,88,422
PI,12734,AROEIRAS DO ITAIM,1096,1162,408,3088,2680,82,263
PR,74004,GODOY MOREIRA,930,1054,638,2911,2273,46,160
PR,74012,ABATIÁ,1623,2734,942,5755,4813,95,184
PR,74020,IBEMA,1650,1277,671,3959,3288,47,138
PR,74039,ADRIANÓPOLIS,2006,1138,1051,4774,3723,93,326
PR,74047,LINDOESTE,1899,1193,800,4234,3434,55,112
PR,74055,AGUDOS DO SUL,1856,2960,1033,6460,5427,142,241
PR,74063,OURO VERDE DO OESTE,1398,1780,674,4255,3581,55,154
PR,74071,ALMIRANTE TAMANDARÉ,21143,16606,5324,50783,45459,1842,2104
PR,74080,SANTA TEREZA DO OESTE,2081,2264,772,5701,4929,67,171
PR,74098,ALTO PARANÁ,2955,3635,1277,8870,7593,164,349
PR,74101,ANAHY,787,982,466,2469,2003,22,74
PR,74110,ALTO PIQUIRI,2884,2586,1504,7716,6212,147,354
PR,74128,ÂNGULO,644,1117,408,2338,1930,40,78
PR,74136,ALVORADA DO SUL,2724,2220,1643,7183,5540,74,247
PR,74144,BOA ESPERANÇA DO IGUAÇU,935,844,397,2347,1950,39,65
PR,74152,AMAPORÃ,1136,1184,293,2906,2613,55,137
PR,74160,BOM SUCESSO DO SUL,916,1141,284,2568,2284,29,71
PR,74179,AMPÉRE,5476,3100,1588,11005,9417,140,367
PR,74187,BRASILÂNDIA DO SUL,932,1137,621,3016,2395,43,176
PR,74195,ANDIRÁ,6250,5740,3348,17155,13807,354,849
PR,74209,CAFEZAL DO SUL,1015,1564,650,3501,2851,66,108
PR,74217,ANTONINA,4306,5629,3130,14965,11835,311,373
PR,74225,CANDÓI,3811,3646,2156,10558,8402,214,375
PR,74233,ANTONIO OLINTO,1418,2741,657,5524,4867,171,268
PR,74241,CRUZEIRO DO IGUAÇU,1260,823,359,2691,2332,29,105
PR,74250,APUCARANA,16785,43157,13497,83938,70441,2202,3153
PR,74268,DIAMANTE DO SUL,1170,728,611,2719,2108,20,102
PR,74276,ARAPONGAS,14662,35655,10953,70408,59455,1942,2904
PR,74284,ENTRE RIOS DO OESTE,957,1346,314,2907,2593,26,60
PR,74292,ARAPOTI,4870,8699,2180,17214,15034,317,539
PR,74306,FAROL,1026,1032,624,2935,2311,36,97
PR,74314,ARARUNA,2755,4582,1814,10062,8248,151,424
PR,74322,FAZENDA RIO GRANDE,19321,12137,7452,44356,36904,1219,1497
PR,74330,MARILÂNDIA DO SUL,1926,3011,1016,6749,5733,169,293
PR,74349,FLOR DA SERRA DO SUL,1551,1259,611,3851,3240,53,148
PR,74357,ARAUCÁRIA,33249,23294,10057,76459,66402,1862,2755
PR,74365,HONÓRIO SERPA,2097,1218,1095,4744,3649,43,105
PR,74373,ASSAÍ,2504,6721,2671,13250,10579,253,465
PR,74381,IGUATU,786,663,196,1797,1601,14,69
PR,74390,ASTORGA,5136,9043,3496,19375,15879,363,557
PR,74403,IRACEMA DO OESTE,960,787,360,2348,1988,34,136
PR,74411,ATALAIA,1040,1371,384,3059,2675,50,77
PR,74420,NOVO ITACOLOMI,524,1235,287,2336,2049,55,92
PR,74438,BALSA NOVA,3063,3410,840,8325,7485,227,315
PR,74446,ITAPERUÇU,7355,4476,2099,15493,13394,397,679
PR,74454,BANDEIRANTES,9081,8764,4166,24392,20226,454,939
PR,74462,IVATÉ,2228,1861,1274,5814,4540,84,226
PR,74470,BARBOSA FERRAZ,3280,3377,2240,9703,7463,158,402
PR,74489,LIDIANÓPOLIS,893,1509,752,3528,2776,84,161
PR,74497,BARRACÃO,2264,2086,759,5630,4871,77,187
PR,74500,MARIPÁ,941,2701,406,4375,3969,41,83
PR,74519,BARRA DO JACARÉ,827,796,259,2156,1897,48,110
PR,74527,MATO RICO,1297,1002,405,3056,2651,40,198
PR,74535,BELA VISTA DO PARAÍSO,3177,5647,2460,12530,10070,187,496
PR,74543,MAUÁ DA SERRA,1279,2891,901,5649,4748,115,235
PR,74551,BITURUNA,3544,4694,1962,11224,9262,171,346
PR,74560,MERCEDES,1118,1806,423,3737,3314,42,73
PR,74578,BOA ESPERANÇA,1201,1795,613,3912,3299,76,110
PR,74586,NOVA LARANJEIRAS,2441,2475,2057,7559,5502,106,245
PR,74594,BOCAIÚVA DO SUL,2161,2791,760,6484,5724,169,282
PR,74608,NOVA SANTA BÁRBARA,1053,1155,548,3136,2588,47,179
PR,74616,BOM SUCESSO,1862,1517,760,4716,3956,103,288
PR,74624,PATO BRAGADO,1205,1784,545,3872,3327,30,85
PR,74632,BORRAZÓPOLIS,1836,3073,1320,6798,5478,103,295
PR,74640,PINHAL DE SÃO BENTO,1103,326,274,1836,1562,20,79
PR,74659,CAFEARA,1058,551,283,2073,1790,44,83
PR,74667,PITANGUEIRAS,506,1184,228,2093,1865,38,60
PR,74675,CALIFÓRNIA,1589,2659,997,6093,5096,211,264
PR,74683,QUATRO PONTES,505,1819,291,2883,2592,24,53
PR,74691,CAMBARÁ,5470,7506,2716,17908,15192,402,885
PR,74705,RAMILÂNDIA,1066,1103,436,2865,2429,47,102
PR,74713,CAMBÉ,17268,29255,9633,65863,56230,1482,2653
PR,74721,RANCHO ALEGRE D'OESTE,725,872,326,2100,1774,17,83
PR,74730,CAMBIRA,1767,2451,716,5553,4837,120,233
PR,74748,RIO BONITO DO IGUAÇU,3979,2453,1971,9027,7056,107,256
PR,74756,CAMPINA DA LAGOA,3682,4161,2321,11454,9133,213,475
PR,74764,SANTA LÚCIA,1257,918,645,3201,2556,53,159
PR,74772,CAMPINA GRANDE DO SUL,8654,9643,4495,25951,21456,611,984
PR,74780,CAMPO BONITO,1479,974,850,3596,2746,41,122
PR,74799,CAMPO DO TENENTE,973,2599,616,4643,4027,73,156
PR,74802,SANTA MARIA DO OESTE,3158,2486,2365,8694,6329,95,387
PR,74810,CAMPO LARGO,23945,27124,8788,70634,61846,2566,3067
PR,74829,SANTA MÔNICA,1099,753,438,2570,2132,41,119
PR,74837,CAMPO MOURÃO,16640,24905,11638,58589,46951,798,1492
PR,74845,SÃO MANOEL DO PARANÁ,335,998,189,1685,1496,18,81
PR,74853,CÂNDIDO DE ABREU,4078,4724,1864,11831,9967,227,571
PR,74861,SÃO PEDRO DO IGUAÇU,1845,2038,994,5510,4516,109,256
PR,74870,CAPANEMA,4990,5145,1420,12541,11121,193,249
PR,74888,TUNAS DO PARANÁ,1264,1495,927,4063,3136,58,225
PR,74896,CAPITÃO LEÔNIDAS MARQUES,4850,2767,1830,10606,8776,132,319
PR,74900,VENTANIA,1870,3343,959,6677,5718,90,229
PR,74918,CARLÓPOLIS,3134,4220,1942,10069,8127,191,368
PR,74926,ALTO PARAÍSO,867,983,759,2860,2101,49,104
PR,74934,CASCAVEL,53208,69687,31415,177768,146353,3041,4580
PR,74942,DOUTOR ULYSSES,1779,1486,479,4142,3663,102,205
PR,74950,CASTRO,10920,23139,7103,45773,38670,989,1480
PR,74969,VIRMOND,905,1487,504,3171,2667,51,90
PR,74977,CATANDUVAS,2097,2817,1268,6925,5657,104,258
PR,74985,LARANJAL,1898,1037,1295,4682,3387,78,243
PR,74993,CENTENÁRIO DO SUL,3458,2386,1312,7966,6654,121,432
PR,75000,ITAIPULÂNDIA,2838,2024,962,6462,5500,52,161
PR,75019,CERRO AZUL,5219,3121,1332,10784,9452,317,546
PR,75027,NOVA ESPERANÇA DO SUDOESTE,1985,1068,726,4131,3405,75,131
PR,75035,CHOPINZINHO,5734,4724,2843,14731,11888,234,335
PR,75043,PINHAIS,27891,24427,12779,77048,64269,2306,2778
PR,75051,CIANORTE,10370,23788,7932,47204,39272,922,1551
PR,75060,SAUDADE DO IGUAÇU,1440,989,640,3360,2720,63,110
PR,75078,CIDADE GAÚCHA,3399,2442,1157,7606,6449,105,272
PR,75086,ARIRANHA DO IVAÍ,826,732,387,2078,1691,15,56
PR,75094,CLEVELÂNDIA,4360,4614,3174,13399,10225,227,419
PR,75108,ARAPUÃ,1285,1185,398,3154,2756,28,142
PR,75116,MANGUEIRINHA,4852,4407,3032,13501,10469,126,566
PR,75124,BELA VISTA DA CAROBA,1395,932,370,2947,2577,33,97
PR,75132,COLOMBO,48922,37675,16338,120274,103936,3730,4414
PR,75140,BOA VENTURA DE SÃO ROQUE,1906,1505,542,4327,3785,61,194
PR,75159,COLORADO,5154,6609,3325,17168,13843,446,773
PR,75167,BOM JESUS DO SUL,1299,978,442,2944,2502,26,101
PR,75175,CONGONHINHAS,2118,2050,944,5712,4768,80,338
PR,75183,CAMPINA DO SIMÃO,1157,1019,552,3000,2448,54,136
PR,75191,CONSELHEIRO MAIRINCK,1187,1007,352,2788,2436,30,111
PR,75205,CAMPO MAGRO,5655,4697,1304,13424,12120,340,525
PR,75213,CONTENDA,3318,4207,1168,9878,8710,277,333
PR,75221,CARAMBEÍ,1930,6978,1523,11800,10277,260,327
PR,75230,CORBÉLIA,3649,5650,1582,11764,10182,133,212
PR,75248,CORONEL DOMINGOS SOARES,1485,1384,1064,4217,3153,39,130
PR,75256,CORNÉLIO PROCÓPIO,9836,14833,6829,36744,29915,660,1252
PR,75264,CRUZMALTINA,682,1316,433,2668,2235,29,134
PR,75272,CORONEL VIVIDA,6565,5869,3705,17625,13920,250,460
PR,75280,CORUMBATAÍ DO SUL,1561,1213,952,4083,3131,45,168
PR,75299,CRUZEIRO DO OESTE,6377,4365,2808,15143,12335,285,652
PR,75302,ESPERANÇA NOVA,504,735,356,1791,1435,26,82
PR,75310,CRUZEIRO DO SUL,1501,1220,349,3373,3024,53,120
PR,75329,ESPIGÃO ALTO DO IGUAÇU,1253,1449,716,3789,3073,67,143
PR,75337,CRUZ MACHADO,3546,6048,1797,12500,10703,269,362
PR,75345,FERNANDES PINHEIRO,1241,2160,826,4630,3804,72,181
PR,75353,CURITIBA,327829,501514,169577,1217263,1047686,29059,47641
PR,75361,FOZ DO JORDÃO,1705,872,902,3794,2892,53,131
PR,75370,CURIÚVA,2872,4344,2092,10422,8330,225,498
PR,75388,GOIOXIM,2276,1246,1048,4992,3944,68,223
PR,75396,DIAMANTE DO NORTE,1325,1826,1053,4594,3541,68,176
PR,75400,DIAMANTE DO OESTE,1501,894,484,3276,2792,50,160
PR,75418,DOIS VIZINHOS,8374,9118,4331,24009,19678,488,579
PR,75426,GUAMIRANGA,1178,3168,738,5656,4918,128,195
PR,75434,DOUTOR CAMARGO,1168,2457,457,4504,4047,69,170
PR,75442,IMBAÚ,2766,2110,1303,6745,5442,154,289
PR,75450,ENÉAS MARQUES,1708,1822,642,4561,3919,80,114
PR,75469,MANFRINÓPOLIS,1155,704,276,2341,2065,22,114
PR,75477,ENGENHEIRO BELTRÃO,3503,4496,1338,10025,8687,139,232
PR,75485,MARQUINHO,1210,1323,973,3838,2865,50,163
PR,75493,FAXINAL,2809,5358,2839,12265,9426,207,473
PR,75507,PEROBAL,1169,1880,817,4344,3527,78,205
PR,75515,FÊNIX,1032,1769,636,3711,3075,44,137
PR,75523,PONTAL DO PARANÁ,4031,3645,2853,11972,9119,224,340
PR,75531,FLORAÍ,1320,2176,623,4524,3901,80,145
PR,75540,PORTO BARREIRO,1030,1126,500,2878,2378,31,63
PR,75558,FLORESTA,1156,2422,609,4533,3924,41,143
PR,75566,PRADO FERREIRA,1299,904,439,2874,2435,29,99
PR,75574,FLORESTÓPOLIS,4070,2867,2027,9776,7749,109,315
PR,75582,QUARTO CENTENÁRIO,1298,1461,559,3645,3086,54,156
PR,75590,FLÓRIDA,829,725,275,2025,1750,28,71
PR,75604,RESERVA DO IGUAÇU,2143,1390,1176,5104,3928,68,180
PR,75612,FORMOSA DO OESTE,1369,3140,887,6012,5125,146,226
PR,75620,RIO BRANCO DO IVAÍ,819,1136,603,2849,2246,45,166
PR,75639,FOZ DO IGUAÇU,60054,58645,36074,178749,142675,2693,4476
PR,75647,SERRANÓPOLIS DO IGUAÇU,925,1873,382,3535,3153,37,61
PR,75655,FRANCISCO BELTRÃO,20327,17637,9527,51880,42353,822,1244
PR,75663,TAMARANA,1717,3655,1394,7547,6153,116,282
PR,75671,GENERAL CARNEIRO,2647,4045,2024,9514,7490,188,285
PR,75698,GOIOERÊ,5763,8725,3996,20499,16503,376,760
PR,75710,GUAÍRA,7511,6626,2808,18752,15944,300,511
PR,75736,GUAIRAÇÁ,1056,1953,480,3893,3413,55,200
PR,75744,ROSÁRIO DO IVAÍ,1138,1931,1072,4699,3627,106,262
PR,75752,GUAPIRAMA,1043,1341,662,3407,2745,47,204
PR,75760,NOVA TEBAS,2333,1957,1301,6256,4955,119,359
PR,75779,GUAPOREMA,519,768,237,1643,1406,19,49
PR,75787,SULINA,1194,931,405,2741,2336,26,81
PR,75795,GUARACI,947,1978,451,3668,3217,51,134
PR,75809,LUIZIANA,2227,1852,1040,5572,4532,87,227
PR,75817,GUARANIAÇU,3793,4545,1778,11367,9589,192,430
PR,75833,GUARAPUAVA,31157,47844,17921,108496,90575,2048,3198
PR,75850,GUARAQUEÇABA,2128,2091,1541,6158,4617,97,148
PR,75876,GUARATUBA,5966,8281,5132,21703,16571,315,633
PR,75892,IBAITI,6948,7768,3210,19775,16565,341,831
PR,75914,IBIPORÃ,7313,16029,5662,33627,27965,835,1353
PR,75930,ICARAÍMA,2044,2765,947,6364,5417,134,258
PR,75957,IGUARAÇU,1047,1274,391,2942,2551,42,91
PR,75973,IMBITUVA,2196,12519,2307,18483,16176,300,480
PR,75990,INÁCIO MARTINS,1997,3994,1581,8258,6677,133,320
PR,76015,INAJÁ,944,651,394,2333,1939,25,147
PR,76031,IPIRANGA,1913,5583,1472,9861,8389,221,331
PR,76058,IPORÃ,3541,4967,2466,12115,9649,187,419
PR,76074,IRATI,9446,19287,5963,39487,33524,940,1418
PR,76090,IRETAMA,2732,2849,1826,8470,6644,150,502
PR,76112,ITAGUAJÉ,1049,1511,626,3516,2890,48,173
PR,76139,ITAMBARACÁ,2191,1664,902,5274,4372,78,263
PR,76155,ITAMBÉ,1493,1779,635,4295,3660,51,153
PR,76171,ITAPEJARA DO OESTE,3195,2496,782,7191,6409,125,205
PR,76198,ITAÚNA DO SUL,1030,842,743,2907,2164,45,138
PR,76210,IVAÍ,1338,5386,667,8025,7358,138,244
PR,76236,IVAIPORÃ,6844,9151,2991,21214,18223,319,786
PR,76252,IVATUBA,703,913,519,2349,1830,30,67
PR,76279,JABOTI,1169,1391,553,3535,2982,75,188
PR,76295,JACAREZINHO,10141,10510,6404,30332,23928,532,976
PR,76317,JAGUAPITÃ,2526,3759,1580,8841,7261,187,405
PR,76333,JAGUARIAÍVA,7118,10318,3834,23348,19514,377,706
PR,76350,JANDAIA DO SUL,4058,7124,2011,14897,12886,321,599
PR,76376,JANIÓPOLIS,2365,1777,1293,5879,4586,78,202
PR,76392,JAPIRA,1488,1252,683,3847,3164,61,178
PR,76414,JAPURÁ,1592,3382,819,6422,5603,202,201
PR,76430,JARDIM ALEGRE,2869,3792,1593,9035,7442,136,283
PR,76457,JARDIM OLINDA,495,418,246,1267,1021,6,53
PR,76473,JATAIZINHO,2278,3924,1667,8889,7222,208,292
PR,76490,JOAQUIM TÁVORA,2138,3246,923,7124,6201,165,373
PR,76511,JUNDIAÍ DO SUL,1130,654,595,2594,1999,29,123
PR,76538,JUSSARA,1611,2031,731,4931,4200,105,209
PR,76554,KALORÉ,1256,1673,593,3894,3301,69,164
PR,76570,LAPA,10357,12961,4889,32475,27586,773,1094
PR,76597,LARANJEIRAS DO SUL,7124,7402,4835,21466,16631,283,758
PR,76619,LEÓPOLIS,1076,1315,492,3269,2777,46,169
PR,76635,LOANDA,4612,5597,2995,14596,11601,209,604
PR,76651,LOBATO,1400,1012,406,3174,2768,33,135
PR,76678,LONDRINA,46453,178589,51209,332086,280877,7087,12618
PR,76694,LUPIONÓPOLIS,1268,1224,573,3375,2802,52,131
PR,76716,MALLET,2019,5213,1539,9669,8130,175,345
PR,76732,MAMBORÊ,3274,4945,1852,11074,9222,171,375
PR,76759,MANDAGUAÇU,4987,5044,2267,13676,11409,321,456
PR,76775,MANDAGUARI,7425,10188,4270,24819,20549,631,1060
PR,76791,MANDIRITUBA,5586,5299,2280,14640,12360,350,407
PR,76813,MANOEL RIBAS,2651,4207,1529,9234,7705,111,374
PR,76830,MARECHAL CÂNDIDO RONDON,8865,14833,3941,31759,27818,482,813
PR,76856,MARIA HELENA,1530,1960,760,4580,3820,49,131
PR,76872,MARIALVA,6158,10590,3896,23128,19232,516,651
PR,76899,MARILUZ,3150,2432,1472,7676,6204,89,365
PR,76910,MARINGÁ,52503,107735,35818,226025,190207,3695,6540
PR,76937,MARIÓPOLIS,1563,1986,476,4488,4012,82,117
PR,76953,MARMELEIRO,3688,3085,1935,9513,7578,159,228
PR,76970,MARUMBI,1308,1349,499,3537,3038,77,159
PR,76996,MATELÂNDIA,2650,5424,2007,11265,9258,192,266
PR,77011,MEDIANEIRA,8316,12573,5315,29132,23817,453,873
PR,77038,MIRADOR,813,489,327,1756,1429,21,58
PR,77054,MIRASELVA,610,779,177,1708,1531,24,58
PR,77070,MOREIRA SALES,2530,4110,1783,9360,7577,178,448
PR,77097,MORRETES,3496,5139,2820,13325,10505,255,422
PR,77119,MUNHOZ DE MELLO,910,1143,357,2721,2364,44,116
PR,77135,NOSSA SENHORA DAS GRAÇAS,1007,1145,561,3113,2552,71,179
PR,77151,NOVA ALIANÇA DO IVAÍ,402,490,159,1136,977,14,26
PR,77178,NOVA AMÉRICA DA COLINA,990,1082,410,2724,2314,26,117
PR,77194,NOVA CANTU,2347,1851,1755,6474,4719,65,242
PR,77216,NOVA ESPERANÇA,6659,7826,4404,20815,16411,403,603
PR,77232,NOVA FÁTIMA,2042,2184,1177,6012,4835,130,251
PR,77259,NOVA LONDRINA,2603,3746,2672,10013,7341,131,437
PR,77275,ORTIGUEIRA,6268,5360,5523,18997,13474,358,912
PR,77291,OURIZONA,1097,1015,203,2500,2297,31,76
PR,77313,PAIÇANDU,8239,8624,3571,23001,19430,549,894
PR,77330,PALMAS,7071,11198,5007,25387,20380,387,810
PR,77356,PALMEIRA,6434,11364,3373,23337,19964,446,610
PR,77372,PALMITAL,4050,3806,3584,12367,8783,145,472
PR,77399,PALOTINA,5786,9509,3428,20436,17008,272,422
PR,77410,PARAÍSO DO NORTE,3603,2823,1302,8393,7091,120,288
PR,77437,PARANACITY,2237,2680,1605,7243,5638,119,279
PR,77453,PARANAGUÁ,30637,34284,12615,91293,78678,1750,2092
PR,77470,PARANAPOEMA,811,680,310,2013,1703,27,105
PR,77496,PARANAVAÍ,14112,27115,11443,58060,46617,847,1574
PR,77518,PATO BRANCO,14802,18033,8331,46560,38229,724,1028
PR,77534,PAULA FREITAS,925,2092,397,3789,3392,89,130
PR,77550,PAULO FRONTIN,1081,2649,781,5070,4289,124,134
PR,77577,PEABIRU,3266,3824,2218,10309,8091,184,373
PR,77593,PÉROLA D'OESTE,2104,1995,752,5326,4574,63,146
PR,77615,PIÊN,1284,4432,525,6898,6373,140,206
PR,77631,PINHALÃO,1427,2107,915,4942,4027,64,214
PR,77658,PINHÃO,7232,7354,4319,20764,16445,374,746
PR,77674,PIRAÍ DO SUL,4276,8495,2845,17436,14591,439,667
PR,77690,PIRAQUARA,19027,13319,7447,45668,38221,1106,1486
PR,77712,PITANGA,7993,9524,5705,25631,19926,432,1074
PR,77739,PLANALTINA DO PARANÁ,1184,975,450,3041,2591,74,151
PR,77755,PLANALTO,4865,2833,1461,9964,8503,142,224
PR,77771,PONTA GROSSA,42045,106012,28015,204026,176011,4209,6198
PR,77798,PORECATU,4860,3074,1678,10626,8948,143,402
PR,77810,PORTO AMAZONAS,764,1545,514,3212,2698,84,112
PR,77836,PORTO RICO,856,704,228,1976,1748,19,94
PR,77852,PORTO VITÓRIA,716,1430,492,2940,2448,61,81
PR,77879,PRESIDENTE CASTELO BRANCO,1801,952,601,3659,3058,41,102
PR,77895,PRIMEIRO DE MAIO,2512,3741,1104,8057,6953,123,294
PR,77917,PRUDENTÓPOLIS,5574,20638,6858,36925,30067,749,1461
PR,77933,QUATIGUÁ,1612,2666,650,5434,4784,109,211
PR,77950,QUATRO BARRAS,3479,4286,940,10287,9347,300,409
PR,77976,QUERÊNCIA DO NORTE,3262,2241,1737,7998,6261,129,432
PR,77992,QUINTA DO SOL,1371,1609,799,4171,3372,62,172
PR,78018,QUITANDINHA,3464,4954,1086,10649,9563,286,401
PR,78034,RANCHO ALEGRE,1170,1364,555,3389,2834,50,126
PR,78050,REALEZA,4876,3806,1668,11302,9634,175,303
PR,78077,REBOUÇAS,3191,4704,1930,11142,9212,228,364
PR,78093,RENASCENÇA,1661,1903,518,4499,3981,50,115
PR,78115,RESERVA,6646,5799,2223,16343,14120,294,848
PR,78131,RIBEIRÃO CLARO,2649,3301,859,7686,6827,213,376
PR,78158,RIBEIRÃO DO PINHAL,4093,3227,3068,11231,8163,176,356
PR,78174,RIO AZUL,1503,5864,1285,9858,8573,191,382
PR,78190,RIO BOM,531,1457,433,2812,2379,85,135
PR,78212,RIO BRANCO DO SUL,8914,8143,2349,22115,19766,576,1076
PR,78239,RIO NEGRO,3842,11782,3282,21563,18281,521,614
PR,78255,ROLÂNDIA,7761,21805,6288,40534,34246,1049,1157
PR,78271,RONCADOR,3392,3259,1942,9451,7509,139,389
PR,78298,RONDON,2369,2801,945,6726,5781,104,221
PR,78310,SABÁUDIA,952,2360,344,4145,3801,120,172
PR,78336,SALGADO FILHO,1365,1159,651,3547,2896,71,129
PR,78352,SALTO DO ITARARÉ,1552,1319,619,3996,3377,106,279
PR,78379,SALTO DO LONTRA,4412,2444,1649,9353,7704,183,297
PR,78395,SANTA AMÉLIA,887,1544,650,3405,2755,65,177
PR,78417,SANTA CECÍLIA DO PAVÃO,726,1390,642,3164,2522,37,211
PR,78433,SANTA CRUZ DO MONTE CASTELO,1978,2316,949,5839,4890,92,311
PR,78450,SANTA FÉ,2150,2965,810,6606,5796,136,229
PR,78476,SANTA INÊS,561,718,285,1687,1402,18,67
PR,78492,SANTA ISABEL DO IVAÍ,1793,3066,1193,6666,5473,130,294
PR,78514,SANTA IZABEL DO OESTE,3060,2508,1173,7498,6325,161,281
PR,78530,SANTA MARIANA,3952,3052,1779,9739,7960,175,462
PR,78557,SANTANA DO ITARARÉ,1507,1360,716,3997,3281,72,203
PR,78573,SANTO ANTÔNIO DO SUDOESTE,5164,3712,1768,11536,9768,141,371
PR,78590,SANTO ANTÔNIO DA PLATINA,8134,11991,3477,26825,23348,835,1051
PR,78611,SANTO ANTONIO DO CAIUÁ,845,792,425,2268,1843,21,115
PR,78638,SANTO ANTONIO DO PARAÍSO,631,788,388,2029,1641,43,88
PR,78654,SANTO INÁCIO,1424,1518,619,3925,3306,39,178
PR,78670,SÃO CARLOS DO IVAÍ,1184,2163,772,4524,3752,129,145
PR,78697,SÃO JERÔNIMO DA SERRA,2743,2949,1745,8476,6731,146,544
PR,78719,SÃO JOÃO,3198,2721,1278,8029,6751,117,266
PR,78735,SÃO JOÃO DO CAIUÁ,2045,1092,1039,4703,3664,121,278
PR,78751,SÃO JOÃO DO IVAÍ,3288,3414,2013,9714,7701,178,478
PR,78778,SÃO JOÃO DO TRIUNFO,2760,4369,1338,9545,8207,323,397
PR,78794,SÃO JORGE DO IVAÍ,1258,1997,356,3942,3586,48,126
PR,78816,SÃO JORGE D'OESTE,2308,2789,1193,7101,5908,119,247
PR,78832,SÃO JOSÉ DA BOA VISTA,1269,2066,762,4487,3725,47,225
PR,78859,SÃO JOSÉ DOS PINHAIS,48231,53974,19556,143945,124389,4267,5354
PR,78875,SÃO MATEUS DO SUL,7291,13958,3728,27924,24196,683,943
PR,78891,SÃO MIGUEL DO IGUAÇU,6795,7017,3563,19541,15978,260,463
PR,78913,SÃO PEDRO DO IVAÍ,2379,2658,1046,6734,5688,111,266
PR,78930,SÃO PEDRO DO PARANÁ,598,1041,348,2193,1845,25,114
PR,78956,SÃO SEBASTIÃO DA AMOREIRA,2555,2202,1097,6488,5391,92,290
PR,78972,SÃO TOMÉ,1183,2015,590,4219,3629,72,163
PR,78999,SAPOPEMA,1813,1734,851,4912,4061,98,253
PR,79014,SENGÉS,3227,6909,2190,13570,11380,194,555
PR,79030,SERTANEJA,1529,2053,802,4867,4065,94,158
PR,79057,SERTANÓPOLIS,2885,6218,2035,12459,10424,281,464
PR,79073,SIQUEIRA CAMPOS,5057,4638,2594,13487,10893,219,527
PR,79090,TAMBOARA,1018,1637,475,3457,2982,86,126
PR,79111,TAPEJARA,4156,3380,1412,9706,8294,183,289
PR,79138,TEIXEIRA SOARES,1507,3410,1122,6601,5479,107,216
PR,79154,TELÊMACO BORBA,17012,15214,7754,45021,37267,957,1309
PR,79170,TERRA BOA,3262,5475,1611,11218,9607,141,368
PR,79197,TERRA RICA,3297,4465,1776,10561,8785,152,377
PR,79219,TERRA ROXA,3429,5617,2315,12490,10175,223,463
PR,79235,TIBAGI,4137,5529,2482,13193,10711,213,453
PR,79251,TIJUCAS DO SUL,2551,4051,1629,9161,7532,241,294
PR,79278,TOLEDO,24485,31891,11954,76405,64451,1061,1948
PR,79294,TOMAZINA,1783,2918,1100,6509,5409,136,315
PR,79316,TUNEIRAS DO OESTE,1795,3013,974,6358,5384,110,257
PR,79332,UBIRATÃ,5650,6191,2672,15682,13010,214,441
PR,79359,UMUARAMA,16486,30689,14918,70062,55144,1219,1968
PR,79375,UNIÃO DA VITÓRIA,8875,18314,6802,37784,30982,679,1043
PR,79391,UNIFLOR,798,689,223,1955,1732,60,66
PR,79413,URAÍ,2945,3462,1609,8998,7389,130,364
PR,79430,WENCESLAU BRAZ,3178,6549,2245,13386,11141,269,627
PR,79456,VERÊ,2864,2225,846,6541,5695,98,216
PR,79472,VITORINO,1220,1899,795,4334,3539,68,134
PR,79499,XAMBRÊ,1934,1896,790,5002,4212,73,129
PR,79510,ALTÔNIA,3954,6466,2473,14342,11869,399,423
PR,79537,ASSIS CHATEAUBRIAND,6679,11529,4276,24797,20521,391,835
PR,79553,QUEDAS DO IGUAÇU,7224,6924,5107,20888,15781,309,640
PR,79570,CÉU AZUL,2171,3725,1171,8008,6837,137,214
PR,79596,GRANDES RIOS,1491,2097,1064,5211,4147,81,266
PR,79618,INDIANÓPOLIS,865,1368,451,3087,2636,76,168
PR,79634,MATINHOS,5353,7000,5251,20032,14781,336,544
PR,79650,NOVA AURORA,2885,3979,1394,9197,7803,185,298
PR,79677,NOVA OLÍMPIA,1650,1445,740,4290,3550,88,166
PR,79693,PÉROLA,2282,2922,788,6705,5917,170,251
PR,79715,SANTA HELENA,6316,6915,2030,16905,14875,243,440
PR,79731,TAPIRA,1412,1928,800,4561,3761,89,205
PR,79758,MARILENA,1910,1595,1206,5160,3954,72,220
PR,79774,FRANCISCO ALVES,1618,2028,933,4998,4065,107,174
PR,79790,NOVA SANTA ROSA,931,3558,647,5568,4921,53,100
PR,79812,BOA VISTA DA APARECIDA,2332,1890,1234,6000,4766,101,212
PR,79839,BRAGANEY,1812,1541,763,4506,3743,76,153
PR,79855,CAFELÂNDIA,3107,3499,1370,8702,7332,134,222
PR,79871,TRÊS BARRAS DO PARANÁ,2559,3634,1522,8564,7042,171,299
PR,79898,VERA CRUZ DO OESTE,2003,2948,1152,6673,5521,64,228
PR,79910,PRANCHITA,1867,1516,562,4346,3784,61,132
PR,79936,TUPÃSSI,1941,2780,932,6213,5281,118,176
PR,79952,NOVA PRATA DO IGUAÇU,3267,2411,1628,7955,6327,115,200
PR,79979,JESUÍTAS,1786,3146,856,6636,5780,132,421
PR,79995,SÃO JORGE DO PATROCÍNIO,1762,1633,907,4738,3831,93,138
PR,84514,CANTAGALO,3389,2942,2361,9378,7017,99,313
PR,84530,TURVO,4129,3347,1517,9873,8356,149,428
PR,84557,ALTAMIRA DO PARANÁ,1442,1025,1392,4237,2845,47,245
PR,84573,FIGUEIRA,2550,1896,1210,6286,5076,109,323
PR,84590,LUNARDELLI,1137,1880,820,4277,3457,81,242
PR,84611,SARANDI,16792,20323,8771,51597,42826,1219,1869
PR,84638,JURANDA,1860,2553,1364,6202,4838,86,146
PR,84654,DOURADINA,1847,1960,823,4952,4129,54,125
PR,84670,SANTA TEREZINHA DE ITAIPU,3945,6374,2515,14569,12054,205,428
PR,84697,MISSAL,3149,3345,1128,8406,7278,79,200
PR,84719,SÃO JOSÉ DAS PALMEIRAS,1096,1046,482,2926,2444,65,128
RJ,58009,QUISSAMÃ,5905,2822,2121,13177,11056,347,812
RJ,58017,ANGRA DOS REIS,41963,24688,15960,100323,84363,2492,4478
RJ,58025,QUATIS,3338,2706,1168,8680,7512,147,557
RJ,58033,ARARUAMA,21480,21092,13512,74108,60596,1946,4557
RJ,58041,BELFORD ROXO,143492,37789,40051,280606,240555,7461,15122
RJ,58050,BARRA DO PIRAÍ,32298,13260,9843,67680,57837,1409,3199
RJ,58068,CARDOSO MOREIRA,4310,2651,1477,10061,8584,218,605
RJ,58076,BARRA MANSA,56897,27921,16434,122702,106268,2633,6034
RJ,58084,VARRE E SAI,1904,2618,707,6512,5805,155,473
RJ,58092,BOM JARDIM,5501,6478,3116,19287,16171,597,1564
RJ,58106,GUAPIMIRIM,14166,5504,5092,30586,25494,615,1749
RJ,58114,BOM JESUS DO ITABAPOANA,9982,8043,3509,26257,22748,426,1820
RJ,58122,QUEIMADOS,44716,9836,11877,84460,72583,2121,4561
RJ,58130,CABO FRIO,34258,24441,16445,99804,83359,2776,5088
RJ,58149,JAPERI,30054,8165,8952,58769,49817,1400,3501
RJ,58157,CACHOEIRAS DE MACACU,13630,9179,6250,37332,31082,877,2368
RJ,58165,COMENDADOR LEVY GASPARIAN,2848,1203,466,5693,5227,107,324
RJ,58173,CAMBUCI,4351,3327,2234,12153,9919,255,787
RJ,58181,APERIBÉ,2690,2147,699,6829,6130,186,492
RJ,58190,CAMPOS,114943,65547,48816,311678,262862,10578,18694
RJ,58203,RIO DAS OSTRAS,15024,8769,6396,39331,32935,902,1837
RJ,58211,CANTAGALO,4209,6484,2379,16184,13805,335,1131
RJ,58220,AREAL,2178,3548,662,7825,7163,136,476
RJ,58238,CARMO,5099,3461,1136,11834,10698,203,775
RJ,58246,PINHEIRAL,7450,2437,1886,14125,12239,198,620
RJ,58254,CASIMIRO DE ABREU,7454,5045,1995,18302,16307,380,1086
RJ,58262,IGUABA GRANDE,4696,4084,2323,14745,12422,279,766
RJ,58270,CONCEIÇÃO DE MACABU,5670,4236,3168,15797,12629,389,984
RJ,58289,SÃO FRANCISCO DE ITABAPOANA,8752,10339,7785,32995,25210,1106,2328
RJ,58297,CORDEIRO,4574,4410,2359,14807,12448,367,1005
RJ,58300,CARAPEBUS,3416,2312,1052,8345,7293,239,513
RJ,58319,DUAS BARRAS,2020,2977,747,7270,6523,152,580
RJ,58327,PORTO REAL,5080,2208,1173,10006,8833,205,489
RJ,58335,DUQUE DE CAXIAS,260010,92015,71322,543646,472324,14065,29171
RJ,58343,SÃO JOSÉ DE UBÁ,1717,2194,523,5445,4922,92,382
RJ,58351,ENGENHEIRO PAULO DE FRONTIN,4092,2599,1018,9851,8833,204,597
RJ,58360,TANGUÁ,9975,3867,2760,20023,17263,405,1067
RJ,58378,ITABORAÍ,65760,21446,17556,133258,115702,3656,7470
RJ,58386,MACUCO,2041,1847,630,5469,4839,102,410
RJ,58394,ITAGUAÍ,28172,17784,10352,70336,59984,1683,3298
RJ,58408,ARMAÇÃO DE BÚZIOS,5670,5101,2277,17229,14952,424,853
RJ,58416,ITAOCARA,5601,6276,1928,17288,15360,481,1135
RJ,58424,SEROPÉDICA,15575,11144,5992,43829,37837,1070,2425
RJ,58432,ITAPERUNA,25016,20539,12353,69947,57594,1522,3526
RJ,58440,ITATIAIA,7329,5980,3324,19737,16413,404,859
RJ,58459,LAJE DO MURIAÉ,2279,1864,1272,6789,5517,193,553
RJ,58467,MESQUITA,52504,19789,16316,121970,105654,3366,6807
RJ,58475,MACAÉ,46387,20073,18335,106759,88424,3630,5760
RJ,58491,MAGÉ,77079,20149,20484,143646,123162,2788,7215
RJ,58513,MANGARATIBA,10353,6260,5203,28001,22798,525,1482
RJ,58530,MARICÁ,22630,15965,10877,65117,54240,1200,3173
RJ,58556,MENDES,5407,3453,1437,13377,11940,295,748
RJ,58572,MIGUEL PEREIRA,6047,6016,2607,19057,16450,358,1159
RJ,58599,MIRACEMA,7354,5291,4548,21070,16522,500,1593
RJ,58610,NATIVIDADE,3292,4242,2444,12403,9959,263,836
RJ,58637,NILÓPOLIS,49844,18952,8902,110956,102054,3284,6192
RJ,58653,NITERÓI,109684,85685,30080,333078,302998,7361,18611
RJ,58670,NOVA FRIBURGO,34719,49797,20627,137454,116827,4429,8799
RJ,58696,NOVA IGUAÇU,219573,90977,66775,500226,433451,15002,29658
RJ,58718,PARACAMBI,12039,7186,2267,28453,26186,630,1753
RJ,58734,PARAÍBA DO SUL,9186,10082,5147,31205,26058,746,1708
RJ,58750,PARATI,6825,7702,3788,21673,17885,489,963
RJ,58777,PETRÓPOLIS,60765,76817,32294,225658,193364,6634,13390
RJ,58793,PIRAÍ,7735,3935,1388,16273,14885,280,903
RJ,58815,PORCIÚNCULA,4838,3508,2870,13256,10386,288,876
RJ,58831,RESENDE,26127,24549,14348,78614,64266,2079,4033
RJ,58858,RIO BONITO,13695,12287,5774,40617,34843,936,2455
RJ,58874,RIO CLARO,5863,3265,2471,13660,11189,289,836
RJ,58890,RIO DAS FLORES,2602,1793,803,6242,5439,80,394
RJ,58912,SANTA MARIA MADALENA,2071,2700,1165,7634,6469,186,615
RJ,58939,SANTO ANTÔNIO DE PÁDUA,10855,8660,5432,30335,24903,708,1952
RJ,58955,SÃO FIDÉLIS,7177,10012,6278,29786,23508,704,1863
RJ,58971,SÃO GONÇALO,285350,91298,83665,617268,533603,17493,38592
RJ,58998,SÃO JOÃO DA BARRA,8973,6055,2876,23607,20731,879,1584
RJ,59013,SÃO JOÃO DE MERITI,160041,49641,44851,334743,289892,8833,18851
RJ,59030,SÃO PEDRO DA ALDEIA,19708,10514,8907,50227,41320,1127,2479
RJ,59056,SÃO SEBASTIÃO DO ALTO,1984,2658,1095,7038,5943,171,640
RJ,59072,SAPUCAIA,5090,4826,2065,14440,12375,292,1114
RJ,59099,SAQUAREMA,15885,13174,9625,49409,39784,1043,2841
RJ,59110,SILVA JARDIM,4321,4976,2800,14976,12176,288,1085
RJ,59137,SUMIDOURO,3192,5364,2035,12553,10518,285,856
RJ,59153,TERESÓPOLIS,25358,46245,17178,112078,94900,3338,6477
RJ,59170,TRAJANO DE MORAIS,3143,2318,1028,8120,7092,175,769
RJ,59196,TRÊS RIOS,25200,11395,8279,56092,47813,1234,2827
RJ,59218,VALENÇA,22790,12887,9157,54919,45762,1028,3280
RJ,59234,VASSOURAS,8444,8704,4758,26798,22040,513,1568
RJ,59250,VOLTA REDONDA,100848,35289,27915,202805,174890,3928,8692
RJ,59277,ARRAIAL DO CABO,6930,5233,3208,20468,17260,529,854
RJ,59293,ITALVA,3728,2989,1379,10078,8699,261,570
RJ,59315,PATI DO ALFERES,5892,6657,3573,19573,16000,354,1090
RJ,59331,SÃO JOSÉ DO VALE DO RIO PRETO,2883,6900,1863,13531,11668,224,558
RJ,60011,RIO DE JANEIRO,1470652,1023425,733589,4534940,3801351,127386,281166
RN,16004,TENENTE LAURENTINO CRUZ,2448,507,545,4131,3586,83,373
RN,16012,ACARI,4089,2208,1402,8956,7554,165,602
RN,16020,SERRA DO MEL,4044,1320,1099,7282,6183,187,452
RN,16039,AÇU,19188,6787,4743,34922,30179,687,2281
RN,16047,CAIÇARA DO NORTE,2245,1172,794,4847,4053,104,360
RN,16055,AFONSO BEZERRA,4118,1890,1460,8861,7401,158,792
RN,16063,SÃO MIGUEL DO GOSTOSO,3271,1135,706,5776,5070,80,450
RN,16071,ÁGUA NOVA,1453,119,344,2201,1857,34,205
RN,16080,ITAJÁ,2857,1354,562,5358,4796,77,389
RN,16098,ALEXANDRIA,5955,1035,1122,9489,8367,117,913
RN,16101,BODÓ,1428,371,306,2448,2142,60,219
RN,16110,ALMINO AFONSO,2752,641,725,4786,4061,119,380
RN,16128,TRIUNFO POTIGUAR,1766,706,485,3414,2929,69,270
RN,16136,ALTO DO RODRIGUES,4960,1358,875,8455,7580,269,639
RN,16144,FERNANDO PEDROSA,1274,757,267,2736,2469,67,271
RN,16152,ANGICOS,4168,2538,913,8800,7887,148,686
RN,16160,MAJOR SALES,1734,162,474,2645,2171,22,216
RN,16179,ANTÔNIO MARTINS,3519,580,612,5524,4912,134,514
RN,16187,VENHA VER,1527,437,612,3090,2478,66,384
RN,16195,APODI,14871,3828,3437,25474,22037,601,1804
RN,16209,SERRINHA DOS PINTOS,2086,679,625,3907,3282,52,369
RN,16217,AREIA BRANCA,9091,3952,3261,19808,16547,559,1407
RN,16225,TIBAU,1528,514,375,2911,2536,83,275
RN,16233,ARÊS,5554,1444,1422,9894,8472,288,813
RN,16241,SANTA MARIA,1758,906,395,3592,3197,71,362
RN,16250,CAMPO GRANDE,4496,942,1215,7644,6429,179,624
RN,16268,RIO DO FOGO,2915,2715,1612,8241,6629,149,623
RN,16276,BAÍA FORMOSA,2703,1326,1352,6467,5115,257,492
RN,16284,PORTO DO MANGUE,2168,447,463,3609,3146,57,333
RN,16292,BARCELONA,1504,1191,439,3704,3265,53,328
RN,16306,JUNDIÁ,1302,755,292,2760,2468,46,280
RN,16314,BENTO FERNANDES,2069,883,295,3793,3498,74,340
RN,16330,BOM JESUS,2832,1964,1583,7515,5932,141,768
RN,16357,BREJINHO,2870,2531,1330,8117,6787,194,891
RN,16373,CAIÇARA DO RIO DO VENTO,1304,1225,495,3576,3081,50,360
RN,16390,CAICÓ,19533,10685,5739,41874,36135,947,2255
RN,16411,CAMPO REDONDO,4240,815,1190,7373,6183,195,727
RN,16438,CANGUARETAMA,9885,3427,3964,20491,16527,626,1683
RN,16454,CARAÚBAS,9446,2236,2609,16518,13909,495,1358
RN,16470,CARNAÚBA DOS DANTAS,2132,1965,535,5391,4856,118,350
RN,16497,CARNAUBAIS,3766,1940,931,7667,6736,175,634
RN,16519,CEARÁ-MIRIM,21184,8917,6888,43174,36286,1064,3173
RN,16535,CERRO-CORÁ,3106,1914,1492,7767,6275,136,847
RN,16551,CORONEL EZEQUIEL,1945,780,659,4095,3436,84,445
RN,16578,CORONEL JOÃO PESSOA,2113,272,924,3912,2988,73,457
RN,16594,CRUZETA,3241,1406,805,6403,5598,181,549
RN,16616,CURRAIS NOVOS,13449,7818,5592,31194,25602,731,2172
RN,16632,DOUTOR SEVERIANO,3136,450,1035,5443,4408,82,605
RN,16659,ENCANTO,2468,227,795,4102,3307,86,408
RN,16675,EQUADOR,2162,763,679,4273,3594,82,412
RN,16691,ESPÍRITO SANTO,2651,1635,1188,6584,5396,157,624
RN,16713,EXTREMOZ,6958,4254,3083,16641,13558,413,1063
RN,16730,FELIPE GUERRA,3570,656,384,5486,5102,181,496
RN,16756,FLORÂNIA,3649,1610,848,7173,6325,142,633
RN,16772,FRANCISCO DANTAS,1432,427,350,2610,2260,38,263
RN,16799,GALINHOS,884,749,340,2251,1911,29,148
RN,16810,GOIANINHA,7358,3802,2165,16002,13837,502,1514
RN,16837,GOVERNADOR DIX-SEPT ROSADO,5174,1683,1387,9890,8503,393,859
RN,16853,GROSSOS,3527,1429,723,6727,6004,299,522
RN,16870,GUAMARÉ,4832,1918,1548,9850,8302,181,799
RN,16896,IELMO MARINHO,4402,2052,2010,9827,7817,242,881
RN,16918,IPANGUAÇU,6670,1621,1745,11391,9646,186,924
RN,16934,IPUEIRA,935,335,147,1663,1516,20,105
RN,16950,ITAÚ,2762,463,515,4356,3841,79,397
RN,16977,JAÇANÃ,2467,1360,857,5542,4685,135,528
RN,16993,JANDAÍRA,2379,1204,762,5059,4297,93,470
RN,17019,JANDUÍS,2544,692,604,4361,3757,118,295
RN,17035,BOA SAÚDE,2866,1466,1069,6493,5424,120,771
RN,17051,JAPI,2104,1284,466,4461,3995,48,468
RN,17078,JARDIM DE ANGICOS,1443,428,308,2515,2207,26,193
RN,17094,JARDIM DE PIRANHAS,5890,1391,1529,10010,8481,197,748
RN,17116,JARDIM DO SERIDÓ,4349,2575,1317,9728,8411,221,735
RN,17132,JOÃO CÂMARA,10950,5283,3546,22727,19181,394,1852
RN,17159,JOÃO DIAS,1710,118,377,2449,2072,26,184
RN,17175,JOSÉ DA PENHA,3288,329,1078,5471,4393,82,569
RN,17191,JUCURUTU,6493,3992,1913,14467,12554,200,1318
RN,17213,MESSIAS TARGINO,1910,635,296,3372,3076,79,314
RN,17230,LAGOA D'ANTA,2130,943,1012,4862,3850,96,507
RN,17256,LAGOA DE PEDRAS,2242,1619,870,5494,4624,107,534
RN,17272,LAGOA DE VELHOS,1229,503,271,2395,2124,46,215
RN,17299,LAGOA NOVA,4355,2720,2059,10534,8475,250,899
RN,17310,LAGOA SALGADA,2826,2082,543,6653,6110,210,746
RN,17337,LAJES,4023,1755,869,7820,6951,123,678
RN,17353,LAJES PINTADAS,2027,900,547,4091,3544,88,393
RN,17370,LUCRÉCIA,1873,152,358,2806,2448,35,255
RN,17396,LUIS GOMES,4564,490,1569,7719,6150,93,813
RN,17418,MACAÍBA,16416,11640,5753,40206,34453,953,3551
RN,17434,MACAU,11549,4075,4075,22701,18626,479,1307
RN,17450,MARCELINO VIEIRA,3931,403,611,5777,5166,122,557
RN,17477,MARTINS,2550,1812,1220,6407,5187,87,512
RN,17493,MAXARANGUAPE,3002,2070,790,6809,6019,120,548
RN,17515,FRUTUOSO GOMES,2204,275,526,3555,3029,141,297
RN,17531,MONTANHAS,4285,974,1933,8365,6432,177,728
RN,17558,MONTE ALEGRE,4564,4082,2126,12758,10632,398,1098
RN,17574,MONTE DAS GAMELEIRAS,1339,242,473,2473,2000,35,308
RN,17590,MOSSORÓ,71888,33824,20316,149398,129082,4464,9347
RN,17612,NATAL,179668,144686,69205,488322,419117,10560,26395
RN,17639,NÍSIA FLORESTA,6632,3187,1695,13785,12090,449,1084
RN,17655,NOVA CRUZ,9660,7369,5556,26426,20870,543,2212
RN,17671,OLHO D'ÁGUA DO BORGES,1961,786,467,3841,3374,109,397
RN,17698,OURO BRANCO,1828,1108,477,3981,3504,97,277
RN,17710,PARANÁ,2014,203,479,3183,2704,44,360
RN,17736,PARAÚ,2187,638,483,3756,3273,64,298
RN,17752,PARAZINHO,1605,1077,403,3601,3198,79,356
RN,17779,PARELHAS,7117,3828,2164,15435,13271,362,1050
RN,17795,PARNAMIRIM,28777,25644,10758,79622,68864,2209,4443
RN,17817,PASSA E FICA,2977,1341,1428,6884,5456,185,761
RN,17833,PASSAGEM,1215,788,215,2587,2372,50,240
RN,17850,PATU,4697,1464,1434,9058,7624,339,748
RN,17876,PAU DOS FERROS,9562,2727,2689,17412,14723,351,1317
RN,17892,PEDRA GRANDE,1755,615,540,3345,2805,64,279
RN,17914,PEDRA PRETA,1389,732,242,2749,2507,38,245
RN,17930,PEDRO AVELINO,1893,2292,1045,6154,5109,126,509
RN,17957,PEDRO VELHO,5202,1807,2541,11189,8648,302,955
RN,17973,PENDÊNCIAS,5011,1807,1709,9833,8124,165,793
RN,17990,PILÕES,1727,284,277,2703,2426,45,282
RN,18015,POÇO BRANCO,4423,2001,928,8659,7731,253,767
RN,18031,PORTALEGRE,1751,2079,524,5293,4769,112,622
RN,18058,SERRA CAIADA,3325,1197,1142,6594,5452,117,641
RN,18074,PUREZA,2639,1438,907,5899,4992,147,568
RN,18090,RAFAEL FERNANDES,2260,407,367,3646,3279,89,415
RN,18112,RIACHO DA CRUZ,1383,415,305,2468,2163,30,236
RN,18139,RIACHO DE SANTANA,2005,246,682,3430,2748,71,335
RN,18155,RIACHUELO,2586,1237,766,5295,4529,76,420
RN,18171,RODOLFO FERNANDES,2453,599,386,4060,3674,49,465
RN,18198,RUY BARBOSA,1071,1118,470,3075,2605,40,241
RN,18210,SÃO FRANCISCO DO OESTE,1558,556,277,2927,2650,97,322
RN,18236,SANTA CRUZ,11583,4621,3682,23123,19441,503,1793
RN,18252,SANTANA DO SERIDÓ,1109,404,221,2045,1824,53,155
RN,18279,SANTANA DO MATOS,4503,3019,1904,11298,9394,253,1021
RN,18295,SANTO ANTÔNIO,8691,1733,3100,16141,13041,473,1603
RN,18317,SÃO BENTO DO NORTE,1600,525,485,3052,2567,46,274
RN,18333,SÃO BENTO DO TRAIRI,1654,576,256,2977,2721,56,315
RN,18350,SÃO FERNANDO,1530,734,179,2823,2644,45,206
RN,18376,SÃO GONÇALO DO AMARANTE,22215,16192,8902,55789,46887,1372,4059
RN,18392,SÃO JOÃO DO SABUGI,2698,1122,539,4943,4404,64,299
RN,18414,SÃO JOSÉ DE MIPIBU,11651,5609,3902,25393,21491,721,2319
RN,18430,SÃO JOSÉ DE CAMPESTRE,4183,1782,1686,9324,7638,351,956
RN,18457,SÃO JOSÉ DO SERIDÓ,1534,1046,298,3467,3169,88,258
RN,18473,SÃO MIGUEL,8410,1725,3709,16734,13025,443,2034
RN,18490,SÃO PAULO DO POTENGI,4577,3672,1932,11877,9945,293,982
RN,18511,SÃO PEDRO,2883,1489,671,5714,5043,83,442
RN,18538,SÃO RAFAEL,3627,1157,608,6484,5876,129,718
RN,18554,SÃO TOMÉ,4343,1371,1580,8611,7031,174,837
RN,18570,SÃO VICENTE,2605,671,651,4575,3924,98,335
RN,18597,SENADOR ELÓI DE SOUZA,1443,1331,756,4238,3482,92,456
RN,18619,SENADOR GEORGINO AVELINO,1418,942,443,3292,2849,106,260
RN,18635,SERRA DE SÃO BENTO,2060,871,1019,4815,3796,120,531
RN,18651,SERRA NEGRA DO NORTE,3091,1228,836,5938,5102,127,467
RN,18678,SERRINHA,3044,966,739,5771,5032,155,658
RN,18694,SEVERIANO MELO,3566,799,1374,6744,5370,140,627
RN,18716,SÍTIO NOVO,1877,800,469,3770,3301,112,407
RN,18732,TABOLEIRO GRANDE,973,463,203,1956,1753,24,178
RN,18759,TAIPU,3779,2045,926,8114,7188,318,791
RN,18775,TANGARÁ,3915,2771,1773,10174,8401,280,947
RN,18791,TENENTE ANANIAS,3789,1188,1570,7528,5958,71,741
RN,18813,TIBAU DO SUL,2760,1977,848,6781,5933,240,562
RN,18830,TIMBAÚBA DOS BATISTAS,902,704,175,2035,1860,33,111
RN,18856,TOUROS,8298,5110,3067,19315,16248,561,1555
RN,18872,UMARIZAL,5229,1115,1039,8605,7566,157,791
RN,18899,UPANEMA,5250,1508,945,9028,8083,197,737
RN,18910,VÁRZEA,1798,1077,379,3833,3454,73,358
RN,18937,RAFAEL GODEIRO,1758,272,352,2852,2500,79,271
RN,18953,VERA CRUZ,3232,2404,717,7577,6860,219,770
RN,18970,VIÇOSA,837,185,153,1365,1212,19,125
RN,18996,VILA FLOR,1049,488,348,2183,1835,44,173
RN,30031,BARAÚNA,7154,2620,1285,13309,12024,494,1338
RO,19,GUAJARÁ-MIRIM,9897,7142,5660,25804,20144,244,1048
RO,35,PORTO VELHO,106965,59003,37308,239787,202479,2631,8367
RO,51,JI-PARANÁ,22950,27804,17783,76394,58611,938,2604
RO,78,ARIQUEMES,17520,20400,11828,55362,43534,905,2280
RO,94,CACOAL,16576,18883,10790,52403,41613,941,2221
RO,116,PIMENTA BUENO,5826,10118,5321,23541,18220,299,816
RO,132,VILHENA,12149,16918,8928,42665,33737,649,1821
RO,159,JARU,8690,16823,9859,40022,30163,707,1939
RO,175,OURO PRETO DO OESTE,7566,11298,7847,29627,21780,409,1148
RO,191,PRESIDENTE MÉDICI,4973,6128,4790,17903,13113,386,806
RO,213,COSTA MARQUES,2698,2734,1666,7914,6248,111,355
RO,230,COLORADO DO OESTE,4343,5282,4005,15124,11119,269,706
RO,256,ESPIGÃO DO OESTE,5672,8205,3764,19378,15614,310,731
RO,272,CEREJEIRAS,2788,6383,3192,13414,10222,164,446
RO,299,ROLIM DE MOURA,11326,11402,7261,33421,26160,548,1476
RO,310,ALTA FLORESTA DO OESTE,6242,6392,4249,18479,14230,251,801
RO,337,ALVORADA DO OESTE,3773,4616,3104,12577,9473,156,615
RO,353,SANTA LUZIA DO OESTE,2226,2807,1970,7750,5780,139,341
RO,370,NOVA BRASILÂNDIA,4192,5677,2674,13868,11194,234,674
RO,396,MACHADINHO DO OESTE,5453,8634,4195,20422,16227,229,1023
RO,418,SÃO MIGUEL DO GUAPORÉ,3985,5018,2279,12243,9964,182,475
RO,434,NOVA MAMORÉ,2482,5468,2170,11445,9275,177,747
RO,450,CABIXI,1560,1804,1080,4900,3820,94,216
RO,477,CANDEIAS DO JAMARI,4737,2426,1681,10093,8412,124,485
RO,493,ITAPUÃ DO OESTE,1741,1412,936,4586,3650,51,216
RO,515,NOVO HORIZONTE DO OESTE,2991,2269,1809,7844,6035,107,407
RO,531,CASTANHEIRAS,1183,950,511,2966,2455,25,146
RO,558,VALE DO PARAÍSO,1895,2663,1789,6944,5155,75,325
RO,566,URUPÁ,2580,3902,2170,9496,7326,157,436
RO,574,MIRANTE DA SERRA,2906,3478,2209,9407,7198,112,431
RO,582,SERINGUEIRAS,2675,3095,1453,7952,6499,112,410
RO,590,THEOBROMA,1925,3272,1837,7864,6027,108,352
RO,604,MINISTRO ANDREAZZA,2147,2319,1371,6391,5020,93,280
RO,612,GOVERNADOR JORGE TEIXEIRA,1564,3398,768,6478,5710,85,395
RO,620,CACAULÂNDIA,1187,1837,957,4412,3455,54,227
RO,639,ALTO PARAÍSO,3893,3393,1683,9817,8134,148,399
RO,647,RIO CRESPO,752,912,260,2133,1873,28,87
RO,655,CORUMBIARA,1447,2540,1168,5698,4530,61,273
RO,663,MONTE NEGRO,2873,3930,2632,10485,7853,148,590
RO,671,CAMPO NOVO DE RONDÔNIA,1753,2574,1728,6528,4800,69,281
RO,680,CUJUBIM,1607,2867,1378,6448,5070,80,344
RO,698,VALE DO ANARI,1253,2735,1102,5707,4605,61,376
RO,701,PARECIS,1109,1210,602,3172,2570,25,126
RO,710,SÃO FELIPE DO OESTE,1373,2060,918,4770,3852,47,204
RO,728,PRIMAVERA DE RONDÔNIA,875,1415,626,3237,2611,49,127
RO,736,ALTO ALEGRE DOS PARECIS,2495,2475,1448,7027,5579,95,301
RO,744,NOVA UNIÃO,1911,1898,1106,5334,4228,60,208
RO,752,TEIXEIRÓPOLIS,1107,1710,1128,4322,3194,60,198
RO,779,BURITIS,5597,7900,4168,19465,15297,362,925
RO,787,PIMENTEIRAS DO OESTE,586,644,514,1887,1373,19,52
RO,795,SÃO FRANCISCO DO GUAPORÉ,2327,4091,1886,9084,7198,151,369
RO,809,CHUPINGUAIA,1257,1782,1154,4641,3487,56,275
RR,3000,CAROEBE,1501,2063,414,4456,4042,44,258
RR,3018,BOA VISTA,26711,77122,24815,156282,131467,1510,4432
RR,3026,IRACEMA,1269,1884,630,4294,3664,37,216
RR,3034,CARACARAÍ,2779,4154,1313,9172,7859,92,348
RR,3042,AMAJARÍ,754,1836,459,3381,2922,11,124
RR,3050,ALTO ALEGRE,1749,3207,539,6534,5995,69,312
RR,3069,CANTÁ,1324,3754,656,6722,6066,55,301
RR,3077,BONFIM,884,2850,545,4832,4287,33,183
RR,3085,RORAINÓPOLIS,3877,3309,1200,9347,8147,82,447
RR,3093,MUCAJAÍ,2369,3777,1373,8456,7083,68,335
RR,3107,UIRAMUTÃ,1254,1214,482,3331,2849,26,300
RR,3115,NORMANDIA,1110,1916,413,3852,3439,22,207
RR,3123,PACARAIMA,918,2523,575,4602,4027,38,165
RR,3131,SÃO JOÃO DO BALIZA,1327,1647,354,3875,3521,56,199
RR,3158,SÃO LUIZ DO ANAUÁ,1607,1652,589,4460,3871,50,197
RS,84735,ÁUREA,690,1644,260,2902,2642,105,99
RS,84743,TRÊS ARROIOS,849,1041,148,2337,2189,88,97
RS,84751,NOVA ROMA DO SUL,539,1544,254,2663,2409,96,129
RS,84760,PROGRESSO,1424,2071,551,4707,4156,165,186
RS,84778,PIRAPÓ,745,939,343,2257,1914,58,98
RS,84786,JABOTICABA,1053,1061,676,3266,2590,60,146
RS,84794,SÃO JORGE,500,1388,329,2512,2183,75,84
RS,84808,ALTO ALEGRE,322,649,150,1537,1387,45,38
RS,84816,NOVA HARTZ,4858,4488,1374,12041,10667,286,317
RS,84824,DOIS LAJEADOS,497,1489,209,2569,2360,102,97
RS,84832,SÃO DOMINGOS DO SUL,646,1079,181,2261,2080,103,109
RS,84840,TUNAS,1343,1241,315,3189,2874,83,131
RS,84859,SÃO JOÃO DA URTIGA,1317,1697,467,3977,3510,218,127
RS,84867,GUABIJU,205,794,270,1458,1188,63,62
RS,84875,QUINZE DE NOVEMBRO,726,1561,331,3042,2711,45,69
RS,84883,DOUTOR MAURÍCIO CARDOSO,1342,2301,402,4417,4015,50,131
RS,84891,CAPELA DE SANTANA,2219,3202,1002,7252,6250,202,228
RS,84905,JAQUIRANA,708,1756,889,3759,2870,94,151
RS,84913,VANINI,322,750,149,1513,1364,94,83
RS,84921,BOQUEIRÃO DO LEÃO,1989,2418,910,6146,5236,193,225
RS,84930,FAGUNDES VARELA,360,1107,187,2059,1872,68,92
RS,84948,ÁGUA SANTA,635,1578,334,2857,2523,65,105
RS,84956,SILVEIRA MARTINS,478,1165,205,2111,1906,45,56
RS,84964,IBIRAPUITÃ,929,1510,353,3100,2747,59,119
RS,84972,IBARAMA,1332,1322,267,3334,3067,95,137
RS,84980,PÂNTANO GRANDE,2256,3525,1588,8417,6829,289,281
RS,84999,IPÊ,856,2564,449,4496,4047,147,190
RS,85006,TRINDADE DO SUL,1747,1274,761,4407,3646,89,152
RS,85014,AGUDO,3510,5996,1559,12591,11032,398,405
RS,85022,ERNESTINA,744,1311,241,2606,2365,66,41
RS,85030,AJURICABA,1494,3013,711,5811,5100,80,147
RS,85049,DEZESSEIS DE NOVEMBRO,664,1065,446,2483,2037,73,126
RS,85057,ALECRIM,2210,2344,797,6014,5217,122,230
RS,85065,BROCHIER,949,1868,253,3639,3386,84,166
RS,85073,ALEGRETE,17403,25376,11887,60463,48576,1070,1363
RS,85081,EREBANGO,687,1052,404,2372,1968,51,91
RS,85090,ALPESTRE,2832,1869,1009,6564,5555,260,245
RS,85103,ENTRE IJUÍS,2595,2870,740,6963,6223,130,193
RS,85111,ALVORADA,34624,50621,15147,124001,108854,4671,4323
RS,85120,NOVA ESPERANÇA DO SUL,567,2007,519,3815,3296,116,173
RS,85138,ANTA GORDA,824,2737,741,5036,4295,242,205
RS,85146,PAVERAMA,1740,2692,797,5849,5052,189,172
RS,85154,ANTÔNIO PRADO,1734,5988,1277,10295,9018,254,462
RS,85162,TERRA DE AREIA,1844,2868,1258,6663,5405,153,251
RS,85170,ARATIBA,1974,2436,480,5429,4949,178,188
RS,85189,HARMONIA,796,1826,215,3217,3002,119,86
RS,85197,ARROIO DO MEIO,3468,7135,1583,14208,12625,462,543
RS,85200,CAMPOS BORGES,788,1106,264,2675,2411,109,80
RS,85219,ARROIO DOS RATOS,2165,4770,1775,10111,8336,320,338
RS,85227,CERRO GRANDE,777,501,270,1997,1727,53,84
RS,85235,ARROIO DO TIGRE,2930,4422,1227,9796,8569,332,386
RS,85243,IPIRANGA DO SUL,206,1209,150,1712,1562,33,69
RS,85251,ARROIO GRANDE,4013,6219,2489,15148,12659,490,423
RS,85260,LAGOÃO,1501,1728,746,4627,3881,180,276
RS,85278,ARVOREZINHA,1958,3037,1264,7877,6613,419,319
RS,85286,ESTAÇÃO,1008,2897,618,5045,4427,128,178
RS,85294,AUGUSTO PESTANA,1689,2946,925,6232,5307,105,148
RS,85308,ARROIO DO SAL,1076,2287,888,4960,4072,81,148
RS,85316,BAGÉ,28338,33019,13049,83485,70436,1853,2183
RS,85324,SÃO JOSÉ DO HORTÊNCIO,818,1618,251,3020,2769,88,116
RS,85332,BARÃO DE COTEGIPE,1366,2481,674,5070,4396,154,202
RS,85340,PINHAL,529,752,354,1929,1575,44,78
RS,85359,BARRACÃO,1225,1620,462,3778,3316,161,175
RS,85367,TRÊS CACHOEIRAS,2218,3317,1127,7406,6279,155,147
RS,85375,BARRA DO RIBEIRO,2130,4627,1524,9380,7856,268,290
RS,85383,SÃO VENDELINO,329,1036,91,1626,1535,36,46
RS,85391,BARROS CASSAL,1870,4139,1588,8638,7050,296,453
RS,85405,PROTÁSIO ALVES,192,1252,214,1876,1662,64,38
RS,85413,BENTO GONÇALVES,15898,38943,8029,73309,65280,2258,2914
RS,85421,POUSO NOVO,538,665,348,1784,1436,55,84
RS,85430,BOA VISTA DO BURICÁ,1564,2447,762,5263,4501,134,120
RS,85448,EUGÊNIO DE CASTRO,630,1280,279,2440,2161,57,70
RS,85456,BOM JESUS,1309,4928,1291,8462,7171,290,303
RS,85464,CRISTAL,1446,2648,910,5601,4691,135,214
RS,85472,BOM RETIRO DO SUL,1499,5155,1067,8743,7676,310,271
RS,85480,SÃO MIGUEL DAS MISSÕES,1919,2343,834,5716,4882,116,154
RS,85499,BOSSOROCA,1911,2142,1161,5781,4620,171,166
RS,85502,GLORINHA,909,3021,723,5269,4546,128,190
RS,85510,BRAGA,1113,963,362,2799,2437,89,118
RS,85529,SEGREDO,1915,2269,778,5526,4748,146,228
RS,85537,BUTIÁ,3852,6788,2805,15770,12965,546,629
RS,85545,ALEGRIA,1228,1565,434,3714,3280,87,168
RS,85553,CAÇAPAVA DO SUL,8356,11088,5335,28361,23026,1003,1005
RS,85561,SALDANHA MARINHO,620,1308,240,2439,2199,90,55
RS,85570,CACEQUI,3255,4337,2478,11190,8712,184,313
RS,85588,SÃO JOSÉ DO HERVAL,606,733,333,1916,1583,49,113
RS,85596,CACHOEIRA DO SUL,14121,32307,12224,67126,54902,1659,1494
RS,85600,VISTA ALEGRE,923,822,216,2136,1920,33,67
RS,85618,CACHOEIRINHA,23248,37125,10572,87022,76450,2887,3070
RS,85626,IVORÁ,440,948,172,1813,1641,60,62
RS,85634,CACIQUE DOBLE,961,1551,324,3301,2977,165,155
RS,85642,VILA MARIA,733,1864,304,3229,2925,96,128
RS,85650,CAIBATÉ,1549,1339,601,3933,3332,129,118
RS,85669,TAQUARUÇÚ DO SUL,968,890,185,2228,2043,54,68
RS,85677,CAIÇARA,1321,1710,641,4226,3585,92,103
RS,85685,IMBÉ,2363,5533,1729,10943,9214,209,316
RS,85693,CAMAQUÃ,9275,25770,6659,47272,40613,1298,1204
RS,85707,SEDE NOVA,803,993,287,2270,1983,49,75
RS,85715,CAMBARÁ DO SUL,970,2714,1153,5511,4358,183,195
RS,85723,TUPANDI,462,1772,182,2671,2489,68,91
RS,85731,CAMPINA DAS MISSÕES,1562,2301,609,5158,4549,85,181
RS,85740,RIOZINHO,1021,1713,449,3639,3190,134,167
RS,85758,CAMPINAS DO SUL,842,2558,658,4507,3849,104,130
RS,85766,RELVADO,429,994,329,2016,1687,55,123
RS,85774,CAMPO BOM,12947,22101,4919,45239,40320,1177,1451
RS,85782,IMIGRANTE,635,1175,216,2374,2158,115,127
RS,85790,CAMPO NOVO,1632,1568,1243,4995,3752,110,142
RS,85804,CIDREIRA,1971,3217,1537,7784,6247,140,221
RS,85812,CANDELÁRIA,6230,10818,3178,22879,19701,846,705
RS,85820,MONTAURI,213,760,123,1346,1223,78,66
RS,85839,CÂNDIDO GODÓI,1082,3285,514,5398,4884,89,135
RS,85847,VISTA GAÚCHA,722,982,275,2211,1936,37,99
RS,85855,CANELA,3437,15921,3062,25637,22575,673,654
RS,85863,VISTA ALEGRE DO PRATA,292,804,179,1456,1277,67,44
RS,85871,CANGUÇÚ,10350,21108,5762,42746,36984,1991,1393
RS,85880,CASEIROS,458,1254,208,2237,2029,126,99
RS,85898,CANOAS,69291,93364,28340,232518,204178,6956,7930
RS,85901,ITACURUBI,753,1053,596,2727,2131,75,67
RS,85910,CARAZINHO,10949,21091,6668,43793,37125,934,1173
RS,85928,ENTRE RIOS DO SUL,803,1108,351,2492,2141,47,107
RS,85936,CARLOS BARBOSA,4527,8834,1648,17728,16080,517,633
RS,85944,CERRO GRANDE DO SUL,1239,3435,583,6218,5635,266,301
RS,85952,CASCA,1329,3597,887,6782,5895,291,242
RS,85960,CAMARGO,370,1185,194,2030,1836,66,102
RS,85979,CATUÍPE,2128,3613,907,8021,7114,207,178
RS,85987,PARAÍSO DO SUL,1477,3081,668,5810,5142,100,140
RS,85995,CAXIAS DO SUL,62352,138225,28127,279761,251634,8975,16935
RS,86010,CERRO LARGO,3120,3825,1930,10010,8080,186,321
RS,86029,FAXINALZINHO,610,843,560,2257,1697,61,95
RS,86037,CHAPADA,1663,4322,757,7440,6683,151,197
RS,86045,AMARAL FERRADOR,1113,1917,470,4385,3915,159,189
RS,86053,CHIAPETTA,1057,1476,547,3414,2867,51,91
RS,86061,VILA FLORES,400,1782,276,2770,2494,56,106
RS,86070,CIRÍACO,999,1695,355,3579,3224,222,99
RS,86088,CERRO BRANCO,1126,1579,359,3646,3287,119,131
RS,86096,COLORADO,627,1783,291,3009,2718,81,78
RS,86100,ANDRÉ DA ROCHA,164,704,232,1234,1002,37,25
RS,86118,CONDOR,1312,2754,740,5452,4712,95,134
RS,86126,POÇO DAS ANTAS,410,953,152,1698,1546,53,41
RS,86134,CONSTANTINA,2304,3100,952,7270,6318,205,277
RS,86142,TRÊS PALMEIRAS,1118,1180,522,3469,2947,76,103
RS,86150,CORONEL BICACO,1999,2211,822,5903,5081,163,300
RS,86169,NOVA ALVORADA,515,1344,158,2329,2171,80,140
RS,86177,CRISSIUMAL,4312,4517,1491,11415,9924,260,281
RS,86185,MORRO REDONDO,1233,2459,450,4756,4306,189,162
RS,86193,CRUZ ALTA,14239,20672,9013,48971,39958,1050,1156
RS,86207,SANTA MARIA DO HERVAL,1248,2733,311,4768,4457,145,107
RS,86215,CRUZEIRO DO SUL,2351,4368,1001,8956,7955,269,339
RS,86223,BARÃO,961,2314,434,4103,3669,103,134
RS,86231,DAVID CANABARRO,884,1782,519,3784,3265,221,123
RS,86240,ELDORADO DO SUL,6086,8357,3149,21151,18002,559,742
RS,86258,DOIS IRMÃOS,6186,9115,1790,18973,17183,471,452
RS,86274,DOM FELICIANO,2400,5189,1526,10353,8827,376,424
RS,86282,ALTO FELIZ,410,1253,131,2100,1969,77,102
RS,86290,DOM PEDRITO,8071,12931,5684,29594,23910,590,749
RS,86304,AMETISTA DO SUL,1244,2749,1023,5843,4820,143,239
RS,86312,DONA FRANCISCA,671,1569,301,2908,2607,75,107
RS,86320,ARAMBARÉ,564,1420,449,2905,2456,59,100
RS,86339,ENCANTADO,3356,7618,2040,15247,13207,534,834
RS,86347,BARÃO DO TRIUNFO,544,2967,665,4636,3971,117,198
RS,86355,ENCRUZILHADA DO SUL,4156,8970,3294,19371,16077,741,688
RS,86363,BARRA DO GUARITA,646,1028,346,2278,1932,57,133
RS,86371,ERECHIM,19576,30167,10043,67735,57692,1817,2216
RS,86380,BARRA DO RIO AZUL,645,667,207,1765,1558,43,67
RS,86398,HERVAL,1788,1948,843,5486,4643,177,213
RS,86401,BARRA FUNDA,540,770,210,2055,1845,60,61
RS,86410,ERVAL GRANDE,1418,1483,470,3939,3469,180,226
RS,86428,BOA VISTA DAS MISSÕES,568,640,214,1657,1443,34,62
RS,86436,ERVAL SECO,2405,1841,1224,6304,5080,130,217
RS,86444,BOM PROGRESSO,782,828,240,2035,1795,36,63
RS,86452,ESMERALDA,388,1356,357,2311,1954,73,55
RS,86460,CAMPESTRE DA SERRA,424,1479,514,2661,2147,84,77
RS,86479,ESPUMOSO,2813,6049,1777,12174,10397,220,235
RS,86487,CANDIOTA,2822,1840,1073,6289,5216,95,98
RS,86495,ESTÂNCIA VELHA,7899,13843,2753,27928,25175,747,975
RS,86509,CAPITÃO,571,1110,228,2311,2083,118,79
RS,86517,ESTEIO,21089,24042,7820,63003,55183,1629,1906
RS,86525,CARLOS GOMES,511,639,227,1565,1338,61,44
RS,86533,ESTRELA,4735,11668,2814,22146,19332,610,737
RS,86541,CENTENÁRIO,869,1115,208,2365,2157,46,60
RS,86550,FARROUPILHA,8994,24672,4995,45439,40444,1469,1907
RS,86568,CHARRUA,530,1425,390,2615,2225,57,138
RS,86576,FAXINAL DO SOTURNO,1472,2677,840,5640,4800,86,155
RS,86584,COLINAS,431,1205,212,2089,1877,42,67
RS,86592,FELIZ,1980,4817,1067,9226,8159,331,500
RS,86606,COQUEIROS DO SUL,507,1206,195,2154,1959,36,56
RS,86614,FLORES DA CUNHA,2624,11865,2437,20173,17736,648,1039
RS,86622,CORONEL BARROS,423,1209,177,2080,1903,25,54
RS,86630,FONTOURA XAVIER,2796,2893,1811,8468,6657,343,290
RS,86649,COXILHA,642,1192,241,2317,2076,55,50
RS,86657,FORMIGUEIRO,1147,3035,673,5600,4927,151,295
RS,86665,DERRUBADAS,708,1276,344,2595,2251,31,119
RS,86673,FREDERICO WESTPHALEN,6042,9665,3450,21415,17965,430,586
RS,86681,DOIS IRMÃOS DAS MISSÕES,648,710,352,1926,1574,39,81
RS,86690,GARIBALDI,4196,12063,2486,21926,19440,764,939
RS,86703,ENGENHO VELHO,461,454,189,1226,1037,20,47
RS,86711,GAURAMA,1197,2640,476,4861,4385,124,135
RS,86720,GARRUCHOS,1147,780,623,2882,2259,65,85
RS,86738,GENERAL CÂMARA,2023,2849,887,6598,5711,208,223
RS,86746,GENTIL,208,793,149,1413,1264,80,64
RS,86754,SÃO VICENTE DO SUL,1766,2885,1282,6749,5467,191,244
RS,86762,GRAMADO DOS LOUREIROS,786,510,381,1989,1608,59,76
RS,86770,GETÚLIO VARGAS,2359,7004,1953,12476,10523,238,366
RS,86789,GRAMADO XAVIER,856,1206,499,3067,2568,78,116
RS,86797,GIRUÁ,3818,5896,3079,14314,11235,225,310
RS,86800,HULHA NEGRA,1630,1403,417,3854,3437,69,120
RS,86819,GRAMADO,3540,15287,3135,24891,21756,728,781
RS,86827,INHACORÁ,733,638,257,1851,1594,41,86
RS,86835,GRAVATAÍ,40859,71556,17687,159510,141823,5913,6560
RS,86843,ITAPUCA,500,723,339,1833,1494,107,96
RS,86851,GUAÍBA,16572,30284,8103,66220,58117,2218,2280
RS,86860,LAJEADO DO BUGRE,682,421,176,1513,1337,36,83
RS,86878,GUAPORÉ,3302,8431,1924,15893,13969,506,538
RS,86886,LAGOA DOS TRÊS CANTOS,166,863,105,1291,1186,28,32
RS,86894,GUARANI DAS MISSÕES,2430,2571,830,6487,5657,129,159
RS,86908,LINDOLFO COLLOR,1576,1434,407,3789,3382,109,125
RS,86916,HORIZONTINA,3890,7242,2419,14992,12573,192,319
RS,86924,LINHA NOVA,239,673,118,1196,1078,47,61
RS,86932,CHARQUEADAS,5735,9758,2352,21027,18675,700,731
RS,86940,MANOEL VIANA,1803,2408,1192,5958,4766,111,168
RS,86959,HUMAITÁ,1257,1975,467,4128,3661,105,95
RS,86967,MAQUINÉ,2200,1818,1037,5744,4707,200,160
RS,86975,IBIAÇÁ,730,1942,287,3488,3201,93,108
RS,86983,MARATÁ,472,1299,166,2157,1991,43,68
RS,86991,IBIRAIARAS,1196,2840,796,5549,4753,192,207
RS,87009,MARIANA PIMENTEL,528,1846,444,3240,2796,87,173
RS,87017,IBIRUBÁ,3590,7749,2191,15107,12916,342,297
RS,87025,MATO CASTELHANO,407,1326,178,2139,1961,66,78
RS,87033,IGREJINHA,6794,9740,2333,21556,19223,713,732
RS,87041,MATO LEITÃO,895,1372,241,2897,2656,76,98
RS,87050,IJUÍ,18387,23217,8891,57671,48780,842,1222
RS,87068,MINAS DO LEÃO,1005,2975,609,5550,4941,196,227
RS,87076,ILÓPOLIS,629,1682,512,3294,2782,141,144
RS,87084,MONTE BELO DO SUL,560,1394,237,2601,2364,83,129
RS,87092,INDEPENDÊNCIA,1446,2807,906,5722,4816,99,166
RS,87106,MORMAÇO,548,1085,236,2118,1882,74,77
RS,87114,IRAÍ,2231,2665,1485,7121,5636,150,216
RS,87122,MORRINHOS DO SUL,1052,1247,290,2809,2519,43,67
RS,87130,ITAQUI,8339,10546,4970,26496,21526,352,574
RS,87149,MORRO REUTER,842,2730,411,4454,4043,125,134
RS,87157,ITATIBA DO SUL,1671,1312,374,3671,3297,96,154
RS,87165,MULITERNO,323,704,134,1429,1295,67,51
RS,87173,IVOTI,3693,6833,1233,13170,11937,297,452
RS,87181,NICOLAU VERGUEIRO,248,1031,224,1655,1431,38,58
RS,87190,JACUTINGA,589,1602,419,2976,2557,93,102
RS,87203,NOVA BOA VISTA,422,978,181,1825,1644,35,36
RS,87211,JAGUARÃO,6859,8647,4131,22081,17950,442,547
RS,87220,NOVA PÁDUA,228,1458,152,2102,1950,40,99
RS,87238,JAGUARI,2229,4718,1285,9665,8380,362,371
RS,87246,NOVA SANTA RITA,4224,5114,1796,12837,11041,366,408
RS,87254,JÚLIO DE CASTILHOS,4678,6660,2740,15537,12797,324,458
RS,87262,NOVO BARREIRO,1324,1185,283,3070,2787,49,129
RS,87270,LAGOA VERMELHA,4174,10158,3470,20178,16708,735,585
RS,87289,NOVO MACHADO,739,1985,374,3357,2983,42,78
RS,87297,LAJEADO,12739,23321,5837,48347,42510,1466,1554
RS,87300,NOVO TIRADENTES,663,670,445,1965,1520,34,87
RS,87319,LAVRAS DO SUL,2180,2549,673,6001,5328,139,193
RS,87327,PARECI NOVO,532,1454,299,2595,2296,69,93
RS,87335,LIBERATO SALZANO,1618,1726,655,4546,3891,137,260
RS,87343,PASSO DO SOBRADO,1420,2127,549,4753,4204,179,126
RS,87351,MACHADINHO,1193,1732,400,3997,3597,132,217
RS,87360,PICADA CAFÉ,962,2024,348,3754,3406,80,121
RS,87378,MARAU,4772,13113,2818,23787,20969,692,839
RS,87386,PINHAL GRANDE,1092,1522,617,3681,3064,114,121
RS,87394,MARCELINO RAMOS,1684,1523,850,4540,3690,85,126
RS,87408,PINHEIRINHO DO VALE,1278,1045,585,3458,2873,78,95
RS,87416,MARIANO MORO,760,682,194,1897,1703,107,60
RS,87424,PONTÃO,1158,1271,265,2949,2684,57,62
RS,87432,MATA,865,2164,623,4212,3589,208,174
RS,87440,PONTE PRETA,314,955,113,1550,1437,51,53
RS,87459,MAXIMILIANO DE ALMEIDA,848,1891,448,3880,3432,174,188
RS,87467,PORTO MAUÁ,589,1051,221,2107,1886,37,62
RS,87475,MIRAGUAÍ,1304,1468,507,3685,3178,77,145
RS,87483,PORTO VERA CRUZ,713,637,210,1756,1546,41,79
RS,87491,MONTENEGRO,11811,17013,4983,40466,35483,1454,1472
RS,87505,PRESIDENTE LUCENA,403,1110,107,1868,1761,17,69
RS,87513,MOSTARDAS,1816,4395,1349,8696,7347,265,290
RS,87521,QUEVEDOS,719,938,369,2217,1848,51,102
RS,87530,MUÇUM,742,2178,387,3941,3554,202,184
RS,87548,RIO DOS ÍNDIOS,1226,1058,654,3440,2786,73,138
RS,87556,NÃO-ME-TOQUE,2920,6367,1497,11982,10485,254,316
RS,87564,SAGRADA FAMÍLIA,828,416,209,1802,1593,36,44
RS,87572,NONOAI,2629,3192,2375,9492,7117,197,380
RS,87580,SALVADOR DAS MISSÕES,668,1138,256,2269,2013,30,58
RS,87599,NOVA ARAÇÁ,470,1543,261,2736,2475,157,127
RS,87602,SANTA CLARA DO SUL,1097,2341,360,4374,4014,119,177
RS,87610,NOVA BASSANO,1268,3534,786,6451,5665,252,238
RS,87629,SANTA TEREZA,452,733,175,1688,1513,56,68
RS,87637,NOVA BRÉSCIA,466,1441,235,2553,2318,74,105
RS,87645,SANTO ANTÔNIO DO PALMA,570,707,151,1676,1525,49,36
RS,87653,NOVA PALMA,1482,2452,683,5129,4446,67,115
RS,87661,SANTO ANTÔNIO DO PLANALTO,319,1009,133,1690,1557,23,42
RS,87670,NOVA PETRÓPOLIS,2299,8529,1803,14611,12808,370,587
RS,87688,SANTO EXPEDITO DO SUL,607,1033,161,2029,1868,97,76
RS,87696,NOVA PRATA,2778,8853,2055,15744,13689,470,527
RS,87700,SÃO JOÃO DO POLÊSINE,534,1231,259,2246,1987,37,58
RS,87718,NOVO HAMBURGO,43763,81708,19191,168531,149340,4699,5114
RS,87726,SÃO JOSÉ DOS AUSENTES,536,1340,565,2680,2115,50,94
RS,87734,OSÓRIO,7522,12668,4115,29356,25241,1017,1001
RS,87742,SÃO JOSÉ DO INHACORÁ,557,980,214,1963,1749,32,58
RS,87750,PAIM FILHO,1520,1390,486,3689,3203,96,94
RS,87769,SÃO JOSÉ DAS MISSÕES,1045,636,308,2324,2016,42,92
RS,87777,PALMEIRA DAS MISSÕES,7074,9205,4336,23376,19040,415,782
RS,87785,SÃO MARTINHO DA SERRA,688,1443,244,2613,2369,76,60
RS,87793,PALMITINHO,2109,2018,854,5518,4664,125,194
RS,87807,SÃO PEDRO DA SERRA,541,1395,250,2539,2289,99,96
RS,87815,PANAMBI,6166,13806,4131,26796,22665,474,521
RS,87823,SÃO PEDRO DO BUTIÁ,596,1107,259,2260,2001,30,70
RS,87831,PARAÍ,810,3017,526,5028,4502,219,182
RS,87840,SÃO VALENTIM DO SUL,408,1050,157,1961,1804,56,80
RS,87858,PASSO FUNDO,37191,55126,16126,124528,108402,2684,2892
RS,87866,SÃO VALÉRIO DO SUL,682,624,406,1967,1561,37,75
RS,87874,PEDRO OSÓRIO,1986,2217,745,5997,5252,226,209
RS,87882,SENTINELA DO SUL,647,2145,356,3623,3267,115,192
RS,87890,PEJUÇARA,931,1466,294,2929,2635,36,92
RS,87904,SÉRIO,709,897,226,2194,1968,78,91
RS,87912,PELOTAS,55232,102270,34593,239370,204777,6604,8512
RS,87920,SERTÃO SANTANA,557,2669,659,4408,3749,129,141
RS,87939,PINHEIRO MACHADO,3347,4117,1805,10702,8897,426,322
RS,87947,SINIMBÚ,2959,2974,1097,7871,6774,200,274
RS,87955,PIRATINI,4116,6531,2775,15826,13051,852,570
RS,87963,TIRADENTES DO SUL,2289,1858,633,5355,4722,87,167
RS,87971,PLANALTO,2515,3089,1882,8703,6821,281,304
RS,87980,TRAVESSEIRO,692,950,182,2027,1845,51,81
RS,87998,PORTÃO,5601,8759,2340,19358,17018,664,766
RS,88005,TRÊS FORQUILHAS,938,1195,389,2736,2347,75,73
RS,88013,PORTO ALEGRE,243568,413294,136989,1019126,882137,27522,35575
RS,88021,TUPANCI DO SUL,343,559,166,1273,1107,67,71
RS,88030,PORTO LUCENA,1587,1765,807,4770,3963,132,139
RS,88048,UNIÃO DA SERRA,319,791,157,1482,1325,72,44
RS,88056,PORTO XAVIER,2935,3097,1836,8814,6978,243,337
RS,88064,VALE DO SOL,3308,3048,836,8021,7185,303,234
RS,88072,PUTINGA,882,1722,684,3900,3216,165,223
RS,88080,VALE REAL,829,2054,426,3819,3393,140,194
RS,88099,QUARAÍ,6099,7279,3298,18237,14939,313,381
RS,88102,VILA NOVA DO SUL,1030,1536,540,3559,3019,130,95
RS,88110,REDENTORA,1931,2067,1348,5998,4650,105,313
RS,88129,VITÓRIA DAS MISSÕES,1116,1065,343,2962,2619,40,67
RS,88137,RESTINGA SÊCA,2590,6951,2249,13096,10847,261,347
RS,88145,XANGRI-LÁ,1702,3301,658,6423,5765,128,154
RS,88153,RIO GRANDE,41069,49567,19107,137187,118080,3887,4447
RS,88161,BOA VISTA DO SUL,567,1257,198,2295,2097,117,63
RS,88170,RIO PARDO,9844,11867,4203,29235,25032,791,781
RS,88188,DILERMANDO DE AGUIAR,667,1248,282,2407,2125,47,68
RS,88196,ROCA SALES,1995,3473,1178,7803,6625,385,280
RS,88200,CAPIVARI DO SUL,472,1434,336,2606,2270,55,94
RS,88218,RODEIO BONITO,1443,1888,844,4638,3794,86,187
RS,88226,NOVA CANDELÁRIA,713,1081,210,2266,2056,76,75
RS,88234,ROLANTE,3028,6806,1447,12954,11507,413,482
RS,88242,FLORIANO PEIXOTO,739,892,239,2002,1763,33,63
RS,88250,RONDA ALTA,2789,2699,1359,7632,6273,172,190
RS,88269,CHUVISCA,496,2478,216,3572,3356,118,127
RS,88277,RONDINHA,1625,2025,443,4508,4065,123,114
RS,88285,ESPERANÇA DO SUL,1167,1120,337,2832,2495,45,87
RS,88293,ROQUE GONZALES,1914,2215,728,5477,4749,137,198
RS,88307,DOUTOR RICARDO,460,881,255,1907,1652,96,98
RS,88315,ROSÁRIO DO SUL,8457,12868,6702,31420,24718,768,787
RS,88323,HERVEIRAS,1097,637,265,2185,1920,44,82
RS,88331,SALVADOR DO SUL,956,2953,330,4839,4509,137,167
RS,88340,CARAÁ,1413,2608,575,5360,4785,240,257
RS,88358,SANANDUVA,2795,6636,1570,12128,10558,388,308
RS,88366,FAZENDA VILANOVA,603,1339,370,2658,2288,93,104
RS,88374,SANTA BÁRBARA DO SUL,2143,3282,1306,7546,6240,177,144
RS,88382,ITAARA,671,2069,631,3819,3188,68,88
RS,88390,SANTA CRUZ DO SUL,20678,43908,9887,86289,76402,2492,2595
RS,88404,ESTRELA VELHA,934,1382,415,3047,2632,94,110
RS,88412,SANTA MARIA,38767,89188,28009,184419,156410,3797,4357
RS,88420,BENJAMIN CONSTANT DO SUL,783,484,428,1865,1437,62,55
RS,88439,SANTANA DA BOA VISTA,2302,2431,926,6771,5845,434,411
RS,88447,MAÇAMBARA,950,1576,887,3828,2941,59,107
RS,88455,SANTANA DO LIVRAMENTO,22569,24430,14370,68388,54018,1314,1321
RS,88463,DOM PEDRO DE ALCÂNTARA,1241,849,252,2637,2385,48,60
RS,88471,SANTA ROSA,11478,24140,7892,48152,40260,616,1085
RS,88480,UNISTALDA,654,1125,340,2347,2007,61,66
RS,88498,SANTA VITÓRIA DO PALMAR,6343,9848,4195,23585,19390,584,722
RS,88501,TURUÇU,449,1949,207,2903,2696,70,92
RS,88510,SANTIAGO,9768,16835,6936,37679,30743,1089,975
RS,88528,CRISTAL DO SUL,860,866,254,2302,2048,65,112
RS,88536,SANTO ÂNGELO,18650,21408,11037,59230,48193,1259,1241
RS,88544,MUITOS CAPÕES,273,1377,472,2377,1905,98,85
RS,88552,SANTO ANTÔNIO DA PATRULHA,5429,15710,4070,29241,25171,1067,1321
RS,88560,NOVA RAMADA,504,1022,187,1979,1792,43,71
RS,88579,SANTO ANTÔNIO DAS MISSÕES,3149,3231,2213,9626,7413,196,223
RS,88587,JARI,1025,1141,436,2974,2538,152,122
RS,88595,SANTO AUGUSTO,3230,4344,1386,10367,8981,203,316
RS,88609,UBIRETAMA,390,1243,173,1968,1795,26,42
RS,88617,SANTO CRISTO,4545,5131,1112,11642,10530,192,281
RS,88625,BARRA DO QUARAÍ,923,1313,755,3134,2379,26,41
RS,88633,SÃO BORJA,16679,16421,9416,47229,37813,701,965
RS,88641,CERRITO,1734,2118,498,5153,4655,247,172
RS,88650,SÃO FRANCISCO DE ASSIS,3944,6611,3262,16078,12816,621,610
RS,88668,VALE VERDE,622,1253,402,2640,2238,88,130
RS,88676,SÃO FRANCISCO DE PAULA,3843,7694,2726,16138,13412,521,571
RS,88684,NOVO CABRAIS,1119,1581,322,3339,3017,76,95
RS,88692,SÃO GABRIEL,12680,18111,8104,44088,35984,909,1023
RS,88706,SETE DE SETEMBRO,640,782,179,1811,1632,29,45
RS,88714,SÃO JERÔNIMO,3623,7909,2530,16205,13675,432,492
RS,88722,TABAÍ,785,1472,298,2930,2632,123,101
RS,88730,SÃO JOSÉ DO NORTE,6507,7422,2568,19488,16920,575,668
RS,88749,VILA LÂNGARO,561,1093,183,2054,1871,59,63
RS,88757,SÃO JOSÉ DO OURO,1176,2951,569,5345,4776,211,187
RS,88765,SENADOR SALGADO FILHO,387,1414,194,2293,2099,16,58
RS,88773,SÃO LEOPOLDO,48000,57366,18039,143874,125835,3827,4298
RS,88781,VESPASIANO CORRÊA,315,1432,420,2427,2007,91,87
RS,88790,SÃO LOURENÇO DO SUL,10164,15341,4959,34320,29361,722,884
RS,88803,MONTE ALEGRE DOS CAMPOS,367,1617,418,2727,2309,91,78
RS,88811,SÃO LUIZ GONZAGA,8369,9235,6141,26687,20546,626,720
RS,88820,MARQUES DE SOUZA,951,1744,361,3425,3064,102,114
RS,88838,SÃO MARCOS,1593,9654,2089,15257,13168,450,631
RS,88846,CHUÍ,1091,1040,447,2951,2504,83,67
RS,88854,SÃO MARTINHO,1400,2175,768,4920,4152,120,168
RS,88862,ARARICÁ,1308,1715,568,3990,3422,91,99
RS,88870,SÃO NICOLAU,1606,1439,923,4506,3583,125,211
RS,88889,PASSA SETE,1253,1717,350,3729,3379,129,141
RS,88897,SÃO PAULO DAS MISSÕES,1734,2297,621,5104,4483,71,114
RS,88900,TOROPI,607,1431,237,2534,2297,74,78
RS,88919,SÃO PEDRO DO SUL,3173,6620,1572,12837,11265,411,433
RS,88927,BALNEÁRIO PINHAL,1373,2686,1094,5970,4876,91,211
RS,88935,SÃO SEBASTIÃO DO CAÍ,4440,8596,2145,17462,15317,489,654
RS,88943,MAMPITUBA,937,1024,328,2521,2193,56,74
RS,88951,SÃO SEPÉ,5543,7840,3467,19265,15798,530,508
RS,88978,SÃO VALENTIM,948,1516,383,3214,2831,128,145
RS,88986,ACEGUÁ,931,1803,398,3352,2954,42,81
RS,88994,SAPIRANGA,18208,23585,6475,53327,46852,1332,1122
RS,89001,ALMIRANTE TAMANDARÉ DO SUL,476,1006,240,1846,1606,28,41
RS,89010,SAPUCAIA DO SUL,36493,32735,10954,94748,83794,2910,3012
RS,89028,ARROIO DO PADRE,217,1551,139,2111,1972,30,40
RS,89036,SARANDI,3598,6994,2810,15639,12829,368,359
RS,89044,BOA VISTA DO CADEADO,398,1021,270,1869,1599,43,52
RS,89052,SEBERI,2579,3807,1034,8414,7380,209,362
RS,89060,BOA VISTA DO INCRA,599,1005,205,1941,1736,34,29
RS,89079,SELBACH,736,2372,511,4011,3500,60,96
RS,89087,BOZANO,442,1121,161,1948,1787,22,27
RS,89095,SERAFINA CORRÊA,2108,5024,1220,9733,8513,414,407
RS,89109,CANUDOS DO VALE,632,828,239,1918,1679,44,86
RS,89117,SERTÃO,1214,3047,846,5691,4845,143,151
RS,89125,CAPÃO BONITO DO SUL,391,833,179,1543,1364,54,53
RS,89133,SEVERIANO DE ALMEIDA,969,1391,256,3037,2781,71,116
RS,89141,CAPÃO DO CIPÓ,803,1060,356,2452,2096,47,65
RS,89150,CAPÃO DA CANOA,6189,12320,4192,26052,21860,644,715
RS,89168,COQUEIRO BAIXO,226,782,170,1332,1162,30,68
RS,89176,SOBRADINHO,2668,5120,1704,10691,8987,261,321
RS,89184,CORONEL PILAR,299,817,158,1475,1317,69,56
RS,89192,SOLEDADE,5123,10616,3705,21971,18266,572,787
RS,89206,CRUZALTENSE,432,1084,210,1918,1708,53,59
RS,89214,TAPEJARA,1943,7457,1375,12304,10929,251,333
RS,89222,FORQUETINHA,557,1295,225,2326,2101,67,105
RS,89230,TAPERA,2160,3675,1020,7850,6830,191,247
RS,89247,SANTA CECÍLIA DO SUL,370,892,193,1618,1425,47,38
RS,89249,ITATI,702,1113,360,2485,2125,86,107
RS,89257,TAPES,2838,6053,2343,13032,10689,386,438
RS,89265,JACUIZINHO,816,843,304,2142,1838,40,68
RS,89273,TAQUARA,8601,19287,5406,38215,32809,1081,1382
RS,89281,LAGOA BONITA DO SUL,851,905,211,2209,1998,78,82
RS,89290,TAQUARI,4876,9480,2558,19801,17243,707,552
RS,89303,MATO QUEIMADO,589,665,214,1608,1394,41,47
RS,89311,TENENTE PORTELA,3039,4145,2201,10410,8209,164,354
RS,89320,NOVO XINGÚ,578,537,155,1476,1321,30,52
RS,89338,TORRES,6874,9832,4128,24295,20167,618,795
RS,89346,PAULO BENTO,414,935,137,1706,1569,43,57
RS,89354,TRAMANDAÍ,7057,12284,5772,28439,22667,655,752
RS,89362,PINHAL DA SERRA,539,763,510,2004,1494,76,72
RS,89370,TRÊS COROAS,4762,7424,1701,15902,14201,588,556
RS,89389,QUATRO IRMÃOS,438,610,221,1412,1191,31,50
RS,89397,TRÊS DE MAIO,4044,9792,3273,18984,15711,308,403
RS,89400,ROLADOR,895,897,464,2530,2066,75,78
RS,89419,TRÊS PASSOS,6238,7521,3163,18565,15402,375,479
RS,89435,TRIUNFO,4170,9295,1768,18803,17035,606,690
RS,89443,SANTA MARGARIDA DO SUL,544,1197,225,2257,2032,41,65
RS,89451,TUCUNDUVA,1015,2809,564,4906,4342,56,158
RS,89460,SÃO JOSÉ DO SUL,400,898,104,1629,1525,61,73
RS,89478,TUPANCIRETÃ,4114,7959,2753,16720,13967,445,578
RS,89486,SÃO PEDRO DAS MISSÕES,565,554,124,1424,1300,31,97
RS,89494,TUPARENDI,1701,3873,1166,7474,6308,127,204
RS,89508,TIO HUGO,548,978,236,2046,1810,58,56
RS,89516,URUGUAIANA,23628,39371,14828,86462,71634,1369,1694
RS,89524,WESTFÁLIA,464,1275,219,2232,2013,67,63
RS,89532,VACARIA,6427,24628,6838,42572,35734,1356,1167
RS,89559,VENÂNCIO AIRES,15771,20828,5596,48285,42689,1703,1622
RS,89567,PEDRAS ALTAS,710,727,411,1994,1583,26,52
RS,89575,VERA CRUZ,5104,8056,1689,16633,14944,448,541
RS,89591,VERANÓPOLIS,2154,10187,2105,17041,14936,665,760
RS,89613,VIADUTOS,1199,2325,741,4768,4027,151,141
RS,89630,VIAMÃO,39549,60799,18093,149260,131167,5038,5175
RS,89656,VICENTE DUTRA,1090,1806,917,4347,3430,100,152
RS,89672,PALMARES DO SUL,2319,4537,1805,9872,8067,180,323
RS,89699,VICTOR GRAEFF,442,1522,332,2634,2302,51,62
RS,89710,TAVARES,1442,1864,504,4277,3773,125,163
RS,89737,CAPÃO DO LEÃO,4499,7111,2672,17018,14346,525,477
RS,89753,SALTO DO JACUÍ,2895,3424,1496,8808,7312,185,307
RS,89770,COTIPORÃ,595,1686,316,3320,3004,136,110
RS,98213,TEUTÔNIA,3871,9868,1965,18390,16425,524,643
RS,98230,BOM PRINCÍPIO,1445,4679,693,7815,7122,261,305
RS,98256,PAROBÉ,12357,12478,3724,31822,28098,939,1038
RS,98272,FORTALEZA DOS VALOS,1084,1749,543,3686,3143,78,82
RS,98299,JÓIA,2112,2490,915,6049,5134,126,157
SC,80004,MONTE CARLO,1838,2856,1339,6799,5460,154,368
SC,80012,ABELARDO LUZ,4254,3863,2600,11780,9180,199,387
SC,80020,IPORÃ DO OESTE,1871,2705,946,6169,5223,108,205
SC,80039,AGROLÂNDIA,1571,3053,715,6119,5404,174,247
SC,80047,LINDÓIA DO SUL,1211,1501,534,3698,3164,101,139
SC,80055,AGRONÔMICA,713,1814,282,3202,2920,66,115
SC,80063,APIÚNA,1856,3179,1022,6644,5622,124,253
SC,80071,ÁGUA DOCE,1425,2081,933,5101,4168,79,229
SC,80080,DOUTOR PEDRINHO,470,1458,167,2368,2201,55,111
SC,80098,ÁGUAS DE CHAPECÓ,1694,1341,448,4022,3574,112,168
SC,80101,JOSÉ BOITEUX,935,1615,563,3441,2878,64,139
SC,80110,ÁGUAS MORNAS,1137,2650,359,4821,4462,119,256
SC,80128,VITOR MEIRELES,1239,1870,805,4282,3477,70,130
SC,80136,ALFREDO WAGNER,1667,3986,1036,7326,6290,122,268
SC,80144,UNIÃO DO OESTE,850,907,281,2393,2112,61,109
SC,80152,ANCHIETA,1645,1965,841,5019,4178,110,202
SC,80160,URUPEMA,509,1034,229,1997,1768,53,78
SC,80179,ANGELINA,1663,2026,467,4692,4225,81,176
SC,80187,IRACEMINHA,947,1551,374,3373,2999,79,148
SC,80195,ANITA GARIBALDI,2092,2756,1996,7686,5690,190,350
SC,80209,TIMBÓ GRANDE,766,2523,855,4551,3696,73,227
SC,80217,ANITÁPOLIS,858,1202,345,2668,2323,34,102
SC,80225,ABDON BATISTA,666,974,135,2072,1937,52,96
SC,80233,ANTÔNIO CARLOS,1111,3122,386,5359,4973,107,220
SC,80241,SANTA ROSA DO SUL,2163,2210,837,6084,5247,170,295
SC,80250,ARAQUARI,3919,4613,2168,11928,9760,227,362
SC,80268,CELSO RAMOS,791,738,330,2205,1875,62,102
SC,80276,ARARANGUÁ,12417,18348,5739,41609,35870,751,1297
SC,80284,SERRA ALTA,864,971,334,2469,2135,59,89
SC,80292,ARMAZÉM,1418,2469,372,4913,4541,87,189
SC,80306,COCAL DO SUL,3532,4098,1538,10782,9244,235,525
SC,80314,ARROIO TRINTA,710,1369,384,2787,2403,53,122
SC,80322,NOVA ITABERABA,1341,1196,289,3137,2848,50,112
SC,80330,ASCURRA,1219,2725,838,5495,4657,159,263
SC,80349,SANTA TEREZINHA,1541,3256,892,6144,5252,81,189
SC,80357,ATALANTA,378,1578,216,2534,2318,49,78
SC,80365,MIRIM DOCE,507,1103,329,2120,1791,26,65
SC,80373,AURORA,1301,1883,564,4276,3712,86,152
SC,80381,CERRO NEGRO,1031,989,337,2761,2424,59,229
SC,80390,BALNEÁRIO CAMBORIÚ,16105,31181,13634,71442,57808,1318,2208
SC,80403,PASSO DE TORRES,1206,1716,632,4169,3537,94,169
SC,80411,BARRA VELHA,2548,5731,2625,12280,9655,263,423
SC,80420,BRAÇO DO TROMBUDO,431,1629,388,2712,2324,35,108
SC,80438,BENEDITO NOVO,1299,4608,787,7524,6737,174,342
SC,80446,SUL BRASIL,908,792,208,2194,1986,37,113
SC,80454,BIGUAÇU,7026,16724,3966,33760,29794,930,1674
SC,80462,VARGEM,652,1049,358,2359,2001,65,117
SC,80470,BLUMENAU,43060,99889,25072,202657,177585,4893,9437
SC,80489,ARABUTÃ,1105,1332,361,3258,2897,91,138
SC,80497,BOM RETIRO,1171,3563,1183,6524,5341,112,251
SC,80500,ÁGUAS FRIAS,854,760,195,1976,1781,22,35
SC,80519,BOTUVERÁ,1020,1342,242,3092,2850,162,159
SC,80527,GUATAMBÚ,1382,1423,359,3616,3257,87,203
SC,80535,BRAÇO DO NORTE,3734,11456,2009,19321,17312,402,726
SC,80543,PLANALTO ALEGRE,727,796,227,2121,1894,33,89
SC,80551,BRUSQUE,16182,31994,6711,63577,56866,1528,2499
SC,80560,RIQUEZA,1289,1246,428,3491,3063,81,171
SC,80578,CAÇADOR,13017,21196,7223,46778,39555,1096,1888
SC,80586,LAJEADO GRANDE,332,687,252,1435,1183,25,60
SC,80594,CAIBI,1574,1888,740,5043,4303,104,257
SC,80608,RIO RUFINO,298,1152,349,2016,1667,39,80
SC,80616,CAMBORIÚ,9602,10621,4805,28092,23287,580,1022
SC,80624,PASSOS MAIA,1216,887,642,3019,2377,50,112
SC,80632,CAMPO ALEGRE,1263,5544,1146,8814,7668,147,376
SC,80640,SÃO JOÃO DO OESTE,1317,2240,422,4527,4105,101,197
SC,80659,CAMPO BELO DO SUL,1222,3338,1299,6447,5148,113,339
SC,80667,CALMON,717,864,650,3010,2360,25,103
SC,80675,CAMPO ERÊ,2727,2059,1239,6661,5422,121,291
SC,80683,BALNEÁRIO BARRA DO SUL,1383,2806,1354,6168,4814,65,176
SC,80691,CAMPOS NOVOS,5387,11261,3883,23148,19265,484,985
SC,80705,PARAÍSO,1177,1211,439,3197,2758,60,141
SC,80713,CANELINHA,1725,3362,1090,7014,5924,198,316
SC,80721,SANTA HELENA,581,817,346,2082,1736,38,72
SC,80730,CANOINHAS,6278,22123,5893,37888,31995,608,1230
SC,80748,BELMONTE,587,1036,325,2180,1855,34,108
SC,80756,CAPINZAL,3936,6316,2115,14500,12385,442,755
SC,80764,NOVO HORIZONTE,640,1027,252,2157,1905,59,84
SC,80772,CATANDUVAS,1937,2574,880,6153,5273,158,253
SC,80780,SÃO MIGUEL DA BOA VISTA,538,610,308,1645,1337,47,61
SC,80799,CAXAMBU DO SUL,1372,1556,336,3744,3408,92,183
SC,80802,ARVOREDO,632,649,112,1661,1549,21,86
SC,80810,CHAPECÓ,35971,47265,14287,107670,93383,1685,3107
SC,80829,IPUAÇU,1735,928,747,3831,3084,50,207
SC,80837,CONCÓRDIA,16735,19964,7098,49991,42893,1254,1798
SC,80845,OURO VERDE,574,716,192,1738,1546,21,90
SC,80853,CORONEL FREITAS,2784,3300,1098,8089,6991,219,302
SC,80861,IRATI,623,619,212,1597,1385,36,60
SC,80870,CORUPÁ,2435,5160,1340,10049,8709,162,382
SC,80888,FORMOSA DO SUL,792,703,336,2099,1763,61,74
SC,80896,CRICIÚMA,39925,53845,17148,128692,111544,2317,4523
SC,80900,MACIEIRA,604,694,325,1832,1507,38,86
SC,80918,CUNHA PORÃ,1601,4210,899,7737,6838,164,348
SC,80926,PONTE ALTA DO NORTE,410,1259,402,2342,1940,25,156
SC,80934,CURITIBANOS,5170,15310,5169,28338,23169,507,1197
SC,80942,SÃO CRISTÓVÃO DO SUL,763,1504,659,3237,2578,25,178
SC,80950,DESCANSO,2107,3056,616,6474,5858,126,212
SC,80969,VARGEM BONITA,1205,1516,480,3687,3207,42,181
SC,80977,DIONÍSIO CERQUEIRA,3920,3273,1458,9570,8112,151,408
SC,80985,BOMBINHAS,1818,3469,1589,8198,6609,207,359
SC,80993,DONA EMMA,786,1080,186,2353,2167,58,95
SC,81000,SANGÃO,2074,2343,824,5876,5052,108,269
SC,81019,ERVAL VELHO,999,1613,433,3426,2993,69,169
SC,81027,CAPIVARI DE BAIXO,5166,4122,958,12228,11270,220,543
SC,81035,FAXINAL DOS GUEDES,3084,2405,1116,7270,6154,153,270
SC,81043,CORDILHEIRA ALTA,903,1119,202,2519,2317,49,99
SC,81051,FLORIANÓPOLIS,61371,110260,40552,288746,248194,5120,13631
SC,81060,FORQUILHINHA,5427,6150,1427,14430,13003,224,441
SC,81078,FRAIBURGO,7044,10079,4474,24573,20099,622,1041
SC,81086,MORRO GRANDE,518,1342,202,2360,2158,30,91
SC,81094,GALVÃO,931,1103,629,2979,2350,54,151
SC,81108,CORONEL MARTINS,700,762,170,1773,1603,29,61
SC,81116,GOVERNADOR CELSO RAMOS,1747,5292,1649,10269,8620,225,495
SC,81124,SÃO JOÃO DO ITAPERIÚ,450,1309,240,2233,1993,41,103
SC,81132,GAROPABA,3751,4599,1818,11900,10082,273,507
SC,81140,JARDINÓPOLIS,501,565,203,1460,1257,34,63
SC,81159,GARUVA,2262,4073,1701,8881,7180,111,285
SC,81167,ERMO,549,1322,167,2296,2129,31,96
SC,81175,GASPAR,9406,16075,3916,33907,29991,798,1246
SC,81183,SÃO PEDRO DE ALCÂNTARA,814,1692,225,3227,3002,53,146
SC,81191,GRÃO-PARÁ,1159,2972,362,5098,4736,132,200
SC,81205,SANTIAGO DO SUL,362,468,123,1120,997,29,53
SC,81213,GRAVATAL,1828,3872,762,7354,6592,141,295
SC,81221,BELA VISTA DO TOLDO,594,2748,532,4312,3780,55,161
SC,81230,GUABIRUBA,3381,4614,775,10182,9407,355,452
SC,81248,CAPÃO ALTO,429,1545,283,2510,2227,29,118
SC,81256,GUARACIABA,3006,3326,1074,8187,7113,148,245
SC,81264,PAINEL,585,977,175,2095,1920,34,105
SC,81272,GUARAMIRIM,7413,8159,2621,20340,17719,354,603
SC,81280,BOCAINA DO SUL,635,1444,234,2641,2407,45,130
SC,81299,GUARUJÁ DO SUL,1134,1600,758,3864,3106,84,104
SC,81302,ALTO BELA VISTA,697,563,146,1648,1502,25,81
SC,81310,HERVAL D'OESTE,4896,6046,2058,14712,12654,259,536
SC,81329,FREI ROGÉRIO,572,1022,376,2178,1802,25,90
SC,81337,IBICARÉ,768,1268,374,2797,2423,78,119
SC,81345,TREVISO,619,1586,216,2782,2566,33,110
SC,81353,IBIRAMA,2943,6033,1910,12377,10467,278,550
SC,81361,IOMERÊ,628,1127,221,2286,2065,51,86
SC,81370,IÇARA,14886,12816,5073,37697,32624,788,1459
SC,81388,BOM JESUS,701,693,285,1923,1638,29,95
SC,81396,ILHOTA,2107,4341,1248,8848,7600,197,339
SC,81400,IBIAM,476,757,134,1622,1488,31,76
SC,81418,IMARUÍ,3345,3649,2107,10472,8365,266,533
SC,81426,ENTRE RIOS,949,513,542,2226,1684,36,111
SC,81434,IMBITUBA,10604,8900,4360,28109,23749,540,1212
SC,81442,PAIAL,531,548,132,1401,1269,25,59
SC,81450,IMBUIA,854,2301,487,4282,3795,163,186
SC,81469,BOM JESUS DO OESTE,526,798,251,1807,1556,55,81
SC,81477,INDAIAL,6861,17958,4185,33144,28959,840,1434
SC,81485,SÃO BERNARDINO,769,764,448,2187,1739,41,65
SC,81493,IPIRA,1402,1247,486,3556,3070,114,144
SC,81507,SANTA TEREZINHA DO PROGRESSO,798,809,313,2222,1909,48,116
SC,81515,IPUMIRIM,1957,2078,783,5578,4795,161,231
SC,81523,SALTINHO,1167,674,356,2725,2369,105,147
SC,81531,IRANI,2260,2272,840,6267,5427,173,295
SC,81540,JUPIÁ,496,763,189,1601,1412,31,67
SC,81558,IRINEÓPOLIS,1752,3699,1108,7132,6024,97,266
SC,81566,PALMEIRA,503,1290,194,2239,2045,26,124
SC,81574,ITÁ,1774,2022,861,5240,4379,75,190
SC,81582,BANDEIRANTE,878,985,280,2360,2080,30,79
SC,81590,ITAIÓPOLIS,2245,8434,2152,14389,12237,302,668
SC,81604,FLOR DO SERTÃO,476,466,197,1310,1113,44,73
SC,81612,ITAJAÍ,25708,52720,15969,113062,97093,3018,4705
SC,81620,CUNHATAÍ,383,744,103,1383,1280,29,47
SC,81639,ITAPEMA,5655,10729,4279,23789,19510,505,775
SC,81647,PRINCESA,668,797,384,2122,1738,75,68
SC,81655,ITAPIRANGA,3411,4791,1770,11211,9441,205,317
SC,81663,ITAPOÁ,2233,3156,2258,8640,6382,109,281
SC,81671,ITUPORANGA,3535,8336,2125,16082,13957,358,586
SC,81680,TIGRINHOS,640,395,185,1386,1201,34,55
SC,81698,JABORÁ,1058,1461,276,3264,2988,68,146
SC,81701,CHAPADÃO DO LAGEADO,562,952,154,1946,1792,25,74
SC,81710,JACINTO MACHADO,1424,4974,883,8327,7444,157,356
SC,81728,BALNEÁRIO ARROIO DO SILVA,1752,2082,764,5409,4645,85,214
SC,81736,JAGUARUNA,4290,4171,1624,11538,9914,208,454
SC,81744,BALNEÁRIO GAIVOTA,1893,1717,864,5208,4344,81,188
SC,81752,JARAGUÁ DO SUL,31196,35636,9991,88457,78466,1696,3256
SC,81760,BARRA BONITA,659,676,230,1792,1562,18,96
SC,81779,JOAÇABA,5195,8615,3044,19666,16622,363,720
SC,81787,BRUNÓPOLIS,1007,918,507,2724,2217,34,178
SC,81795,JOINVILLE,91268,145612,38387,321131,282744,5880,12113
SC,81809,LUZERNA,1223,2180,612,4685,4073,89,191
SC,81817,LACERDÓPOLIS,515,731,198,1775,1577,60,120
SC,81825,ZORTÉA,748,979,306,2341,2035,45,123
SC,81833,LAGES,21955,58981,17422,110699,93277,1842,3931
SC,81850,LAGUNA,12845,13382,5022,36001,30979,639,1184
SC,81876,LAURENTINO,1136,2087,379,4142,3763,123,171
SC,81892,LAURO MÜLLER,2672,5506,1325,10987,9662,212,459
SC,81914,LEBON RÉGIS,2303,3360,1832,8444,6612,219,443
SC,81930,LEOBERTO LEAL,519,1694,219,2736,2517,64,114
SC,81957,LONTRAS,1729,3290,961,6648,5687,191,250
SC,81973,LUÍS ALVES,1431,3704,727,6696,5969,134,255
SC,81990,MAFRA,6420,22035,5255,38650,33395,819,1464
SC,82015,MAJOR GERCINO,724,1130,376,2604,2228,76,123
SC,82031,MAJOR VIEIRA,1062,3060,761,5381,4620,66,237
SC,82058,MARAVILHA,5123,6232,2928,15975,13047,367,545
SC,82066,MAREMA,696,679,217,1808,1591,48,64
SC,82074,MASSARANDUBA,2666,5701,1249,10590,9341,164,336
SC,82090,MATOS COSTA,663,904,542,2336,1794,25,115
SC,82112,MELEIRO,1277,2850,486,5250,4764,92,228
SC,82139,MODELO,872,1305,397,2974,2577,48,116
SC,82155,MONDAÍ,2898,2308,1086,7124,6038,110,291
SC,82171,MONTE CASTELO,1478,3052,1397,6471,5074,113,231
SC,82198,MORRO DA FUMAÇA,2715,5070,1044,10227,9183,222,438
SC,82210,NAVEGANTES,8936,14112,5214,32514,27300,721,1148
SC,82236,NOVA ERECHIM,993,1334,450,3153,2703,40,112
SC,82252,NOVA TRENTO,2054,4344,966,8510,7544,299,358
SC,82279,NOVA VENEZA,2911,4052,1027,9339,8312,161,318
SC,82295,ORLEANS,2647,9321,2041,15898,13857,362,573
SC,82317,OURO,1389,2760,724,5689,4965,137,236
SC,82333,PALHOÇA,20152,31795,8365,73836,65471,2003,3250
SC,82350,PALMA SOLA,2189,1771,1203,5756,4553,98,250
SC,82376,PALMITOS,3367,5498,2359,12664,10305,258,508
SC,82392,PAPANDUVA,4204,5265,2317,13149,10832,231,561
SC,82414,PAULO LOPES,1655,2093,577,5008,4431,132,255
SC,82430,PEDRAS GRANDES,879,1864,440,3788,3348,91,168
SC,82457,PENHA,2609,6738,2695,13647,10952,279,495
SC,82473,PERITIBA,699,1358,320,2696,2376,60,106
SC,82490,PETROLÂNDIA,1134,2597,682,5064,4382,117,193
SC,82511,BALNEÁRIO PIÇARRAS,2342,4328,2132,9927,7795,161,364
SC,82538,PINHALZINHO,3803,4129,1519,10551,9032,222,355
SC,82554,PINHEIRO PRETO,596,1045,334,2285,1951,58,97
SC,82570,PIRATUBA,1255,1512,529,3898,3369,118,208
SC,82597,POMERODE,5379,8933,1940,18611,16671,387,838
SC,82619,PONTE ALTA,687,2086,688,3883,3195,60,255
SC,82635,PONTE SERRADA,2662,2734,1635,7942,6307,171,369
SC,82651,PORTO BELO,1914,3728,1581,8183,6602,156,312
SC,82678,PORTO UNIÃO,5249,11148,4519,23384,18865,323,740
SC,82694,POUSO REDONDO,2600,4396,1409,9541,8132,219,391
SC,82716,PRAIA GRANDE,1509,2417,411,5055,4644,138,275
SC,82732,PRESIDENTE CASTELO BRANCO,494,760,216,1620,1404,32,56
SC,82759,PRESIDENTE GETÚLIO,2463,5082,1231,9978,8747,253,401
SC,82775,PRESIDENTE NEREU,558,883,346,2043,1697,38,92
SC,82791,QUILOMBO,2749,3242,1062,7842,6780,165,301
SC,82813,RANCHO QUEIMADO,523,1317,233,2377,2144,57,72
SC,82830,RIO DAS ANTAS,1072,2724,795,5356,4561,112,283
SC,82856,RIO DO CAMPO,1033,2957,859,5311,4452,72,162
SC,82872,RIO DO OESTE,1507,2601,620,5336,4716,138,163
SC,82899,RIO DOS CEDROS,1267,4084,503,6827,6324,134,344
SC,82910,RIO DO SUL,9763,20865,5909,41553,35644,822,1436
SC,82937,RIO FORTUNA,826,2153,213,3755,3542,70,143
SC,82953,RIO NEGRINHO,4193,18150,4061,29151,25090,406,997
SC,82970,RODEIO,1770,4529,1011,8329,7318,238,334
SC,82996,ROMELÂNDIA,1714,1421,696,4294,3598,106,139
SC,83011,SALETE,1190,3252,782,5640,4858,56,193
SC,83038,SALTO VELOSO,820,1459,441,3093,2652,52,154
SC,83054,SANTA CECÍLIA,1519,6679,2313,11712,9399,243,547
SC,83070,SANTA ROSA DE LIMA,534,816,119,1699,1580,21,57
SC,83097,SANTO AMARO DA IMPERATRIZ,3244,6636,1179,13038,11859,260,639
SC,83119,SÃO BENTO DO SUL,9216,31742,5732,51449,45717,785,1567
SC,83135,SÃO BONIFÁCIO,389,1494,313,2589,2276,79,128
SC,83151,SÃO CARLOS,2309,3236,1114,7361,6247,148,213
SC,83178,SÃO DOMINGOS,2691,2559,1424,7389,5965,169,279
SC,83194,SÃO FRANCISCO DO SUL,6857,11691,5304,28446,23142,566,957
SC,83216,SÃO JOÃO BATISTA,3126,6789,1774,13625,11851,454,606
SC,83232,SÃO JOÃO DO SUL,1400,2617,353,5052,4699,92,228
SC,83259,SÃO JOAQUIM,3733,10347,2560,18756,16196,405,772
SC,83275,SÃO JOSÉ,30448,54367,15696,129549,113853,3091,6053
SC,83291,SÃO JOSÉ DO CEDRO,3719,3873,2335,11198,8863,216,372
SC,83313,SÃO JOSÉ DO CERRITO,2468,2882,1591,7676,6085,152,367
SC,83330,SÃO LOURENÇO DO OESTE,4635,7169,3279,16752,13473,409,545
SC,83356,SÃO LUDGERO,2083,3672,783,7321,6538,157,252
SC,83372,SÃO MARTINHO,775,1483,150,2718,2568,55,80
SC,83399,SÃO MIGUEL DO OESTE,8130,9643,4548,25060,20512,392,752
SC,83410,SAUDADES,2404,2888,711,6546,5835,85,226
SC,83437,SCHROEDER,3844,3042,1015,8946,7931,142,293
SC,83453,SEARA,4954,4985,1830,13045,11215,251,424
SC,83470,SIDERÓPOLIS,2830,4116,1529,9871,8342,179,348
SC,83496,SOMBRIO,5462,7232,2691,17988,15297,399,800
SC,83518,TAIÓ,2446,7412,2089,13234,11145,218,474
SC,83534,TANGARÁ,1576,3429,728,6399,5671,143,257
SC,83550,TIJUCAS,5312,9869,3083,20764,17681,395,892
SC,83577,TIMBÓ,4201,14739,2593,24707,22114,482,1005
SC,83593,TRÊS BARRAS,3177,6272,2287,13136,10849,192,567
SC,83615,TREZE DE MAIO,1331,2535,565,5183,4618,143,225
SC,83631,TREZE TÍLIAS,742,2051,689,3905,3216,84,149
SC,83658,TROMBUDO CENTRAL,885,2544,415,4407,3992,90,180
SC,83674,TUBARÃO,19316,28345,9013,68306,59293,1366,2756
SC,83682,TUNÁPOLIS,829,1870,463,3612,3149,64,121
SC,83690,TURVO,1761,4875,725,8636,7911,151,391
SC,83712,URUBICI,1351,4084,1316,7482,6166,74,286
SC,83739,URUSSANGA,3779,6688,2346,15253,12907,245,597
SC,83755,VARGEÃO,998,838,383,2476,2093,63,88
SC,83771,VIDAL RAMOS,1116,2524,659,4808,4149,115,168
SC,83798,VIDEIRA,8576,13945,4831,31534,26703,846,1314
SC,83810,WITMARSUM,639,1253,384,2703,2319,92,96
SC,83836,XANXERÊ,11733,9803,4542,28779,24237,562,871
SC,83852,XAVANTINA,1357,1328,223,3207,2984,52,85
SC,83879,XAXIM,6037,6950,2794,17838,15044,467,671
SC,83895,BOM JARDIM DA SERRA,549,1816,407,3173,2766,51,207
SC,83917,MARACAJÁ,2092,1798,612,5053,4441,99,195
SC,83933,TIMBÉ DO SUL,1137,2280,487,4388,3901,91,174
SC,83950,CORREIA PINTO,2510,6023,1573,11285,9712,201,440
SC,83976,OTACÍLIO COSTA,2770,5633,1711,11309,9598,159,384
SE,31003,SANTANA DO SÃO FRANCISCO,2046,1170,510,4325,3815,158,259
SE,31011,AMPARO DO SÃO FRANCISCO,784,511,277,1869,1592,35,130
SE,31038,AQUIDABÃ,4266,5525,2760,14445,11685,266,1135
SE,31054,ARACAJU,112844,125987,46750,347712,300962,6418,13594
SE,31070,ARAUÁ,2840,2909,1477,8137,6660,169,513
SE,31097,AREIA BRANCA,3226,4223,1132,9909,8777,248,702
SE,31119,BARRA DOS COQUEIROS,3986,6490,1917,14336,12419,306,673
SE,31135,BREJO GRANDE,1899,1307,606,4542,3936,128,448
SE,31151,BOQUIM,9001,5039,3086,18993,15907,370,1000
SE,31194,CAMPO DO BRITO,4649,4146,1977,12298,10321,265,897
SE,31216,CANHOBA,1530,1065,418,3612,3194,89,295
SE,31232,CANINDÉ DO SÃO FRANCISCO,8004,3617,2622,15901,13279,183,939
SE,31259,CAPELA,6510,6294,3427,18645,15218,403,1277
SE,31275,CARIRA,3491,5967,2762,14342,11580,372,1322
SE,31291,CARMÓPOLIS,2484,3268,1278,8426,7148,330,532
SE,31313,CEDRO DE SÃO JOÃO,1937,1565,554,4562,4008,78,241
SE,31330,CRISTINÁPOLIS,5333,2093,2430,11002,8572,178,689
SE,31356,NOSSA SENHORA APARECIDA,2447,1821,803,5736,4933,94,414
SE,31372,CUMBE,1032,1046,250,2698,2448,64,209
SE,31399,DIVINA PASTORA,848,1225,226,2700,2474,89,202
SE,31410,ESTÂNCIA,16192,11225,5944,39424,33480,1176,2391
SE,31437,FEIRA NOVA,1423,1644,427,4015,3588,86,318
SE,31453,FREI PAULO,3190,3729,1297,9479,8182,254,674
SE,31470,GENERAL MAYNARD,540,832,153,1802,1649,50,122
SE,31496,GARARU,2543,3179,691,7418,6727,154,577
SE,31518,GRACCHO CARDOSO,1679,1626,705,4708,4003,160,386
SE,31534,ILHA DAS FLORES,2393,1817,1292,6281,4989,160,435
SE,31550,INDIAROBA,5043,1402,1222,8673,7451,146,621
SE,31577,ITABAIANA,18014,22699,6570,54382,47812,1080,3559
SE,31593,ITABAIANINHA,10652,7318,4567,25376,20809,584,1667
SE,31615,ITABI,1358,1492,612,4048,3436,98,301
SE,31631,ITAPORANGA D'AJUDA,5660,8354,2301,19291,16990,517,1642
SE,31658,JAPARATUBA,4124,4237,1964,11610,9646,186,660
SE,31674,JAPOATÃ,3138,3446,1326,9130,7804,263,693
SE,31690,LAGARTO,23377,19580,10109,61302,51193,1551,4254
SE,31712,LARANJEIRAS,7711,5493,1691,17324,15633,463,1037
SE,31739,MACAMBIRA,1891,1727,418,4636,4218,99,334
SE,31755,MALHADA DOS BOIS,1185,1002,361,2900,2539,41,195
SE,31771,MALHADOR,3233,2897,828,7996,7168,190,609
SE,31798,MARUIM,3660,4247,1388,10848,9460,347,693
SE,31810,MOITA BONITA,3479,2393,847,7732,6885,231,602
SE,31836,MONTE ALEGRE DE SERGIPE,3284,2759,657,7778,7121,129,677
SE,31852,MURIBECA,1535,2392,944,5636,4692,126,404
SE,31879,NEÓPOLIS,4483,4582,1656,12850,11194,398,996
SE,31895,NOSSA SENHORA DA GLÓRIA,6521,8258,2842,19973,17131,367,1370
SE,31917,NOSSA SENHORA DAS DORES,5564,6349,2745,17292,14547,652,1366
SE,31933,NOSSA SENHORA DE LOURDES,1953,1533,397,4418,4021,71,296
SE,31950,NOSSA SENHORA DO SOCORRO,20700,30947,9158,71757,62599,1751,3314
SE,31976,PACATUBA,3856,2593,2086,9695,7609,277,653
SE,31992,PEDRA MOLE,877,776,275,2247,1972,31,182
SE,32018,PEDRINHAS,2996,1508,1252,6457,5205,108,394
SE,32034,PINHÃO,1977,1358,352,4141,3789,55,314
SE,32050,PIRAMBU,2244,2399,952,6381,5429,111,374
SE,32077,POÇO REDONDO,6186,5134,2385,15583,13198,221,1217
SE,32093,POÇO VERDE,7104,4294,3353,16480,13127,279,1041
SE,32115,PORTO DA FOLHA,5884,6844,2784,18088,15304,387,1291
SE,32131,PROPRIÁ,7693,6619,3445,19755,16310,337,901
SE,32158,RIACHÃO DO DANTAS,6807,3507,2507,14679,12172,376,1034
SE,32174,RIACHUELO,2056,2318,448,5879,5431,225,412
SE,32190,RIBEIRÓPOLIS,4580,3879,1329,11291,9962,230,893
SE,32212,ROSÁRIO DO CATETE,1937,2844,986,6651,5665,143,378
SE,32239,SALGADO,5681,3468,1478,12456,10978,340,959
SE,32255,SANTA LUZIA DO ITANHY,3353,2257,1653,8470,6817,303,675
SE,32298,SANTA ROSA DE LIMA,1073,1045,409,2940,2531,69,235
SE,32310,SANTO AMARO DAS BROTAS,3507,1874,1436,7704,6268,119,567
SE,32336,SÃO CRISTÓVÃO,14663,16420,5395,43675,38280,1052,2445
SE,32352,SÃO DOMINGOS,2201,2448,1327,6868,5541,147,580
SE,32379,SÃO FRANCISCO,740,1157,177,2362,2185,26,166
SE,32395,SÃO MIGUEL DO ALEIXO,808,1020,404,2728,2324,62,332
SE,32417,SIMÃO DIAS,14345,5917,3641,27703,24062,657,2104
SE,32433,SIRIRI,1695,2132,814,5419,4605,158,368
SE,32450,TELHA,949,871,246,2361,2115,40,154
SE,32476,TOBIAS BARRETO,18754,5726,6735,34579,27844,439,2042
SE,32492,TOMAR DO GERU,4154,2356,2091,9724,7633,171,731
SE,32514,UMBAÚBA,6597,3263,1893,13200,11307,293,758
SP,61000,EUCLIDES DA CUNHA PAULISTA,2571,2556,1841,7477,5636,83,189
SP,61018,ADAMANTINA,5561,11945,5544,26284,20740,778,732
SP,61026,BOREBI,393,988,338,1877,1539,25,70
SP,61034,ADOLFO,1007,1190,490,3002,2512,119,93
SP,61042,TARUMÃ,3548,3388,1465,8927,7462,162,227
SP,61050,AGUAÍ,6033,9480,4013,21870,17857,477,844
SP,61069,MOTUCA,1164,1212,643,3258,2615,49,69
SP,61077,ÁGUAS DA PRATA,1117,3010,1109,5884,4775,122,183
SP,61085,IARAS,893,1018,658,2786,2128,51,79
SP,61093,ÁGUAS DE LINDÓIA,1384,7515,2149,12163,10014,232,405
SP,61107,GUATAPARÁ,1804,1389,949,4504,3555,113,122
SP,61115,ÁGUAS DE SÃO PEDRO,339,1770,640,3027,2387,44,69
SP,61123,DIRCE REIS,415,645,159,1391,1232,54,33
SP,61131,AGUDOS,5765,12264,4748,25969,21221,657,1084
SP,61140,ESPÍRITO SANTO DO TURVO,842,1236,325,2541,2216,45,51
SP,61158,ALFREDO MARCONDES,1008,1499,468,3366,2898,84,134
SP,61166,ROSANA,6405,3875,5346,17270,11924,233,404
SP,61174,ALTAIR,1026,997,711,3032,2321,99,106
SP,61182,EMBAÚBA,604,761,237,1864,1627,75,76
SP,61190,ALTINÓPOLIS,3257,5223,2449,12414,9965,392,440
SP,61204,ILHA SOLTEIRA,5474,6157,4716,19647,14931,377,892
SP,61212,ALTO ALEGRE,931,1683,543,3576,3033,94,163
SP,61220,ALUMÍNIO,4369,4067,1092,11221,10129,304,354
SP,61239,ÁLVARES FLORENCE,581,1649,280,2792,2512,56,116
SP,61247,PEDRINHAS PAULISTA,519,1237,441,2412,1971,13,46
SP,61255,ÁLVARES MACHADO,5318,5615,2670,15308,12638,441,525
SP,61263,ARAÇARIGUAMA,2696,4688,2128,10546,8418,199,340
SP,61271,ÁLVARO DE CARVALHO,909,1091,560,2920,2360,83,172
SP,61280,BERTIOGA,7873,11914,6529,29775,23246,580,784
SP,61298,ALVINLÂNDIA,913,792,448,2378,1930,31,66
SP,61301,SUZANÁPOLIS,951,856,511,2536,2025,75,95
SP,61310,AMERICANA,50248,59965,19838,152445,132607,4539,5316
SP,61328,SANTO ANTÔNIO DO ARACANGUÁ,2173,2237,1174,5824,4650,45,88
SP,61336,AMÉRICO BRASILIENSE,8138,8385,3483,22314,18831,599,930
SP,61344,CANITAR,915,1388,632,3196,2564,73,105
SP,61352,AMÉRICO DE CAMPOS,759,2645,729,4548,3819,112,105
SP,61360,BARRA DO CHAPÉU,1530,1551,960,4280,3320,69,111
SP,61379,AMPARO,7248,26744,6855,46246,39391,1177,1836
SP,61387,EMILIANÓPOLIS,1025,847,342,2421,2079,53,81
SP,61395,ANALÂNDIA,454,2209,708,3698,2990,71,108
SP,61409,NOVAIS,935,1100,429,2764,2335,68,139
SP,61417,ANDRADINA,11805,16794,8540,42016,33476,1170,1324
SP,61425,NOVA CANAÃ PAULISTA,658,806,351,1971,1620,57,56
SP,61433,ANGATUBA,4082,7017,2641,15194,12553,308,467
SP,61441,SALTINHO,860,3405,493,5295,4802,166,137
SP,61450,ANHEMBI,917,1875,1024,4059,3035,66,75
SP,61468,UBARANA,1146,1423,709,3599,2890,91,107
SP,61476,ANHUMAS,875,1136,384,2681,2297,85,78
SP,61484,CAJATI,6060,9004,5111,21725,16614,379,642
SP,61492,APARECIDA,6132,13590,2907,25577,22670,465,601
SP,61506,CAMPINA DO MONTE ALEGRE,753,2234,709,4024,3315,72,134
SP,61514,APARECIDA D'OESTE,1217,1478,698,3743,3045,119,114
SP,61522,ASPÁSIA,462,699,198,1494,1296,37,49
SP,61530,APIAÍ,4651,8089,5318,19616,14298,372,613
SP,61549,VARGEM,1013,2816,1364,5788,4424,211,195
SP,61557,ARAÇATUBA,25425,65517,23111,127663,104552,2294,3825
SP,61565,POTIM,2738,4375,1382,9371,7989,146,243
SP,61573,ARAÇOIABA DA SERRA,3387,8885,2051,15992,13941,378,490
SP,61581,ALAMBARI,554,1893,663,3346,2683,57,83
SP,61590,ARAMINA,1807,1135,532,3854,3322,86,117
SP,61603,ITAÓCA,757,922,434,2324,1890,51,107
SP,61611,ARANDU,1408,2103,680,4532,3852,91,121
SP,61620,TUIUTI,705,2573,855,4536,3681,117,150
SP,61638,ARARAQUARA,33471,62489,21678,139101,117423,3648,6576
SP,61646,ARAPEÍ,662,920,427,2198,1771,31,72
SP,61654,ARARAS,15636,43357,10793,81552,70759,2720,3397
SP,61662,ESTIVA GERBI,2781,2767,1017,7356,6339,217,240
SP,61670,AREALVA,984,3123,810,5548,4738,196,180
SP,61689,ENGENHEIRO COELHO,2909,3532,1644,8690,7046,166,189
SP,61697,AREIAS,887,1237,662,3077,2415,33,100
SP,61700,RIBEIRÃO GRANDE,1920,2529,1097,6049,4952,193,175
SP,61719,AREIÓPOLIS,2434,3036,1346,7510,6164,285,244
SP,61727,HORTOLÂNDIA,55224,23339,15411,105448,90037,2259,2792
SP,61735,ARIRANHA,1701,2988,1024,6436,5412,228,248
SP,61743,HOLAMBRA,2174,4359,954,8133,7179,159,211
SP,61751,ARTUR NOGUEIRA,8558,10620,3978,25938,21960,713,790
SP,61760,ELISIÁRIO,863,950,309,2325,2016,61,60
SP,61778,ARUJÁ,15294,21211,8500,51003,42503,1109,1634
SP,61786,BOM SUCESSO DE ITARARÉ,575,1236,604,2549,1945,32,56
SP,61794,ASSIS,16015,28675,12401,64731,52330,1375,2016
SP,61808,PONTALINDA,1049,1189,523,2981,2458,96,72
SP,61816,ATIBAIA,13413,46756,15014,84729,69715,2268,2832
SP,61824,PARISI,366,979,237,1735,1498,32,55
SP,61832,AURIFLAMA,3101,4666,1410,10100,8690,286,279
SP,61840,TAQUARIVAÍ,660,2139,931,3915,2984,49,71
SP,61859,AVAÍ,1150,1562,809,3823,3014,50,92
SP,61867,MARAPOAMA,483,951,222,1829,1607,55,71
SP,61875,AVANHANDAVA,2353,2589,1344,6965,5621,205,182
SP,61883,SÃO JOÃO DE IRACEMA,532,460,294,1429,1135,36,37
SP,61891,AVARÉ,11065,28951,9590,55470,45880,1247,1999
SP,61905,SÃO LOURENÇO DA SERRA,2239,3981,1672,8922,7250,260,378
SP,61913,BADY BASSIT,2241,4681,1794,9845,8051,249,307
SP,61921,ZACARIAS,728,656,235,1778,1543,33,74
SP,61930,BALBINOS,292,644,187,1265,1078,40,57
SP,61948,ITAPIRAPUÃ PAULISTA,914,1089,471,2661,2190,44,88
SP,61956,BÁLSAMO,1351,3059,577,5606,5029,233,126
SP,61964,MESÓPOLIS,332,748,291,1490,1199,57,31
SP,61972,BANANAL,1971,3568,1222,7551,6329,133,328
SP,61980,NOVA CAMPINA,1446,3088,1037,5914,4877,73,159
SP,61999,BARBOSA,1224,2106,1210,4983,3773,89,164
SP,62006,ILHA COMPRIDA,1757,3000,2319,7733,5414,108,160
SP,62014,BARÃO DE ANTONINA,476,1172,610,2435,1825,37,66
SP,62022,LOURDES,381,898,185,1604,1419,27,60
SP,62030,BARIRI,3138,12287,4167,22193,18026,799,815
SP,62049,TORRE DE PEDRA,409,1134,589,2300,1711,40,54
SP,62057,BARRA BONITA,5122,15761,4908,28704,23796,649,865
SP,62065,ARCO ÍRIS,405,964,179,1626,1447,22,24
SP,62073,BARRA DO TURVO,2116,1755,2337,6702,4365,74,290
SP,62081,BREJO ALEGRE,821,612,209,1791,1582,66,54
SP,62090,BARRETOS,19515,35468,13454,77684,64230,1963,2353
SP,62103,CANAS,594,1574,467,2857,2390,43,66
SP,62111,BARRINHA,8325,4808,3662,18783,15121,549,636
SP,62120,PRACINHA,325,624,151,1181,1030,18,35
SP,62138,BARUERI,71353,60076,26846,181007,154161,5092,5996
SP,62146,PRATÂNIA,563,1912,682,3449,2767,92,129
SP,62154,BASTOS,3014,8859,3766,16904,13138,423,356
SP,62162,QUADRA,409,1416,529,2571,2042,54,71
SP,62170,BATATAIS,7895,20832,5983,38594,32611,1017,1213
SP,62189,SANTA CRUZ DA ESPERANÇA,306,735,245,1450,1205,34,77
SP,62197,BAURU,54846,101805,34867,225390,190523,5554,9045
SP,62200,SANTA SALETE,377,622,149,1316,1167,52,37
SP,62219,BEBEDOURO,12764,25344,9824,53868,44044,1369,1612
SP,62227,VITÓRIA BRASIL,437,605,201,1422,1221,71,49
SP,62235,BENTO DE ABREU,556,910,198,1857,1659,52,90
SP,62243,IPIGUÁ,492,1600,387,2716,2329,62,55
SP,62251,BERNARDINO DE CAMPOS,1702,4091,1510,8083,6573,168,211
SP,62260,TAQUARAL,650,789,372,2041,1669,78,76
SP,62278,BILAC,794,3148,793,5330,4537,90,193
SP,62286,FERNÃO,285,543,150,1070,920,30,40
SP,62294,BIRIGUI,15020,36308,10135,70504,60369,2418,3318
SP,62308,GAVIÃO PEIXOTO,1081,1320,575,3320,2745,106,103
SP,62316,BIRITIBA MIRIM,3197,10387,3615,19389,15774,514,621
SP,62324,JUMIRIM,289,1104,298,1851,1553,38,43
SP,62332,BOA ESPERANÇA DO SUL,3897,3053,1804,9611,7807,259,332
SP,62340,NANTES,497,941,315,1869,1554,17,54
SP,62359,BOCAINA,1462,4020,1236,7548,6312,218,278
SP,62367,NOVA CASTILHO,188,675,157,1084,927,17,16
SP,62375,BOFETE,1593,2703,1800,6772,4972,195,230
SP,62383,OUROESTE,1762,2112,831,5250,4419,203,147
SP,62391,BOITUVA,5398,15577,4793,29211,24418,813,1216
SP,62405,PAULISTÂNIA,251,753,170,1270,1100,28,39
SP,62413,BOM JESUS DOS PERDÕES,2230,6773,2025,12301,10276,313,462
SP,62421,RIBEIRÃO DOS ÍNDIOS,646,700,182,1759,1577,73,81
SP,62430,BORÁ,231,382,137,834,697,29,18
SP,62448,TRABIJU,390,588,133,1179,1046,18,26
SP,62456,BORACÉIA,741,1532,338,2873,2535,84,97
SP,62472,BORBOREMA,2419,4975,2191,10757,8566,348,340
SP,62499,BOTUCATU,14515,41073,13340,81837,68497,2320,3945
SP,62510,BRAGANÇA PAULISTA,15902,54323,15964,99523,83559,2898,3843
SP,62553,BRAÚNA,850,1998,478,3682,3204,128,116
SP,62570,BRODOWSKI,2813,6847,2399,13641,11242,370,523
SP,62596,BROTAS,2772,7657,3238,15488,12250,450,650
SP,62618,BURI,2792,6670,2674,13080,10406,303,320
SP,62634,BURITAMA,2801,4972,2414,11316,8902,311,412
SP,62650,BURITIZAL,656,1652,476,3078,2602,82,115
SP,62677,CABRÁLIA PAULISTA,1195,1291,795,3587,2792,76,95
SP,62693,CABREÚVA,8900,9972,4305,25630,21325,683,842
SP,62715,CAÇAPAVA,13549,30686,8244,59647,51403,1356,1810
SP,62731,CACHOEIRA PAULISTA,7971,7411,3515,21653,18138,438,483
SP,62758,CACONDE,2826,6418,2833,13278,10445,306,462
SP,62774,CAFELÂNDIA,2994,5836,2656,12636,9980,258,320
SP,62790,CAIABU,1309,1189,550,3384,2834,104,124
SP,62812,CAIEIRAS,17647,19594,6701,52286,45585,1644,2174
SP,62839,CAIUÁ,1507,1154,752,3756,3004,76,114
SP,62855,CAJAMAR,16654,14101,4968,41301,36333,1263,1469
SP,62871,CAJOBI,2400,2918,1484,7582,6098,244,237
SP,62898,CAJURU,4599,6870,3251,16642,13391,540,685
SP,62910,CAMPINAS,230908,256237,102662,689904,587242,14720,25616
SP,62936,CAMPO LIMPO PAULISTA,20157,17268,7600,51403,43803,1110,2019
SP,62952,CAMPOS DO JORDÃO,5498,18789,7093,35135,28042,1044,1091
SP,62979,CAMPOS NOVOS PAULISTA,775,1504,397,3010,2613,88,117
SP,62995,CANANÉIA,1900,4362,2347,9334,6987,130,248
SP,63010,CÂNDIDO MOTA,6190,10888,4377,23449,19072,620,555
SP,63037,CÂNDIDO RODRIGUES,649,987,372,2321,1949,114,114
SP,63053,CAPÃO BONITO,6726,17612,7808,34949,27141,796,896
SP,63070,CAPELA DO ALTO,1642,6324,1908,11127,9219,282,297
SP,63096,CAPIVARI,5753,16342,4861,30672,25811,870,1007
SP,63118,CARAGUATATUBA,13780,28411,12693,62241,49548,1535,1967
SP,63134,CARAPICUÍBA,95738,82453,32895,239913,207018,6459,7205
SP,63150,CARDOSO,3113,3206,1599,8808,7209,241,324
SP,63177,CASA BRANCA,3100,9529,3921,19174,15253,517,765
SP,63193,CÁSSIA DOS COQUEIROS,329,1303,431,2295,1864,51,113
SP,63215,CASTILHO,5520,3351,3044,13239,10195,268,303
SP,63231,CATANDUVA,14942,38596,11367,76042,64675,2149,3311
SP,63258,CATIGUÁ,1999,1784,478,4944,4466,210,287
SP,63274,CEDRAL,1185,2936,1079,6052,4973,174,296
SP,63290,CERQUEIRA CÉSAR,2032,6421,2537,12180,9643,320,335
SP,63312,CERQUILHO,4964,13525,3433,24615,21182,702,987
SP,63339,CESÁRIO LANGE,1463,5839,1916,10468,8552,402,471
SP,63355,CHARQUEADA,2710,5682,1999,11478,9479,257,346
SP,63371,CHAVANTES,2763,3730,1751,9201,7450,183,318
SP,63398,CLEMENTINA,1170,2152,987,4772,3785,125,181
SP,63410,COLINA,4198,5284,2867,13530,10663,345,413
SP,63436,COLÔMBIA,1547,1680,728,4309,3581,92,132
SP,63452,CONCHAL,3743,9168,3196,18028,14832,706,652
SP,63479,CONCHAS,2482,6068,2713,12426,9713,290,399
SP,63495,CORDEIRÓPOLIS,3709,6304,1856,14011,12155,452,521
SP,63517,COROADOS,867,1752,586,3501,2915,73,107
SP,63533,CORONEL MACEDO,1553,1702,967,4554,3587,83,122
SP,63550,CORUMBATAÍ,429,1738,745,3227,2482,86,102
SP,63576,COSMÓPOLIS,13669,13068,5632,36353,30721,960,1162
SP,63592,COSMORAMA,1128,2948,606,5174,4568,150,114
SP,63614,COTIA,38264,47221,16030,115678,99648,2797,3675
SP,63630,CRAVINHOS,3893,11959,3316,21510,18194,659,844
SP,63657,CRISTAIS PAULISTA,984,2840,958,5217,4259,100,162
SP,63673,CRUZÁLIA,515,1219,272,2118,1846,24,30
SP,63690,CRUZEIRO,17470,22364,8401,55014,46613,1210,1882
SP,63711,CUBATÃO,41043,24949,12841,89380,76539,1678,2082
SP,63738,CUNHA,4644,7532,4331,18189,13858,518,561
SP,63754,DESCALVADO,3414,13160,3729,23253,19524,840,870
SP,63770,DIADEMA,142428,73479,36379,286840,250461,6363,9831
SP,63797,DIVINOLÂNDIA,1400,5292,1979,9700,7721,385,352
SP,63819,DOBRADA,2023,2132,1038,5775,4737,133,215
SP,63835,DOIS CÓRREGOS,2987,9103,3154,17007,13853,551,503
SP,63851,DOLCINÓPOLIS,740,716,270,1912,1642,46,67
SP,63878,DOURADO,1546,3229,1291,6979,5688,370,242
SP,63894,DRACENA,7670,14983,6788,32996,26208,793,1087
SP,63916,DUARTINA,2380,4677,2364,10487,8123,246,353
SP,63932,DUMONT,1414,2422,751,5197,4446,192,200
SP,63959,ECHAPORÃ,1216,2438,1235,5300,4065,63,160
SP,63975,ELDORADO,2798,4362,3146,11158,8012,142,355
SP,63991,ELIAS FAUSTO,3386,4756,2373,11661,9288,288,426
SP,64017,EMBU,53795,58390,20773,154495,133722,4178,4978
SP,64033,EMBU-GUAÇU,11987,18919,7560,43296,35736,1018,1294
SP,64050,ESTRELA D'OESTE,1692,3181,733,6456,5723,229,248
SP,64076,ESTRELA DO NORTE,478,1140,412,2192,1780,38,44
SP,64092,FARTURA,2389,5960,2543,11851,9308,202,332
SP,64114,FERNANDÓPOLIS,12302,21260,8831,46945,38114,1164,1074
SP,64130,FERNANDO PRESTES,1220,1818,777,4428,3651,268,171
SP,64157,FERRAZ DE VASCONCELOS,40772,30149,14860,99735,84875,2467,3392
SP,64173,FLORA RICA,659,709,361,1876,1515,23,47
SP,64190,FLOREAL,680,1268,506,2713,2207,58,70
SP,64211,FLÓRIDA PAULISTA,3211,2816,1800,8715,6915,314,258
SP,64238,FLORÍNIA,834,1007,420,2481,2061,53,62
SP,64254,FRANCA,41960,112191,27182,202945,175763,4682,5798
SP,64270,FRANCISCO MORATO,36419,25653,13643,85695,72052,2824,3092
SP,64297,FRANCO DA ROCHA,31200,24403,10826,79030,68204,2520,3320
SP,64319,GABRIEL MONTEIRO,293,1403,342,2257,1915,51,101
SP,64335,GÁLIA,1314,2327,1310,5478,4168,107,179
SP,64351,GARÇA,5156,17373,6935,32589,25654,868,978
SP,64378,GASTÃO VIDIGAL,878,1241,602,3031,2429,92,99
SP,64394,GENERAL SALGADO,2371,3934,1991,9086,7095,209,184
SP,64416,GETULINA,1890,3736,1911,8209,6298,169,271
SP,64432,GLICÉRIO,1119,1569,522,3497,2975,71,118
SP,64459,GUAIÇARA,2569,2479,1452,7081,5629,159,164
SP,64475,GUAIMBÊ,1150,1665,674,3866,3192,83,148
SP,64491,GUAÍRA,6488,14112,4969,27407,22438,540,549
SP,64513,GUAPIAÇU,3570,5390,2172,12426,10254,420,370
SP,64530,GUAPIARA,4325,5475,4012,14820,10808,238,501
SP,64556,GUARÁ,5751,4537,2832,14202,11370,256,415
SP,64572,GUARAÇAÍ,2099,2589,1487,6958,5471,207,213
SP,64599,GUARACI,2222,2665,1728,7300,5572,170,225
SP,64610,GUARANI D'OESTE,469,602,169,1351,1182,23,34
SP,64637,GUARANTÃ,1254,2275,1095,5090,3995,173,119
SP,64653,GUARARAPES,4663,11611,4587,22969,18382,505,714
SP,64670,GUARAREMA,3920,8784,1944,16423,14479,330,489
SP,64696,GUARATINGUETÁ,20773,37941,11761,80744,68983,1586,2219
SP,64718,GUAREÍ,1616,4020,1484,8190,6706,374,392
SP,64734,GUARIBA,9009,9240,4102,24712,20610,659,712
SP,64750,GUARUJÁ,80102,58901,28835,197466,168631,5410,5944
SP,64777,GUARULHOS,234914,271318,87736,699876,612140,16831,26376
SP,64793,GUZOLÂNDIA,948,1546,476,3209,2733,75,88
SP,64815,HERCULÂNDIA,1850,2754,1237,6350,5113,108,211
SP,64831,IACANGA,1155,3740,1539,7214,5675,194,200
SP,64858,IACRI,1087,2589,612,4647,4035,90,125
SP,64874,IBATÉ,6123,8460,2809,19921,17112,765,694
SP,64890,IBIRÁ,1210,3911,1459,7586,6127,287,316
SP,64912,IBIRAREMA,925,2509,520,4372,3852,114,128
SP,64939,IBITINGA,8957,17699,6080,36363,30283,1132,1286
SP,64955,IBIÚNA,5784,29109,10189,49195,39006,871,1698
SP,64971,ICÉM,1822,2307,941,5715,4774,135,174
SP,64998,IEPÊ,1058,3086,815,5375,4560,62,141
SP,65013,IGARAÇU DO TIETÊ,5272,7213,2925,17642,14717,788,739
SP,65030,IGARAPAVA,7182,7176,4741,21498,16757,578,739
SP,65056,IGARATÁ,1342,3308,828,6096,5268,112,211
SP,65072,IGUAPE,5646,9369,5420,22308,16888,325,596
SP,65099,ILHABELA,3255,9023,3214,17020,13806,261,425
SP,65110,INDAIATUBA,39291,42946,16782,116477,99695,3421,4232
SP,65137,INDIANA,991,1922,683,4096,3413,163,110
SP,65153,INDIAPORÃ,853,1441,615,3165,2550,71,73
SP,65170,INÚBIA PAULISTA,594,1428,294,2566,2272,63,110
SP,65196,IPAUÇU,1985,4788,1702,9348,7646,222,236
SP,65218,IPERÓ,4771,4773,2989,14479,11490,332,485
SP,65234,IPEÚNA,808,1752,731,3622,2891,75,115
SP,65250,IPORANGA,1227,966,873,3299,2426,41,88
SP,65277,IPUÃ,3621,3470,1476,9156,7680,182,212
SP,65293,IRACEMÁPOLIS,3539,6262,1447,12867,11420,283,453
SP,65315,IRAPUÃ,1121,2593,1161,5397,4236,161,205
SP,65331,IRAPURU,1454,2209,804,5035,4231,155,170
SP,65358,ITABERÁ,4404,5450,2529,13213,10684,304,253
SP,65374,ITAÍ,4071,7425,3098,15853,12755,343,468
SP,65390,ITAJOBI,1892,6272,2259,12062,9803,576,509
SP,65412,ITAJU,394,1331,489,2516,2027,80,74
SP,65439,ITANHAÉM,14112,23454,13867,57579,43712,1135,1628
SP,65455,ITAPECERICA DA SERRA,32516,35427,13404,92471,79067,2633,2883
SP,65471,ITAPETININGA,15422,50133,14076,89953,75877,2016,2804
SP,65498,ITAPEVA,13306,30940,10456,59879,49423,1303,1440
SP,65510,ITAPEVI,50993,33065,16383,112391,96008,3157,3491
SP,65536,ITAPIRA,8418,26330,7198,49521,42323,1926,2138
SP,65552,ITÁPOLIS,6170,13693,5570,29092,23522,1226,1174
SP,65579,ITAPORANGA,2008,5990,2959,11836,8877,257,312
SP,65595,ITAPUÍ,1965,3696,1193,7502,6309,198,196
SP,65617,ITAPURA,1278,756,838,3153,2315,57,120
SP,65633,ITAQUAQUECETUBA,70725,46326,25593,163658,138065,4723,5886
SP,65650,ITARARÉ,7196,17631,6992,35198,28206,770,949
SP,65676,ITARIRI,1525,4032,2118,8361,6243,145,231
SP,65692,ITATIBA,11717,33996,8664,61192,52528,1745,2186
SP,65714,ITATINGA,2500,5904,1962,11507,9545,312,410
SP,65730,ITIRAPINA,1844,3930,1744,8575,6831,224,341
SP,65757,ITIRAPUÃ,1364,1817,799,4374,3575,98,158
SP,65773,ITOBI,1106,3033,1112,5865,4753,191,171
SP,65790,ITU,26930,47436,15799,101796,85997,2732,3860
SP,65811,ITUPEVA,7187,10197,4073,23958,19885,666,803
SP,65838,ITUVERAVA,9137,11417,5643,28762,23119,599,797
SP,65854,JABORANDI,2173,1599,995,5214,4219,178,162
SP,65870,JABOTICABAL,8562,25102,9548,49302,39754,1240,1594
SP,65897,JACAREÍ,36026,69080,20671,141046,120375,2213,3630
SP,65919,JACI,1065,2037,529,3945,3416,87,90
SP,65935,JACUPIRANGA,2527,6079,3015,12605,9590,164,314
SP,65951,JAGUARIÚNA,7797,11137,4064,25954,21890,847,813
SP,65978,JALES,9005,16184,7054,36183,29129,975,1051
SP,65994,JAMBEIRO,657,2092,314,3363,3049,52,81
SP,66010,JANDIRA,24929,25987,9924,68585,58661,1637,1819
SP,66036,JARDINÓPOLIS,5402,10570,4057,23041,18984,858,897
SP,66052,JARINU,3161,7112,2864,14601,11737,315,516
SP,66079,JAÚ,16492,47369,11811,86310,74499,2766,3088
SP,66095,JERIQUARA,842,1206,694,2937,2243,56,87
SP,66117,JOANÓPOLIS,1205,4675,1572,8315,6743,232,289
SP,66133,JOÃO RAMALHO,1015,1350,754,3406,2652,58,136
SP,66150,JOSÉ BONIFÁCIO,4706,10875,3281,21526,18245,967,678
SP,66176,JÚLIO MESQUITA,1403,1305,690,3693,3003,82,114
SP,66192,JUNDIAÍ,77706,104984,33253,251398,218145,5692,11314
SP,66214,JUNQUEIRÓPOLIS,3751,5710,3132,13791,10659,305,308
SP,66230,JUQUIÁ,3508,7184,4688,16663,11975,233,505
SP,66257,JUQUITIBA,4842,9540,4507,21135,16628,464,727
SP,66273,LAGOINHA,778,2804,816,4785,3969,102,132
SP,66290,LARANJAL PAULISTA,2854,10640,2668,17684,15016,439,487
SP,66311,LAVÍNIA,1352,1310,427,3552,3125,108,161
SP,66338,LAVRINHAS,1484,2425,804,5189,4385,93,151
SP,66354,LEME,17949,26167,8937,60532,51595,2277,2175
SP,66370,LENÇÓIS PAULISTA,7880,22228,5777,40442,34665,1182,1394
SP,66397,LIMEIRA,54085,74459,25830,181180,155350,5173,7018
SP,66419,LINDÓIA,459,2902,557,4318,3761,70,155
SP,66435,LINS,9142,25568,9743,50786,41043,1251,1551
SP,66451,LORENA,13882,27175,10110,58674,48564,1264,1535
SP,66478,LOUVEIRA,5942,11070,3228,22413,19185,575,692
SP,66494,LUCÉLIA,3581,6079,3315,14496,11181,388,532
SP,66516,LUCIANÓPOLIS,626,654,214,1653,1439,40,67
SP,66532,LUÍS ANTÔNIO,2443,2240,1389,7000,5611,175,226
SP,66559,LUISIÂNIA,1037,1567,629,3507,2878,57,95
SP,66575,LUPÉRCIO,1258,1185,728,3433,2705,71,80
SP,66591,LUTÉCIA,551,1101,335,2192,1857,46,67
SP,66613,MACATUBA,3907,5033,2316,12449,10133,328,360
SP,66630,MACAUBAL,887,3192,670,5362,4692,231,129
SP,66656,MACEDÔNIA,754,1260,461,2765,2304,85,85
SP,66672,MAGDA,684,1289,478,2740,2262,97,89
SP,66699,MAIRINQUE,11044,12446,5146,32329,27183,894,1009
SP,66710,MAIRIPORÃ,9788,22421,7013,45206,38193,1242,1779
SP,66737,MANDURI,1363,3453,1289,6940,5651,194,227
SP,66753,MARABÁ PAULISTA,887,1404,551,3142,2591,55,100
SP,66770,MARACAÍ,3685,4344,2143,11087,8944,205,243
SP,66796,MARIÁPOLIS,917,1265,463,3008,2545,133,71
SP,66818,MARÍLIA,30178,68892,25874,146605,120731,3919,5055
SP,66834,MARINÓPOLIS,641,747,242,1817,1575,84,43
SP,66850,MARTINÓPOLIS,4019,7789,3375,16767,13392,341,500
SP,66877,MATÃO,17040,24693,8378,56968,48590,1744,2187
SP,66893,MAUÁ,108601,80697,33809,263093,229284,6425,11113
SP,66915,MENDONÇA,768,1474,382,2963,2581,101,114
SP,66931,MERIDIANO,960,1362,575,3235,2660,104,107
SP,66958,MIGUELÓPOLIS,4763,5816,3239,15044,11805,327,415
SP,66974,MINEIROS DO TIETÊ,2131,3917,1447,8307,6860,288,257
SP,66990,MIRACATU,3686,6901,3970,15702,11732,218,442
SP,67016,MIRA ESTRELA,906,819,424,2359,1935,66,72
SP,67032,MIRANDÓPOLIS,4959,7471,4177,19486,15309,666,918
SP,67059,MIRANTE DO PARANAPANEMA,4144,4602,3288,13184,9896,267,393
SP,67075,MIRASSOL,7538,17802,5997,36324,30327,1210,1419
SP,67091,MIRASSOLÂNDIA,658,1838,450,3211,2761,65,87
SP,67113,MOCOCA,7056,27652,9455,50075,40620,1688,1913
SP,67130,MOGI DAS CRUZES,58779,119028,34340,244291,209951,5536,8063
SP,67156,MOJI-GUACU,30754,38558,13383,95527,82144,2936,3561
SP,67172,MOJI-MIRIM,10799,31130,8918,58874,49956,2012,2194
SP,67199,MOMBUCA,569,1393,565,2824,2259,83,109
SP,67210,MONÇÕES,356,842,306,1757,1451,110,73
SP,67237,MONGAGUÁ,8285,11443,7638,30418,22780,484,721
SP,67253,MONTE ALEGRE DO SUL,1085,3031,950,5613,4663,158,209
SP,67270,MONTE ALTO,8081,15594,6050,34243,28193,1439,1272
SP,67296,MONTE APRAZÍVEL,3955,6961,2923,15649,12726,504,577
SP,67318,MONTE AZUL PAULISTA,3506,7458,2833,15264,12431,513,529
SP,67334,MONTE CASTELO,1367,918,639,3243,2604,77,119
SP,67350,MONTEIRO LOBATO,777,1836,604,3568,2964,49,114
SP,67377,MONTE MOR,12087,9542,5600,30524,24924,772,1082
SP,67393,MORRO AGUDO,6694,6624,3076,18246,15170,541,616
SP,67415,MORUNGABA,1350,5070,841,8034,7193,223,298
SP,67431,MURUTINGA DO SUL,902,1438,599,3264,2665,87,105
SP,67458,NARANDIBA,1081,1217,362,2936,2574,55,132
SP,67474,NATIVIDADE DA SERRA,1428,2682,1376,6039,4663,127,213
SP,67490,NAZARÉ PAULISTA,2065,6059,2202,11660,9458,362,466
SP,67512,NEVES PAULISTA,1661,3367,1290,7276,5986,355,250
SP,67539,NHANDEARA,1389,4495,1330,8107,6777,256,240
SP,67555,NIPOÃ,759,1469,390,2876,2486,91,101
SP,67571,NOVA ALIANÇA,895,2097,727,4394,3667,180,210
SP,67598,NOVA EUROPA,2026,2494,1296,6496,5200,175,209
SP,67610,NOVA GRANADA,3343,5992,2634,13704,11070,385,581
SP,67636,NOVA GUATAPORANGA,786,435,301,1721,1420,48,96
SP,67652,NOVA INDEPENDÊNCIA,677,775,232,1838,1606,48,52
SP,67679,NOVA LUZITÂNIA,633,1246,289,2289,2000,32,47
SP,67695,NOVA ODESSA,14685,10886,4526,34220,29694,848,1023
SP,67717,NOVO HORIZONTE,7200,10855,4505,25430,20925,811,852
SP,67733,NUPORANGA,1016,2841,1012,5355,4343,165,159
SP,67750,OCAUÇU,945,1304,421,3090,2669,98,134
SP,67776,ÓLEO,369,1365,425,2489,2064,102,115
SP,67792,OLÍMPIA,7988,16800,6296,34913,28617,1146,1080
SP,67814,ONDA VERDE,983,1167,688,3261,2573,83,81
SP,67830,ORIENTE,1129,2528,780,4955,4175,127,181
SP,67857,ORINDIÚVA,976,1909,682,3835,3153,50,126
SP,67873,ORLÂNDIA,6184,14538,4020,27748,23728,725,1041
SP,67890,OSASCO,187291,171315,64399,490686,426287,11146,17240
SP,67911,OSCAR BRESSANE,335,1263,419,2205,1786,44,68
SP,67938,OSVALDO CRUZ,4434,11857,5205,23701,18496,575,689
SP,67954,OURINHOS,16382,32944,12602,69715,57113,1436,1946
SP,67970,OURO VERDE,2483,1735,1333,6025,4692,104,189
SP,67997,PACAEMBU,2391,3609,1579,8474,6895,193,266
SP,68012,PALESTINA,1444,3913,1362,7587,6225,273,299
SP,68039,PALMARES PAULISTA,2429,2366,1062,6589,5527,243,257
SP,68055,PALMEIRA D'OESTE,2313,3210,1203,7498,6295,294,208
SP,68071,PALMITAL,4207,7692,3119,16103,12984,315,331
SP,68098,PANORAMA,3240,3404,2043,9543,7500,207,275
SP,68110,PARAGUAÇU PAULISTA,10360,10371,5653,29397,23744,847,834
SP,68136,PARAIBUNA,2993,6354,2156,12773,10617,237,392
SP,68152,PARAÍSO,1393,1898,701,4466,3765,172,171
SP,68179,PARANAPANEMA,3822,5633,2421,12670,10249,197,324
SP,68195,PARANAPUÃ,674,1459,493,2893,2400,96,67
SP,68217,PARAPUÃ,2417,3096,1861,8479,6618,251,392
SP,68233,PARDINHO,947,1934,542,3766,3224,77,137
SP,68250,PARIQUERA-AÇU,3465,6185,2924,13683,10759,246,372
SP,68276,PATROCÍNIO PAULISTA,1993,4948,1525,9069,7544,130,220
SP,68292,PAULICÉIA,1510,1415,724,4013,3289,106,112
SP,68314,PAULÍNIA,18445,17285,7313,50566,43253,1275,1589
SP,68330,PAULO DE FARIA,1844,2843,1632,6881,5249,119,238
SP,68357,PEDERNEIRAS,8451,11208,4784,27728,22944,854,1050
SP,68373,PEDRA BELA,824,1993,864,4152,3288,139,206
SP,68390,PEDRANÓPOLIS,737,897,384,2203,1819,47,63
SP,68411,PEDREGULHO,3512,5049,2777,12740,9963,413,495
SP,68438,PEDREIRA,7743,13798,3734,28723,24989,896,1186
SP,68454,PEDRO DE TOLEDO,1808,2583,1922,7026,5104,152,189
SP,68470,PENÁPOLIS,11594,17606,7483,41823,34340,1123,1535
SP,68497,PEREIRA BARRETO,4912,7929,4945,19690,14745,361,577
SP,68519,PEREIRAS,1183,2865,1203,5770,4567,161,210
SP,68535,PERUÍBE,10279,19138,10794,44599,33805,816,1203
SP,68551,PIACATU,895,2024,498,3737,3239,81,149
SP,68578,PIEDADE,6530,18294,6372,34639,28267,1075,980
SP,68594,PILAR DO SUL,3177,9842,3010,17424,14414,398,439
SP,68616,PINDAMONHANGABA,21423,48552,13396,92311,78915,1701,2498
SP,68632,PINDORAMA,3008,4758,1655,10694,9039,349,378
SP,68659,ESPÍRITO SANTO DO PINHAL,5553,17108,5592,31719,26127,936,1128
SP,68675,PINHALZINHO,1633,4828,1729,9047,7318,248,331
SP,68691,PIQUEROBI,1256,799,370,2685,2315,74,90
SP,68713,PIQUETE,2581,5585,2620,12467,9847,216,362
SP,68730,PIRACAIA,2967,10267,3556,18501,14945,418,461
SP,68756,PIRACICABA,62157,113105,31676,240285,208609,6547,8776
SP,68772,PIRAJU,3921,10593,4462,21688,17226,548,836
SP,68799,PIRAJUÍ,3028,6825,3304,14843,11539,425,467
SP,68810,PIRANGI,1529,3646,1324,7488,6164,379,252
SP,68837,PIRAPORA DO BOM JESUS,2533,3996,1399,8632,7233,103,281
SP,68853,PIRAPOZINHO,5294,7144,3714,18246,14532,413,556
SP,68870,PIRASSUNUNGA,9141,25028,9262,50266,41004,1496,1774
SP,68896,PIRATININGA,1598,4535,1863,9037,7174,223,314
SP,68918,PITANGUEIRAS,7027,9272,4781,23410,18629,636,826
SP,68934,PLANALTO,772,1440,314,2837,2523,73,120
SP,68950,PLATINA,736,1054,290,2234,1944,55,59
SP,68977,POÁ,27827,26015,10950,75691,64741,1815,2531
SP,68993,POLONI,768,2187,637,3987,3350,120,95
SP,69019,POMPÉIA,2386,8931,2678,15346,12668,312,505
SP,69035,PONGAÍ,585,1816,593,3277,2684,66,81
SP,69051,PONTAL,7681,8824,4592,23891,19299,905,1000
SP,69078,PONTES GESTAL,626,927,394,2144,1750,67,74
SP,69094,POPULINA,862,1600,700,3554,2854,111,157
SP,69116,PORANGABA,1483,2742,968,5754,4786,95,207
SP,69132,PORTO FELIZ,8668,16297,5334,33449,28115,885,910
SP,69159,PORTO FERREIRA,7654,18409,5319,35699,30380,1190,1171
SP,69175,POTIRENDABA,2060,5664,1890,11024,9134,493,405
SP,69191,PRADÓPOLIS,4225,4439,1738,11523,9785,306,411
SP,69213,PRAIA GRANDE,42164,54720,27636,143327,115691,3299,4391
SP,69230,PRESIDENTE ALVES,855,1658,675,3504,2829,68,93
SP,69256,PRESIDENTE BERNARDES,3076,4482,2496,11144,8648,292,313
SP,69272,PRESIDENTE EPITÁCIO,9508,9798,5873,28206,22333,549,834
SP,69299,PRESIDENTE PRUDENTE,39435,58492,28533,148705,120172,4198,4858
SP,69310,PRESIDENTE VENCESLAU,6124,12960,5725,28236,22511,633,930
SP,69337,PROMISSÃO,9141,8319,4820,24967,20147,807,655
SP,69353,QUATÁ,2682,3867,2013,9482,7469,219,276
SP,69370,QUEIROZ,786,711,313,1983,1670,42,79
SP,69396,QUELUZ,2472,2646,1454,7187,5733,111,194
SP,69418,QUINTANA,1158,2054,802,4479,3677,96,182
SP,69434,RAFARD,1534,3352,726,6338,5612,169,234
SP,69450,RANCHARIA,5647,10143,4762,22837,18075,471,564
SP,69477,REDENÇÃO DA SERRA,774,1878,558,3547,2989,86,136
SP,69493,REGENTE FEIJÓ,3070,6808,2296,13575,11279,304,352
SP,69515,REGINÓPOLIS,682,2148,540,3876,3336,89,176
SP,69531,REGISTRO,9110,19043,9034,40357,31323,591,876
SP,69558,RESTINGA,1729,1949,543,4625,4082,97,145
SP,69574,RIBEIRA,942,1019,549,2684,2135,27,73
SP,69590,RIBEIRÃO BONITO,2457,3869,2120,9567,7447,260,432
SP,69612,RIBEIRÃO BRANCO,4261,5235,3283,13546,10263,217,304
SP,69639,RIBEIRÃO CORRENTE,782,1551,475,3007,2532,46,105
SP,69655,RIBEIRÃO DO SUL,1140,1534,392,3308,2916,82,78
SP,69671,RIBEIRÃO PIRES,25645,31280,11627,79843,68216,1748,3182
SP,69698,RIBEIRÃO PRETO,82816,165156,57992,369696,311704,9666,19733
SP,69710,RIVERSUL,1528,2017,742,4691,3949,132,141
SP,69736,RIFAINA,932,1375,729,3374,2645,87,103
SP,69752,RINCÃO,2271,3024,1373,7397,6024,208,265
SP,69779,RINÓPOLIS,1296,3977,1247,7203,5956,201,249
SP,69795,RIO CLARO,25514,58894,19069,124572,105503,3995,7093
SP,69817,RIO DAS PEDRAS,6194,9101,3481,21022,17541,661,521
SP,69833,RIO GRANDE DA SERRA,11285,10802,5059,30705,25646,691,1029
SP,69850,RIOLÂNDIA,1483,2990,1600,6455,4855,118,163
SP,69876,ROSEIRA,1444,3629,1123,6670,5547,109,118
SP,69892,RUBIÁCEA,426,965,332,1905,1573,38,76
SP,69914,RUBINÉIA,729,837,555,2361,1806,49,97
SP,69930,SABINO,1466,1521,762,4284,3522,150,179
SP,69957,SAGRES,546,823,269,1764,1495,24,35
SP,69973,SALES,694,2055,608,3801,3193,94,130
SP,69990,SALES OLIVEIRA,1432,3878,989,7021,6032,206,216
SP,70017,SALESÓPOLIS,2053,7094,2420,12912,10492,280,391
SP,70033,SALMOURÃO,900,1631,640,3479,2839,71,165
SP,70050,SALTO,27189,25754,10094,70660,60566,1583,2170
SP,70076,SALTO DE PIRAPORA,6207,10909,3918,24099,20181,821,828
SP,70092,SALTO GRANDE,1609,2717,1343,6232,4889,135,174
SP,70114,SANDOVALINA,865,1173,469,2740,2271,26,58
SP,70130,SANTA ADÉLIA,2896,4699,1904,10783,8879,330,407
SP,70157,SANTA ALBERTINA,970,2064,817,4288,3471,160,119
SP,70173,SANTA BÁRBARA D'OESTE,49099,37663,15421,118046,102625,3687,4037
SP,70190,ÁGUAS DE SANTA BÁRBARA,817,2113,1035,4344,3309,81,144
SP,70211,SANTA BRANCA,2354,5531,2026,10887,8861,189,262
SP,70238,SANTA CLARA D'OESTE,505,895,285,1882,1597,53,60
SP,70254,SANTA CRUZ DA CONCEIÇÃO,550,1565,296,2716,2420,61,92
SP,70270,SANTA CRUZ DAS PALMEIRAS,4428,10618,3374,20183,16809,627,634
SP,70297,SANTA CRUZ DO RIO PARDO,4661,18344,5396,31322,25926,841,854
SP,70319,SANTA ERNESTINA,1733,1368,448,3847,3399,73,88
SP,70335,SANTA FÉ DO SUL,4574,10278,4679,21734,17055,566,726
SP,70351,SANTA GERTRUDES,4052,5691,1943,13690,11747,566,578
SP,70378,SANTA ISABEL,9175,16556,4819,34220,29401,860,1300
SP,70394,SANTA LÚCIA,2920,2081,1095,6907,5812,272,253
SP,70416,SANTA MARIA DA SERRA,1042,1656,867,4001,3134,111,157
SP,70432,SANTA MERCEDES,736,717,475,2090,1615,37,61
SP,70459,SANTANA DA PONTE PENSA,404,736,219,1523,1304,59,64
SP,70475,SANTANA DE PARNAÍBA,17884,22363,7528,53780,46252,1226,1750
SP,70491,SANTA RITA D'OESTE,677,965,331,2207,1876,65,73
SP,70513,SANTA RITA DO PASSA QUATRO,3690,10633,3659,20507,16848,611,710
SP,70530,SANTA ROSA DE VITERBO,5499,6799,3131,17899,14768,614,630
SP,70556,SANTO ANASTÁCIO,5211,5797,3414,16500,13086,557,633
SP,70572,SANTO ANDRÉ,172262,196394,73867,519510,445643,11325,25272
SP,70599,SANTO ANTÔNIO DA ALEGRIA,1201,2233,921,4865,3944,115,176
SP,70610,SANTO ANTÔNIO DA POSSE,3387,6848,2270,13793,11523,452,373
SP,70637,SANTO ANTÔNIO DO JARDIM,916,2654,661,4612,3951,132,127
SP,70653,SANTO ANTÔNIO DO PINHAL,1161,2795,1108,5496,4388,104,168
SP,70670,SANTO EXPEDITO,924,823,342,2314,1972,38,105
SP,70696,SANTÓPOLIS DO AGUAPEÍ,912,1277,454,2907,2453,98,106
SP,70718,SANTOS,81284,138249,30738,298696,267958,5801,11051
SP,70734,SÃO BENTO DO SAPUCAÍ,1215,4653,1555,8132,6577,144,248
SP,70750,SÃO BERNARDO DO CAMPO,214271,167472,69653,521882,452229,10585,21182
SP,70777,SÃO CAETANO DO SUL,25461,62282,13434,119002,105568,2015,4825
SP,70793,SÃO CARLOS,25917,78259,20794,147395,126601,3629,6794
SP,70815,SÃO FRANCISCO,733,932,341,2251,1910,112,63
SP,70831,SÃO JOÃO DA BOA VISTA,11955,31654,8827,59550,50723,1526,2204
SP,70858,SÃO JOÃO DAS DUAS PONTES,645,855,242,1977,1735,55,89
SP,70874,SÃO JOÃO DO PAU D'ALHO,534,775,237,1762,1525,48,56
SP,70890,SÃO JOAQUIM DA BARRA,10007,14062,4679,31990,27311,830,1057
SP,70912,SÃO JOSÉ DA BELA VISTA,1734,2449,1225,5901,4676,226,170
SP,70939,SÃO JOSÉ DO BARREIRO,713,1699,478,3184,2706,39,122
SP,70955,SÃO JOSÉ DO RIO PARDO,6694,20514,6386,37595,31209,1180,1010
SP,70971,SÃO JOSÉ DO RIO PRETO,51391,133901,40430,265110,224680,6136,9947
SP,70998,SÃO JOSÉ DOS CAMPOS,104797,191579,55205,397310,342105,6633,9792
SP,71013,SÃO LUÍS DO PARAITINGA,1855,4749,1055,8561,7506,215,319
SP,71030,SÃO MANUEL,4908,14424,4614,27942,23328,1120,1452
SP,71056,SÃO MIGUEL ARCANJO,4423,11462,4485,22412,17927,481,692
SP,71072,SÃO PAULO,2243168,3384767,1114728,7953144,6838416,207488,347956
SP,71099,SÃO PEDRO,3685,11838,4581,22159,17578,489,698
SP,71110,SÃO PEDRO DO TURVO,1012,2541,560,4492,3932,137,137
SP,71137,SÃO ROQUE,11420,24617,7688,49635,41947,1349,1720
SP,71153,SÃO SEBASTIÃO,14103,17579,8981,45942,36961,1003,1349
SP,71170,SÃO SEBASTIÃO DA GRAMA,1323,4821,1941,8892,6951,241,366
SP,71196,SÃO SIMÃO,2596,4579,2184,10945,8761,239,450
SP,71218,SÃO VICENTE,82459,77479,33053,228567,195514,5973,7438
SP,71234,SARAPUÍ,1471,2999,1315,6291,4976,120,203
SP,71250,SARUTAIÁ,888,1218,527,2875,2348,57,101
SP,71277,SEBASTIANÓPOLIS DO SUL,421,1461,318,2379,2061,66,42
SP,71293,SERRA AZUL,2049,2032,1268,5994,4726,143,273
SP,71315,SERRANA,8168,10366,4056,25652,21596,882,1008
SP,71331,SERRA NEGRA,2542,11749,3771,19773,16002,335,589
SP,71358,SERTÃOZINHO,25871,24397,11377,70958,59581,2702,3004
SP,71374,SETE BARRAS,2982,4013,2897,10617,7720,148,322
SP,71390,SEVERÍNIA,3371,4625,2049,10977,8928,340,325
SP,71412,SILVEIRAS,1046,2113,586,4333,3747,121,182
SP,71439,SOCORRO,3701,15086,4668,26034,21366,556,1036
SP,71455,SOROCABA,103223,156793,45778,364794,319016,8267,14025
SP,71471,SUD MENUCCI,2104,2120,745,5476,4731,192,191
SP,71498,SUMARÉ,62742,40543,19705,137298,117593,3256,3941
SP,71510,SUZANO,54948,65480,25187,167443,142256,4226,5613
SP,71536,TABAPUÃ,2255,3594,1192,8152,6960,369,349
SP,71552,TABATINGA,2541,5011,2064,10663,8599,384,337
SP,71579,TABOÃO DA SERRA,54592,65055,24883,167537,142654,4599,6150
SP,71595,TACIBA,1177,2091,669,4304,3635,89,111
SP,71617,TAGUAÍ,1778,3270,1132,6523,5391,81,147
SP,71633,TAIAÇU,1234,1730,825,4249,3424,167,132
SP,71650,TAIÚVA,1090,2090,896,4530,3634,116,128
SP,71676,TAMBAÚ,2814,9148,2483,15996,13513,445,506
SP,71692,TANABI,3645,9818,3219,18477,15258,472,456
SP,71714,TAPIRAÍ,1079,2819,1604,6050,4446,136,220
SP,71730,TAPIRATIBA,2969,4109,1658,9634,7976,261,271
SP,71757,TAQUARITINGA,12576,13119,6936,38246,31310,1595,1405
SP,71773,TAQUARITUBA,4430,8078,3477,17276,13799,479,442
SP,71790,TARABAÍ,1675,1596,611,4348,3737,77,152
SP,71811,TATUÍ,9418,38956,12022,70364,58342,2256,3095
SP,71838,TAUBATÉ,48572,83556,28092,183659,155567,4308,5851
SP,71854,TEJUPÁ,1201,1540,881,3895,3014,85,113
SP,71870,TEODORO SAMPAIO,5259,5129,3611,15250,11639,254,424
SP,71897,TERRA ROXA,2250,2407,1201,6342,5141,141,213
SP,71919,TIETÊ,3425,14842,3618,24303,20685,534,820
SP,71935,TIMBURI,532,1152,452,2312,1860,49,81
SP,71951,TORRINHA,1154,3634,1138,6677,5539,215,210
SP,71978,TREMEMBÉ,4849,10661,3407,21818,18411,497,752
SP,71994,TRÊS FRONTEIRAS,1048,1840,777,4113,3336,122,131
SP,72010,TUPÃ,8531,25335,9470,47604,38134,834,1277
SP,72036,TUPI PAULISTA,2759,4681,1435,9891,8456,234,317
SP,72052,TURIÚBA,389,905,202,1674,1472,37,56
SP,72079,TURMALINA,442,815,364,1826,1462,59,74
SP,72095,UBATUBA,13223,24085,9921,52808,42887,1086,1492
SP,72117,UBIRAJARA,732,1723,629,3398,2769,82,116
SP,72133,UCHOA,1586,3701,1231,7334,6103,228,265
SP,72150,UNIÃO PAULISTA,320,689,273,1376,1103,31,34
SP,72176,URÂNIA,1956,3028,1450,7228,5778,249,247
SP,72192,URU,197,705,140,1134,994,27,28
SP,72214,URUPÊS,1725,5160,1869,9628,7759,224,287
SP,72230,VALENTIM GENTIL,1649,3987,1281,7634,6353,220,224
SP,72257,VALINHOS,19925,30553,10796,70317,59521,1955,2678
SP,72273,VALPARAÍSO,4318,5786,2877,14271,11394,294,382
SP,72311,VARGEM GRANDE DO SUL,4105,15930,4448,27036,22588,881,788
SP,72338,VÁRZEA PAULISTA,32623,18529,8433,68005,59572,1754,2490
SP,72354,VERA CRUZ,1903,4078,1780,8673,6893,151,353
SP,72370,VINHEDO,9835,22086,6483,43804,37321,1308,1398
SP,72397,VIRADOURO,3827,5409,2172,12677,10505,367,350
SP,72419,VISTA ALEGRE DO ALTO,1027,1770,422,3818,3396,212,184
SP,72435,VOTORANTIM,26317,25390,9430,71464,62034,1729,2355
SP,72451,VOTUPORANGA,10988,31850,9475,58360,48885,1152,1856
SP,72737,VARGEM GRANDE PAULISTA,8974,11608,4599,28521,23922,700,892
TO,73008,ABREULÂNDIA,732,530,355,1760,1405,12,107
TO,73016,PIRAQUÊ,858,809,391,2241,1850,10,142
TO,73024,RIACHINHO,1524,650,583,2975,2392,31,157
TO,73032,DARCINÓPOLIS,1781,702,487,3339,2852,27,285
TO,73040,PALMEIRAS DO TOCANTINS,1429,1013,598,3392,2794,28,201
TO,73059,MAURILÂNDIA DO TOCANTINS,1175,608,382,2410,2028,18,187
TO,73067,CACHOEIRINHA,788,392,234,1566,1332,7,112
TO,73075,ANGICO,943,845,358,2366,2008,25,146
TO,73083,PALMEIRANTE,1065,772,429,2528,2099,11,212
TO,73091,CAMPOS LINDOS,1551,1548,845,4297,3452,23,263
TO,73105,SÃO FÉLIX DO TOCANTINS,478,351,255,1187,932,5,75
TO,73113,LAGOA DO TOCANTINS,1427,160,459,2291,1832,8,203
TO,73121,BOM JESUS DO TOCANTINS,963,736,393,2291,1898,11,158
TO,73130,SANTA MARIA DO TOCANTINS,762,716,324,1981,1657,16,114
TO,73148,NOVO ALEGRE,801,490,308,1786,1478,15,108
TO,73156,SANDOLÂNDIA,655,1124,496,2570,2074,25,184
TO,73164,TAIPAS DO TOCANTINS,777,314,256,1519,1263,10,115
TO,73172,NOVO JARDIM,640,593,349,1778,1429,22,134
TO,73180,SÃO MIGUEL DO TOCANTINS,3105,740,892,5167,4275,47,300
TO,73199,FORTALEZA DO TABOCÃO,676,592,197,1641,1444,25,112
TO,73202,ITAPIRATINS,947,805,367,2408,2041,39,228
TO,73210,CENTENÁRIO,752,512,362,1839,1477,11,140
TO,73229,RECURSOLÂNDIA,816,927,433,2429,1996,12,209
TO,73237,TUPIRATINS,669,309,303,1427,1124,10,115
TO,73245,BRASILÂNDIA DO TOCANTINS,786,447,240,1651,1411,15,132
TO,73253,JUARINA,482,785,328,1691,1363,10,53
TO,73261,PAU D'ARCO,1224,977,635,3077,2442,14,181
TO,73270,MATEIROS,620,240,344,1380,1036,18,127
TO,73288,SÃO BENTO DO TOCANTINS,1561,845,527,3186,2659,15,193
TO,73296,ESPERANTINA,2902,1023,1023,5597,4574,62,421
TO,73300,CARIRI DO TOCANTINS,1239,728,522,2702,2180,25,125
TO,73318,ARAGUANÃ,1840,765,688,3714,3026,27,333
TO,73326,CARMOLÂNDIA,1027,395,208,1762,1554,11,105
TO,73334,ARAGOMINAS,1547,1468,1080,4449,3369,35,237
TO,73342,MURICILÂNDIA,795,718,311,2019,1708,12,142
TO,73350,SANTA FÉ DO ARAGUAIA,1986,1343,1082,4776,3694,22,264
TO,73369,JAÚ DO TOCANTINS,1012,942,686,3002,2316,26,268
TO,73377,SUCUPIRA,470,603,184,1370,1186,10,78
TO,73385,LAGOA DA CONFUSÃO,2534,1276,1087,5354,4267,40,270
TO,73393,SÃO SALVADOR DO TOCANTINS,1127,433,433,2213,1780,9,150
TO,73407,LAJEADO,921,462,243,1785,1542,12,93
TO,73415,RIO DOS BOIS,927,452,376,1944,1568,27,119
TO,73423,CARRASCO BONITO,1282,368,460,2331,1871,19,184
TO,73431,RIO DA CONCEIÇÃO,683,389,206,1382,1176,4,73
TO,73440,PALMAS,59545,31382,20581,122343,101762,988,2847
TO,73458,TUPIRAMA,598,303,129,1109,980,13,53
TO,73466,OLIVEIRA DE FÁTIMA,488,410,199,1210,1011,9,73
TO,73474,CHAPADA DE AREIA,407,540,215,1335,1120,24,101
TO,73482,CHAPADA DA NATIVIDADE,1250,758,622,2933,2311,14,231
TO,73504,TALISMÃ,785,626,440,2038,1598,13,105
TO,73512,AGUIARNÓPOLIS,1598,517,334,2745,2411,20,202
TO,73520,LUZINÓPOLIS,1095,444,265,1988,1723,11,132
TO,73539,SANTA TEREZINHA DO TOCANTINS,813,526,243,1723,1480,15,90
TO,73547,SANTA RITA DO TOCANTINS,510,504,286,1453,1167,10,89
TO,73555,CRIXÁS DO TOCANTINS,538,523,195,1344,1149,11,54
TO,73563,MONTE SANTO,794,720,263,1920,1657,15,87
TO,73571,PUGMIL,987,459,464,2030,1566,10,76
TO,73580,BANDEIRANTE DO TOCANTINS,951,872,485,2501,2016,19,130
TO,73598,IPUEIRAS,603,363,120,1188,1068,6,64
TO,73601,LAVANDEIRA,619,287,94,1118,1024,7,74
TO,73610,BARRA DO OURO,1376,689,632,2928,2296,20,151
TO,92002,BERNARDO SAYÃO,1004,1293,480,3004,2524,23,154
TO,92045,BURITI DO TOCANTINS,2705,1585,1133,5838,4705,50,317
TO,92070,ALMAS,1396,1961,1170,5082,3912,32,395
TO,92088,CASEARA,1488,637,592,3026,2434,12,225
TO,92134,ALVORADA,1885,2386,1436,6387,4951,63,377
TO,92142,COMBINADO,1497,915,607,3362,2755,47,200
TO,92185,DIVINÓPOLIS DO TOCANTINS,1975,1399,760,4545,3785,48,248
TO,92193,ANANÁS,3676,1654,1481,7280,5799,51,315
TO,92240,GOIANORTE,1283,1609,581,3738,3157,21,178
TO,92304,MARIANÓPOLIS DO TOCANTINS,1396,845,583,3071,2488,22,163
TO,92371,ARAGUACEMA,1620,1245,848,4100,3252,23,237
TO,92398,ARAGUAÇU,1641,3251,1511,7040,5529,97,340
TO,92401,NOVA ROSALÂNDIA,1009,720,364,2306,1942,24,103
TO,92410,ARAGUAÍNA,39645,23019,13816,83416,69600,841,3560
TO,92436,ARAGUATINS,7761,4964,3162,17328,14166,144,922
TO,92452,ARAPOEMA,2547,1480,1324,5804,4480,41,299
TO,92479,ARRAIAS,3252,1665,1751,7705,5954,60,651
TO,92487,PEQUIZEIRO,1138,1460,783,3627,2844,16,169
TO,92509,PORTO ALEGRE DO TOCANTINS,824,549,367,2007,1640,22,143
TO,92525,PRAIA NORTE,3097,443,936,4849,3913,44,286
TO,92533,AURORA DO TOCANTINS,1237,652,302,2541,2239,33,233
TO,92541,SAMPAIO,1152,691,543,2596,2053,13,169
TO,92576,AXIXÁ DO TOCANTINS,3690,1918,900,7340,6440,66,641
TO,92584,SANTA ROSA DO TOCANTINS,1294,1121,590,3307,2717,23,207
TO,92592,BABAÇULÂNDIA,2698,1374,984,5698,4714,67,488
TO,92606,SANTA TEREZA DO TOCANTINS,1170,341,291,1944,1653,6,78
TO,92681,SÃO VALÉRIO DO TOCANTINS,1303,1302,763,3689,2926,22,215
TO,92738,BREJINHO DE NAZARÉ,2116,761,601,3890,3289,31,291
TO,93114,COLINAS DO TOCANTINS,7680,6891,3505,19665,16160,205,946
TO,93130,CONCEIÇÃO DO TOCANTINS,1256,734,683,3024,2341,19,244
TO,93211,COUTO DE MAGALHÃES,1194,1078,949,3466,2517,23,182
TO,93238,CRISTALÂNDIA,2325,1481,1032,5344,4312,46,249
TO,93416,DIANÓPOLIS,4374,2915,2095,10500,8405,106,618
TO,93459,DOIS IRMÃOS DO TOCANTINS,2129,1149,866,4690,3824,35,377
TO,93475,DUERÉ,1257,1285,782,3644,2862,31,174
TO,93556,FILADÉLFIA,2463,1752,1136,5990,4854,66,432
TO,93653,FORMOSO DO ARAGUAIA,4842,4933,3083,13926,10843,115,611
TO,93858,GURUPI,19627,15522,8499,47918,39419,527,1839
TO,94056,ITACAJÁ,2192,1762,1177,5633,4456,39,358
TO,94099,ITAGUATINS,2091,1138,1008,4691,3683,30,332
TO,94170,ITAPORÃ DO TOCANTINS,815,803,240,1993,1753,19,84
TO,94617,MIRACEMA DO TOCANTINS,7414,2571,2744,13955,11211,102,701
TO,94633,MIRANORTE,3938,3095,1699,9560,7861,105,483
TO,94692,MONTE DO CARMO,1670,1283,895,4350,3455,39,297
TO,94811,NATIVIDADE,1899,2613,1374,6433,5059,43,341
TO,94838,NAZARÉ,1789,887,610,3593,2983,34,211
TO,94994,NOVO ACORDO,1541,639,379,2873,2494,18,208
TO,95192,PARAÍSO DO TOCANTINS,10328,10654,4389,27592,23203,276,1013
TO,95214,PARANÃ,2665,1719,1484,6584,5100,28,554
TO,95257,PEDRO AFONSO,2750,2409,1087,6727,5640,50,275
TO,95273,PEIXE,3234,1975,1681,7467,5786,44,370
TO,95290,COLMÉIA,2181,2644,1351,6791,5440,52,418
TO,95338,GOIATINS,3447,1502,1407,7162,5755,87,604
TO,95370,PINDORAMA DO TOCANTINS,1363,961,592,3240,2648,23,210
TO,95478,PIUM,1887,1436,919,4762,3843,38,354
TO,95516,PONTE ALTA DO BOM JESUS,1289,955,759,3392,2633,33,288
TO,95532,PONTE ALTA DO TOCANTINS,1748,1564,883,4697,3814,35,299
TO,95591,PORTO NACIONAL,14658,6870,4788,29183,24395,248,1212
TO,95699,LIZARDA,1214,609,718,2900,2182,18,282
TO,96032,SÃO SEBASTIÃO DO TOCANTINS,1728,399,456,2835,2379,18,194
TO,96130,SÍTIO NOVO DO TOCANTINS,4275,851,1423,7322,5899,50,587
TO,96156,TAGUATINGA,4368,2376,1921,9750,7829,103,713
TO,96199,TOCANTÍNIA,2222,732,718,4089,3371,29,291
TO,96210,TOCANTINÓPOLIS,8126,2449,2404,14360,11956,135,903
TO,96270,GUARAÍ,7065,4415,2683,15560,12877,124,792
TO,96296,PRESIDENTE KENNEDY,1370,710,589,2949,2360,35,180
TO,96431,XAMBIOÁ,3825,2320,2243,9162,6919,95,452
TO,96490,PALMEIRÓPOLIS,1562,2128,1197,5422,4225,52,302
TO,96598,SILVANÓPOLIS,1207,1422,694,3702,3008,43,208
TO,96636,NOVA OLINDA,2323,2311,1345,6569,5224,51,404
TO,96652,WANDERLÂNDIA,2714,2143,1384,6979,5595,89,491
TO,96679,FIGUEIRÓPOLIS,1900,1281,832,4362,3530,29,217
TO,96792,RIO SONO,1648,1300,587,3849,3262,21,222
TO,96830,FÁTIMA,991,1217,463,2935,2472,34,148
TO,96857,AUGUSTINÓPOLIS,5203,2163,1842,10124,8282,78,665
TO,96954,ALIANÇA DO TOCANTINS,2029,1187,1012,4519,3507,36,150
TO,96970,APARECIDA DO RIO NEGRO,1446,906,528,3109,2581,13,155
TO,96997,BARROLÂNDIA,2154,1345,566,4387,3821,26,193