STATE,CD_MUN,NM_MUN,VOTES_INCUMBENT,VOTES_CHALLENGER,QT_ABST,QT_APT,QT_ATTEND,QT_BLANK,QT_NULL
AC,1007,BUJARI,1090,2807,614,5551,4937,60,246
AC,1015,CAPIXABA,916,3481,1322,6441,5119,45,199
AC,1023,PORTO ACRE,1431,5889,2011,10537,8526,66,348
AC,1031,SANTA ROSA DO PURUS,359,687,738,2360,1622,23,175
AC,1040,MARECHAL THAUMATURGO,1998,2431,2869,7808,4939,11,183
AC,1058,BRASILÉIA,2827,6534,4325,15326,11001,106,380
AC,1066,PORTO WALTER,1392,1666,1486,4866,3380,6,141
AC,1074,CRUZEIRO DO SUL,9469,16811,16045,48418,32373,338,1265
AC,1082,RODRIGUES ALVES,2208,2949,2879,8695,5816,31,241
AC,1090,MÂNCIO LIMA,2996,3560,2676,10007,7331,70,323
AC,1104,JORDÃO,947,1054,1349,3702,2353,10,134
AC,1112,EPITACIOLÂNDIA,1606,4033,2467,9422,6955,99,293
AC,1120,ACRELÂNDIA,1460,4872,2125,9111,6986,90,250
AC,1139,FEIJÓ,5930,4097,4916,17153,12237,141,874
AC,1392,RIO BRANCO,27394,82959,37313,217034,179721,1878,4886
AC,1457,SENA MADUREIRA,4972,8946,6201,24006,17805,236,1004
AC,1473,TARAUACÁ,5860,6160,6858,21311,14453,233,1268
AC,1490,XAPURI,2505,4056,2640,10790,8150,67,434
AC,1511,PLÁCIDO DE CASTRO,2145,6052,2770,12551,9781,91,354
AC,1538,SENADOR GUIOMARD,2653,7461,3170,15880,12710,144,467
AC,1554,MANOEL URBANO,1260,1812,1371,5077,3706,43,244
AC,1570,ASSIS BRASIL,1315,1935,830,4499,3669,30,222
AL,27006,PARIPUEIRA,2310,2674,1356,7928,6572,256,534
AL,27014,ÁGUA BRANCA,7349,1252,4447,14675,10228,188,1063
AL,27022,PARICONHA,4186,601,2169,7856,5687,116,606
AL,27030,ANADIA,5278,2558,4121,13937,9816,398,1111
AL,27049,ESTRELA DE ALAGOAS,5207,1174,4368,12250,7882,275,915
AL,27057,ARAPIRACA,42408,39372,23985,125965,101980,3356,7852
AL,27065,JEQUIÁ DA PRAIA,3016,1675,2144,8074,5930,160,524
AL,27073,ATALAIA,9512,9154,7060,29788,22728,719,2207
AL,27081,CAMPESTRE,2041,664,751,4287,3536,108,379
AL,27090,BARRA DE SANTO ANTÔNIO,2972,2353,759,7547,6788,312,551
AL,27111,BARRA DE SÃO MIGUEL,1772,1652,919,5219,4300,117,250
AL,27138,BATALHA,5430,1863,2400,11076,8676,162,657
AL,27154,BELÉM,2083,725,1256,4863,3607,132,435
AL,27170,BELO MONTE,2363,513,1169,4675,3506,59,386
AL,27197,BOCA DA MATA,8292,3393,5049,19974,14925,732,1357
AL,27219,BRANQUINHA,2945,1040,950,6053,5103,185,620
AL,27235,CACIMBINHAS,3045,1581,1257,6823,5566,84,609
AL,27251,CAJUEIRO,5003,3643,3452,14012,10560,394,1008
AL,27278,CAMPO ALEGRE,8245,3604,6474,22239,15765,548,1551
AL,27294,CAMPO GRANDE,3988,1012,1698,7579,5881,186,517
AL,27316,CANAPI,6936,703,3994,13218,9224,177,1093
AL,27332,CAPELA,3400,4376,3285,13116,9831,342,1051
AL,27359,CARNEIROS,2610,712,1541,5687,4146,86,453
AL,27375,CHÃ PRETA,2592,876,497,4861,4364,160,536
AL,27391,COITÉ DO NÓIA,3782,997,786,6593,5807,207,607
AL,27413,COLÔNIA LEOPOLDINA,4303,4133,4330,14758,10428,480,911
AL,27430,COQUEIRO SECO,1742,975,764,4184,3420,192,284
AL,27456,CORURIPE,9232,12327,9411,36868,27457,1342,2496
AL,27472,DELMIRO GOUVEIA,18323,3053,9550,35344,25794,735,2163
AL,27499,DOIS RIACHOS,4197,1194,2533,8846,6313,115,673
AL,27510,FEIRA GRANDE,7682,1742,3493,15273,11780,551,1352
AL,27537,FELIZ DESERTO,1184,818,749,3240,2491,116,280
AL,27553,FLEXEIRAS,2565,2356,1749,7782,6033,171,619
AL,27570,GIRAU DO PONCIANO,11679,2242,6966,23759,16793,484,1717
AL,27596,IBATEGUARA,3701,2254,2895,10679,7784,344,900
AL,27618,IGACI,8100,1950,3082,15562,12480,500,1492
AL,27634,IGREJA NOVA,7063,3171,4426,17109,12683,884,1196
AL,27650,INHAPI,6457,617,3972,12618,8646,208,1156
AL,27677,JACARÉ DOS HOMENS,2403,670,1145,4685,3540,53,267
AL,27693,JACUÍPE,2395,756,1430,5390,3960,150,350
AL,27715,JAPARATINGA,1564,1926,1335,5976,4641,274,409
AL,27731,JARAMATAIA,2006,716,378,3764,3386,102,392
AL,27758,JOAQUIM GOMES,4944,2944,4310,14401,10091,452,1227
AL,27774,JUNDIÁ,1265,1055,1079,3921,2842,121,247
AL,27790,JUNQUEIRO,7682,3597,5255,18791,13536,554,1042
AL,27812,LAGOA DA CANOA,5919,1869,3250,12916,9666,347,1005
AL,27839,LIMOEIRO DE ANADIA,8171,1914,4412,16617,12205,443,1336
AL,27855,MACEIÓ,132870,179137,89873,538516,448643,16122,26246
AL,27871,MAJOR ISIDORO,6240,2557,4232,14911,10679,333,1072
AL,27898,MARAGOGI,4950,4478,4037,17432,13395,909,1273
AL,27910,MARAVILHA,2635,2026,2730,8421,5691,165,615
AL,27936,MARECHAL DEODORO,8026,10892,6380,30889,24509,1121,1982
AL,27952,MARIBONDO,3690,2578,881,8844,7963,307,854
AL,27979,MAR VERMELHO,1453,714,564,3268,2704,87,240
AL,27995,MATA GRANDE,8635,1311,5340,17376,12036,379,1334
AL,28010,MATRIZ DE CAMARAGIBE,4038,4945,4898,17159,12261,494,999
AL,28037,MESSIAS,3468,3276,2686,11697,9011,362,915
AL,28053,MINADOR DO NEGRÃO,1929,521,597,3591,2994,44,337
AL,28070,MONTEIRÓPOLIS,2499,867,1406,5410,4004,85,351
AL,28096,MURICI,6554,4616,4269,18903,14634,601,1655
AL,28118,NOVO LINO,2508,2413,1698,8099,6401,377,558
AL,28134,OLHO D'ÁGUA DAS FLORES,4782,3910,3698,14092,10394,310,872
AL,28150,OLHO D'ÁGUA DO CASADO,3394,428,1091,5541,4450,76,409
AL,28177,OLHO D'ÁGUA GRANDE,1749,584,1267,4177,2910,136,345
AL,28193,OLIVENÇA,3513,1757,2547,8788,6241,124,644
AL,28215,OURO BRANCO,4418,818,2100,8338,6238,95,585
AL,28231,PALESTINA,1906,501,1042,3870,2828,60,250
AL,28258,PALMEIRA DOS ÍNDIOS,17680,12958,12906,51373,38467,1280,3510
AL,28274,PÃO DE AÇÚCAR,8549,2232,4557,17743,13186,313,1143
AL,28290,PASSO DE CAMARAGIBE,4394,2082,2482,10685,8203,471,722
AL,28312,PAULO JACINTO,3132,1056,1044,6010,4966,136,432
AL,28339,PENEDO,14316,10090,9871,39416,29545,1045,1975
AL,28355,PIAÇABUÇU,4997,2553,3414,12669,9255,358,858
AL,28371,PILAR,5352,9833,6081,25577,19496,1022,1698
AL,28398,PINDOBA,1205,419,468,2417,1949,35,216
AL,28410,PIRANHAS,7373,1381,2683,13409,10726,232,1155
AL,28436,POÇO DAS TRINCHEIRAS,4330,1163,802,7341,6539,144,686
AL,28452,PORTO CALVO,4286,6384,5470,20010,14540,925,1525
AL,28479,PORTO DE PEDRAS,1842,1820,1676,6474,4798,300,389
AL,28495,PORTO REAL DO COLÉGIO,4873,3614,3449,13946,10497,641,884
AL,28517,QUEBRANGULO,4010,1934,767,7855,7088,165,737
AL,28533,RIO LARGO,16236,11052,3198,39428,36230,1598,2383
AL,28550,ROTEIRO,983,1229,1555,4752,3197,146,408
AL,28576,SANTA LUZIA DO NORTE,2102,1327,1200,5541,4341,169,388
AL,28592,SANTANA DO IPANEMA,13017,6446,7390,30540,23150,469,2028
AL,28614,SANTANA DO MUNDAÚ,3258,1362,2364,8065,5701,237,614
AL,28630,SÃO BRÁS,1978,1126,1372,5422,4050,290,347
AL,28657,SÃO JOSÉ DA LAJE,7357,2805,2977,15822,12845,374,1303
AL,28673,SÃO JOSÉ DA TAPERA,7987,2998,6717,20013,13296,288,1516
AL,28690,SÃO LUÍS DO QUITUNDE,9076,4332,5748,22661,16913,715,1653
AL,28711,SÃO MIGUEL DOS CAMPOS,7831,12624,6909,36312,29403,958,2157
AL,28738,SÃO MIGUEL DOS MILAGRES,1502,1464,458,4561,4103,310,373
AL,28754,SÃO SEBASTIÃO,10181,4105,6599,23656,17057,844,1398
AL,28770,SATUBA,2896,2564,1755,9286,7531,365,521
AL,28797,TANQUE D'ARCA,2132,667,881,4362,3481,148,362
AL,28819,TAQUARANA,5809,1966,3729,13448,9719,358,1168
AL,28835,TRAIPU,7955,2240,6202,18629,12427,245,1419
AL,28851,UNIÃO DOS PALMARES,15955,8640,11696,42896,31200,1152,2900
AL,28878,VIÇOSA,7981,4002,4530,19810,15280,649,1485
AL,28894,CRAÍBAS,7950,1939,3829,15703,11874,381,1202
AL,28916,SENADOR RUI PALMEIRA,4221,747,2314,8289,5975,110,754
AL,28932,TEOTÔNIO VILELA,8499,8303,8809,29262,20453,684,1713
AM,2003,APUÍ,4312,1336,2778,9055,6277,84,404
AM,2011,NOVO AIRÃO,3693,634,1212,6463,5251,32,325
AM,2020,GUAJARÁ,1911,1271,4096,7818,3722,41,322
AM,2038,ANORI,4546,799,2154,8465,6311,31,343
AM,2046,CAREIRO DA VÁRZEA,8607,468,3383,14038,10655,73,657
AM,2054,ATALAIA DO NORTE,1804,1068,1456,5025,3569,13,261
AM,2070,AUTAZES,10605,718,4729,18370,13641,82,805
AM,2097,BARCELOS,3345,768,2608,8006,5398,37,309
AM,2119,BARREIRINHA,8776,578,3748,14907,11159,53,1219
AM,2135,BENJAMIN CONSTANT,9759,981,3842,16316,12474,62,871
AM,2151,BOCA DO ACRE,5866,4614,5292,17571,12279,156,1039
AM,2178,BORBA,9787,677,4872,17421,12549,61,837
AM,2194,CANUTAMA,2498,1111,2106,6371,4265,42,380
AM,2216,CARAUARI,6987,1162,6669,16286,9617,71,831
AM,2232,CAREIRO,10644,608,4906,18083,13177,122,974
AM,2259,COARI,20889,2143,12144,41928,29784,243,1759
AM,2275,CODAJÁS,6210,767,3929,13119,9190,49,457
AM,2291,EIRUNEPÉ,9385,757,6603,18476,11873,108,1164
AM,2313,ENVIRA,4827,758,3508,9868,6360,23,444
AM,2330,FONTE BOA,6707,829,3623,12308,8685,44,723
AM,2356,HUMAITÁ,13171,2574,6063,24066,18003,213,856
AM,2372,SANTA ISABEL DO RIO NEGRO,1946,1041,2221,5792,3571,22,261
AM,2399,IPIXUNA,2855,1315,3630,8604,4974,72,565
AM,2410,ITACOATIARA,29151,3710,13657,56332,42675,352,1907
AM,2437,ITAPIRANGA,3495,362,1207,5802,4595,20,152
AM,2453,JAPURÁ,1863,186,946,3192,2246,4,102
AM,2470,JURUÁ,1610,1572,2254,5760,3506,21,253
AM,2496,JUTAÍ,4405,779,3678,9744,6066,20,626
AM,2518,LÁBREA,9934,1555,6757,20006,13249,81,877
AM,2534,MANACAPURU,30846,3473,13725,58041,44316,410,2584
AM,2550,MANAUS,516520,61290,155231,1123758,968527,16618,34682
AM,2577,MANICORÉ,11401,3298,6880,23150,16270,100,922
AM,2593,MARAÃ,3486,436,2881,7414,4533,15,375
AM,2615,MAUÉS,15619,847,7800,27518,19718,128,1137
AM,2631,NHAMUNDÁ,6307,966,3117,11205,8088,32,387
AM,2658,NOVA OLINDA DO NORTE,7766,496,3783,13448,9665,35,640
AM,2674,NOVO ARIPUANÃ,5553,595,3508,10695,7187,62,489
AM,2690,PARINTINS,32556,3843,13715,57694,43979,305,1594
AM,2712,PAUINI,4081,767,2909,8552,5643,24,430
AM,2739,SANTO ANTÔNIO DO IÇÁ,5069,1521,2787,10762,7975,44,650
AM,2755,SÃO PAULO DE OLIVENÇA,6726,1836,2581,12410,9829,70,781
AM,2771,SILVES,3774,219,1282,5920,4638,18,174
AM,2798,TAPAUÁ,4916,1141,3657,10703,7046,94,621
AM,2810,TEFÉ,18382,1445,9641,33570,23929,160,1360
AM,2836,SÃO GABRIEL DA CACHOEIRA,11635,1815,7206,22745,15539,91,696
AM,2852,URUCARÁ,5564,447,2744,9696,6952,46,305
AM,2879,URUCURITUBA,5575,453,2842,10144,7302,43,346
AM,2895,ALVARÃES,4828,316,2190,7944,5754,28,334
AM,2917,AMATURÁ,2496,342,1170,4597,3427,16,328
AM,2933,ANAMÃ,2968,409,1755,6034,4279,35,234
AM,2950,BERURI,4460,907,2274,8367,6093,23,389
AM,2976,BOA VISTA DO RAMOS,5105,355,2396,8998,6602,41,424
AM,2992,CAAPIRANGA,3583,232,2045,6550,4505,32,258
AM,98353,IRANDUBA,15195,712,4287,24149,19862,164,1089
AM,98370,ITAMARATI,2928,322,1626,5305,3679,10,305
AM,98396,MANAQUIRI,6582,255,2789,10827,8038,34,491
AM,98418,PRESIDENTE FIGUEIREDO,8415,841,2611,14625,12014,112,656
AM,98434,RIO PRETO DA EVA,6549,731,2145,11556,9411,101,454
AM,98450,SÃO SEBASTIÃO DO UATUMÃ,2425,477,1217,4904,3687,21,179
AM,98477,TABATINGA,12878,2178,5715,24557,18842,111,1690
AM,98493,UARINI,3517,263,1771,6030,4259,16,309
AM,98515,TONANTINS,3835,821,1823,7062,5239,41,426
AP,6009,PRACUÚBA,1388,296,328,2508,2180,17,79
AP,6017,AMAPÁ,2952,606,978,5548,4570,41,184
AP,6025,PORTO GRANDE,5281,1347,1603,10126,8523,71,386
AP,6033,CALÇOENE,3095,937,1159,6371,5212,53,254
AP,6041,ITAUBAL,1761,564,573,3760,3187,11,161
AP,6050,MACAPÁ,82215,45289,32283,243099,210816,2238,7181
AP,6068,CUTIAS,1493,496,687,3482,2795,11,149
AP,6076,MAZAGÃO,6246,1603,1703,11675,9972,58,406
AP,6084,ÁGUA BRANCA DO AMAPARI,2466,728,1010,5189,4179,40,221
AP,6092,OIAPOQUE,5867,1895,4963,15380,10417,129,620
AP,6106,SERRA DO NAVIO,1260,544,665,3226,2561,16,111
AP,6114,FERREIRA GOMES,1680,635,308,3599,3291,33,138
AP,6122,VITÓRIA DO JARI,4540,1614,2338,9584,7246,63,336
AP,6130,LARANJAL DO JARI,12343,4119,5116,25862,20746,258,924
AP,6157,SANTANA,25563,10787,7706,63992,56286,561,1978
AP,6173,TARTARUGALZINHO,3293,1314,1119,6930,5811,30,294
BA,30007,LUÍS EDUARDO MAGALHÃES,9390,7368,5246,26060,20814,499,940
BA,30058,EUNÁPOLIS,19028,18577,17826,68174,50348,1043,3299
BA,30660,IUIU,4182,871,2026,7836,5810,89,514
BA,30678,JABORANDI,3796,967,1376,6884,5508,140,428
BA,30694,JUSSARI,1898,960,1022,4430,3408,36,312
BA,30716,AMÉRICA DOURADA,5689,1252,3506,11801,8295,157,679
BA,30732,ARATACA,2693,1018,1301,5744,4443,63,411
BA,30759,BARRO ALTO,4727,1243,1558,8596,7038,111,480
BA,30775,BARROCAS,6437,1240,2162,11042,8880,174,502
BA,30791,BURITIRAMA,5215,3034,4517,14132,9615,65,1168
BA,30813,CAPELA DO ALTO ALEGRE,3923,1138,1610,8400,6790,275,602
BA,30830,CAPIM GROSSO,7151,4231,4842,19556,14714,525,1205
BA,30856,CANUDOS,6492,693,3121,11538,8417,108,661
BA,30872,DIAS D'ÁVILA,19237,3818,7383,38857,31474,1174,1714
BA,30899,FÁTIMA,6767,1635,3512,13594,10082,277,922
BA,30910,FILADÉLFIA,5102,2367,3529,13161,9632,392,910
BA,30937,GAVIÃO,1549,808,701,3743,3042,84,349
BA,30953,GUAJERU,3164,476,2792,7242,4450,78,531
BA,30970,HELIÓPOLIS,5034,1116,3266,10629,7363,242,603
BA,30996,JOÃO DOURADO,6519,3399,4104,16446,12342,258,859
BA,33014,ABAÍRA,2895,1289,1321,6504,5183,139,590
BA,33030,ABARÉ,7430,581,1315,10782,9467,74,882
BA,33057,ACAJUTIBA,4768,1748,1851,9735,7884,202,692
BA,33065,ADUSTINA,5277,1755,3041,11486,8445,207,868
BA,33073,ÁGUA FRIA,5296,1175,2022,10700,8678,200,1106
BA,33090,ÉRICO CARDOSO,3878,891,2907,8677,5770,155,596
BA,33111,AIQUARA,1955,391,946,3989,3043,61,326
BA,33138,ALAGOINHAS,39449,14808,19884,97745,77861,2446,4113
BA,33154,ALCOBAÇA,7422,1722,4699,15771,11072,291,933
BA,33170,ALMADINA,1819,897,1172,4831,3659,48,437
BA,33197,AMARGOSA,9955,4172,4318,22339,18021,452,1487
BA,33219,AMÉLIA RODRIGUES,7405,2956,2321,15799,13478,553,948
BA,33235,ANAGÉ,7494,3299,3688,16746,13058,292,1388
BA,33251,ANDARAÍ,5277,593,2892,9836,6944,135,641
BA,33260,ANDORINHA,7108,909,2708,11840,9132,184,568
BA,33278,ANGICAL,6597,1485,2105,11235,9130,137,564
BA,33294,ANGUERA,4323,884,1344,7899,6555,183,599
BA,33316,ANTAS,5030,1272,1490,9180,7690,190,786
BA,33332,ANTÔNIO CARDOSO,5649,1003,1280,9298,8018,169,517
BA,33359,ANTÔNIO GONÇALVES,3095,1305,1256,6864,5608,109,667
BA,33375,APORÁ,5367,2103,3779,12760,8981,196,937
BA,33383,ARAÇÁS,4397,1444,2462,9706,7244,200,523
BA,33391,ARACATU,5609,1378,2900,11333,8433,130,881
BA,33405,APUAREMA,2011,1213,1375,5500,4125,62,471
BA,33413,ARACI,19080,2795,11326,36596,25270,371,1929
BA,33430,ARAMARI,4324,802,1047,7318,6271,157,430
BA,33456,ARATUÍPE,3044,1208,1314,6968,5654,120,708
BA,33472,AURELINO LEAL,4497,963,3823,10670,6847,106,540
BA,33499,BAIANÓPOLIS,5777,1009,1833,9974,8141,143,828
BA,33510,BAIXA GRANDE,5372,3275,3123,14140,11017,429,1105
BA,33529,BANZAÊ,4472,1155,2376,9106,6730,122,661
BA,33537,BARRA,15472,3922,9640,32367,22727,244,1941
BA,33553,BARRA DA ESTIVA,8015,2523,3025,15730,12705,390,949
BA,33570,BARRA DO CHOÇA,8419,4871,6681,24011,17330,472,2021
BA,33596,BARRA DO MENDES,5787,875,2972,10989,8017,172,746
BA,33618,BARRA DO ROCHA,1719,493,1164,4205,3041,40,291
BA,33634,BARREIRAS,39360,11326,17294,81283,63989,1542,3039
BA,33650,BARRO PRETO,2196,907,849,4757,3908,96,410
BA,33677,BELMONTE,5941,1989,3322,13663,10341,263,848
BA,33693,BELO CAMPO,5296,2398,4489,13811,9322,228,867
BA,33715,BIRITINGA,6482,597,1866,10462,8596,194,863
BA,33731,BOA NOVA,5581,919,4558,12712,8154,198,1106
BA,33758,BOA VISTA DO TUPIM,5558,2236,2233,11614,9381,180,919
BA,33774,BOM JESUS DA LAPA,19394,5185,12674,42776,30102,674,2149
BA,33782,BOM JESUS DA SERRA,3937,518,2530,7942,5412,79,669
BA,33790,BONINAL,4118,1077,2446,8759,6313,126,749
BA,33804,BONITO,4032,2410,2706,10445,7739,190,719
BA,33812,BOQUIRA,8102,958,3754,14411,10657,194,935
BA,33839,BOTUPORÃ,4329,724,2686,8765,6079,99,688
BA,33855,BREJÕES,5116,1207,3471,11391,7920,177,723
BA,33871,BREJOLÂNDIA,3488,1050,1601,7205,5604,139,679
BA,33898,BROTAS DE MACAÚBAS,3714,1764,1781,8182,6401,80,621
BA,33910,BRUMADO,22685,5099,5894,41554,35660,915,2928
BA,33936,BUERAREMA,4255,4008,2532,12678,10146,204,775
BA,33952,CAATIBA,2816,902,2090,6835,4745,69,625
BA,33960,CABACEIRAS DO PARAGUAÇU,4772,2417,3603,12558,8955,208,913
BA,33979,CACHOEIRA,12054,2340,3244,21657,18413,575,1055
BA,33995,CACULÉ,6222,3288,2977,14538,11561,275,1121
BA,34010,CAEM,4044,905,2315,8591,6276,119,682
BA,34029,CAETANOS,4118,717,2815,8440,5625,98,492
BA,34037,CAETITÉ,16710,5219,7037,33642,26605,556,2325
BA,34053,CAFARNAUM,4813,1950,3550,12187,8637,283,668
BA,34070,CAIRU,3908,1519,1515,9045,7530,198,626
BA,34096,CALDEIRÃO GRANDE,3442,1040,1378,6927,5549,129,691
BA,34118,CAMACAN,8004,2929,3786,17365,13579,258,1012
BA,34134,CAMAÇARI,52320,19021,20632,134108,113476,5218,6433
BA,34150,CAMAMU,7088,5702,7153,23298,16145,336,1623
BA,34177,CAMPO ALEGRE DE LOURDES,8761,2598,6442,19842,13400,165,1519
BA,34193,CAMPO FORMOSO,19464,8547,9008,44322,35314,1251,3575
BA,34215,CANÁPOLIS,3659,1272,1227,6971,5744,144,488
BA,34231,CANARANA,8512,1868,2802,15163,12361,188,978
BA,34258,CANAVIEIRAS,9366,4552,8966,25994,17028,293,1279
BA,34274,CANDEAL,3510,891,837,6227,5390,155,443
BA,34290,CANDEIAS,28340,4348,8537,54250,45713,2402,2502
BA,34312,CANDIBA,5621,943,1445,9338,7893,263,681
BA,34339,CÂNDIDO SALES,8350,3262,7132,21010,13878,331,1114
BA,34355,CANSANÇÃO,13366,1231,7585,24631,17046,231,1482
BA,34363,CARAÍBAS,2956,1486,1733,7213,5480,85,697
BA,34371,CARAVELAS,5702,1674,2623,12323,9700,271,1000
BA,34398,CARDEAL DA SILVA,3216,559,1750,6466,4716,131,467
BA,34410,CARINHANHA,7842,4434,5488,19654,14166,193,1184
BA,34436,CASA NOVA,26559,3746,7403,44222,36819,746,3435
BA,34452,CASTRO ALVES,11061,2704,4358,20613,16255,357,1201
BA,34479,CATOLÂNDIA,2058,180,589,3198,2609,80,186
BA,34495,CATU,20176,2187,4591,34989,30398,1297,1695
BA,34509,CATURAMA,3452,582,1877,6667,4790,138,497
BA,34517,CENTRAL,6353,1617,1973,11604,9631,216,695
BA,34533,CHORROCHÓ,4768,835,1342,7973,6631,71,673
BA,34550,CÍCERO DANTAS,11023,3516,4409,22161,17752,819,1674
BA,34576,CIPÓ,4393,2488,2321,11368,9047,174,785
BA,34592,COARACI,7118,2862,3071,15536,12465,199,1028
BA,34614,COCOS,5916,2107,4351,14049,9698,232,1042
BA,34630,CONCEIÇÃO DA FEIRA,5545,3076,1671,13021,11350,548,839
BA,34657,CONCEIÇÃO DO ALMEIDA,7297,1184,3263,13608,10345,265,817
BA,34673,CONCEIÇÃO DO COITÉ,20478,9613,6381,43225,36844,887,2644
BA,34690,CONCEIÇÃO DO JACUÍPE,8547,4020,2542,19273,16731,555,1007
BA,34711,CONDE,7063,1832,3944,15090,11146,343,1041
BA,34738,CONDEÚBA,6385,1466,3703,13493,9790,148,1182
BA,34754,CONTENDAS DO SINCORÁ,1633,564,435,3039,2604,48,225
BA,34770,CORAÇÃO DE MARIA,9622,2334,2973,17966,14993,501,1041
BA,34797,CORDEIROS,2142,1265,1347,5675,4328,70,553
BA,34819,CORIBE,6247,1382,3719,12359,8640,172,550
BA,34835,CORONEL JOÃO SÁ,5938,1599,3223,12165,8942,156,1016
BA,34851,CORRENTINA,10165,3758,7301,24807,17506,405,1886
BA,34878,COTEGIPE,5257,841,2718,9974,7256,138,699
BA,34894,CRAVOLÂNDIA,2021,436,925,4045,3120,148,330
BA,34916,CRISÓPOLIS,7335,1551,5194,15670,10476,202,1017
BA,34932,CRISTÓPOLIS,6185,887,2127,10594,8467,119,832
BA,34959,CRUZ DAS ALMAS,16602,8867,4453,36989,32536,965,1727
BA,34975,CURAÇÁ,13141,2805,5002,23167,18165,191,982
BA,34991,DÁRIO MEIRA,3490,753,3144,8913,5769,105,759
BA,35017,DOM BASÍLIO,4773,1267,1668,8849,7181,235,584
BA,35033,DOM MACEDO COSTA,1697,526,541,3424,2883,59,293
BA,35050,ELÍSIO MEDRADO,3024,1562,1383,7109,5726,129,634
BA,35076,ENCRUZILHADA,6004,2489,5374,16121,10747,244,1212
BA,35092,ENTRE RIOS,11938,3166,7536,27157,19621,862,1455
BA,35114,ESPLANADA,9474,3610,4176,20860,16684,691,1326
BA,35130,EUCLIDES DA CUNHA,19673,4583,7564,36550,28986,655,2496
BA,35149,FEIRA DA MATA,2063,875,1206,4472,3266,49,173
BA,35157,FEIRA DE SANTANA,114938,81709,60323,359314,298991,8714,15286
BA,35173,FIRMINO ALVES,1468,1077,771,3883,3112,97,312
BA,35190,FLORESTA AZUL,3021,1449,1379,6918,5539,104,601
BA,35211,FORMOSA DO RIO PRETO,7539,2577,3980,15655,11675,205,790
BA,35238,GANDU,6989,4244,2973,18265,15292,353,1382
BA,35254,GENTIO DO OURO,4610,785,1223,7583,6360,80,658
BA,35270,GLÓRIA,6581,1004,2847,11785,8938,255,840
BA,35297,GONGOGI,2348,775,2856,6556,3700,51,329
BA,35319,GOVERNADOR MANGABEIRA,7541,1961,3379,15070,11691,347,868
BA,35335,GUANAMBI,23227,12575,11162,54733,43571,1098,3363
BA,35351,GUARATINGA,7731,1321,3008,13842,10834,125,627
BA,35378,IAÇU,8891,1784,7351,20718,13367,352,1360
BA,35394,IBIASSUCÊ,3400,1896,2224,8366,6142,80,592
BA,35416,IBICARAÍ,5998,4783,3358,16367,13009,306,1176
BA,35432,IBICOARA,4834,2108,2228,10868,8640,267,917
BA,35459,IBICUÍ,4745,1870,2166,10440,8274,244,751
BA,35475,IBIPEBA,7264,805,3092,12460,9368,203,666
BA,35491,SANTA RITA DE CÁSSIA,9247,2823,6029,20763,14734,394,1411
BA,35513,IBIPITANGA,5657,818,3131,10615,7484,126,517
BA,35530,IBIQUERA,1768,233,684,3164,2480,28,311
BA,35556,IBIRAPITANGA,5469,1283,2367,11591,9224,229,967
BA,35572,IBIRAPUÃ,2374,1182,1116,5501,4385,110,459
BA,35599,IBIRATAIA,5142,2045,6001,17364,11363,269,1465
BA,35610,IBITIARA,5887,1052,2100,10470,8370,125,695
BA,35637,IBITITÁ,7450,1008,2328,12533,10205,186,628
BA,35653,IBOTIRAMA,8301,2816,3139,16745,13606,210,1195
BA,35670,ICHU,2371,814,588,4490,3902,106,269
BA,35696,IGAPORÃ,5504,1198,1799,10082,8283,257,826
BA,35700,IGRAPIÚNA,4158,1240,2736,9541,6805,192,669
BA,35718,IGUAÍ,8107,1913,6557,19388,12831,275,1303
BA,35734,ILHÉUS,45886,21374,33826,129706,95880,3121,5034
BA,35750,INHAMBUPE,11953,2992,3943,22107,18164,500,1489
BA,35777,IPECAETÁ,5338,2106,2114,11278,9164,182,928
BA,35793,IPIAÚ,12702,3440,5022,27402,22380,470,2021
BA,35815,IPIRÁ,18596,6539,8558,39550,30992,764,2680
BA,35831,IPUPIARA,3071,1291,1715,7083,5368,133,418
BA,35858,IRAJUBA,2716,553,721,4792,4071,93,466
BA,35874,IRAMAIA,4394,1239,2710,9329,6619,148,600
BA,35890,IRAQUARA,8552,1163,2655,13844,11189,171,901
BA,35912,IRARÁ,10009,2711,3755,19733,15978,402,1342
BA,35939,IRECÊ,17990,6375,10652,42271,31619,873,2323
BA,35947,ITABELA,6850,5107,6457,21413,14956,376,1297
BA,35955,ITABERABA,16931,5190,6113,35553,29440,889,2743
BA,35971,ITABUNA,44607,40007,27683,139788,112105,2923,5767
BA,35998,ITACARÉ,5293,1174,1509,10336,8827,229,697
BA,36013,ITAETÉ,4257,1790,1994,9223,7229,162,867
BA,36030,ITAGI,3570,2200,2129,9677,7548,123,900
BA,36056,ITAGIBÁ,5419,977,2114,10546,8432,125,788
BA,36072,ITAGIMIRIM,1843,1066,1230,5146,3916,56,459
BA,36080,ITAGUAÇU DA BAHIA,5359,464,1882,8569,6687,79,570
BA,36099,ITAJU DO COLÔNIA,2135,679,816,4221,3405,40,207
BA,36110,ITAJUÍPE,6822,3036,3093,15246,12153,252,786
BA,36137,ITAMARAJU,14279,9761,8614,38993,30379,885,2380
BA,36153,ITAMARI,2763,1093,1307,6119,4812,68,405
BA,36170,ITAMBÉ,7138,4101,5430,19129,13699,244,1315
BA,36196,ITANAGRA,2231,474,991,4304,3313,93,259
BA,36218,ITANHÉM,6610,1997,3987,15012,11025,326,1148
BA,36234,ITAPARICA,7267,1566,3354,14725,11371,334,558
BA,36250,ITAPÉ,3275,1781,2309,8706,6397,165,587
BA,36277,ITAPEBI,2827,1143,1960,6781,4821,75,433
BA,36293,ITAPETINGA,12905,12203,6319,40329,34010,916,2559
BA,36315,ITAPICURU,10511,1292,6700,20963,14263,277,1420
BA,36331,ITAPITANGA,3149,739,2433,7046,4613,56,361
BA,36358,ITAQUARA,2573,1098,1201,5812,4611,84,575
BA,36374,ITARANTIM,5283,1920,2444,11988,9544,205,1220
BA,36382,ITATIM,3826,2822,1920,10174,8254,244,834
BA,36390,ITIRUÇU,3615,1824,2349,9534,7185,229,679
BA,36412,ITIÚBA,12217,4327,7815,27323,19508,562,1619
BA,36439,ITORORÓ,4836,4498,4021,15532,11511,224,1129
BA,36455,ITUAÇU,5017,3734,2511,13304,10793,318,1107
BA,36471,ITUBERÁ,7351,3813,5110,18871,13761,415,1080
BA,36498,JACARACI,5201,1050,3135,10756,7621,142,879
BA,36510,JACOBINA,25196,5751,9482,49464,39982,985,3247
BA,36536,JAGUAQUARA,14008,4842,9800,33802,24002,644,2238
BA,36552,JAGUARARI,9326,3862,3161,19448,16287,506,1424
BA,36579,JAGUARIPE,5592,1051,2130,10380,8250,311,792
BA,36595,JANDAÍRA,3635,680,1983,7186,5203,68,535
BA,36617,JEQUIÉ,38262,12099,18540,93189,74649,2160,4840
BA,36633,JEREMOABO,13866,2138,4753,23301,18548,320,1626
BA,36650,JIQUIRIÇÁ,4037,2218,2669,10403,7734,250,782
BA,36676,JITAÚNA,5075,1914,4778,13793,9015,184,1016
BA,36692,JUAZEIRO,63638,15482,23746,125191,101445,1970,4922
BA,36706,JUCURUÇU,4125,828,1514,7324,5810,81,561
BA,36714,JUSSARA,6440,613,2260,10615,8355,139,745
BA,36730,JUSSIAPE,3142,1168,1318,6318,5000,88,395
BA,36757,LAFAIETE COUTINHO,2121,250,461,3215,2754,50,183
BA,36765,LAGOA REAL,4666,1292,2581,9595,7014,103,718
BA,36773,LAJE,8981,1845,4147,17635,13488,291,1397
BA,36790,LAJEDÃO,1806,558,584,3512,2928,33,301
BA,36811,LAJEDINHO,1939,146,493,2838,2345,22,188
BA,36820,LAJEDO DO TABOCAL,2888,552,1152,5504,4352,96,415
BA,36838,LAMARÃO,3257,606,2249,6934,4685,124,475
BA,36854,LAURO DE FREITAS,40432,10292,16942,97516,80574,2819,4535
BA,36870,LENÇÓIS,3343,599,1815,6616,4801,99,369
BA,36897,LICÍNIO DE ALMEIDA,3981,1651,1869,8468,6599,159,495
BA,36919,LIVRAMENTO DE NOSSA SENHORA,15584,3393,8076,31195,23119,654,1919
BA,36935,MACAJUBA,3484,1697,2677,9213,6536,126,901
BA,36951,MACARANI,4607,2397,2886,12529,9643,265,1481
BA,36978,MACAÚBAS,15925,3530,8928,31797,22869,393,1933
BA,36994,MACURURÉ,3391,684,1469,6269,4800,67,441
BA,37010,MAIQUINIQUE,2645,1113,1380,6289,4909,94,571
BA,37036,MAIRI,5722,2227,2988,13111,10123,289,1182
BA,37052,MALHADA,5937,1448,3355,11791,8436,147,630
BA,37079,MALHADA DE PEDRAS,3148,892,1071,6204,5133,103,566
BA,37095,MANOEL VITORINO,5342,1002,1330,8857,7527,117,645
BA,37117,MARACÁS,8416,2426,6065,19377,13312,359,1052
BA,37133,MARAGOGIPE,14087,5609,4191,27737,23546,868,1662
BA,37150,MARAÚ,5254,1332,4004,12288,8284,241,763
BA,37176,MARCIONÍLIO SOUZA,3489,849,1882,7112,5230,109,532
BA,37192,MASCOTE,3924,1587,2252,8963,6711,96,634
BA,37214,MATA DE SÃO JOÃO,14248,3295,5193,29658,24465,1151,2032
BA,37222,MATINA,4574,502,2084,8216,6132,167,761
BA,37230,MEDEIROS NETO,7823,2487,3651,16552,12901,294,1249
BA,37257,MIGUEL CALMON,10317,1742,6223,21754,15531,318,1474
BA,37273,MILAGRES,5035,511,1493,8238,6745,70,501
BA,37290,MIRANGABA,4467,1844,3320,11364,8044,242,1100
BA,37303,MIRANTE,3096,990,1998,7051,5053,66,701
BA,37311,MONTE SANTO,20733,3282,11826,40012,28186,652,2564
BA,37338,MORPARÁ,3073,1159,1398,6495,5097,84,570
BA,37354,MORRO DO CHAPÉU,10673,2978,4501,21729,17228,326,1787
BA,37370,MORTUGABA,4094,1243,2118,8441,6323,91,647
BA,37397,MUCUGÊ,3421,1884,1602,7985,6383,129,639
BA,37419,MUCURI,9064,3873,8518,25397,16879,351,987
BA,37427,MULUNGU DO MORRO,4415,765,2617,8567,5950,121,423
BA,37435,MUNDO NOVO,7172,1293,3231,14124,10893,267,1192
BA,37451,MUNIZ FERREIRA,3408,1005,1118,6523,5405,131,438
BA,37460,MUQUÉM DO SÃO FRANCISCO,4248,769,1667,7384,5717,101,386
BA,37478,MURITIBA,9779,3133,5706,22113,16407,605,1077
BA,37494,MUTUÍPE,6254,4171,4307,17152,12845,295,1245
BA,37516,NAZARÉ,11105,2095,3753,19890,16137,526,897
BA,37532,NILO PEÇANHA,3427,1408,1184,7241,6057,254,605
BA,37559,NOVA CANAÃ,4975,990,2677,10676,7999,127,983
BA,37567,NOVA FÁTIMA,2869,1218,987,6126,5139,133,478
BA,37575,NOVA ITARANA,2453,818,1042,5051,4009,102,482
BA,37583,NOVA REDENÇÃO,3128,515,1160,5525,4365,79,378
BA,37591,NOVA SOURE,9757,1335,3399,16605,13206,269,1217
BA,37613,NOVA VIÇOSA,8967,4929,7394,25704,18310,357,1415
BA,37621,NOVO TRIUNFO,2528,1915,2256,7543,5287,107,562
BA,37630,OLINDINA,9757,1298,6091,19766,13675,379,1257
BA,37656,OLIVEIRA DOS BREJINHOS,8018,1646,3370,14976,11606,308,1129
BA,37672,OURIÇANGAS,2850,1327,1290,6342,5052,104,532
BA,37680,OUROLÂNDIA,4538,2540,3945,12569,8624,144,981
BA,37699,PALMAS DE MONTE ALTO,8703,1452,2923,14915,11992,200,1238
BA,37710,PALMEIRAS,3180,576,1017,5541,4524,56,393
BA,37737,PARAMIRIM,8079,1248,4473,15617,11144,275,1032
BA,37753,PARATINGA,10487,3279,4076,19832,15756,192,1323
BA,37770,PARIPIRANGA,10162,3187,6042,22105,16063,542,1389
BA,37796,PAU BRASIL,3247,1196,1749,7198,5449,77,399
BA,37818,PAULO AFONSO,37625,7996,17536,72287,54751,1141,3947
BA,37834,PEDRÃO,2750,668,1069,5410,4341,106,425
BA,37850,PEDRO ALEXANDRE,4564,857,2411,8890,6479,176,744
BA,37877,PIATÃ,7058,1168,3532,13748,10216,223,1209
BA,37893,PILÃO ARCADO,11960,1935,4914,21289,16375,154,1750
BA,37915,PINDAÍ,4763,2115,2758,11338,8580,212,924
BA,37931,PINDOBAÇU,5824,3193,2549,13466,10917,326,737
BA,37940,PIRAÍ DO NORTE,2181,1412,887,5206,4319,86,389
BA,37958,PIRIPÁ,3160,1291,3232,8641,5409,63,664
BA,37974,PIRITIBA,6535,1066,2338,12075,9737,145,830
BA,37990,PLANALTINO,3133,596,1000,5538,4538,146,528
BA,38016,PLANALTO,7928,2799,2605,15296,12691,230,1101
BA,38032,POÇÕES,12524,4553,10482,32455,21973,545,2317
BA,38059,POJUCA,12233,2077,2148,22282,20134,1180,1395
BA,38067,PONTO NOVO,4275,2533,3276,11448,8172,164,824
BA,38075,PORTO SEGURO,26148,11628,19054,71958,52904,1385,3064
BA,38091,POTIRAGUÁ,3484,966,2827,8576,5749,102,681
BA,38113,PRADO,7542,3246,6264,19507,13243,251,1072
BA,38130,PRESIDENTE DUTRA,6375,482,1587,9786,8199,149,703
BA,38156,PRESIDENTE JÂNIO QUADROS,4309,902,4383,10910,6527,90,954
BA,38164,PRESIDENTE TANCREDO NEVES,5072,5846,4073,17694,13621,422,1615
BA,38172,QUEIMADAS,8976,2178,3574,17165,13591,331,1120
BA,38199,QUINJINGUE,9861,2138,4191,18534,14343,192,1290
BA,38210,REMANSO,15119,2435,5163,25804,20641,315,1876
BA,38237,RETIROLÂNDIA,4749,1576,1203,9473,8270,267,670
BA,38253,RIACHÃO DAS NEVES,8873,1452,3545,16030,12485,237,1316
BA,38270,RIACHÃO DO JACUÍPE,11244,4367,3104,22554,19450,561,1528
BA,38296,RIACHO DE SANTANA,10638,2866,4334,20641,16307,648,1633
BA,38318,RIBEIRA DO AMPARO,5051,1318,2671,10489,7818,195,924
BA,38334,RIBEIRA DO POMBAL,16523,5431,10449,37114,26665,717,2398
BA,38342,RIBEIRÃO DO LARGO,3294,1580,2441,8542,6101,83,736
BA,38350,RIO DE CONTAS,5824,1376,2631,11165,8534,175,621
BA,38377,RIO DO ANTÔNIO,4970,1037,3553,11030,7477,171,908
BA,38393,RIO DO PIRES,4355,1059,2688,9120,6432,97,665
BA,38415,RIO REAL,13292,2994,6821,26598,19777,559,1383
BA,38431,RODELAS,3115,450,927,5365,4438,50,318
BA,38458,RUY BARBOSA,10401,2979,6722,22914,16192,331,1530
BA,38474,SALINAS DA MARGARIDA,5455,456,1181,8589,7408,221,398
BA,38490,SALVADOR,720567,197851,325021,1831496,1506475,66502,100865
BA,38512,SANTA BÁRBARA,7539,2747,2765,15381,12616,285,1083
BA,38539,SANTA BRÍGIDA,6038,820,3115,11164,8049,136,849
BA,38555,SANTA CRUZ CABRÁLIA,4644,3480,4609,15621,11012,340,892
BA,38571,SANTA CRUZ DA VITÓRIA,1592,757,1508,4350,2842,63,310
BA,38598,SANTA INÊS,3690,823,1711,7316,5605,185,592
BA,38610,SANTALUZ,10058,5731,5933,26358,20425,583,2142
BA,38636,SANTA MARIA DA VITÓRIA,12161,4503,7636,28036,20400,512,2040
BA,38652,SANTANA,10040,2455,3288,17900,14612,248,1319
BA,38679,SANTANÓPOLIS,3697,1115,1311,7490,6179,265,641
BA,38695,SANTA TEREZINHA,3628,1102,1892,7721,5829,161,616
BA,38717,SANTO AMARO,23000,3118,5709,39625,33916,1200,1724
BA,38733,SANTO ANTÔNIO DE JESUS,26454,10646,12166,61438,49272,1529,2953
BA,38750,SANTO ESTEVÃO,15324,4964,8935,33466,24531,570,1725
BA,38776,SÃO DESIDÉRIO,8936,3119,2990,17378,14388,248,1579
BA,38792,SÃO FÉLIX,4694,1416,1323,9047,7724,212,575
BA,38806,SÃO DOMINGOS,3114,1192,945,6361,5416,155,443
BA,38814,SÃO FELIPE,7506,2325,2957,14973,12016,382,900
BA,38822,SÃO FÉLIX DO CORIBE,4347,1933,1560,8971,7411,157,551
BA,38830,SÃO FRANCISCO DO CONDE,14257,1949,2526,24345,21819,819,1254
BA,38857,SÃO GONÇALO DOS CAMPOS,11557,2681,2432,20921,18489,704,1119
BA,38865,SÃO JOSÉ DO JACUÍPE,3123,1161,1430,6905,5475,222,576
BA,38873,SÃO MIGUEL DAS MATAS,4148,1180,1129,7720,6591,131,657
BA,38890,SÃO SEBASTIÃO DO PASSÉ,16203,2379,3523,27961,24438,771,1483
BA,38911,SAPEAÇU,6961,1718,1912,12415,10503,278,749
BA,38938,SÁTIRO DIAS,5833,1500,3849,12577,8728,276,763
BA,38946,SAUBARA,4485,1285,1568,9160,7592,350,397
BA,38954,SAÚDE,4298,1027,1665,8320,6655,209,720
BA,38970,SEABRA,15785,2360,5337,26779,21442,412,1466
BA,38997,SEBASTIÃO LARANJEIRAS,3486,673,1583,6384,4801,110,378
BA,39012,SENHOR DO BONFIM,16132,13981,5903,43562,37659,978,2682
BA,39039,SENTO SÉ,11492,5150,7569,26710,19141,255,1192
BA,39047,SERRA DO RAMALHO,11263,1850,7969,23386,15417,262,1339
BA,39055,SERRA DOURADA,6444,2855,3902,14568,10666,147,856
BA,39071,SERRA PRETA,8237,1309,3305,15209,11904,340,1070
BA,39098,SERRINHA,27033,6262,7261,48321,41060,991,2878
BA,39110,SERROLÂNDIA,3368,1860,2687,9606,6919,215,668
BA,39136,SIMÕES FILHO,34255,5525,12761,72831,60070,2504,3686
BA,39144,SÍTIO DO MATO,4129,1110,2529,8916,6387,142,575
BA,39152,SOUTO SOARES,5841,1300,2027,10097,8070,151,401
BA,39179,TABOCAS DO BREJO VELHO,4938,803,2824,9675,6851,146,711
BA,39195,TANHAÇU,8012,2906,2418,15089,12671,169,937
BA,39217,TANQUINHO,3085,948,734,5561,4827,119,349
BA,39233,TAPEROÁ,5573,1778,2063,10947,8884,198,785
BA,39250,TAPIRAMUTÁ,4787,928,3231,10542,7311,111,814
BA,39276,TEODORO SAMPAIO,3261,561,1156,6018,4862,150,329
BA,39292,TEOFILÂNDIA,8872,1103,4082,15589,11507,288,807
BA,39314,TEOLÂNDIA,3616,2337,1567,9064,7497,160,910
BA,39330,TERRA NOVA,4442,1102,1326,8727,7401,295,514
BA,39357,TREMEDAL,6676,1262,3925,13766,9841,131,1202
BA,39373,TUCANO,17238,3554,11221,37190,25969,868,2409
BA,39390,UAUÁ,9986,1794,4246,19111,14865,388,1015
BA,39411,UBAÍRA,6491,2341,2655,13612,10957,180,1203
BA,39438,UBAITABA,5058,3255,5628,16823,11195,233,1183
BA,39454,UBATÃ,4561,2067,3311,12408,9097,241,846
BA,39470,UIBAÍ,4879,1659,2174,9934,7760,184,672
BA,39489,UMBURANAS,3522,2387,2480,9439,6959,91,677
BA,39497,UNA,6893,2455,6749,18811,12062,254,991
BA,39519,URANDI,5963,1116,2812,11227,8415,233,753
BA,39535,URUÇUCA,7293,2435,3479,15916,12437,224,1024
BA,39551,UTINGA,6456,1238,2639,11698,9059,117,825
BA,39578,VALENÇA,20782,10312,13456,57679,44223,2365,4031
BA,39594,VALENTE,7158,4649,2585,16576,13991,387,939
BA,39616,VÁRZEA DO POÇO,2708,1382,1188,6298,5110,145,403
BA,39624,VARZEDO,3567,1098,856,6329,5473,102,436
BA,39632,VERA CRUZ,14956,1778,6363,27354,20991,755,727
BA,39640,VEREDA,2747,738,1574,5694,4120,76,413
BA,39659,VITÓRIA DA CONQUISTA,56780,59420,44945,204920,159975,4200,11786
BA,39675,WAGNER,3237,719,2065,6788,4723,85,396
BA,39691,WENCESLAU GUIMARÃES,5823,2353,2087,12389,10302,158,1032
BA,39713,XIQUE-XIQUE,16216,3397,6758,30849,24091,374,2692
BA,39730,LAPÃO,9983,2124,5197,20003,14806,249,1173
BA,39748,MADRE DE DEUS,6674,1069,1516,12222,10706,256,749
BA,39756,MAETINGA,2590,575,2507,6366,3859,61,477
BA,39772,MANSIDÃO,3885,877,3382,9040,5658,96,613
BA,39799,NORDESTINA,4990,475,2876,9415,6539,134,626
BA,39810,PÉ DE SERRA,4398,1870,1839,9583,7744,168,786
BA,39837,PINTADAS,3040,1729,1790,7510,5720,115,602
BA,39845,QUIXABEIRA,2997,1485,1543,6953,5410,184,528
BA,39853,RAFAEL JAMBEIRO,7136,2576,3387,15048,11661,184,1171
BA,39870,SANTA LUZIA,2906,1813,3754,9876,6122,81,634
BA,39896,SÃO GABRIEL,7555,1463,2344,13411,11067,226,1018
BA,39900,SÍTIO DO QUINTO,4731,1005,2336,9063,6727,121,675
BA,39918,TANQUE NOVO,5977,1224,3200,11729,8529,286,755
BA,39926,SÃO JOSÉ DA VITÓRIA,2037,877,1071,4778,3707,53,301
BA,39934,TEIXEIRA DE FREITAS,33853,16794,23126,88896,65770,1522,4473
BA,39942,NOVO HORIZONTE,4368,615,1239,7100,5861,105,530
BA,39950,VÁRZEA NOVA,3341,1518,2812,9110,6298,162,735
BA,39969,NOVA IBIÁ,2107,912,1079,5075,3996,103,302
BA,39977,VÁRZEA DA ROÇA,4396,984,2209,9499,7290,415,723
BA,39985,SOBRADINHO,7177,2688,2482,14871,12389,206,836
BA,39993,WANDERLEY,4625,1498,2153,9351,7198,125,632
CE,13005,JIJOCA DE JERICOACOARA,5349,1567,2784,11288,8504,203,814
CE,13013,ABAIARA,3525,455,1468,6400,4932,180,623
CE,13021,MADALENA,7379,860,2770,12420,9650,122,819
CE,13030,ACARAÚ,18287,3184,11486,39064,27578,831,2445
CE,13048,PIRES FERREIRA,3561,772,1756,6799,5043,80,394
CE,13056,ACOPIARA,18081,4287,5464,33878,28414,1171,3627
CE,13064,GRAÇA,5203,653,4467,12224,7757,244,1143
CE,13072,AIUABA,5665,890,2772,10966,8194,174,1217
CE,13080,TURURU,6966,1204,1698,11623,9925,226,830
CE,13099,ALCÂNTARAS,4297,617,2203,8380,6177,167,628
CE,13102,QUITERIANÓPOLIS,7431,1659,4676,15803,11127,439,1230
CE,13110,ALTANEIRA,2691,834,1255,5602,4347,103,569
CE,13129,BARREIRA,8468,1891,2775,16059,13284,300,1124
CE,13137,ALTO SANTO,7141,795,2590,11793,9203,237,734
CE,13145,ACARAPE,5032,1265,1825,10389,8564,328,619
CE,13153,ANTONINA DO NORTE,2978,539,1993,6344,4351,85,551
CE,13161,CHOROZINHO,8260,1500,2245,15076,12831,395,1116
CE,13170,APUIARÉS,6282,1048,2416,11352,8936,203,681
CE,13188,HORIZONTE,21425,4379,5863,39276,33413,999,2059
CE,13196,AQUIRAZ,22198,4456,4026,39936,35910,1136,2645
CE,13200,ERERÊ,2381,713,1128,4872,3744,74,393
CE,13218,ARACATI,26776,5499,8855,49788,40933,1661,2395
CE,13226,EUSÉBIO,13491,2612,1735,24678,22943,591,1426
CE,13234,ARACOIABA,11179,3622,2998,20770,17772,456,1426
CE,13242,GUAIÚBA,8883,3033,3340,17558,14218,270,1092
CE,13250,ARARIPE,8415,1212,4698,16579,11881,259,1624
CE,13269,POTIRETAMA,3343,271,816,4942,4126,72,276
CE,13277,ARATUBA,5118,846,1864,9542,7678,198,950
CE,13285,PINDORETAMA,8778,909,2220,14619,12399,235,1001
CE,13293,ARNEIROZ,3255,662,1494,6328,4834,105,587
CE,13307,OCARA,11634,2186,1850,18485,16635,359,1471
CE,13315,ASSARÉ,8821,1222,4888,17526,12638,353,1516
CE,13323,TEJUÇUOCA,6937,1646,2354,13199,10845,194,1069
CE,13331,AURORA,9409,3560,4850,20137,15287,317,1386
CE,13340,IPAPORANGA,4574,861,3167,9831,6664,168,854
CE,13358,BAIXIO,2834,238,1259,5042,3783,84,413
CE,13366,TARRAFAS,3794,510,1901,7079,5178,142,555
CE,13374,BARBALHA,16734,8806,8220,38918,30698,933,2163
CE,13382,BANABUIÚ,7044,1418,3023,13245,10222,282,818
CE,13390,BARRO,8754,905,4613,16719,12106,328,1322
CE,13404,BARROQUINHA,5900,1153,2215,11093,8878,276,1152
CE,13412,BATURITÉ,13570,2816,5858,26190,20332,731,1535
CE,13420,ARARENDÁ,4323,884,2208,8433,6225,125,679
CE,13439,BEBERIBE,19156,4267,7383,37909,30526,1081,2168
CE,13447,CATUNDA,4407,585,2024,7950,5926,123,539
CE,13455,BELA CRUZ,9935,3363,5607,21132,15525,329,1246
CE,13463,CHORÓ,5860,902,2562,10626,8064,170,819
CE,13471,BOA VIAGEM,21027,3286,11538,40301,28763,725,2509
CE,13480,ITAITINGA,13216,2365,3976,24482,20506,526,1487
CE,13498,BREJO SANTO,18444,2876,6916,32493,25577,419,2109
CE,13501,FORTIM,6760,840,1475,11150,9675,234,782
CE,13510,CAMOCIM,23128,3617,9233,43167,33934,848,2703
CE,13536,CAMPOS SALES,9176,2594,5341,19977,14636,397,1630
CE,13552,CANINDÉ,28711,4210,13763,53577,39814,771,3576
CE,13579,CAPISTRANO,8018,1061,2497,13675,11178,326,947
CE,13595,CARIDADE,7488,1964,2648,14021,11373,257,995
CE,13617,CARIRÉ,7090,2284,3213,14667,11454,304,1329
CE,13633,CARIRIAÇU,9713,3066,7119,22587,15468,329,1644
CE,13650,CARIÚS,7995,1277,4397,15711,11314,325,1228
CE,13676,CARNAUBAL,5961,824,4506,12750,8244,180,959
CE,13692,CASCAVEL,21732,5630,9304,48516,39212,1852,3162
CE,13714,CATARINA,4397,610,2338,8421,6083,119,810
CE,13730,CAUCAIA,94543,14090,26596,177994,151398,4093,9545
CE,13757,CEDRO,10034,2905,3287,19059,15772,363,1406
CE,13773,CHAVAL,5341,816,2709,10400,7691,256,916
CE,13811,COREAÚ,8210,2477,4126,17482,13356,373,1574
CE,13838,CRATEÚS,25220,6155,15737,56397,40660,1664,4280
CE,13854,CRATO,40574,11679,16035,82103,66068,1647,5094
CE,13870,FARIAS BRITO,8422,1550,3336,15834,12498,472,1404
CE,13897,FORTALEZA,611724,193873,246096,1557613,1311517,40083,65425
CE,13919,FRECHEIRINHA,4746,1431,2386,9842,7456,178,788
CE,13935,GENERAL SAMPAIO,2715,1099,849,5565,4716,105,438
CE,13951,GRANJA,19380,2570,8216,35628,27412,855,3561
CE,13978,GRANJEIRO,1945,919,1307,4821,3514,92,378
CE,13994,GROAÍRAS,3773,1071,1571,7938,6367,333,663
CE,14010,GUARACIABA DO NORTE,11800,3590,9851,29828,19977,485,2312
CE,14036,GUARAMIRANGA,2718,362,914,5005,4091,150,390
CE,14052,HIDROLÂNDIA,7662,1127,4237,15282,11045,246,967
CE,14060,IBARETAMA,5613,1561,1164,9814,8650,256,742
CE,14079,IBIAPINA,7281,2673,5699,17689,11990,293,974
CE,14095,ICÓ,24483,4110,14788,50544,35756,1041,3653
CE,14117,IGUATU,37483,5274,15768,68570,52802,1588,4787
CE,14133,INDEPENDÊNCIA,9551,3053,5647,21140,15493,526,1445
CE,14150,IPAUMIRIM,4646,516,1947,8706,6759,252,848
CE,14176,IPU,14091,3423,10341,32234,21893,593,2172
CE,14192,IPUEIRAS,15047,1909,10986,31908,20922,497,2402
CE,14214,IRACEMA,6119,817,2171,10433,8262,158,771
CE,14230,IRAUÇUBA,9260,1121,3433,16596,13163,198,1056
CE,14257,ITAIÇABA,3026,1102,828,5860,5032,143,281
CE,14273,ITAPAGÉ,19303,3008,6971,35744,28773,911,1983
CE,14290,ITAPIPOCA,44185,6380,15488,77679,62191,1215,4584
CE,14311,ITAPIÚNA,7983,1767,3081,15118,12037,314,1096
CE,14338,ITATIRA,8218,1143,3680,14877,11197,154,1163
CE,14354,JAGUARETAMA,8084,1049,3445,14797,11352,366,1073
CE,14370,JAGUARIBARA,4629,588,1623,7927,6304,201,583
CE,14397,JAGUARIBE,13907,2284,7417,28292,20875,654,1899
CE,14419,JAGUARUANA,13010,3124,5490,25937,20447,1165,1415
CE,14435,JARDIM,8739,3483,5968,21301,15333,311,1842
CE,14451,JATI,3845,350,1393,6304,4911,76,453
CE,14478,JUAZEIRO DO NORTE,62972,30797,33823,157137,123314,4265,9313
CE,14494,JUCÁS,7769,2663,5443,18456,13013,522,1367
CE,14516,LAVRAS DA MANGABEIRA,11080,2508,7364,24692,17328,491,2277
CE,14532,LIMOEIRO DO NORTE,23501,3389,7623,41956,34333,1377,2334
CE,14559,MARANGUAPE,37490,5052,10376,67463,57087,1354,3835
CE,14575,MARCO,9338,4403,2043,17771,15728,254,1105
CE,14591,MARTINÓPOLE,4328,758,1470,7771,6301,196,657
CE,14613,MASSAPÊ,10572,6362,5348,25540,20192,721,1651
CE,14630,MAURITI,16033,5176,8063,32466,24403,427,2069
CE,14656,MERUOCA,5377,775,1360,9339,7979,289,739
CE,14672,MILAGRES,12429,1224,5942,22248,16306,309,1648
CE,14680,MIRAÍMA,6091,792,2474,10575,8101,88,710
CE,14699,MISSÃO VELHA,13346,2785,6239,26434,20195,694,2398
CE,14710,MOMBAÇA,15485,3342,9437,32817,23380,825,2428
CE,14737,MONSENHOR TABOSA,6734,1190,4250,13986,9736,243,1058
CE,14753,MORADA NOVA,29422,3555,12170,54911,42741,1312,3710
CE,14770,MORAÚJO,3477,647,1264,6320,5056,103,566
CE,14796,MORRINHOS,5870,3848,1812,13280,11468,208,858
CE,14818,MUCAMBO,5063,1510,3626,11875,8249,205,924
CE,14834,MULUNGU,4318,574,1745,7876,6131,141,554
CE,14850,NOVA OLINDA,5255,1440,2478,10936,8458,293,921
CE,14877,NOVA RUSSAS,11342,1680,5963,22525,16562,573,1805
CE,14893,NOVO ORIENTE,8745,3107,6635,21189,14554,544,1643
CE,14915,ORÓS,9097,1549,4317,17748,13431,350,1484
CE,14931,PACAJUS,21516,3950,6084,40180,34096,1314,2426
CE,14958,PACATUBA,19381,4604,6491,40543,34052,982,2185
CE,14974,PACOTI,5227,979,1636,9694,8058,204,672
CE,14990,PACUJÁ,3011,343,745,4917,4172,114,468
CE,15016,PALHANO,3818,1506,906,7296,6390,169,415
CE,15032,PALMÁCIA,4298,550,1093,7451,6358,168,625
CE,15059,PARACURU,11229,2371,4699,24424,19725,562,1544
CE,15075,PARAMBU,12098,4125,6869,26784,19915,584,2098
CE,15091,PARAMOTI,5135,1276,1993,9654,7661,143,608
CE,15113,PEDRA BRANCA,17610,1381,10801,34032,23231,561,2698
CE,15130,PENAFORTE,3666,555,621,5645,5024,84,407
CE,15156,PENTECOSTE,16704,2444,4965,28685,23720,422,1834
CE,15172,PEREIRO,5628,1947,3887,13234,9347,238,1052
CE,15199,PIQUET CARNEIRO,5947,912,1639,9932,8293,256,904
CE,15210,PORANGA,3866,1266,2825,9308,6483,114,940
CE,15237,PORTEIRAS,7608,441,3077,12775,9698,131,1211
CE,15253,POTENGI,3879,596,1831,7274,5443,165,617
CE,15270,QUIXADÁ,21539,12917,11338,53401,42063,1513,2924
CE,15296,QUIXERAMOBIM,27237,5829,11052,51127,40075,712,3305
CE,15318,QUIXERÉ,7970,1678,2718,15376,12658,531,1204
CE,15334,REDENÇÃO,11442,2384,4477,22569,18092,542,1448
CE,15350,RERIUTABA,7561,1168,4801,15580,10779,304,1143
CE,15377,RUSSAS,24764,5044,8241,47492,39251,1604,2965
CE,15393,SABOEIRO,6287,1088,3384,12652,9268,217,1242
CE,15415,SANTANA DO ACARAÚ,13374,2282,3381,22252,18871,642,1676
CE,15431,SANTANA DO CARIRI,5976,1659,3753,13142,9389,187,1136
CE,15440,SALITRE,6379,777,2745,11409,8664,204,968
CE,15458,SANTA QUITÉRIA,16131,4507,9000,33725,24725,652,1985
CE,15474,SÃO BENEDITO,17445,2739,11611,36230,24619,743,2246
CE,15490,SÃO GONÇALO DO AMARANTE,14872,4089,6018,33527,27509,627,2273
CE,15512,SÃO JOÃO DO JAGUARIBE,4398,358,1357,7319,5962,172,509
CE,15539,SÃO LUÍS DO CURU,5709,1011,1472,10414,8942,333,750
CE,15555,SENADOR POMPEU,9337,3787,4629,20628,15999,400,1464
CE,15571,SENADOR SÁ,2879,462,527,4641,4114,71,464
CE,15598,SOBRAL,64020,11269,20083,124035,103952,5998,8083
CE,15610,SOLONÓPOLE,7126,974,3781,14195,10414,200,1130
CE,15636,TABULEIRO DO NORTE,13405,1568,4433,23006,18573,677,1432
CE,15652,TAMBORIL,9165,3366,4847,19808,14961,362,1448
CE,15679,TAUÁ,20451,5714,9743,42363,32620,1002,3470
CE,15695,TIANGUÁ,21777,7023,9356,45967,36611,1383,3630
CE,15717,TRAIRI,17682,5138,8455,37430,28975,803,2266
CE,15733,UBAJARA,10688,3274,5688,23308,17620,670,1592
CE,15750,UMARI,3023,642,973,5635,4662,101,589
CE,15776,URUBURETAMA,8284,2323,1933,15310,13377,485,1058
CE,15792,URUOCA,4748,2071,2318,10495,8177,178,773
CE,15814,VÁRZEA ALEGRE,14988,3296,6500,29315,22815,798,2380
CE,15830,VIÇOSA DO CEARÁ,13316,13835,9081,40276,31195,505,2790
CE,15857,MARACANAÚ,65495,11791,20353,135489,115136,3662,6453
CE,15873,AMONTADA,14270,4012,6641,29019,22378,552,1798
CE,15881,CROATÁ,6333,1187,4835,13909,9074,190,911
CE,15890,CRUZ,8372,2851,5254,18664,13410,233,1270
CE,15911,FORQUILHA,8478,1200,3251,16167,12916,768,1285
CE,15920,IBICUITINGA,5720,1423,1204,9906,8702,362,644
CE,15938,ICAPUÍ,6153,4042,2788,14962,12174,458,628
CE,15954,ITAREMA,12316,3638,6974,26325,19351,405,1626
CE,15970,MILHÃ,6137,667,2588,10873,8285,155,842
CE,15989,DEPUTADO IRAPUAN PINHEIRO,2949,1467,1035,6348,5313,156,564
CE,15997,PARAIPABA,11895,1962,3560,20996,17436,457,1417
CE,98531,QUIXELÔ,7275,931,1659,11854,10195,397,1128
CE,98558,UMIRIM,7603,1472,3211,14305,11094,214,1024
CE,98574,VARJOTA,7037,1095,3649,13865,10216,287,892
DF,97012,BRASÍLIA,462441,354070,283177,1833942,1550765,33674,60032
ES,56006,SÃO DOMINGOS DO NORTE,2842,1960,1114,6898,5784,151,293
ES,56014,AFONSO CLÁUDIO,6357,8658,5491,24771,19280,621,1104
ES,56022,ÁGUA DOCE DO NORTE,3759,2091,2546,9942,7396,168,530
ES,56030,ALEGRE,6116,8079,5742,24898,19156,568,1148
ES,56049,IRUPI,2148,3256,1967,8721,6754,183,523
ES,56057,ALFREDO CHAVES,2847,4399,1755,10928,9173,441,458
ES,56065,ALTO RIO NOVO,2229,1436,1039,5588,4549,94,303
ES,56073,ANCHIETA,5261,5919,2850,18423,15573,510,642
ES,56081,VILA PAVÃO,3288,1836,890,6948,6058,123,200
ES,56090,APIACÁ,1816,1707,1625,6413,4788,99,320
ES,56103,MARECHAL FLORIANO,3261,4657,2262,12491,10229,486,531
ES,56111,ARACRUZ,16725,14065,9623,58420,48797,1535,2601
ES,56120,MARATAÍZES,5888,7808,5639,24937,19298,531,781
ES,56138,ATÍLIO VIVÁCQUA,2999,2475,1172,7974,6802,151,266
ES,56146,BREJETUBA,2793,2528,2218,8938,6720,182,479
ES,56154,BAIXO GUANDU,6261,8411,5243,24101,18858,506,1125
ES,56162,SÃO ROQUE DO CANAÃ,3285,2653,1738,9139,7401,292,433
ES,56170,BARRA DE SÃO FRANCISCO,10242,8332,7821,32005,24184,498,1263
ES,56189,SOORETAMA,5872,4041,3890,17099,13209,459,825
ES,56197,BOA ESPERANÇA,4051,2473,3188,11976,8788,194,499
ES,56200,PONTO BELO,2355,1519,1167,5890,4723,92,290
ES,56219,BOM JESUS DO NORTE,2406,2269,1818,8232,6414,195,424
ES,56227,VILA VALÉRIO,5865,2041,2026,11565,9539,176,390
ES,56235,CACHOEIRO DE ITAPEMIRIM,28662,46417,20734,127743,107009,3970,3600
ES,56251,CARIACICA,76911,48281,33494,237231,203737,5917,8329
ES,56278,CASTELO,5571,11370,2585,25259,22674,954,907
ES,56294,COLATINA,17664,30800,14275,82171,67896,2423,2867
ES,56308,GOVERNADOR LINDENBERG,3688,2228,1623,8705,7082,192,334
ES,56316,CONCEIÇÃO DA BARRA,7513,3564,6100,21442,15342,383,1243
ES,56332,CONCEIÇÃO DO CASTELO,1684,3900,1408,8587,7179,322,495
ES,56359,DIVINO DE SÃO LOURENÇO,970,1456,897,3947,3050,102,199
ES,56375,DOMINGOS MARTINS,6641,10873,4598,26574,21976,886,983
ES,56391,DORES DO RIO PRETO,1919,1811,1327,6138,4811,145,368
ES,56413,ECOPORANGA,6061,4280,3040,16312,13272,246,984
ES,56430,FUNDÃO,4492,2733,1967,12654,10687,324,555
ES,56456,GUAÇUÍ,4979,7745,4790,21067,16277,587,913
ES,56472,GUARAPARI,17424,25667,15358,78439,63081,2035,2937
ES,56499,IBIRAÇU,2350,2422,1538,9053,7515,264,528
ES,56502,IBITIRAMA,1593,2748,1840,7281,5441,172,376
ES,56510,ICONHA,3591,3766,962,9699,8737,288,339
ES,56537,ITAGUAÇU,4570,3278,2776,12486,9710,356,466
ES,56553,ITAPEMIRIM,6852,7521,5384,25307,19923,563,870
ES,56570,ITARANA,3080,3376,1754,9545,7791,239,389
ES,56596,IÚNA,4278,8775,4624,20740,16116,486,969
ES,56618,JERÔNIMO MONTEIRO,2670,2856,1013,8460,7447,217,473
ES,56626,JOÃO NEIVA,3282,3154,2154,13021,10867,393,620
ES,56634,LINHARES,24518,30502,18819,98564,79745,3017,4478
ES,56650,MANTENÓPOLIS,2982,3539,1834,9690,7856,167,619
ES,56677,MIMOSO DO SUL,7076,6432,4620,21555,16935,544,1145
ES,56693,MONTANHA,3888,3894,2459,12388,9929,282,668
ES,56715,MUCURICI,1918,1190,1175,4927,3752,55,259
ES,56731,MUNIZ FREIRE,4397,4106,3526,14753,11227,446,807
ES,56758,MUQUI,2608,4529,1069,10126,9057,325,405
ES,56774,NOVA VENÉCIA,11819,9238,6975,34003,27028,761,1207
ES,56790,PANCAS,5623,4201,3818,15673,11855,211,547
ES,56812,PINHEIROS,6025,3562,2579,15492,12913,226,783
ES,56839,PIÚMA,2942,4165,2699,12511,9812,312,437
ES,56855,PRESIDENTE KENNEDY,2739,3011,1378,8654,7276,184,437
ES,56871,RIO NOVO DO SUL,2668,3475,1876,9911,8035,293,339
ES,56898,SANTA LEOPOLDINA,3834,2597,1898,10153,8255,293,342
ES,56910,SANTA TERESA,4000,7238,3538,18336,14798,589,873
ES,56936,SÃO GABRIEL DA PALHA,7539,7658,4406,23585,19179,560,813
ES,56952,SÃO JOSÉ DO CALÇADO,3129,2125,1306,8342,7036,241,472
ES,56979,SÃO MATEUS,27690,12160,14536,71060,56524,1207,2374
ES,56995,SERRA,82651,40620,38576,259239,220663,6459,9751
ES,57010,VIANA,13153,7834,2357,34911,32554,936,1298
ES,57037,VILA VELHA,68124,66755,43987,283000,239013,6917,8463
ES,57053,VITÓRIA,54461,64959,41861,250714,208853,5090,6703
ES,57070,MARILÂNDIA,3250,3162,1386,9489,8103,350,407
ES,57096,IBATIBA,3981,6353,3692,16941,13249,332,914
ES,57118,RIO BANANAL,5746,3587,2912,14001,11089,380,493
ES,57134,JAGUARÉ,8389,3529,3576,18619,15043,461,680
ES,57150,PEDRO CANÁRIO,6179,3142,4577,17431,12854,316,999
ES,57916,LARANJA DA TERRA,2593,3925,1603,9183,7580,241,409
ES,57932,SANTA MARIA DE JETIBÁ,8698,9213,2654,24280,21626,675,859
ES,57959,VARGEM ALTA,3215,5451,2523,13809,11286,379,478
ES,57975,VENDA NOVA DO IMIGRANTE,2426,7235,2689,15204,12515,510,692
ES,57991,ÁGUIA BRANCA,4045,1569,977,7289,6312,91,262
GO,92010,ABADIÂNIA,2461,3776,2142,9705,7563,226,312
GO,92029,BONFINÓPOLIS,2079,1701,647,5383,4736,99,252
GO,92037,ÁGUA LIMPA,698,784,250,1995,1745,35,81
GO,92053,ALEXÂNIA,3121,6809,1500,14333,12833,333,663
GO,92061,CAMPOS VERDES,2180,819,1112,4637,3525,37,311
GO,92096,ALOÂNDIA,784,633,269,1867,1598,23,82
GO,92100,CEZARINA,2730,2014,1411,7403,5992,150,301
GO,92118,ALTO PARAÍSO DE GOIÁS,1311,1247,1484,5023,3539,67,212
GO,92126,COLINAS DO SUL,1405,478,812,3066,2254,36,162
GO,92150,ALVORADA DO NORTE,1576,2215,1174,5834,4660,88,398
GO,92169,MORRO AGUDO DE GOIÁS,835,777,251,2181,1930,27,140
GO,92177,AMORINÓPOLIS,1431,1149,570,3534,2964,42,147
GO,92207,EDEALINA,1311,1036,556,3360,2804,66,189
GO,92215,ANÁPOLIS,59466,77475,39925,230076,190151,5591,7162
GO,92223,FAINA,2601,1509,1338,6111,4773,56,217
GO,92231,ANHANGÜERA,311,320,123,929,806,4,40
GO,92258,ANICUNS,5995,4699,3211,16381,13170,275,616
GO,92266,GOUVELÂNDIA,1384,1164,510,3487,2977,75,210
GO,92274,APARECIDA DE GOIÂNIA,89889,60381,40556,251177,210621,5707,9937
GO,92282,ITAGUARI,1965,904,615,4010,3395,69,174
GO,92290,APORÉ,776,1048,921,3158,2237,49,153
GO,92312,ARAÇU,1347,1525,545,3980,3435,77,157
GO,92320,MATRINCHÃ,1350,1207,885,3799,2914,15,125
GO,92339,ARAGARÇAS,4943,3238,3106,13506,10400,209,428
GO,92347,MIMOSO DE GOIÁS,669,657,456,2348,1892,29,116
GO,92355,ARAGOIÂNIA,2640,1798,923,6335,5412,112,250
GO,92363,MONTIVIDIU,1919,3463,1442,7734,6292,121,269
GO,92444,NOVO PLANALTO,1379,653,521,2876,2355,38,142
GO,92460,PALESTINA DE GOIÁS,1450,971,696,3455,2759,32,129
GO,92495,ARUANÃ,1907,1367,912,4646,3734,58,111
GO,92517,AURILÂNDIA,1541,673,464,3059,2595,56,129
GO,92550,AVELINÓPOLIS,885,1260,447,2960,2513,38,113
GO,92568,SANTA FÉ DE GOIÁS,1513,1192,1057,4288,3231,61,231
GO,92614,BALIZA,1238,493,535,2556,2021,18,136
GO,92622,SÃO JOÃO DA PARAÚNA,599,657,397,1880,1483,25,71
GO,92630,BARRO ALTO,2678,1462,999,6077,5078,93,279
GO,92649,SÃO LUIZ DO NORTE,1478,1178,831,4000,3169,71,178
GO,92657,BELA VISTA DE GOIÁS,5082,5909,3294,17474,14180,377,833
GO,92665,SÃO MIGUEL DO PASSA QUATRO,1146,1210,559,3361,2802,42,145
GO,92673,BOM JARDIM DE GOIÁS,2847,1846,1012,6450,5438,74,290
GO,92690,BOM JESUS DE GOIÁS,4887,4775,3021,14730,11709,429,661
GO,92703,SENADOR CANEDO,17892,11769,8471,51419,42948,1095,2072
GO,92711,BRAZABRANTES,933,785,335,2493,2158,44,119
GO,92720,SIMOLÂNDIA,1620,1867,1350,5496,4146,80,325
GO,92754,BRITÂNIA,1544,1503,938,4478,3540,44,245
GO,92762,TERESINA DE GOIÁS,783,510,746,2447,1701,12,203
GO,92770,BURITI ALEGRE,2188,2848,956,6905,5949,155,352
GO,92789,TROMBAS,1076,862,570,2889,2319,40,196
GO,92797,CABECEIRAS,2262,1580,748,5364,4616,109,240
GO,92800,TURVELÂNDIA,1531,1149,1085,4207,3122,33,207
GO,92819,CACHOEIRA ALTA,2142,2005,1564,6616,5052,166,269
GO,92827,RIO QUENTE,813,1010,518,2853,2335,43,117
GO,92835,CACHOEIRA DE GOIÁS,394,688,302,1518,1216,17,31
GO,92851,CAÇU,2930,2968,1303,8282,6979,145,440
GO,92860,GUARINOS,907,495,271,1889,1618,28,133
GO,92878,CAIAPÔNIA,4348,3075,2328,11701,9373,174,613
GO,92886,COCALZINHO DE GOIÁS,3955,3188,2544,11993,9449,340,592
GO,92894,CALDAS NOVAS,14719,13895,9574,48203,38629,1121,1987
GO,92908,SANTO ANTÔNIO DE GOIÁS,1511,890,477,3560,3083,93,182
GO,92916,CAMPESTRE DE GOIÁS,1120,1147,598,3281,2683,45,139
GO,92924,CHAPADÃO DO CÉU,1539,1640,1056,4927,3871,81,152
GO,92932,CAMPINORTE,3241,2049,1784,8060,6276,128,226
GO,92940,ALTO HORIZONTE,1426,1215,672,3627,2955,42,97
GO,92959,CAMPO ALEGRE DE GOIÁS,1723,1438,631,4247,3616,56,127
GO,92967,CASTELÂNDIA,1388,997,893,3613,2720,36,129
GO,92975,CAMPOS BELOS,5484,2962,4058,14539,10481,179,862
GO,92983,JESÚPOLIS,801,683,400,2177,1777,34,115
GO,92991,CARMO DO RIO VERDE,2113,2435,882,6395,5513,123,264
GO,93009,APARECIDA DO RIO DOCE,1010,626,372,2401,2029,45,125
GO,93017,CATALÃO,20297,17660,9110,59338,50228,1630,2354
GO,93025,CIDADE OCIDENTAL,10644,4985,5405,30151,24746,667,916
GO,93033,CATURAÍ,1471,945,443,3382,2939,117,194
GO,93041,PROFESSOR JAMIL,1072,952,746,3218,2472,40,148
GO,93050,CAVALCANTE,2793,705,2508,7064,4556,56,548
GO,93068,PEROLÂNDIA,1084,693,678,2781,2103,38,129
GO,93076,CERES,4681,5612,1666,14421,12755,244,528
GO,93084,NOVA IGUAÇU DE GOIÁS,1103,656,567,2532,1965,24,93
GO,93092,DIVINÓPOLIS DE GOIÁS,1605,1007,1132,4570,3438,162,357
GO,93106,BURITI DE GOIÁS,997,849,463,2702,2239,39,120
GO,93122,CALDAZINHA,1025,808,476,2789,2313,43,119
GO,93149,GUARAÍTA,903,731,287,2244,1957,35,97
GO,93157,CÓRREGO DO OURO,865,900,311,2388,2077,34,73
GO,93165,INACIOLÂNDIA,1671,1385,847,4431,3584,77,219
GO,93173,CORUMBÁ DE GOIÁS,1543,2907,1576,7305,5729,231,354
GO,93181,MONTIVIDIU DO NORTE,1341,674,794,3296,2502,47,187
GO,93190,CORUMBAÍBA,2124,1987,797,5775,4978,97,333
GO,93203,SANTO ANTÔNIO DA BARRA,1459,1243,484,3473,2989,53,137
GO,93220,TEREZÓPOLIS DE GOIÁS,2100,1445,983,5375,4392,106,258
GO,93246,UIRAPURU,1283,488,421,2451,2030,26,123
GO,93254,CRISTALINA,7184,10320,6234,28222,21988,710,947
GO,93262,BURITINÓPOLIS,608,1280,892,3107,2215,29,155
GO,93270,CRISTIANÓPOLIS,770,1245,412,2823,2411,44,98
GO,93289,VILA BOA,1313,782,955,3445,2490,29,171
GO,93297,CRIXÁS,5587,2233,1981,11199,9218,161,456
GO,93300,VALPARAÍSO DE GOIÁS,19340,9531,9902,56668,46766,1451,1917
GO,93319,CROMÍNIA,1208,1153,321,3148,2827,70,135
GO,93327,NOVO GAMA,13097,9366,7909,43412,35503,1252,1541
GO,93335,CUMARI,982,676,413,2475,2062,52,86
GO,93343,ÁGUAS LINDAS DE GOIÁS,22392,8778,11957,60214,48257,2073,2408
GO,93351,DAMIANÓPOLIS,957,1254,681,3321,2640,60,169
GO,93360,ABADIA DE GOIÁS,1929,1764,903,5591,4688,89,201
GO,93378,DAMOLÂNDIA,889,1146,287,2638,2351,47,134
GO,93386,AMARALINA,1263,746,576,2829,2253,28,116
GO,93394,DAVINÓPOLIS,1001,657,311,2283,1972,48,117
GO,93408,BONÓPOLIS,1221,538,430,2462,2032,28,119
GO,93424,PORTEIRÃO,1297,490,580,2629,2049,35,95
GO,93432,DIORAMA,890,646,279,2050,1771,25,73
GO,93440,SANTA RITA DO NOVO DESTINO,1374,587,362,2678,2316,45,135
GO,93483,SÃO PATRÍCIO,557,688,197,1755,1558,42,87
GO,93491,EDÉIA,2697,3311,1436,8461,7025,123,299
GO,93505,VILA PROPÍCIO,1471,1004,601,3623,3022,64,255
GO,93513,ESTRELA DO NORTE,1166,774,410,2686,2276,33,145
GO,93530,FAZENDA NOVA,2113,1424,1117,5458,4341,71,270
GO,93548,IPIRANGA DE GOIÁS,1122,729,487,2736,2249,30,149
GO,93564,GAMELEIRA DE GOIÁS,788,850,324,2259,1935,23,87
GO,93572,FIRMINÓPOLIS,2484,2411,1310,7727,6417,148,358
GO,93580,CAMPO LIMPO DE GOIÁS,1642,1816,774,4913,4139,100,198
GO,93599,FLORES DE GOIÁS,2399,1278,1665,6012,4347,52,345
GO,93602,LAGOA SANTA,327,448,223,1178,955,19,46
GO,93610,FORMOSA,19081,18558,11654,63035,51381,1477,2672
GO,93637,FORMOSO,1850,1043,934,4350,3416,62,219
GO,93670,GOIANÁPOLIS,2170,3744,1982,9155,7173,182,263
GO,93696,GOIANDIRA,1522,1147,455,3905,3450,105,218
GO,93718,GOIANÉSIA,16251,11482,8211,43097,34886,1108,1979
GO,93734,GOIÂNIA,230309,287891,147195,901988,754793,18038,33596
GO,93750,GOIANIRA,6493,5101,3653,19306,15653,440,838
GO,93777,GOIÁS,7484,5395,4486,20690,16204,290,686
GO,93793,GOIATUBA,7897,9123,5114,25810,20696,671,1064
GO,93815,GUAPÓ,3407,3531,1867,10301,8434,175,417
GO,93831,GUARANI DE GOIÁS,1459,1114,867,3773,2906,35,208
GO,93874,HEITORAÍ,1280,1136,463,3253,2790,49,149
GO,93890,HIDROLÂNDIA,4284,3940,893,11258,10365,245,556
GO,93912,HIDROLINA,1416,1286,575,3733,3158,62,169
GO,93939,IACIARA,2966,2349,2196,8292,6096,75,426
GO,93955,INHUMAS,12193,12544,6579,38188,31609,1061,1656
GO,93971,IPAMERI,6377,5621,4312,19391,15079,405,781
GO,93998,IPORÁ,8557,6873,5289,24193,18904,389,844
GO,94013,ISRAELÂNDIA,1017,863,545,2749,2204,34,97
GO,94030,ITABERAÍ,9914,7837,4788,26297,21509,534,1201
GO,94072,ITAGUARU,2076,1376,606,4843,4237,84,213
GO,94110,ITAJÁ,1297,1373,978,4203,3225,49,204
GO,94137,ITAPACI,5227,3353,2933,13508,10575,264,666
GO,94153,ITAPIRAPUÃ,2188,2521,1599,7034,5435,71,261
GO,94196,ITAPURANGA,8391,4785,2863,19655,16792,489,933
GO,94218,ITARUMÃ,1397,1593,1104,4559,3455,44,187
GO,94234,ITAUÇU,2531,2115,786,6491,5705,122,292
GO,94250,ITUMBIARA,20343,26136,12703,68690,55987,1670,2219
GO,94277,IVOLÂNDIA,991,669,634,2690,2056,39,129
GO,94293,JANDAIA,2276,2053,936,6125,5189,71,243
GO,94315,JARAGUÁ,8584,10754,5140,28977,23837,666,1143
GO,94331,JATAÍ,22045,18251,11967,62560,50593,1637,2319
GO,94358,JAUPACI,1275,638,369,2594,2225,17,82
GO,94374,JOVIÂNIA,1864,2069,1099,5851,4752,99,260
GO,94390,JUSSARA,4241,5625,2197,13889,11692,219,685
GO,94439,LEOPOLDO DE BULHÕES,1973,2046,1171,6131,4960,190,275
GO,94455,LUZIÂNIA,29991,30586,18258,104936,86678,2679,3704
GO,94471,MAIRIPOTABA,643,886,330,2146,1816,45,99
GO,94498,MAMBAÍ,1102,2430,1260,5311,4051,38,283
GO,94510,MARA ROSA,3235,2154,2017,8495,6478,108,421
GO,94536,MARZAGÃO,726,554,314,1952,1638,23,85
GO,94552,PARANAIGUARA,3071,1704,933,6651,5718,96,299
GO,94579,MAURILÂNDIA,3474,2320,2018,8630,6612,128,380
GO,94595,MINEIROS,12555,9899,6532,34817,28285,870,1557
GO,94650,MOIPORÁ,515,741,433,2066,1633,53,92
GO,94676,MONTE ALEGRE DE GOIÁS,1870,1338,1212,5157,3945,40,401
GO,94714,MONTES CLAROS DE GOIÁS,2599,1633,1258,6189,4931,62,170
GO,94730,MORRINHOS,11073,10262,5656,31933,26277,645,1169
GO,94757,MOSSÂMEDES,1968,1084,612,4224,3612,81,175
GO,94773,MOZARLÂNDIA,3454,3549,1888,9842,7954,115,393
GO,94790,MUTUNÓPOLIS,1301,1052,572,3278,2706,24,152
GO,94854,NAZÁRIO,2366,2211,780,6351,5571,126,311
GO,94870,NERÓPOLIS,6452,5803,3496,18889,15393,479,838
GO,94897,NIQUELÂNDIA,12284,5920,4170,26753,22583,435,1218
GO,94919,NOVA AMÉRICA,667,719,232,1867,1635,30,114
GO,94935,NOVA AURORA,677,700,220,1813,1593,30,98
GO,94951,NOVA ROMA,995,694,765,2809,2044,24,170
GO,94978,NOVA VENEZA,2152,2365,930,6463,5533,140,274
GO,95010,NOVO BRASIL,1311,1069,483,3269,2786,43,191
GO,95036,ORIZONA,3825,3884,1101,10154,9053,203,411
GO,95052,OURO VERDE DE GOIÁS,867,1567,655,3748,3093,95,167
GO,95079,OUVIDOR,2154,1288,446,4635,4189,93,168
GO,95095,PADRE BERNARDO,4098,4097,3956,15664,11708,289,851
GO,95117,PALMEIRAS DE GOIÁS,4331,6796,1988,16011,14023,232,573
GO,95133,PALMELO,661,615,334,1996,1662,23,83
GO,95150,PALMINÓPOLIS,1067,1629,488,3547,3059,22,54
GO,95176,PANAMÁ,824,852,437,2364,1927,33,100
GO,95230,PARAÚNA,3273,2633,1754,8757,7003,112,398
GO,95311,PETROLINA DE GOIÁS,2415,2931,1563,7952,6389,186,364
GO,95354,PILAR DE GOIÁS,992,782,352,2415,2063,47,117
GO,95397,PIRACANJUBA,7265,5585,3801,18959,15158,333,595
GO,95419,PIRANHAS,4075,2312,1885,9518,7633,104,391
GO,95435,PIRENÓPOLIS,4512,7594,2302,17074,14772,410,608
GO,95451,PIRES DO RIO,5915,7290,4260,21773,17513,575,1017
GO,95494,PONTALINA,5312,4517,2631,14200,11569,279,572
GO,95559,PORANGATU,13030,5972,7137,30188,23051,352,1201
GO,95575,PORTELÂNDIA,1216,866,601,3208,2607,70,181
GO,95613,POSSE,6794,7978,5031,22117,17086,329,871
GO,95630,QUIRINÓPOLIS,10663,10685,5804,31303,25499,675,1430
GO,95656,RIALMA,2884,2775,1707,8630,6923,153,342
GO,95672,RIANÁPOLIS,1202,1342,682,3696,3014,72,201
GO,95710,RIO VERDE,30208,40415,17668,103491,85823,2449,3673
GO,95737,RUBIATABA,4213,5511,2861,14862,12001,276,619
GO,95753,SANCLERLÂNDIA,2771,1990,1064,6814,5750,103,261
GO,95770,SANTA BÁRBARA DE GOIÁS,1529,1760,783,4693,3910,67,162
GO,95796,SANTA CRUZ DE GOIÁS,802,1213,626,3126,2500,40,110
GO,95818,SANTA HELENA DE GOIÁS,11288,8195,3373,27030,23657,766,1322
GO,95834,SANTA RITA DO ARAGUAIA,1013,1505,890,3845,2955,88,120
GO,95850,SANTA ROSA DE GOIÁS,1107,919,359,2925,2566,135,143
GO,95877,SANTA TEREZA DE GOIÁS,1155,1018,841,3448,2607,80,157
GO,95893,SANTA TEREZINHA DE GOIÁS,3557,2080,1368,7733,6365,76,323
GO,95915,SÃO DOMINGOS,2692,1534,2304,7512,5208,94,547
GO,95931,SÃO FRANCISCO DE GOIÁS,1435,1676,907,4697,3790,118,288
GO,95958,PLANALTINA,16846,10031,8932,47719,38787,1441,1927
GO,95974,SÃO JOÃO D'ALIANÇA,1970,1606,1741,6368,4627,117,312
GO,95990,SÃO LUÍS DE MONTES BELOS,6297,7735,4480,22684,18204,555,952
GO,96016,SÃO MIGUEL DO ARAGUAIA,5171,5747,4776,18290,13514,233,806
GO,96059,SÃO SIMÃO,5731,2321,1975,11633,9658,179,540
GO,96075,SERRANÓPOLIS,1927,1360,800,4780,3980,74,227
GO,96091,SILVÂNIA,4721,4839,2281,14031,11750,259,466
GO,96113,SÍTIO D'ABADIA,803,789,591,2409,1818,14,143
GO,96172,TAQUARAL DE GOIÁS,1204,1140,542,3334,2792,54,147
GO,96237,TRÊS RANCHOS,1236,1003,557,3230,2673,41,115
GO,96253,TRINDADE,25061,20228,11581,69828,58247,1422,2868
GO,96318,TURVÂNIA,1500,1575,593,4366,3773,66,173
GO,96334,URUAÇU,10618,5928,5560,24928,19368,377,848
GO,96350,URUANA,3521,3630,2462,11350,8888,221,489
GO,96377,URUTAÍ,970,823,504,2731,2227,80,103
GO,96393,VARJÃO,1061,1481,591,3618,3027,70,163
GO,96415,VIANÓPOLIS,2045,3958,1561,9083,7522,194,431
GO,96458,ACREÚNA,4880,5297,3256,15498,12242,287,700
GO,96474,MINAÇU,11355,4205,7777,26735,18958,337,1087
GO,96512,MUNDO NOVO,1724,1280,1322,5005,3683,58,301
GO,96539,NOVA CRIXÁS,3348,1979,2140,8304,6164,96,375
GO,96555,NOVA GLÓRIA,2715,1516,1744,7300,5556,154,293
GO,96571,VICENTINÓPOLIS,2023,2097,840,5493,4653,80,228
GO,96610,AMERICANO DO BRASIL,1743,1558,522,4443,3921,67,176
GO,96695,ARAGUAPAZ,1997,2226,1248,6053,4805,66,198
GO,96717,ARENÓPOLIS,1471,823,588,3168,2580,32,85
GO,96733,CACHOEIRA DOURADA,2931,2203,1670,7593,5923,132,280
GO,96750,DOVERLÂNDIA,2843,1436,803,5665,4862,51,272
GO,96776,SANTO ANTÔNIO DO DESCOBERTO,11459,7684,7094,35227,28133,942,1351
GO,96814,INDIARA,4349,2277,2273,10397,8124,217,442
GO,96873,CAMPINAÇU,1662,600,535,3172,2637,59,152
GO,96890,SANTA ISABEL,1148,947,473,2948,2475,47,168
GO,96911,ADELÂNDIA,981,788,335,2421,2086,19,130
GO,96938,ÁGUA FRIA DE GOIÁS,1093,1371,1130,4186,3056,71,163
MA,7005,ÁGUA DOCE DO MARANHÃO,3856,1665,3100,9769,6669,180,652
MA,7013,AFONSO CUNHA,3223,157,904,4899,3995,49,409
MA,7021,ALTO ALEGRE DO MARANHÃO,8167,793,3687,14341,10654,149,1132
MA,7030,ALCÂNTARA,9140,648,4128,16264,12136,375,940
MA,7048,ALTO ALEGRE DO PINDARÉ,10437,1001,5412,19689,14277,289,1803
MA,7056,ALDEIAS ALTAS,8049,738,4226,15712,11486,205,1709
MA,7064,APICUM-AÇU,4706,1249,2136,8964,6828,99,399
MA,7072,ALTAMIRA DO MARANHÃO,2258,515,1035,4747,3712,100,473
MA,7080,AMAPÁ DO MARANHÃO,2135,595,1182,4622,3440,44,466
MA,7099,ALTO PARNAÍBA,2877,1280,2120,7415,5295,140,663
MA,7102,ARAGUANÃ,3802,289,1900,6737,4837,52,446
MA,7110,AMARANTE DO MARANHÃO,9890,3674,5315,22750,17435,374,2032
MA,7129,BACABEIRA,6639,493,1202,9964,8762,248,622
MA,7137,ANAJATUBA,10556,676,4601,18420,13819,270,1160
MA,7145,BACURITUBA,2519,328,1400,4802,3402,56,238
MA,7153,ANAPURUS,6356,728,1026,9458,8432,258,780
MA,7161,BELÁGUA,3041,167,570,4388,3818,33,485
MA,7170,ARAIOSES,12696,3715,8482,29539,21057,953,2615
MA,7188,BELA VISTA DO MARANHÃO,4075,563,1922,7672,5750,54,559
MA,7196,ARARI,10535,1621,5115,20761,15646,323,1215
MA,7200,BERNARDO DO MEARIM,2378,328,1123,4635,3512,92,339
MA,7218,AXIXÁ,5221,506,1875,8908,7033,142,392
MA,7226,CACHOEIRA GRANDE,3424,153,1804,6282,4478,69,511
MA,7234,BACABAL,29937,6899,15610,63418,47808,820,3875
MA,7242,DAVINÓPOLIS,3851,1326,2204,9063,6859,87,387
MA,7250,BACURI,6491,874,3268,12047,8779,116,732
MA,7269,BOM JESUS DAS SELVAS,6863,2159,3651,14382,10731,130,976
MA,7277,BALSAS,21602,11020,10288,50268,39980,764,2469
MA,7285,BOM LUGAR,5274,644,2567,9535,6968,66,665
MA,7293,BARÃO DE GRAJAÚ,6468,947,3052,12336,9284,219,1005
MA,7307,BREJO DE AREIA,3196,591,1664,6403,4739,101,661
MA,7315,BARRA DO CORDA,25080,6611,14835,54586,39751,982,3673
MA,7323,BOA VISTA DO GURUPI,2155,705,936,4369,3433,31,260
MA,7331,BARREIRINHAS,22349,1788,8024,35419,27395,246,1635
MA,7340,BURITICUPU,20489,4220,9589,39651,30062,345,2858
MA,7358,BENEDITO LEITE,1635,641,1377,4320,2943,46,406
MA,7366,BURITIRANA,4209,1275,2400,9824,7424,190,854
MA,7374,BEQUIMÃO,7869,2169,2651,14578,11927,282,853
MA,7382,CAMPESTRE DO MARANHÃO,4833,839,2195,9018,6823,134,493
MA,7390,BREJO,11462,2584,5166,22346,17180,397,1579
MA,7404,CAPINZAL DO NORTE,3769,664,1567,7326,5759,128,651
MA,7412,BURITI,9683,1167,5119,18794,13675,393,1799
MA,7420,CENTRAL DO MARANHÃO,3526,149,1905,6175,4270,62,384
MA,7439,BURITI BRAVO,7381,1249,4383,15434,11051,133,1558
MA,7447,CENTRO DO GUILHERME,3303,296,1347,5636,4289,50,511
MA,7455,CAJAPIÓ,4289,542,2253,8266,6013,186,590
MA,7463,CENTRO NOVO DO MARANHÃO,5149,725,1836,8761,6925,80,760
MA,7471,CAJARI,7380,330,1724,11020,9296,147,864
MA,7480,CIDELÂNDIA,4382,1011,2380,9396,7016,126,673
MA,7498,CÂNDIDO MENDES,5660,1669,4084,13111,9027,175,777
MA,7501,CONCEIÇÃO DO LAGO-AÇU,5051,636,1874,8767,6893,128,789
MA,7510,CANTANHEDE,6079,707,2825,11096,8271,106,759
MA,7528,FEIRA NOVA DO MARANHÃO,2183,1107,1350,5514,4164,144,453
MA,7536,CAROLINA,7315,2090,4626,16796,12170,224,1107
MA,7544,FERNANDO FALCÃO,3474,633,859,5727,4868,61,430
MA,7552,CARUTAPERA,6778,2524,3325,14658,11333,123,882
MA,7560,FORMOSA DA SERRA NEGRA,4186,2579,2093,10272,8179,79,646
MA,7579,CAXIAS,49833,6948,26956,102285,75329,1425,7065
MA,7595,CEDRAL,4474,270,1950,7729,5779,181,338
MA,7609,GOVERNADOR EDISON LOBÃO,4194,1818,1860,9738,7878,143,502
MA,7617,CHAPADINHA,24895,3623,11754,47809,36055,1090,3316
MA,7625,GOVERNADOR LUIZ ROCHA,1933,1301,1008,5292,4284,146,492
MA,7633,CODÓ,32502,6037,26802,77919,51117,1262,5687
MA,7641,GOVERNADOR NEWTON BELLO,3881,409,2065,7328,5263,77,603
MA,7650,COELHO NETO,17996,1955,10093,34443,24350,390,2377
MA,7668,GOVERNADOR NUNES FREIRE,7751,1603,3029,13942,10913,93,888
MA,7676,COLINAS,11661,2189,7396,24595,17199,396,2074
MA,7684,IGARAPÉ DO MEIO,4988,594,2861,9762,6901,118,753
MA,7692,COROATÁ,21263,3426,12537,44077,31540,589,3615
MA,7706,ITAIPAVA DO GRAJAÚ,4921,844,2102,8770,6668,57,532
MA,7714,CURURUPU,12419,1607,7327,23981,16654,368,1117
MA,7722,ITINGA DO MARANHÃO,6046,4186,4294,17352,13058,195,1209
MA,7730,DOM PEDRO,8077,2237,3429,15995,12566,224,963
MA,7749,JATOBÁ,2829,442,1126,5199,4073,119,541
MA,7757,DUQUE BACELAR,4196,454,2147,8222,6075,113,698
MA,7765,JENIPAPO DOS VIEIRAS,5874,1022,2650,10781,8131,137,626
MA,7773,ESPERANTINÓPOLIS,6969,1072,3589,13785,10196,256,1147
MA,7781,JUNCO DO MARANHÃO,2410,383,1032,4353,3321,60,304
MA,7790,FORTALEZA DOS NOGUEIRAS,5124,856,1878,8828,6950,113,569
MA,7803,LAGO DOS RODRIGUES,3453,1031,1107,6518,5411,65,501
MA,7811,FORTUNA,6122,562,2425,10785,8360,272,829
MA,7820,LAGOA DO MATO,3888,310,1976,7328,5352,89,871
MA,7838,GODOFREDO VIANA,2889,905,1493,6039,4546,82,440
MA,7846,LAGOA GRANDE DO MARANHÃO,4179,633,1493,7187,5694,89,606
MA,7854,GONÇALVES DIAS,5960,812,3077,11369,8292,195,816
MA,7862,LAJEADO NOVO,2519,899,1146,5442,4296,70,406
MA,7870,GOVERNADOR ARCHER,3765,520,1872,7293,5421,97,673
MA,7889,MARACAÇUMÉ,5792,1430,3342,12353,9011,144,876
MA,7897,GOVERNADOR EUGÊNIO BARROS,5925,842,2622,10920,8298,173,848
MA,7900,MARAJÁ DO SENA,2967,370,1269,5536,4267,137,608
MA,7919,GRAÇA ARANHA,3133,310,1209,5280,4071,53,349
MA,7927,MARANHÃOZINHO,3725,532,1338,6166,4828,32,293
MA,7935,GRAJAÚ,19572,4099,9165,38023,28858,356,2397
MA,7943,MATÕES DO NORTE,3896,204,1881,6711,4830,37,424
MA,7951,GUIMARÃES,5540,454,2551,9913,7362,242,585
MA,7960,MILAGRES DO MARANHÃO,2391,436,1091,4523,3432,59,384
MA,7978,HUMBERTO DE CAMPOS,10926,700,4803,18890,14087,216,1351
MA,7986,NOVA COLINAS,2053,508,798,3900,3102,74,342
MA,7994,ICATU,11125,587,4419,18933,14514,301,1399
MA,8001,NOVA OLINDA DO MARANHÃO,6116,895,2665,11387,8722,159,886
MA,8010,IGARAPÉ GRANDE,3667,1017,1137,7342,6205,113,679
MA,8028,OLINDA NOVA DO MARANHÃO,4500,357,2465,8540,6075,172,676
MA,8036,IMPERATRIZ,42452,39868,31257,156727,125470,1725,5398
MA,8044,PAULINO NEVES,6089,835,2560,10657,8097,114,734
MA,8052,SÃO LUÍS GONZAGA DO MARANHÃO,9861,684,5010,17865,12855,169,1544
MA,8060,PEDRO DO ROSÁRIO,8064,641,3786,14358,10572,129,1251
MA,8079,ITAPECURU MIRIM,20407,2028,9411,37781,28370,454,2547
MA,8087,PERITORÓ,8275,765,3881,14883,11002,179,1202
MA,8095,JOÃO LISBOA,6764,2829,4635,17851,13216,268,1171
MA,8109,PORTO RICO DO MARANHÃO,2738,455,1304,5511,4207,148,306
MA,8117,JOSELÂNDIA,5814,880,3016,11407,8391,231,894
MA,8125,PRESIDENTE MÉDICI,2897,320,948,4644,3696,33,199
MA,8133,LAGO DA PEDRA,13516,5695,8960,32799,23839,394,2269
MA,8141,PRESIDENTE SARNEY,6050,664,3243,11399,8156,108,855
MA,8150,LAGO DO JUNCO,3870,562,1621,7276,5655,189,652
MA,8168,RAPOSA,8636,914,945,12632,11687,201,702
MA,8176,LAGO VERDE,6065,476,2924,10743,7819,142,841
MA,8184,RIBAMAR FIQUENE,2754,1145,1425,6195,4770,64,380
MA,8192,LIMA CAMPOS,3816,1310,1611,8567,6956,261,759
MA,8206,SANTA FILOMENA DO MARANHÃO,2834,364,1065,5044,3979,143,403
MA,8214,LORETO,3912,714,1914,7581,5667,80,777
MA,8222,SANTANA DO MARANHÃO,2986,376,2072,6472,4400,97,657
MA,8230,LUÍS DOMINGUES,2024,1139,1102,4893,3791,63,302
MA,8249,SANTO AMARO DO MARANHÃO,5095,346,1377,7748,6371,100,502
MA,8257,MAGALHÃES DE ALMEIDA,5091,1673,3216,11589,8373,184,863
MA,8265,SÃO DOMINGOS DO AZEITÃO,2894,364,1187,5180,3993,71,480
MA,8273,MATA ROMA,6423,1076,1941,11221,9280,264,936
MA,8281,SÃO FRANCISCO DO BREJÃO,2824,1185,1190,6162,4972,60,409
MA,8290,MATINHA,9285,1065,3830,16745,12915,484,869
MA,8303,SÃO JOÃO DO CARÚ,5038,636,2293,9168,6875,87,944
MA,8311,MATÕES,11075,1291,5807,21166,15359,225,2102
MA,8320,SÃO JOÃO DO PARAÍSO,3250,1830,1849,8079,6230,124,560
MA,8338,MIRADOR,7517,915,3561,13852,10291,185,1213
MA,8346,SÃO JOÃO DO SOTER,5824,398,2214,9767,7553,84,981
MA,8354,MIRINZAL,5544,526,2879,10237,7358,198,588
MA,8362,SÃO JOSÉ DOS BASÍLIOS,3492,379,2094,6943,4849,135,585
MA,8370,MONÇÃO,10326,1030,4768,18424,13656,185,1366
MA,8389,SÃO PEDRO DA ÁGUA BRANCA,4322,768,2232,8230,5998,71,490
MA,8397,MONTES ALTOS,3356,973,1526,7220,5694,97,596
MA,8400,SÃO PEDRO DOS CRENTES,1340,975,712,3529,2817,26,255
MA,8419,MORROS,6870,627,3074,12560,9486,128,1096
MA,8427,SÃO RAIMUNDO DO DOCA BEZERRA,2299,475,1272,4727,3455,89,406
MA,8435,NINA RODRIGUES,4516,451,1967,8283,6316,66,735
MA,8443,SÃO ROBERTO,2410,372,849,4068,3219,26,307
MA,8451,NOVA IORQUE,1605,461,1022,3587,2565,54,294
MA,8460,SATUBINHA,2575,285,1308,5000,3692,77,456
MA,8478,OLHO D'ÁGUA DAS CUNHÃS,6577,1389,3902,13690,9788,330,1092
MA,8486,SENADOR ALEXANDRE COSTA,3368,493,1423,6265,4842,88,618
MA,8494,PAÇO DO LUMIAR,23067,2734,2561,39020,36459,881,1419
MA,8508,SENADOR LA ROCQUE,6802,1892,3918,15195,11277,254,1190
MA,8516,PALMEIRÂNDIA,7911,693,3967,14299,10332,192,977
MA,8524,SERRANO DO MARANHÃO,3882,297,1636,6720,5084,104,644
MA,8532,PARAIBANO,6472,1212,4916,14702,9786,253,1353
MA,8540,SUCUPIRA DO RIACHÃO,1950,265,928,3763,2835,84,385
MA,8559,PARNARAMA,12426,1355,7081,24487,17406,391,2224
MA,8567,TRIZIDELA DO VALE,6378,1533,1952,12614,10662,235,1094
MA,8575,PASSAGEM FRANCA,5820,1338,2349,11553,9204,244,1447
MA,8583,TUFILÂNDIA,3060,202,1367,5320,3953,38,457
MA,8591,PASTOS BONS,6447,1254,3416,12771,9355,198,1015
MA,8605,TURILÂNDIA,6323,762,4033,12671,8638,145,896
MA,8613,PEDREIRAS,13298,3135,7248,29394,22146,459,1864
MA,8621,VILA NOVA DOS MARTÍRIOS,2472,1445,1260,5979,4719,74,418
MA,8630,PENALVA,12140,1037,8374,24404,16030,167,1880
MA,8656,PERI MIRIM,5190,892,2747,10068,7321,265,595
MA,8672,PINDARÉ-MIRIM,10834,1658,5572,21537,15965,286,1611
MA,8699,PINHEIRO,22005,8289,14116,52223,38107,600,2600
MA,8710,PIO XII,8706,1674,4612,17574,12962,261,1433
MA,8737,PIRAPEMAS,6412,494,3252,11763,8511,155,943
MA,8753,POÇÃO DE PEDRAS,7731,1485,4046,15528,11482,305,1086
MA,8770,PORTO FRANCO,4906,4393,2981,14560,11579,144,676
MA,8796,PRESIDENTE DUTRA,14601,3161,7457,29490,22033,660,1762
MA,8818,PRESIDENTE JUSCELINO,4977,203,2165,8518,6353,58,615
MA,8834,PRESIDENTE VARGAS,4930,339,1914,8583,6669,152,768
MA,8850,PRIMEIRA CRUZ,5222,391,2369,9020,6651,107,625
MA,8877,RIACHÃO,6788,1219,3791,13728,9937,184,1128
MA,8893,SÃO JOSÉ DE RIBAMAR,40470,4874,14286,75407,61121,1509,3754
MA,8915,ROSÁRIO,15096,1028,6571,26979,20408,465,1342
MA,8931,SAMBAÍBA,2721,578,631,4594,3963,45,344
MA,8958,SANTA HELENA,10535,1874,6503,21526,15023,224,1310
MA,8974,SANTA LUZIA,22273,3869,12946,45006,32060,732,3166
MA,8990,SANTA QUITÉRIA DO MARANHÃO,9679,1384,4559,17845,13286,463,1428
MA,9016,SANTA RITA,10751,1401,5005,19693,14688,306,1203
MA,9032,SANTO ANTÔNIO DOS LOPES,6142,762,2351,10896,8545,157,873
MA,9059,SÃO BENEDITO DO RIO PRETO,6904,733,2516,11859,9343,137,1010
MA,9075,SÃO BENTO,12168,3008,8007,25986,17979,393,1346
MA,9091,SÃO BERNARDO,8366,2804,5065,18986,13921,303,1744
MA,9113,SÃO DOMINGOS DO MARANHÃO,11498,3542,7123,26253,19130,511,1960
MA,9130,SÃO FÉLIX DE BALSAS,2026,240,769,3639,2870,83,401
MA,9156,SÃO FRANCISCO DO MARANHÃO,4466,612,2546,8934,6388,153,784
MA,9172,SÃO JOÃO BATISTA,10200,821,3733,16829,13096,186,1133
MA,9199,SÃO JOÃO DOS PATOS,7931,2222,5563,18275,12712,349,1293
MA,9210,SÃO LUÍS,289588,66543,125299,668201,542902,12886,22239
MA,9237,SÃO MATEUS DO MARANHÃO,12660,2870,9130,28179,19049,248,1794
MA,9253,SÃO RAIMUNDO DAS MANGABEIRAS,6890,1336,3034,12763,9729,136,874
MA,9270,SÃO VICENTE FERRER,8192,669,5611,16528,10917,306,979
MA,9296,SÍTIO NOVO,5361,2224,2951,12381,9430,141,1046
MA,9318,SUCUPIRA DO NORTE,4686,371,1844,7989,6145,114,676
MA,9334,TASSO FRAGOSO,2519,757,1170,5302,4132,58,432
MA,9350,TIMBIRAS,8802,920,6455,18438,11983,176,1482
MA,9377,TIMON,51751,9127,20372,100146,79774,1552,6398
MA,9393,TUNTUM,12133,3427,7488,27468,19980,472,1582
MA,9415,TURIAÇU,11053,2619,6850,23350,16500,339,1398
MA,9431,TUTÓIA,14359,4427,9658,33236,23578,875,2295
MA,9458,URBANO SANTOS,9488,721,2905,15857,12952,340,1485
MA,9474,VARGEM GRANDE,13591,2296,7774,27805,20031,407,2803
MA,9490,VIANA,17362,2982,8715,34288,25573,487,2038
MA,9512,VITÓRIA DO MEARIM,10286,1835,7239,23484,16245,534,1426
MA,9539,VITORINO FREIRE,9932,2544,6084,22370,16286,501,2062
MA,9555,BOM JARDIM,12185,2335,7112,25583,18471,465,2106
MA,9571,SANTA INÊS,23278,7929,12584,54908,42324,855,2987
MA,9598,PAULO RAMOS,7078,1287,3396,14365,10969,392,1422
MA,9610,AÇAILÂNDIA,27223,12703,15166,70192,55026,1218,3550
MA,9636,ESTREITO,8260,3531,4447,19572,15125,316,1096
MA,9652,SANTA LUZIA DO PARUÁ,8001,1488,3559,15195,11636,209,945
MA,9679,ARAME,9310,3113,5251,19730,14479,153,1256
MA,9695,MIRANDA DO NORTE,7283,511,3469,13092,9623,108,639
MA,9717,ZÉ DOCA,15993,2888,9179,31797,22618,363,1993
MG,40002,ALFREDO VASCONCELOS,2298,1082,561,4732,4171,132,225
MG,40010,ABADIA DOS DOURADOS,2377,1394,568,5268,4700,155,282
MG,40029,ARAPORÃ,2203,1672,922,5688,4766,83,222
MG,40037,ABAETÉ,5201,6275,3797,18261,14464,534,532
MG,40045,BRASILÂNDIA DE MINAS,4759,1541,2188,9489,7301,140,348
MG,40053,ABRE CAMPO,4292,2421,2626,11140,8514,311,653
MG,40061,CAPITÃO ANDRADE,1348,1001,673,3679,3006,75,288
MG,40070,ACAIACA,1404,745,851,3440,2589,80,141
MG,40088,CARNEIRINHO,3681,1765,1049,7264,6215,139,276
MG,40096,AÇUCENA,3432,1146,2882,8719,5837,249,504
MG,40100,CATUJI,3117,1090,1345,6338,4993,103,403
MG,40118,ÁGUA BOA,5043,1356,4149,11822,7673,145,744
MG,40126,DIVISA ALEGRE,1679,986,1178,4415,3237,38,299
MG,40134,ÁGUA COMPRIDA,684,632,412,2055,1643,83,86
MG,40142,DIVISÓPOLIS,2376,1272,923,5294,4371,58,326
MG,40150,AGUANIL,1636,549,535,3451,2916,106,141
MG,40169,DURANDÉ,2482,1317,1299,5819,4520,119,241
MG,40177,ÁGUAS FORMOSAS,5430,2520,4400,14350,9950,172,761
MG,40185,ENTRE FOLHAS,2027,890,1191,5062,3871,117,331
MG,40193,ÁGUAS VERMELHAS,3183,1919,3537,9839,6302,185,648
MG,40207,FERVEDOURO,3777,1500,1672,7908,6236,178,349
MG,40215,AIMORÉS,5881,5078,3080,17473,14393,396,876
MG,40223,FRANCISCÓPOLIS,1853,500,1569,4513,2944,57,285
MG,40231,AIURUOCA,1592,1421,1169,5053,3884,128,241
MG,40240,ICARAÍ DE MINAS,3795,844,1313,6470,5157,40,282
MG,40258,ALAGOA,726,812,363,2226,1863,48,78
MG,40266,IPABA,5773,1436,2453,12135,9682,202,337
MG,40274,ALBERTINA,579,946,334,2134,1800,55,72
MG,40282,JAÍBA,11656,2861,4721,21376,16655,278,1018
MG,40290,ALÉM PARAÍBA,11574,4840,5646,28466,22820,523,898
MG,40304,JAMPRUCA,1796,540,794,3733,2939,81,292
MG,40312,ALFENAS,15230,20026,10019,54367,44348,1361,1582
MG,40320,JUATUBA,6145,2258,2321,15071,12750,529,684
MG,40339,ALMENARA,12666,3369,8468,28677,20209,294,1754
MG,40347,LAGOA GRANDE,2843,1651,1246,6297,5051,64,229
MG,40355,ALPERCATA,2348,1238,1224,5872,4648,136,286
MG,40363,LIMEIRA DO OESTE,2760,910,603,4689,4086,45,178
MG,40371,ALPINÓPOLIS,6594,3128,2479,14276,11797,408,566
MG,40380,LONTRA,3674,719,2160,7296,5136,83,379
MG,40398,ALTEROSA,3666,4252,1781,10774,8993,215,365
MG,40401,MAMONAS,2521,1168,715,4954,4239,77,349
MG,40410,ALTO RIO DOCE,3512,2811,2265,9964,7699,307,592
MG,40428,MATA VERDE,2479,1311,1857,6610,4753,52,422
MG,40436,ALVARENGA,1614,1002,640,3706,3066,60,195
MG,40444,MATIAS CARDOSO,2774,1023,1271,5731,4460,56,429
MG,40452,ALVINÓPOLIS,5688,1711,2886,13035,10149,346,1329
MG,40460,MONTEZUMA,2094,916,1525,5251,3726,63,403
MG,40479,ALVORADA DE MINAS,1514,333,1129,3433,2304,71,233
MG,40487,NAQUE,2142,740,1222,4763,3541,97,198
MG,40495,AMPARO DO SERRA,2286,732,743,4292,3549,86,210
MG,40509,NOVO ORIENTE DE MINAS,3203,930,3239,8605,5366,118,740
MG,40517,ANDRADAS,6549,11420,3917,26881,22964,1003,950
MG,40525,PALMÓPOLIS,2333,833,2251,6160,3909,86,493
MG,40533,CACHOEIRA DE PAJEÚ,2410,1374,1574,6309,4735,99,600
MG,40541,PEDRAS DE MARIA DA CRUZ,3864,568,2366,7497,5131,60,418
MG,40550,ANDRELÂNDIA,2888,3038,2159,9618,7459,279,466
MG,40568,PERIQUITO,1938,1651,1601,5887,4286,72,312
MG,40576,ANTÔNIO CARLOS,4277,1748,1528,9017,7489,294,403
MG,40584,PONTO DOS VOLANTES,3439,1374,2173,7939,5766,87,642
MG,40592,ANTÔNIO DIAS,2924,1981,1798,8426,6628,183,384
MG,40606,RIACHINHO,2676,677,1330,5218,3888,48,273
MG,40614,ANTÔNIO PRADO DE MINAS,599,599,174,1617,1443,28,45
MG,40622,ROSÁRIO DA LIMEIRA,2169,1064,828,4788,3960,157,212
MG,40630,ARAÇAÍ,705,759,513,2519,2006,63,90
MG,40649,SANTA BÁRBARA DO LESTE,2722,1599,1410,6823,5413,168,354
MG,40657,ARACITABA,854,367,336,1906,1570,80,139
MG,40665,SANTA RITA DE MINAS,1809,1242,965,5139,4174,142,295
MG,40673,ARAÇUAÍ,10141,5930,9393,27868,18475,310,1138
MG,40681,SANTANA DO PARAÍSO,5352,2764,2817,14403,11586,349,698
MG,40690,ARAGUARI,28665,20970,14408,83303,68895,2030,2673
MG,40703,SÃO JOÃO DA LAGOA,1944,637,982,4189,3207,63,256
MG,40711,ARANTINA,1266,355,560,2644,2084,68,148
MG,40720,SÃO JOÃO DO MANHUAÇU,3259,1774,1236,7140,5904,97,268
MG,40738,ARAPONGA,3309,689,1454,6227,4773,136,471
MG,40746,SÃO JOÃO DO MANTENINHA,1869,1173,864,4536,3672,117,247
MG,40754,ARAPUÁ,625,1143,443,2680,2237,98,106
MG,40762,SÃO JOÃO DO PACUÍ,1799,313,696,3346,2650,49,238
MG,40770,ARAÚJOS,1353,2472,922,5712,4790,202,174
MG,40789,SÃO JOSÉ DA LAPA,5679,2624,2113,15245,13132,426,516
MG,40797,ARAXÁ,23078,21257,10679,68706,58027,1919,2434
MG,40800,SARZEDO,5378,2429,1907,15194,13287,628,599
MG,40819,ARCEBURGO,1754,2806,887,6538,5651,230,332
MG,40827,SEM PEIXE,1235,627,895,3249,2354,111,186
MG,40835,ARCOS,10633,6652,3911,28073,24162,1266,1090
MG,40843,SENADOR AMARAL,2108,1059,615,4364,3749,119,134
MG,40851,AREADO,2292,5232,1895,11048,9153,271,310
MG,40860,UBAPORANGA,3238,2413,2413,9319,6906,197,405
MG,40878,ARGIRITA,1375,507,390,2707,2317,53,92
MG,40886,URUCUIA,3094,964,1747,6345,4598,39,244
MG,40894,ARINOS,5653,2206,3919,13449,9530,113,711
MG,40908,VARGEM ALEGRE,2418,1121,1665,6052,4387,91,353
MG,40916,ASTOLFO DUTRA,5097,2442,1562,10393,8831,190,364
MG,40924,JOSENÓPOLIS,1782,233,1135,3499,2364,5,215
MG,40932,ATALÉIA,5159,1178,4013,11921,7908,93,681
MG,40940,JUVENÍLIA,2157,908,1626,5157,3531,43,258
MG,40959,AUGUSTO DE LIMA,1757,753,1265,4281,3016,83,133
MG,40967,LEME DO PRADO,1633,567,1300,3827,2527,36,125
MG,40975,BAEPENDI,4559,4711,2653,15118,12465,389,600
MG,40983,LUISBURGO,1467,1946,978,4939,3961,96,245
MG,40991,BALDIM,2923,1035,1040,6250,5210,197,225
MG,41009,LUISLÂNDIA,2808,416,1634,5354,3720,59,291
MG,41017,BAMBUÍ,7121,4522,3860,18281,14421,505,614
MG,41025,MÁRIO CAMPOS,3046,1685,1351,8924,7573,326,374
MG,41033,BANDEIRA,1743,556,1193,3993,2800,76,271
MG,41041,MARTINS SOARES,2353,1406,1097,5624,4527,103,275
MG,41050,BANDEIRA DO SUL,1762,1333,768,4722,3954,138,171
MG,41068,MIRAVÂNIA,1784,422,1235,3694,2459,16,167
MG,41076,BARÃO DE COCAIS,8474,3816,3593,21081,17488,777,762
MG,41084,MONTE FORMOSO,1611,494,1207,3713,2506,29,241
MG,41092,BARÃO DE MONTE ALTO,1810,1592,589,4655,4066,90,224
MG,41106,NATALÂNDIA,1557,359,564,2746,2182,26,108
MG,41114,BARBACENA,37705,18172,14497,92791,78294,3306,5154
MG,41122,NINHEIRA,2586,1321,2598,7362,4764,146,617
MG,41130,BARRA LONGA,2263,1310,1178,5447,4269,150,238
MG,41149,NOVA BELÉM,1326,729,840,3432,2592,45,257
MG,41157,TRÊS MARIAS,6821,5122,4413,21183,16770,521,636
MG,41165,NOVA PORTEIRINHA,3116,925,1182,6073,4891,91,308
MG,41173,BARROSO,6805,3500,2651,16107,13456,753,706
MG,41181,NOVORIZONTE,1579,756,842,3913,3071,44,360
MG,41190,BELA VISTA DE MINAS,3450,1194,984,7055,6071,187,328
MG,41203,OLHOS D'ÁGUA,2718,293,1133,4634,3501,42,275
MG,41211,BELMIRO BRAGA,1253,627,429,2796,2367,57,147
MG,41220,ORATÓRIOS,1861,634,877,4036,3159,85,226
MG,41238,BELO HORIZONTE,434157,389416,288958,1828630,1539672,60457,74939
MG,41246,ORIZÂNIA,2686,1117,1293,5767,4474,89,304
MG,41254,BELO ORIENTE,7594,2822,3815,17465,13650,515,670
MG,41262,PADRE CARVALHO,2232,404,1409,4473,3064,36,266
MG,41270,BELO VALE,2754,1729,1360,7264,5904,325,252
MG,41289,PAI PEDRO,2282,499,818,4141,3323,52,332
MG,41297,BERILO,4087,1059,3681,9661,5980,96,532
MG,41300,PATIS,2325,535,826,4003,3177,15,126
MG,41319,BERTÓPOLIS,1485,657,854,3417,2563,35,273
MG,41327,PEDRA BONITA,2138,1507,931,5124,4193,62,291
MG,41335,BETIM,90116,38828,32073,240925,208852,8049,9705
MG,41343,PIEDADE DE CARATINGA,2283,1453,1048,5424,4376,87,270
MG,41351,BIAS FORTES,1675,726,649,3610,2961,75,233
MG,41360,PINGO D'ÁGUA,1789,503,734,3529,2795,36,234
MG,41378,BICAS,3839,2389,2156,11169,9013,258,534
MG,41386,PINTÓPOLIS,2854,620,1972,5988,4016,62,278
MG,41394,BIQUINHAS,883,807,383,2434,2051,70,86
MG,41408,PONTO CHIQUE,1551,546,1077,3570,2493,20,177
MG,41416,BOA ESPERANÇA,10184,9442,6257,29868,23611,697,782
MG,41424,REDUTO,1638,1426,1020,4976,3956,114,257
MG,41432,BOCAINA DE MINAS,1435,1374,791,4282,3491,118,206
MG,41440,SANTA BÁRBARA DO MONTE VERDE,1252,590,600,2953,2353,67,149
MG,41459,BOCAIÚVA,17028,3448,8154,33771,25617,544,1554
MG,41467,SANTA CRUZ DE MINAS,1797,2051,745,6023,5278,281,213
MG,41475,BOM DESPACHO,9519,11629,5854,34938,29084,1228,1130
MG,41483,SANTA CRUZ DE SALINAS,2118,337,1268,4193,2925,52,347
MG,41491,BOM JARDIM DE MINAS,2373,1206,1146,5464,4318,142,290
MG,41505,SANTA HELENA DE MINAS,1777,1058,929,4257,3328,44,300
MG,41513,BOM JESUS DA PENHA,1277,869,513,3055,2542,69,142
MG,41521,SANTO ANTÔNIO DO RETIRO,2607,661,1515,5528,4013,73,472
MG,41530,BOM JESUS DO AMPARO,2043,933,915,4708,3793,128,248
MG,41548,SÃO DOMINGOS DAS DORES,2358,1120,1002,4956,3954,74,183
MG,41556,BOM JESUS DO GALHO,4601,2827,1639,10540,8901,237,772
MG,41564,SÃO FÉLIX DE MINAS,1034,600,770,2979,2209,59,146
MG,41572,BOM REPOUSO,3319,2405,1111,7799,6688,188,264
MG,41580,SÃO GERALDO DO BAIXIO,1105,648,446,2574,2128,43,128
MG,41599,BOM SUCESSO,4060,5418,3030,14619,11589,486,480
MG,41602,SÃO JOÃO DAS MISSÕES,3674,723,2036,7339,5303,79,669
MG,41610,BONFIM,2422,1454,963,6177,5214,431,319
MG,41629,SÃO JOAQUIM DE BICAS,7705,1905,2841,15913,13072,566,654
MG,41637,BONFINÓPOLIS DE MINAS,2039,933,1501,5146,3645,69,199
MG,41645,SÃO JOSÉ DA BARRA,2446,1310,1212,5742,4530,143,175
MG,41653,BORDA DA MATA,3992,4347,2256,12627,10371,370,501
MG,41661,ALTO CAPARAÓ,713,1691,361,3381,3020,77,93
MG,41670,BOTELHOS,4415,3705,2518,12512,9994,286,494
MG,41688,ANGELÂNDIA,2042,1481,2135,6274,4139,84,359
MG,41696,BOTUMIRIM,2347,492,1682,5135,3453,55,258
MG,41700,ARICANDUVA,1725,688,1159,4181,3022,94,327
MG,41718,BRASÍLIA DE MINAS,12722,2417,7182,25365,18183,297,1082
MG,41726,BERIZAL,1415,807,581,3310,2729,31,243
MG,41734,BRÁS PIRES,1669,792,923,3793,2870,78,142
MG,41742,BONITO DE MINAS,3273,510,2154,6468,4314,37,384
MG,41750,BRAÚNAS,1591,709,685,3702,3017,136,348
MG,41769,BUGRE,1394,904,846,3797,2951,109,198
MG,41777,BRAZÓPOLIS,3369,4845,2658,12546,9888,319,461
MG,41785,CABECEIRA GRANDE,2015,1110,1182,5088,3906,81,206
MG,41793,BRUMADINHO,7997,5245,3169,22704,19535,931,1020
MG,41807,CAMPO AZUL,1657,362,857,3304,2447,35,196
MG,41815,BUENO BRANDÃO,2064,3480,1659,8582,6923,351,322
MG,41823,CANTAGALO,1191,744,573,3010,2437,67,191
MG,41831,BUENÓPOLIS,2924,1356,3032,8315,5283,232,365
MG,41840,CATAS ALTAS,1471,1010,643,3998,3355,113,167
MG,41858,BURITIS,5497,4628,4109,16486,12377,266,581
MG,41866,CATUTI,2148,502,1023,4167,3144,50,333
MG,41874,BURITIZEIRO,7789,3296,5071,19476,14405,393,1023
MG,41882,CHAPADA GAÚCHA,3323,954,1739,6693,4954,62,433
MG,41890,CABO VERDE,3569,3086,1851,9773,7922,231,396
MG,41904,CÔNEGO MARINHO,2832,509,1115,4970,3855,61,318
MG,41912,CACHOEIRA DA PRATA,1001,680,381,3179,2798,85,85
MG,41920,CONFINS,1855,1008,445,4735,4290,141,188
MG,41939,CACHOEIRA DE MINAS,2316,3684,1318,8627,7309,246,244
MG,41947,CÓRREGO FUNDO,2083,1122,552,4629,4077,231,183
MG,41955,CACHOEIRA DOURADA,1178,428,672,2585,1913,34,87
MG,41963,CRISÓLITA,1982,614,955,4134,3179,32,371
MG,41971,CAETANÓPOLIS,2700,1663,1276,7363,6087,227,281
MG,41980,CUPARAQUE,1145,1254,798,3779,2981,53,250
MG,41998,CAETÉ,10460,6966,5201,31420,26219,1016,1115
MG,42005,CURRAL DE DENTRO,2065,1412,1527,5687,4160,56,454
MG,42013,CAIANA,1471,984,396,3356,2960,74,216
MG,42021,DELTA,2210,670,851,4412,3561,112,205
MG,42030,CAJURI,1736,719,757,3792,3035,150,221
MG,42048,DOM BOSCO,1287,657,666,3048,2382,52,160
MG,42056,CALDAS,3131,3863,1557,10248,8691,249,431
MG,42064,FREI LAGONEGRO,1495,405,528,2866,2338,60,281
MG,42072,CAMACHO,1166,1033,607,3184,2577,120,107
MG,42080,FRUTA DE LEITE,2296,342,1784,5008,3224,49,455
MG,42099,CAMANDUCAIA,5610,4878,2826,15639,12813,475,646
MG,42102,GAMELEIRAS,1848,758,857,3881,3024,43,280
MG,42110,CAMBUÍ,5590,6177,3475,19686,16211,493,799
MG,42129,GLAUCILÂNDIA,1663,445,461,3052,2591,61,108
MG,42137,CAMBUQUIRA,2026,4336,1866,9769,7903,201,362
MG,42145,GOIABEIRA,925,699,388,2504,2116,64,160
MG,42153,CAMPANÁRIO,1453,506,673,3036,2363,36,191
MG,42161,GOIANÁ,1290,637,605,3374,2769,97,192
MG,42170,CAMPANHA,2306,5215,2111,11563,9452,286,417
MG,42188,GUARACIAMA,3141,458,1059,5177,4118,69,254
MG,42196,CAMPESTRE,3391,7078,2792,15873,13081,614,566
MG,42200,IBIRACATU,2370,805,1736,5447,3711,41,409
MG,42218,CAMPINA VERDE,5648,4831,2441,14439,11998,204,467
MG,42226,IMBÉ DE MINAS,2149,1090,1391,5136,3745,37,301
MG,42234,CAMPO BELO,14116,8815,7288,38700,31412,1178,1602
MG,42242,INDAIABIRA,2040,1182,1676,5621,3945,58,395
MG,42250,CAMPO DO MEIO,3667,2248,2166,9577,7411,270,441
MG,42269,JAPONVAR,3748,658,2299,7369,5070,100,385
MG,42277,CAMPO FLORIDO,1571,1278,615,4015,3400,71,125
MG,42285,JENIPAPO DE MINAS,2029,680,2226,5382,3156,44,286
MG,42293,CAMPOS ALTOS,3168,3317,2359,10150,7791,236,325
MG,42307,JOSÉ GONÇALVES DE MINAS,1299,851,1054,3558,2504,30,227
MG,42315,CAMPOS GERAIS,5974,6569,4398,20180,15782,642,778
MG,42323,JOSÉ RAYDAN,1757,396,1018,3652,2634,37,247
MG,42331,CANAÃ,1943,844,431,3756,3325,90,255
MG,42340,SÃO SEBASTIÃO DA VARGEM ALEGRE,1190,606,401,2599,2198,60,161
MG,42358,CANÁPOLIS,3892,2383,1804,9126,7322,132,388
MG,42366,SÃO SEBASTIÃO DO ANTA,1904,1047,1133,4550,3417,77,214
MG,42374,CANA VERDE,1585,1231,481,4303,3822,121,203
MG,42382,SERRANÓPOLIS DE MINAS,1773,610,764,3572,2808,61,226
MG,42390,CANDEIAS,4074,3329,2136,11771,9635,532,500
MG,42404,SETUBINHA,3017,908,2885,7710,4825,75,598
MG,42412,CAPARAÓ,1059,1660,740,3995,3255,71,159
MG,42420,TAPARUBA,1171,831,805,3147,2342,58,164
MG,42439,CAPELA NOVA,1480,1077,602,3910,3308,279,206
MG,42447,UNIÃO DE MINAS,1699,706,1004,3736,2732,40,154
MG,42455,CAPELINHA,8020,5622,6657,23537,16880,507,1264
MG,42463,URUANA DE MINAS,1513,356,723,2979,2256,39,129
MG,42471,CAPETINGA,1732,1950,1449,5994,4545,152,232
MG,42480,VARGEM GRANDE DO RIO PARDO,1473,852,690,3484,2794,28,270
MG,42498,CAPIM BRANCO,2398,1799,950,6777,5827,255,235
MG,42501,VARJÃO DE MINAS,1615,1640,647,4432,3785,120,145
MG,42510,CAPINÓPOLIS,5193,2859,1391,10723,9332,175,366
MG,42528,VERDELÂNDIA,3136,671,1564,5965,4401,92,356
MG,42536,CAPITÃO ENÉAS,5416,1568,2828,11469,8641,159,665
MG,42544,VEREDINHA,2176,575,1300,4604,3304,70,316
MG,42552,CAPITÓLIO,2666,1718,1309,6729,5420,141,209
MG,42560,VERMELHO NOVO,1535,1378,811,4267,3456,134,249
MG,42579,CAPUTIRA,2765,1916,1591,7376,5785,325,384
MG,42587,TOCOS DO MOJI,1487,1201,345,3368,3023,101,69
MG,42595,CARAÍ,6399,1063,5046,14334,9288,148,1020
MG,42617,CARANAÍBA,1043,937,333,2873,2540,142,176
MG,42633,CARANDAÍ,7006,4741,2341,18255,15914,1216,944
MG,42650,CARANGOLA,8859,6154,5290,24596,19306,442,1003
MG,42676,CARATINGA,17649,16128,13166,59862,46696,1634,2680
MG,42692,CARBONITA,2816,1755,2170,7486,5316,87,400
MG,42714,CAREAÇU,1678,1584,863,4721,3858,64,159
MG,42730,CARLOS CHAGAS,5413,3798,5633,16960,11327,310,833
MG,42757,CARMÉSIA,895,331,510,2110,1600,34,118
MG,42773,CARMO DA CACHOEIRA,3426,2490,1867,9299,7432,219,370
MG,42790,CARMO DA MATA,3480,2534,1205,8812,7607,276,370
MG,42811,CARMO DE MINAS,2428,3315,1568,9222,7654,210,388
MG,42838,CARMO DO CAJURU,5332,4580,2221,15547,13326,680,545
MG,42854,CARMO DO PARANAÍBA,6190,7138,5054,21639,16585,928,975
MG,42870,CARMO DO RIO CLARO,5796,4169,3001,15161,12160,327,472
MG,42897,CARMÓPOLIS DE MINAS,4730,3412,1808,11981,10173,419,424
MG,42919,CARRANCAS,926,1168,420,2989,2569,57,139
MG,42935,CARVALHÓPOLIS,997,982,506,2872,2366,58,118
MG,42951,CARVALHOS,1276,1292,718,3895,3177,145,232
MG,42978,CASA GRANDE,751,656,341,2213,1872,111,103
MG,42994,CASCALHO RICO,950,900,452,2674,2222,40,113
MG,43010,CÁSSIA,4431,4552,2828,13770,10942,337,529
MG,43036,CONCEIÇÃO DA BARRA DE MINAS,1169,1270,351,3205,2854,88,119
MG,43052,CATAGUASES,23538,8084,9090,52520,43430,1308,2297
MG,43079,CATAS ALTAS DA NORUEGA,1592,596,505,3113,2608,81,165
MG,43095,CAXAMBU,4686,5253,4021,17880,13859,415,566
MG,43117,CEDRO DO ABAETÉ,281,506,334,1312,978,39,53
MG,43133,CENTRAL DE MINAS,1698,1824,1077,5573,4496,169,369
MG,43150,CENTRALINA,3201,1451,943,6509,5566,167,350
MG,43176,CHÁCARA,1095,484,292,2388,2096,57,127
MG,43192,CHALÉ,1587,1288,708,4249,3541,135,262
MG,43214,CHAPADA DO NORTE,4464,769,3965,10003,6038,106,518
MG,43230,CHIADOR,1296,671,368,2738,2370,36,108
MG,43257,CIPOTÂNEA,1967,974,1619,5334,3715,285,251
MG,43273,CLARAVAL,1064,1924,643,4117,3474,40,126
MG,43290,CLARO DOS POÇÕES,3309,1117,1793,7216,5423,143,342
MG,43311,CLÁUDIO,6260,6724,2450,18498,16048,779,602
MG,43338,COIMBRA,2357,1719,972,6094,5122,231,373
MG,43354,COLUNA,2920,942,2123,6839,4716,113,495
MG,43370,COMENDADOR GOMES,815,979,443,2418,1975,47,56
MG,43397,COMERCINHO,3197,810,2201,6935,4734,84,406
MG,43419,CONCEIÇÃO DA APARECIDA,2801,2335,1657,7819,6162,216,205
MG,43435,CONCEIÇÃO DAS PEDRAS,868,836,410,2448,2038,72,88
MG,43451,CONCEIÇÃO DAS ALAGOAS,7166,3847,3568,16484,12916,300,628
MG,43478,CONCEIÇÃO DE IPANEMA,1668,839,579,3574,2995,58,222
MG,43494,CONCEIÇÃO DO MATO DENTRO,5301,1392,4521,14385,9864,350,784
MG,43516,CONCEIÇÃO DO PARÁ,1631,1231,673,4368,3695,167,146
MG,43532,CONCEIÇÃO DO RIO VERDE,2342,3785,2071,9722,7651,274,386
MG,43559,CONCEIÇÃO DOS OUROS,2236,3044,1268,7972,6704,229,261
MG,43575,CONGONHAL,1766,3322,931,7129,6198,221,205
MG,43591,CONGONHAS,11098,8087,4296,36260,31964,1607,1761
MG,43613,CONGONHAS DO NORTE,1715,353,1221,3824,2603,54,318
MG,43630,CONQUISTA,1507,1961,473,4612,4139,141,168
MG,43656,CONSELHEIRO LAFAIETE,34490,16889,10517,85422,74905,3551,3998
MG,43672,CONSELHEIRO PENA,5093,4506,3898,16400,12502,390,728
MG,43699,CONSOLAÇÃO,470,597,262,1592,1330,47,67
MG,43710,CONTAGEM,144759,64732,58005,418491,360486,14464,18113
MG,43737,COQUEIRAL,1855,2991,1680,7457,5777,187,235
MG,43753,CORAÇÃO DE JESUS,10909,1806,5676,20986,15310,325,1080
MG,43770,CORDISBURGO,2834,1372,1626,6868,5242,177,182
MG,43796,CORDISLÂNDIA,1069,949,730,3077,2347,45,107
MG,43818,CORINTO,8994,2666,5241,19484,14243,288,589
MG,43834,COROACI,3222,2128,2287,8804,6517,199,486
MG,43850,COROMANDEL,7912,6201,4406,22131,17725,584,919
MG,43877,CORONEL FABRICIANO,26204,13816,14551,76678,62127,2097,2922
MG,43893,CORONEL MURTA,3195,1210,1552,6652,5100,87,258
MG,43915,CORONEL PACHECO,1093,385,181,2243,2062,66,140
MG,43931,CORONEL XAVIER CHAVES,975,683,410,2681,2271,71,82
MG,43958,CÓRREGO DANTA,1017,961,643,2955,2312,52,126
MG,43974,CÓRREGO DO BOM JESUS,1011,1011,431,3213,2782,77,149
MG,43990,CÓRREGO NOVO,1515,570,909,3349,2440,54,151
MG,44016,COUTO DE MAGALHÃES DE MINAS,1594,395,1029,3649,2620,70,207
MG,44032,CRISTAIS,3488,1585,1399,7994,6595,366,422
MG,44059,CRISTÁLIA,2082,545,1203,4349,3146,59,286
MG,44075,CRISTIANO OTONI,1432,1099,519,4059,3540,235,211
MG,44091,CRISTINA,1763,3283,1773,7983,6210,199,317
MG,44113,CRUCILÂNDIA,1552,1274,715,4398,3683,212,237
MG,44130,CRUZEIRO DA FORTALEZA,1367,1028,687,3525,2838,73,101
MG,44156,CRUZÍLIA,3816,4076,2168,11609,9441,258,439
MG,44172,CURVELO,20034,13244,6179,50449,44270,1473,1747
MG,44199,DATAS,2169,427,1268,4488,3220,107,261
MG,44210,DELFIM MOREIRA,1570,2789,1230,6477,5247,187,184
MG,44237,DELFINÓPOLIS,2095,1710,1206,5633,4427,116,184
MG,44253,DESCOBERTO,1293,1524,629,4220,3591,147,179
MG,44270,DESTERRO DE ENTRE RIOS,1536,1946,692,5323,4631,421,265
MG,44296,DESTERRO DO MELO,1067,1046,290,2810,2520,74,144
MG,44318,DIAMANTINA,13412,5444,8553,34401,25848,706,1575
MG,44334,DIOGO DE VASCONCELOS,1820,358,532,3232,2700,48,222
MG,44350,DIONÍSIO,2906,1023,2235,7460,5225,221,392
MG,44377,DIVINÉSIA,1578,811,298,3180,2882,62,136
MG,44393,DIVINO,6157,3060,3364,14321,10957,248,791
MG,44415,DIVINO DAS LARANJEIRAS,1136,1063,832,3920,3088,102,335
MG,44431,DIVINOLÂNDIA DE MINAS,2167,1127,1528,5622,4094,95,342
MG,44458,DIVINÓPOLIS,61161,32154,19824,154376,134552,6265,6417
MG,44474,DIVISA NOVA,1507,1625,849,4565,3716,78,186
MG,44490,DOM CAVATI,1715,1575,801,4535,3734,57,203
MG,44512,DOM JOAQUIM,1519,516,922,3567,2645,76,258
MG,44539,DOM SILVÉRIO,1454,1177,567,4150,3583,132,299
MG,44555,DOM VIÇOSO,858,885,355,2521,2166,74,55
MG,44571,DONA EUSÉBIA,2583,841,470,4678,4208,98,181
MG,44598,DORES DE CAMPOS,1976,2298,748,7070,6322,568,418
MG,44610,DORES DE GUANHÃES,2283,526,1104,4647,3543,74,243
MG,44636,DORES DO INDAIÁ,3109,3997,2469,11184,8715,251,390
MG,44652,DORES DO TURVO,1829,1102,912,4396,3484,93,211
MG,44679,DORESÓPOLIS,557,435,333,1511,1178,47,47
MG,44695,DOURADOQUARA,819,462,193,1719,1526,40,70
MG,44717,ELÓI MENDES,4570,8000,2721,18138,15417,417,665
MG,44733,ENGENHEIRO CALDAS,2584,2057,1552,7168,5616,192,314
MG,44750,ENGENHEIRO NAVARRO,2797,745,1095,5562,4467,103,361
MG,44776,ENTRE RIOS DE MINAS,4232,2778,1209,10573,9364,547,484
MG,44792,ERVÁLIA,6584,3344,2313,14664,12351,604,906
MG,44814,ESMERALDAS,15184,6281,6175,35715,29540,1252,1344
MG,44830,ESPERA FELIZ,5532,4394,2056,14337,12281,388,815
MG,44857,ESPINOSA,9796,4124,8839,25238,16399,331,1285
MG,44873,ESPÍRITO SANTO DO DOURADO,1438,1364,385,3800,3415,159,183
MG,44890,ESTIVA,2581,3162,1260,8353,7093,327,286
MG,44911,ESTRELA DALVA,1099,417,443,2348,1905,39,132
MG,44938,ESTRELA DO INDAIÁ,750,1191,663,2958,2295,83,101
MG,44954,ESTRELA DO SUL,2517,1146,1050,5524,4474,126,260
MG,44970,EUGENÓPOLIS,3505,1954,1380,8115,6735,192,321
MG,44997,EWBANK DA CÂMARA,1648,492,588,3473,2885,78,181
MG,45012,EXTREMA,7159,6461,3535,20988,17453,597,740
MG,45039,FAMA,847,807,459,2522,2063,72,84
MG,45055,FARIA LEMOS,1302,708,579,3157,2578,36,159
MG,45071,FELÍCIO DOS SANTOS,1645,660,1666,4525,2859,56,245
MG,45098,SÃO GONÇALO DO RIO PRETO,1207,488,728,2851,2123,58,162
MG,45110,FELISBURGO,1731,1143,1740,5137,3397,46,309
MG,45136,FELIXLÂNDIA,4301,2746,2467,11107,8640,291,361
MG,45152,FERNANDES TOURINHO,1032,725,427,2499,2072,35,139
MG,45179,FERROS,3556,1519,1590,8088,6498,176,709
MG,45195,FLORESTAL,2132,954,867,5432,4565,166,191
MG,45217,FORMIGA,15229,15615,8364,52130,43766,1891,1990
MG,45233,FORMOSO,2500,1061,1007,5012,4005,43,237
MG,45250,FORTALEZA DE MINAS,988,1076,587,3290,2703,179,190
MG,45276,FORTUNA DE MINAS,918,545,436,2443,2007,56,99
MG,45292,FRANCISCO BADARÓ,2760,1134,2983,7398,4415,91,281
MG,45314,FRANCISCO DUMONT,1682,618,1195,4248,3053,70,227
MG,45330,FRANCISCO SÁ,10044,1524,3258,17575,14317,289,1256
MG,45357,FREI GASPAR,2177,500,1103,4517,3414,49,440
MG,45373,FREI INOCÊNCIO,2906,1254,1682,6805,5123,117,373
MG,45390,FRONTEIRA,4231,2304,2601,10597,7996,168,448
MG,45411,FRUTAL,12642,12156,7657,38141,30484,930,1287
MG,45438,FUNILÂNDIA,1413,839,666,3661,2995,78,148
MG,45454,GALILÉIA,1800,1314,1410,5412,4002,79,278
MG,45470,GONÇALVES,717,1530,704,3522,2818,86,151
MG,45497,GONZAGA,1065,1546,792,3987,3195,66,316
MG,45519,GOUVEIA,4533,1023,2513,9452,6939,244,515
MG,45535,GOVERNADOR VALADARES,48978,55006,43989,193945,149956,5116,6431
MG,45551,GRÃO MOGOL,4861,1320,3120,10645,7525,148,661
MG,45578,GRUPIARA,518,446,256,1468,1212,34,38
MG,45594,GUANHÃES,7087,5331,5720,22670,16950,564,1345
MG,45616,GUAPÉ,3015,3850,2039,10091,8052,306,352
MG,45632,GUARACIABA,3507,1961,1749,8103,6354,157,422
MG,45659,GUARANÉSIA,6748,2688,2588,14294,11706,401,677
MG,45675,GUARANI,2340,1863,1126,6844,5718,182,336
MG,45691,GUARARÁ,1089,752,613,3391,2778,89,173
MG,45713,GUARDA-MOR,1842,1467,1270,5212,3942,94,177
MG,45730,GUAXUPÉ,12478,10217,6680,36852,30172,1196,1642
MG,45756,GUIDOVAL,2875,1468,1074,6439,5365,157,283
MG,45772,GUIMARÂNIA,2391,1556,1172,6097,4925,186,207
MG,45799,GUIRICEMA,3036,1604,635,6460,5825,247,428
MG,45810,GURINHATÃ,1960,1869,1574,5891,4317,58,152
MG,45837,HELIODORA,1605,1827,689,4802,4113,138,282
MG,45853,IAPU,2727,2016,1750,7880,6130,160,365
MG,45870,IBERTIOGA,2328,958,686,4488,3802,102,216
MG,45896,IBIÁ,5617,5109,3929,17396,13467,471,700
MG,45918,IBIAÍ,3139,625,1602,6029,4427,64,267
MG,45934,IBIRACI,2109,3823,1321,8263,6942,156,410
MG,45950,IBIRITÉ,38217,13251,12901,95284,82383,3760,4021
MG,45977,IBITIÚRA DE MINAS,1091,1053,424,3095,2671,116,107
MG,45993,IBITURUNA,792,942,405,2369,1964,29,51
MG,46019,IGARAPÉ,10241,3444,3956,23262,19306,823,868
MG,46035,IGARATINGA,3584,825,886,6291,5405,336,215
MG,46051,IGUATAMA,2181,2071,781,6336,5555,175,254
MG,46078,IJACI,1626,1709,387,4468,4081,203,137
MG,46094,ILICÍNEA,3632,2512,1504,8615,7111,215,290
MG,46116,INCONFIDENTES,1962,2224,806,5796,4990,164,148
MG,46132,INDIANÓPOLIS,2227,989,906,4717,3811,111,173
MG,46159,INGAÍ,786,988,386,2500,2114,64,96
MG,46175,INHAPIM,7991,4445,4288,19326,15038,410,804
MG,46191,INHAÚMA,2005,970,918,4905,3987,116,194
MG,46213,INIMUTABA,2255,1119,1129,5333,4204,167,161
MG,46230,IPANEMA,4216,4714,2533,13515,10982,268,625
MG,46256,IPATINGA,52451,40045,31219,174441,143222,5106,6102
MG,46272,IPIAÇU,1551,984,890,3763,2873,56,106
MG,46299,IPUIÚNA,2736,2489,1097,7320,6223,143,223
MG,46310,IRAÍ DE MINAS,2603,1294,846,5416,4570,116,254
MG,46337,ITABIRA,28091,15088,12729,84918,72189,2434,3570
MG,46353,ITABIRINHA,2603,1832,1784,7863,6079,183,533
MG,46370,ITABIRITO,11143,9280,4635,35121,30486,1485,1521
MG,46396,ITACAMBIRA,2314,375,1161,4315,3154,42,197
MG,46418,ITACARAMBI,6162,1489,3884,13031,9147,147,882
MG,46434,ITAGUARA,3388,2736,1686,10033,8347,579,499
MG,46450,ITAIPÉ,2895,1434,2658,8032,5374,149,461
MG,46477,ITAJUBÁ,14274,24068,12039,68471,56432,1894,2223
MG,46493,ITAMARANDIBA,8207,5244,5916,22504,16588,654,1140
MG,46515,ITAMARATI DE MINAS,1755,595,338,3339,3001,82,156
MG,46531,ITAMBACURI,7477,2473,5940,18290,12350,270,1239
MG,46558,ITAMBÉ DO MATO DENTRO,917,369,493,2201,1708,58,166
MG,46574,ITAMOGI,3126,2722,1834,8982,7148,241,429
MG,46590,ITAMONTE,2561,3977,1699,10473,8774,380,471
MG,46612,ITANHANDU,2920,4245,1832,11303,9471,267,313
MG,46639,ITANHOMI,3451,2473,1594,8857,7263,148,532
MG,46655,ITAOBIM,4575,4826,5111,16454,11343,295,949
MG,46671,ITAPAGIPE,3283,3277,2131,9749,7618,192,226
MG,46698,ITAPECERICA,5174,5759,2544,16759,14215,642,732
MG,46710,ITAPEVA,2403,1887,1377,6843,5466,200,299
MG,46736,ITATIAIUÇU,3176,1528,1309,7687,6378,332,327
MG,46752,ITAÚNA,14932,22544,7892,63226,55334,2497,2729
MG,46779,ITAVERAVA,2414,1232,1010,5434,4424,250,288
MG,46795,ITINGA,4446,1916,3584,10841,7257,115,546
MG,46817,ITUETA,1838,1638,974,5108,4134,91,146
MG,46833,ITUIUTABA,31920,16251,15161,73708,58547,1302,2245
MG,46850,ITUMIRIM,1856,1779,904,5502,4598,212,194
MG,46876,ITURAMA,13375,5157,5362,26701,21339,352,877
MG,46892,ITUTINGA,1123,1157,675,3482,2807,79,102
MG,46914,JABOTICATUBAS,5237,2175,1575,11749,10174,253,480
MG,46930,JACINTO,3174,2095,1982,8400,6418,106,537
MG,46957,JACUÍ,915,3062,1181,6046,4865,257,266
MG,46973,JACUTINGA,3657,6437,2211,15633,13422,387,501
MG,46990,JAGUARAÇU,1080,463,388,2565,2177,75,115
MG,47015,JANAÚBA,20790,8774,10548,47149,36601,858,2243
MG,47031,JANUÁRIA,23225,4482,14280,47247,32967,556,2108
MG,47058,JAPARAÍBA,1006,951,325,2965,2640,92,83
MG,47074,JECEABA,1750,1374,879,4991,4112,233,158
MG,47090,JEQUERI,4100,1658,1822,9408,7586,395,683
MG,47112,JEQUITAÍ,3143,600,2231,6774,4543,113,378
MG,47139,JEQUITIBÁ,1642,1363,1037,5021,3984,149,187
MG,47155,JEQUITINHONHA,6935,2834,5981,17700,11719,160,1119
MG,47171,JESUÂNIA,1336,1460,752,4186,3434,100,196
MG,47198,JOAÍMA,4595,1787,3687,11333,7646,149,777
MG,47210,JOANÉSIA,1925,761,1136,4683,3547,195,328
MG,47236,JOÃO MONLEVADE,17606,14858,10481,56744,46263,1823,2103
MG,47252,JOÃO PINHEIRO,13793,7672,8050,34809,26759,801,959
MG,47279,JOAQUIM FELÍCIO,1221,734,1109,3550,2441,112,141
MG,47295,JORDÂNIA,3114,1411,2477,7891,5414,75,367
MG,47317,NOVA UNIÃO,2277,827,1053,5107,4054,123,200
MG,47333,JUIZ DE FORA,139654,53787,61367,378042,316675,12056,19259
MG,47350,JURAMENTO,2044,570,643,3869,3226,99,172
MG,47376,JURUAIA,2461,2130,1099,6741,5642,200,256
MG,47392,LADAINHA,4983,1367,3949,11747,7798,110,1004
MG,47414,LAGAMAR,2605,1762,1104,6275,5171,135,182
MG,47430,LAGOA DA PRATA,8701,11386,5099,31590,26491,1170,997
MG,47457,LAGOA DOS PATOS,1779,562,1038,3874,2836,48,240
MG,47473,LAGOA DOURADA,3062,3068,1283,9126,7843,627,384
MG,47490,LAGOA FORMOSA,4418,4391,1527,12162,10635,645,372
MG,47511,LAGOA SANTA,9474,8129,5495,35601,30106,1342,1294
MG,47538,LAJINHA,4404,4624,3057,14415,11358,365,969
MG,47554,LAMBARI,4027,5593,2984,15571,12587,487,647
MG,47570,LAMIM,1452,578,452,3031,2579,113,195
MG,47597,LARANJAL,2318,1419,681,5360,4679,155,227
MG,47619,LASSANCE,2062,536,1324,5093,3769,82,273
MG,47635,LAVRAS,19305,20642,10448,66200,55752,2323,2932
MG,47651,LEANDRO FERREIRA,988,922,442,2835,2393,108,99
MG,47678,LEOPOLDINA,16454,7682,7169,39079,31910,995,1335
MG,47694,LIBERDADE,1530,1250,819,4275,3456,89,239
MG,47716,LIMA DUARTE,5330,2627,2747,13248,10501,402,635
MG,47732,LUMINÁRIAS,1474,1331,618,4096,3478,146,153
MG,47759,LUZ,4170,4923,2943,14002,11059,416,473
MG,47775,MACHACALIS,2533,699,1048,5023,3975,69,334
MG,47791,MACHADO,5501,13527,4724,27935,23211,719,999
MG,47813,MADRE DE DEUS DE MINAS,1842,1036,852,4280,3428,96,199
MG,47830,MALACACHETA,5441,2251,5811,15646,9835,272,982
MG,47856,MANGA,7655,1601,4560,15375,10815,144,796
MG,47872,MANHUAÇU,15163,16540,9914,53044,43130,1466,2067
MG,47899,MANHUMIRIM,3883,5853,3503,16086,12583,399,697
MG,47910,MANTENA,6202,4736,3376,17963,14587,401,1020
MG,47937,MARAVILHAS,2177,1790,902,5701,4799,162,136
MG,47953,MAR DE ESPANHA,3090,2320,1629,9062,7433,201,452
MG,47970,MARIA DA FÉ,3316,4902,1823,11828,10005,287,319
MG,47996,MARIANA,15178,8037,6958,41320,34362,1660,2252
MG,48011,MARILAC,1503,706,827,3557,2730,90,232
MG,48038,MARIPÁ DE MINAS,1137,525,504,2775,2271,62,146
MG,48054,MARLIÉRIA,1215,681,546,3557,3011,101,158
MG,48070,MARMELÓPOLIS,1216,578,712,2961,2249,76,103
MG,48097,MARTINHO CAMPOS,3397,2693,2214,10093,7879,385,392
MG,48119,MATERLÂNDIA,1842,538,1399,4227,2828,63,268
MG,48135,MATEUS LEME,7288,3759,3091,19407,16316,916,836
MG,48151,MATIAS BARBOSA,4544,1953,1525,10591,9066,341,527
MG,48178,MATIPÓ,5210,3454,2961,13537,10576,428,768
MG,48194,MATO VERDE,5103,1689,2398,10396,7998,217,613
MG,48216,MATOZINHOS,10250,5125,4081,26819,22738,1249,1119
MG,48232,MATUTINA,885,1180,654,3278,2624,94,226
MG,48259,MEDEIROS,898,994,548,2811,2263,87,94
MG,48275,MEDINA,6953,2686,3447,15029,11582,333,970
MG,48291,MENDES PIMENTEL,1528,1074,1009,4755,3746,153,380
MG,48313,MERCÊS,3325,1573,1147,7375,6228,256,420
MG,48330,MESQUITA,1770,1145,1472,5254,3782,190,255
MG,48356,MINAS NOVAS,8307,2377,9190,22089,12899,329,1179
MG,48372,MINDURI,1117,898,522,3098,2576,60,113
MG,48399,MIRABELA,5827,940,2783,10520,7737,82,379
MG,48410,MIRADOURO,3540,2065,1681,8706,7025,263,491
MG,48437,MIRAÍ,3065,2975,1987,10083,8096,315,573
MG,48453,MOEDA,1643,904,807,4471,3664,158,145
MG,48470,MOEMA,2057,1945,1254,6049,4795,105,213
MG,48496,MONJOLOS,694,543,627,2110,1483,31,92
MG,48518,MONSENHOR PAULO,2011,2014,956,5924,4968,157,289
MG,48534,MONTALVÂNIA,5117,2243,4290,13054,8764,145,755
MG,48550,MONTE ALEGRE DE MINAS,6105,3262,3222,14575,11353,384,509
MG,48577,MONTE AZUL,8951,2635,3024,16525,13501,241,1112
MG,48593,MONTE BELO,3518,3500,1975,10408,8433,473,441
MG,48615,MONTE CARMELO,16677,6455,6646,35487,28841,933,1449
MG,48631,MONTE SANTO DE MINAS,3778,7093,3448,16731,13283,528,730
MG,48658,MONTES CLAROS,96941,35665,38275,238224,199949,6183,10704
MG,48674,MONTE SIÃO,3404,7213,3070,15980,12910,452,602
MG,48690,MORADA NOVA DE MINAS,2625,1945,1370,6656,5286,105,184
MG,48712,MORRO DA GARÇA,1035,604,620,2586,1966,57,76
MG,48739,MORRO DO PILAR,1398,519,566,2972,2406,71,212
MG,48755,MUNHOZ,1834,1818,1082,5367,4285,182,213
MG,48771,MURIAÉ,28515,15710,12949,73532,60583,1927,3418
MG,48798,MUTUM,7288,5657,3209,19481,16272,491,1125
MG,48810,MUZAMBINHO,5504,5453,2998,16678,13680,526,516
MG,48836,NACIP RAYDAN,1208,341,669,2510,1841,33,165
MG,48852,NANUQUE,10075,7515,9354,31726,22372,581,1481
MG,48879,NATÉRCIA,820,2089,663,4048,3385,141,111
MG,48895,NAZARENO,2457,1587,1230,6101,4871,178,181
MG,48917,NEPOMUCENO,5901,6758,3793,19770,15977,599,902
MG,48933,NOVA ERA,5423,2707,3219,14792,11573,360,595
MG,48950,NOVA LIMA,15144,11397,7066,56279,49213,1969,2182
MG,48976,NOVA MÓDICA,1140,760,740,3191,2451,42,323
MG,48992,NOVA PONTE,4354,1965,1504,9228,7724,174,275
MG,49018,NOVA RESENDE,3725,4050,1718,11214,9496,398,539
MG,49034,NOVA SERRANA,11529,12619,6694,40905,34211,1979,1416
MG,49050,NOVO CRUZEIRO,9193,2241,8879,22875,13996,273,1347
MG,49077,OLARIA,943,462,313,2034,1721,56,100
MG,49093,OLÍMPIO NORONHA,652,868,305,2175,1870,32,83
MG,49115,OLIVEIRA,8868,9196,4848,30589,25741,1111,1146
MG,49131,OLIVEIRA FORTES,989,297,247,1906,1659,66,131
MG,49158,ONÇA DE PITANGUI,945,890,319,2617,2298,55,97
MG,49174,OURO BRANCO,8581,6072,3961,26362,22401,772,852
MG,49190,OURO FINO,5522,10404,4236,24047,19811,644,750
MG,49212,OURO PRETO,19894,10393,8441,55275,46834,1954,2532
MG,49239,OURO VERDE DE MINAS,2516,1023,1629,5950,4321,63,411
MG,49255,PADRE PARAÍSO,5690,1972,5119,14618,9499,212,878
MG,49271,PAINEIRAS,1678,1001,912,4205,3293,123,143
MG,49298,PAINS,2054,2580,985,6561,5576,113,241
MG,49310,PAIVA,632,274,258,1544,1286,56,103
MG,49336,PALMA,2141,1246,733,4814,4081,84,255
MG,49352,FRONTEIRA DOS VALES,1801,677,939,3879,2940,32,260
MG,49379,PAPAGAIOS,5109,2584,1580,10501,8921,236,282
MG,49395,PARACATU,18846,16643,10321,58243,47922,1952,1788
MG,49417,PARÁ DE MINAS,18310,17481,3600,54086,50486,2498,2806
MG,49433,PARAGUAÇU,4466,6508,2760,16022,13262,390,510
MG,49450,PARAISÓPOLIS,3514,6240,2588,15395,12807,388,493
MG,49476,PARAOPEBA,7016,3451,2842,17423,14581,554,575
MG,49492,PASSABÉM,690,358,344,1743,1399,40,106
MG,49514,PASSA QUATRO,3069,4406,2120,12519,10399,419,474
MG,49530,PASSA TEMPO,2766,1481,1505,7077,5572,316,341
MG,49557,PASSA VINTE,657,498,283,1918,1635,32,84
MG,49573,PASSOS,32457,17517,12370,75581,63211,1809,2612
MG,49590,PATOS DE MINAS,31545,32413,18008,101306,83298,3207,3112
MG,49611,PATROCÍNIO,21889,15523,10245,58913,48668,2043,2210
MG,49638,PATROCÍNIO DO MURIAÉ,1802,1393,743,4628,3885,123,203
MG,49654,PAULA CÂNDIDO,3377,1273,1532,7296,5764,184,416
MG,49670,PAULISTAS,1700,709,1169,4207,3038,59,284
MG,49697,PAVÃO,2563,1317,1119,5730,4611,51,483
MG,49719,PEÇANHA,4797,2150,4500,13175,8675,199,789
MG,49735,PEDRA AZUL,6588,3699,6383,19069,12686,247,1339
MG,49751,PEDRA DO ANTA,1535,678,543,3286,2743,97,259
MG,49778,PEDRA DO INDAIÁ,1319,1178,482,3467,2985,108,135
MG,49794,PEDRA DOURADA,791,536,302,1935,1633,28,81
MG,49816,PEDRALVA,1934,4282,1693,9206,7513,255,335
MG,49832,PEDRINÓPOLIS,1065,917,463,2900,2437,85,99
MG,49859,PEDRO LEOPOLDO,14254,9157,5608,43313,37705,1691,1639
MG,49875,PEDRO TEIXEIRA,1055,263,199,1763,1564,26,73
MG,49891,PEQUERI,923,742,522,2753,2231,57,114
MG,49913,PEQUI,1307,1016,500,3390,2890,65,122
MG,49930,PERDIGÃO,1751,2158,912,6045,5133,236,242
MG,49956,PERDIZES,2832,3986,2361,10516,8155,214,332
MG,49972,PERDÕES,5499,4382,2580,15713,13133,556,718
MG,49999,PESCADOR,1070,801,664,3021,2357,55,201
MG,50016,PIAU,1192,683,453,2878,2425,82,169
MG,50032,PIEDADE DE PONTE NOVA,1658,688,645,3512,2867,55,157
MG,50059,PIEDADE DO RIO GRANDE,1304,1003,993,3996,3003,131,264
MG,50075,PIEDADE DOS GERAIS,1591,926,660,3997,3337,238,213
MG,50091,PIMENTA,2258,1708,1124,6315,5191,347,258
MG,50113,PIRACEMA,2482,1103,789,5525,4736,277,376
MG,50130,PIRAJUBA,1285,986,763,3345,2582,66,112
MG,50156,PIRANGA,4794,2636,4010,13769,9759,560,977
MG,50172,PIRANGUÇU,1049,1933,777,4352,3575,94,141
MG,50199,PIRANGUINHO,2272,2172,1047,6509,5462,134,263
MG,50210,PIRAPETINGA,4251,1901,948,8510,7562,244,361
MG,50237,PIRAPORA,12408,8163,8768,38192,29424,951,1598
MG,50253,PIRAÚBA,3649,2427,1584,9009,7425,217,360
MG,50270,PITANGUI,5423,6722,2995,19278,16283,560,557
MG,50296,PIUMHI,7767,7024,4791,24330,19539,865,941
MG,50318,PLANURA,3030,2011,1991,8200,6209,125,300
MG,50334,POÇO FUNDO,4393,4479,1950,12304,10354,449,324
MG,50350,POÇOS DE CALDAS,28887,34975,18975,107733,88758,2624,4021
MG,50377,POCRANE,2814,2032,1610,7353,5743,144,354
MG,50393,POMPÉU,9422,4352,4002,21071,17069,788,995
MG,50415,PONTE NOVA,18129,8086,4746,40120,35374,1139,1414
MG,50431,PORTEIRINHA,14933,3879,7615,29924,22309,504,1590
MG,50458,PORTO FIRME,3297,1363,1744,7503,5759,253,418
MG,50474,POTÉ,4447,2355,3460,11850,8390,157,839
MG,50490,POUSO ALEGRE,23651,31093,14133,90632,76499,2803,3343
MG,50512,POUSO ALTO,1303,2007,910,5206,4296,158,203
MG,50539,PRADOS,2183,2225,823,6498,5675,348,343
MG,50555,PRATA,8944,4639,2898,18547,15649,367,602
MG,50571,PRATÁPOLIS,2306,2367,1320,7194,5874,224,260
MG,50598,PRATINHA,784,1030,478,2685,2207,107,116
MG,50610,PRESIDENTE BERNARDES,2178,1212,888,4829,3941,72,258
MG,50636,PRESIDENTE JUSCELINO,1837,594,1082,3951,2869,65,199
MG,50652,PRESIDENTE KUBITSCHEK,1381,254,404,2392,1988,34,199
MG,50679,PRESIDENTE OLEGÁRIO,6728,3158,3457,15549,12092,372,659
MG,50695,ALTO JEQUITIBÁ,1593,2905,1292,6779,5487,118,270
MG,50717,PRUDENTE DE MORAIS,2629,1714,1066,7295,6229,359,394
MG,50733,QUARTEL GERAL,1007,992,513,2904,2391,78,143
MG,50750,QUELUZITO,982,323,291,2017,1726,47,132
MG,50776,RAPOSOS,4659,1331,850,11039,10189,462,490
MG,50792,RAUL SOARES,6830,3796,3206,16739,13533,496,921
MG,50814,RECREIO,3158,1961,1330,7535,6205,186,272
MG,50830,RESENDE COSTA,3104,2566,1391,8474,7083,264,275
MG,50857,RESPLENDOR,3000,4528,2585,12551,9966,250,347
MG,50873,RESSAQUINHA,1825,924,274,3669,3395,102,105
MG,50890,RIACHO DOS MACHADOS,3789,675,1920,7272,5352,95,439
MG,50911,RIBEIRÃO DAS NEVES,62363,23351,25691,167409,141718,7080,6948
MG,50938,RIBEIRÃO VERMELHO,941,910,400,3093,2693,90,127
MG,50954,RIO ACIMA,1854,1407,572,6466,5894,199,243
MG,50970,RIO CASCA,4295,2566,2772,11688,8916,405,630
MG,50997,RIO DOCE,810,631,285,2055,1770,39,122
MG,51012,RIO DO PRADO,1963,561,686,3724,3038,58,316
MG,51039,RIO ESPERA,1434,1689,876,4713,3837,195,248
MG,51055,RIO MANSO,1833,678,546,3959,3413,94,192
MG,51071,RIO NOVO,2424,1728,954,6727,5773,191,412
MG,51098,RIO PARANAÍBA,3716,1831,1887,8744,6857,343,395
MG,51110,RIO PARDO DE MINAS,8498,3088,4832,19403,14571,356,1256
MG,51136,RIO PIRACICABA,4514,2608,2524,12033,9509,408,530
MG,51152,RIO POMBA,4433,3428,2587,13521,10934,585,621
MG,51179,RIO PRETO,2164,920,883,4837,3954,66,203
MG,51195,RIO VERMELHO,4158,1433,4263,11318,7055,190,845
MG,51217,RITÁPOLIS,1352,1519,671,4232,3561,130,164
MG,51233,ROCHEDO DE MINAS,707,552,321,1982,1661,40,100
MG,51250,RODEIRO,2413,1073,607,5010,4403,188,266
MG,51276,ROMARIA,1654,639,546,3188,2642,47,150
MG,51292,RUBELITA,2886,982,2551,7361,4810,91,597
MG,51314,RUBIM,2102,1857,1379,6304,4925,121,531
MG,51330,SABARÁ,22600,12853,11611,82441,70830,3980,3727
MG,51357,SABINÓPOLIS,5081,1558,3657,12134,8477,318,823
MG,51373,SACRAMENTO,5554,6785,3527,18152,14625,312,521
MG,51390,SALINAS,11467,5423,7400,29312,21912,459,1789
MG,51411,SALTO DA DIVISA,1783,1074,1067,4595,3528,35,393
MG,51438,SANTA BÁRBARA,9166,3380,3858,21325,17467,530,692
MG,51454,SANTA BÁRBARA DO TUGÚRIO,1884,938,440,3825,3385,79,243
MG,51470,SANTA CRUZ DO ESCALVADO,2309,636,915,4396,3481,83,222
MG,51497,SANTA EFIGÊNIA DE MINAS,1110,917,1235,3929,2694,127,322
MG,51519,SANTA FÉ DE MINAS,1746,304,1117,3444,2327,28,115
MG,51535,SANTA JULIANA,3461,2075,771,7109,6338,160,195
MG,51551,SANTA LUZIA,45479,22788,19936,140952,121016,5626,5514
MG,51578,SANTA MARGARIDA,4277,3664,2059,11427,9368,216,616
MG,51594,SANTA MARIA DE ITABIRA,3036,1673,1781,8108,6327,241,455
MG,51616,SANTA MARIA DO SALTO,1735,785,1409,4477,3068,77,261
MG,51632,SANTA MARIA DO SUAÇUÍ,4889,1486,4296,12016,7720,146,668
MG,51659,SANTANA DA VARGEM,2511,1600,609,5483,4874,139,186
MG,51675,SANTANA DE CATAGUASES,1211,927,287,2955,2668,50,160
MG,51691,SANTANA DE PIRAPAMA,3088,1256,1818,7410,5592,162,283
MG,51713,SANTANA DO DESERTO,1486,520,523,3142,2619,50,112
MG,51730,SANTANA DO GARAMBÉU,662,757,244,1922,1678,66,101
MG,51756,SANTANA DO JACARÉ,1412,826,733,3850,3117,210,200
MG,51772,SANTANA DO MANHUAÇU,2952,1401,1747,6731,4984,117,200
MG,51799,SANTANA DO RIACHO,1764,545,1078,4285,3207,99,182
MG,51810,SANTANA DOS MONTES,1112,1158,571,3419,2848,188,185
MG,51837,SANTA RITA DE CALDAS,2403,2663,1253,7387,6134,175,270
MG,51853,SANTA RITA DE JACUTINGA,1668,1317,819,4462,3643,91,173
MG,51870,SANTA RITA DE IBITIPOCA,1233,732,657,3033,2376,78,168
MG,51896,SANTA RITA DO ITUETO,1837,1252,1260,5061,3801,53,104
MG,51918,SANTA RITA DO SAPUCAÍ,4052,13823,4387,27341,22954,839,808
MG,51934,SANTA ROSA DA SERRA,1274,553,765,2873,2108,52,69
MG,51950,SANTA VITÓRIA,7142,2645,2664,14015,11351,253,481
MG,51977,SANTO ANTÔNIO DO AMPARO,6422,2495,2085,12794,10709,496,506
MG,51993,SANTO ANTÔNIO DO AVENTUREIRO,1156,958,345,2997,2652,105,137
MG,52019,SANTO ANTÔNIO DO GRAMA,1289,1071,571,3407,2836,68,213
MG,52035,SANTO ANTÔNIO DO ITAMBÉ,1551,341,1315,3699,2384,57,228
MG,52051,SANTO ANTÔNIO DO JACINTO,3427,1713,2057,8368,6311,124,688
MG,52078,SANTO ANTÔNIO DO MONTE,4451,7333,2816,17923,15107,745,580
MG,52094,SANTO ANTÔNIO DO RIO ABAIXO,768,249,474,1817,1343,36,96
MG,52116,SANTO HIPÓLITO,1203,548,1065,3183,2118,58,117
MG,52132,SANTOS DUMONT,14726,7138,6662,38374,31712,1136,1767
MG,52159,SÃO BENTO ABADE,1110,1514,652,3749,3097,86,158
MG,52175,SÃO BRÁS DO SUAÇUÍ,967,727,397,2859,2462,175,173
MG,52191,SÃO DOMINGOS DO PRATA,5933,2480,1848,12809,10961,301,713
MG,52213,SÃO FRANCISCO,17917,4187,11811,37533,25722,303,1498
MG,52230,SÃO FRANCISCO DE PAULA,2310,1379,1027,5567,4540,151,206
MG,52256,SÃO FRANCISCO DE SALES,2291,861,648,4180,3532,69,149
MG,52272,SÃO FRANCISCO DO GLÓRIA,1908,839,487,3789,3302,72,221
MG,52299,SÃO GERALDO,2696,1335,1051,6243,5192,200,400
MG,52310,SÃO GERALDO DA PIEDADE,1448,617,876,3492,2616,91,264
MG,52337,SÃO GONÇALO DO ABAETÉ,1712,1257,774,4429,3655,82,175
MG,52353,SÃO GONÇALO DO PARÁ,2834,2000,1047,7386,6339,312,292
MG,52370,SÃO GONÇALO DO RIO ABAIXO,3243,1818,840,7608,6768,254,343
MG,52396,SÃO GONÇALO DO SAPUCAÍ,4721,6970,3387,17813,14426,341,585
MG,52418,SÃO GOTARDO,5652,8569,4978,23152,18174,809,1241
MG,52434,SÃO JOÃO BATISTA DO GLÓRIA,2445,1416,828,5526,4698,143,224
MG,52450,SÃO JOÃO DA MATA,756,937,402,2595,2193,100,118
MG,52477,SÃO JOÃO DA PONTE,9897,2167,7352,21793,14441,257,1272
MG,52493,SÃO JOÃO DEL REI,18277,19664,5765,61296,55531,2397,2558
MG,52515,SÃO JOÃO DO ORIENTE,2759,1534,937,6435,5498,144,444
MG,52531,SÃO JOÃO DO PARAÍSO,6061,3468,4874,16904,12030,388,1225
MG,52558,SÃO JOÃO EVANGELISTA,4447,2132,2292,10554,8262,204,678
MG,52574,SÃO JOÃO NEPOMUCENO,6723,4253,3379,19528,16149,569,886
MG,52590,SÃO JOSÉ DA SAFIRA,1424,647,1039,3451,2412,48,179
MG,52612,SÃO JOSÉ DA VARGINHA,1254,884,558,3303,2745,129,152
MG,52639,SÃO JOSÉ DO ALEGRE,715,1557,570,3373,2803,160,99
MG,52655,SÃO JOSÉ DO DIVINO,1028,925,677,3106,2429,41,222
MG,52671,SÃO JOSÉ DO GOIABAL,1869,902,1100,4779,3679,135,347
MG,52698,SÃO JOSÉ DO JACURI,2062,875,1038,4707,3669,128,384
MG,52710,SÃO JOSÉ DO MANTIMENTO,659,709,400,2166,1766,61,123
MG,52736,SÃO LOURENÇO,5511,11598,5609,31468,25859,765,1166
MG,52752,SÃO MIGUEL DO ANTA,2623,1234,796,5532,4736,160,393
MG,52779,SÃO PEDRO DA UNIÃO,1940,809,904,4227,3323,185,205
MG,52795,SÃO PEDRO DOS FERROS,2544,1344,1772,6820,5048,178,439
MG,52817,SÃO PEDRO DO SUAÇUÍ,1833,758,838,4072,3234,59,314
MG,52833,SÃO ROMÃO,3302,414,2190,6579,4389,71,342
MG,52850,SÃO ROQUE DE MINAS,1196,2270,1171,5288,4117,181,222
MG,52876,SÃO SEBASTIÃO DA BELA VISTA,1525,1198,561,3917,3356,50,106
MG,52892,SÃO SEBASTIÃO DO MARANHÃO,3151,1268,3287,8525,5238,141,413
MG,52914,SÃO SEBASTIÃO DO OESTE,2072,1252,526,4597,4071,142,248
MG,52930,SÃO SEBASTIÃO DO PARAÍSO,14266,14996,8336,46767,38431,1248,1754
MG,52957,SÃO SEBASTIÃO DO RIO PRETO,455,346,347,1432,1085,31,123
MG,52973,SÃO SEBASTIÃO DO RIO VERDE,584,709,233,1848,1615,49,67
MG,52990,SÃO TIAGO,2312,2992,1460,8373,6913,387,270
MG,53015,SÃO TOMÁS DE AQUINO,1950,1837,1074,5598,4524,91,219
MG,53031,SÃO THOMÉ DAS LETRAS,1943,1438,1152,5395,4243,109,263
MG,53058,SÃO VICENTE DE MINAS,1223,1966,889,5199,4310,105,256
MG,53074,SAPUCAÍ-MIRIM,1361,1594,900,4603,3703,69,161
MG,53090,SARDOÁ,1395,1083,1037,4066,3029,87,279
MG,53112,SENADOR CORTES,929,489,235,2179,1944,50,121
MG,53139,SENADOR FIRMINO,3111,1206,949,6201,5252,138,366
MG,53155,SENADOR JOSÉ BENTO,663,667,481,2180,1699,68,93
MG,53171,SENADOR MODESTINO GONÇALVES,1639,751,1509,4507,2998,94,236
MG,53198,SENHORA DE OLIVEIRA,2232,968,1242,5158,3916,178,256
MG,53210,SENHORA DO PORTO,891,912,611,2914,2303,50,230
MG,53236,SENHORA DOS REMÉDIOS,2984,2170,964,7039,6075,142,418
MG,53252,SERICITA,2334,1567,1336,5987,4651,171,292
MG,53279,SERITINGA,678,441,254,1760,1506,42,116
MG,53295,SERRA AZUL DE MINAS,1350,449,1208,3483,2275,55,288
MG,53317,SERRA DA SAUDADE,237,438,247,1034,787,12,16
MG,53333,SERRA DOS AIMORÉS,2407,1036,1343,5715,4372,80,360
MG,53350,SERRA DO SALITRE,2988,2374,1702,7860,6158,172,176
MG,53376,SERRANIA,1798,2269,1258,6094,4836,139,255
MG,53392,SERRANOS,533,685,410,1862,1452,46,81
MG,53414,SERRO,6557,1902,4869,15615,10746,292,1086
MG,53430,SETE LAGOAS,51227,31529,20563,149976,129413,6872,6636
MG,53457,SILVEIRÂNIA,1111,487,325,2278,1953,50,101
MG,53473,SILVIANÓPOLIS,1235,1971,690,4588,3898,99,183
MG,53490,SIMÃO PEREIRA,1004,702,523,2808,2285,64,95
MG,53511,SIMONÉSIA,4640,3999,3339,13823,10484,411,735
MG,53538,SOBRÁLIA,1840,975,932,4388,3456,50,300
MG,53554,SOLEDADE DE MINAS,1089,1781,708,4618,3910,120,108
MG,53570,TABULEIRO,1488,1082,804,3996,3192,128,196
MG,53597,TAIOBEIRAS,7044,7709,6170,23957,17787,320,1214
MG,53619,TAPIRA,1529,1109,646,3774,3128,54,94
MG,53635,TAPIRAÍ,991,525,612,2414,1802,52,63
MG,53651,TAQUARAÇU DE MINAS,1150,1088,801,3905,3104,106,197
MG,53678,TARUMIRIM,3952,3219,1701,9972,8271,172,490
MG,53694,TEIXEIRAS,4083,2069,1692,9600,7908,319,553
MG,53716,TEÓFILO OTONI,30175,22783,26368,100944,74576,2550,4968
MG,53732,TIMÓTEO,19010,9499,9737,58009,48272,1660,2286
MG,53759,TIRADENTES,1564,1693,561,5192,4631,163,253
MG,53775,TIROS,1372,1886,1079,5241,4162,185,373
MG,53791,TOCANTINS,4702,3785,1981,12638,10657,451,588
MG,53813,TOLEDO,1790,1508,1051,4918,3867,123,238
MG,53830,TOMBOS,2394,2420,1659,7304,5645,115,314
MG,53856,TRÊS CORAÇÕES,12134,18817,8772,52689,43917,1428,1856
MG,53872,TRÊS PONTAS,13054,12070,6845,40272,33427,1166,1431
MG,53899,TUMIRITINGA,1602,1391,1078,4828,3750,75,202
MG,53910,TUPACIGUARA,8726,4347,3713,19417,15704,495,619
MG,53937,TURMALINA,6669,1574,3359,13188,9829,196,518
MG,53953,TURVOLÂNDIA,1118,1130,706,3687,2981,174,160
MG,53970,UBÁ,30073,11409,9851,65837,55986,2060,2645
MG,53996,UBAÍ,4495,1154,1585,8012,6427,67,394
MG,54011,UBERABA,80317,49261,36128,209262,173134,5734,9786
MG,54038,UBERLÂNDIA,186797,70680,65127,423150,358023,11229,17624
MG,54054,UMBURATIBA,1055,507,604,2488,1884,53,159
MG,54070,UNAÍ,16615,18038,12016,56500,44484,1250,1884
MG,54097,URUCÂNIA,2270,2598,1806,8150,6344,161,490
MG,54119,VARGEM BONITA,716,619,301,1932,1631,38,57
MG,54135,VARGINHA,17257,31846,12880,91386,78506,2542,2862
MG,54151,VÁRZEA DA PALMA,10836,4692,6169,26522,20353,639,1125
MG,54178,VARZELÂNDIA,5883,2417,5008,14811,9803,236,795
MG,54194,VAZANTE,7333,2360,2349,14646,12297,428,530
MG,54216,WENCESLAU BRAZ,688,889,250,2243,1993,58,67
MG,54232,VERÍSSIMO,1005,605,333,2137,1804,25,52
MG,54259,VESPASIANO,23046,10005,10476,65343,54867,2574,2608
MG,54275,VIÇOSA,22187,9297,9370,52319,42949,2115,2209
MG,54291,VIEIRAS,1764,842,560,3601,3041,42,191
MG,54313,MATHIAS LOBATO,1065,638,650,2773,2123,59,132
MG,54330,VIRGEM DA LAPA,3881,1596,3740,10230,6490,135,521
MG,54356,VIRGÍNIA,2740,1931,1304,6783,5479,121,164
MG,54372,VIRGINÓPOLIS,2900,1559,1584,7562,5978,182,569
MG,54399,VIRGOLÂNDIA,2133,598,736,4025,3289,82,299
MG,54410,VISCONDE DO RIO BRANCO,11435,7362,4152,28249,24097,1074,1286
MG,54437,VOLTA GRANDE,1661,822,966,4219,3253,83,227
MG,54453,ITAÚ DE MINAS,3103,3933,2259,11977,9718,375,494
MS,55000,NOVA ALVORADA DO SUL,4385,3415,2184,11077,8893,115,311
MS,55018,ALCINÓPOLIS,1045,1308,561,3313,2752,22,167
MS,55026,LAGUNA CARAPÃ,1460,1523,788,4319,3531,35,210
MS,55034,JAPORÃ,1795,1349,1111,4763,3652,45,282
MS,55042,NOVO HORIZONTE DO SUL,1190,1368,602,3552,2950,75,177
MS,55050,PARAÍSO DAS ÁGUAS,743,1543,735,3360,2625,29,151
MS,55069,FIGUEIRÃO,589,1022,320,2171,1851,17,103
MS,90034,ÁGUA CLARA,2845,2377,2568,9321,6753,104,377
MS,90115,AMAMBAI,8044,6319,5351,23271,17920,257,978
MS,90131,ANASTÁCIO,6323,4109,3606,17253,13647,199,656
MS,90158,ANAURILÂNDIA,2148,2002,1335,6247,4912,51,296
MS,90174,ANTÔNIO JOÃO,2153,1922,1159,6310,5151,56,284
MS,90190,APARECIDA DO TABOADO,4442,5350,3191,15604,12413,296,717
MS,90212,AQUIDAUANA,11704,8183,7247,33649,26402,330,1124
MS,90298,BANDEIRANTES,1919,1701,1026,5332,4306,52,262
MS,90379,BATAGUASSU,4268,4950,3239,15018,11779,210,653
MS,90395,BATAYPORÃ,2914,2810,1861,8591,6730,109,386
MS,90417,BELA VISTA,5873,5320,3610,16524,12914,127,458
MS,90433,BONITO,5541,4153,3373,15191,11818,120,470
MS,90450,BRASILÂNDIA,2489,2561,2616,9205,6589,136,470
MS,90492,CAMAPUÃ,3824,3861,2575,11578,9003,123,342
MS,90514,CAMPO GRANDE,141709,183472,79720,541144,461424,8974,17415
MS,90530,CARACOL,1596,1500,724,4263,3539,24,131
MS,90557,CAARAPÓ,5600,4928,2827,16678,13851,279,699
MS,90573,CASSILÂNDIA,3371,6465,3524,16058,12534,321,908
MS,90611,CORGUINHO,952,1130,660,3251,2591,23,138
MS,90638,CORUMBÁ,26077,16017,13783,67454,53671,751,1835
MS,90654,COXIM,7238,7684,5893,24736,18843,337,1083
MS,90735,DOURADOS,35514,51690,24281,139804,115523,3339,6148
MS,90751,FÁTIMA DO SUL,4174,6085,1867,14416,12549,287,541
MS,90794,GLÓRIA DE DOURADOS,2371,2573,1012,7154,6142,196,306
MS,90816,GUIA LOPES DA LAGUNA,2666,2417,1532,7674,6142,92,289
MS,90859,IGUATEMI,3042,3925,2599,10806,8207,118,408
MS,90875,INOCÊNCIA,1386,2262,1567,6033,4466,69,311
MS,90891,ITAPORÃ,3588,4933,2181,12644,10463,266,497
MS,90930,IVINHEMA,5257,6054,1683,15512,13829,358,745
MS,90972,JARAGUARI,1635,1525,1156,5055,3899,52,211
MS,90999,JARDIM,6239,5571,3493,17718,14225,200,520
MS,91014,JATEÍ,1203,1415,477,3451,2974,20,66
MS,91030,LADÁRIO,4525,2541,2552,11796,9244,187,351
MS,91073,MARACAJU,8877,7287,4278,24025,19747,315,634
MS,91111,MIRANDA,7348,5115,3577,18207,14630,166,749
MS,91138,NAVIRAÍ,10638,11316,6845,33684,26839,635,1301
MS,91154,NIOAQUE,3807,2855,2147,10350,8203,103,376
MS,91235,NOVA ANDRADINA,10055,10687,6737,31404,24667,481,989
MS,91251,PARANAÍBA,8373,10521,6115,29774,23659,578,1352
MS,91278,PEDRO GOMES,1832,2441,1394,6372,4978,74,319
MS,91316,PONTA PORÃ,17865,17945,10457,53475,43018,892,2049
MS,91375,PORTO MURTINHO,3376,2496,1983,8679,6696,48,282
MS,91413,RIBAS DO RIO PARDO,3991,3684,2887,12443,9556,144,545
MS,91430,RIO BRILHANTE,6974,6701,3408,20215,16807,324,650
MS,91456,RIO NEGRO,1174,1590,696,4051,3355,41,214
MS,91472,RIO VERDE DE MATO GROSSO,4914,4270,2912,13903,10991,90,601
MS,91499,ROCHEDO,763,1403,424,3260,2836,38,174
MS,91570,SIDROLÂNDIA,10706,6680,4890,26474,21584,355,824
MS,91596,TERENOS,3966,3277,1889,11031,9142,125,447
MS,91650,TRÊS LAGOAS,21194,15087,12446,66287,53841,1587,2580
MS,91693,ANGÉLICA,2117,2299,943,6277,5334,118,310
MS,91715,ARAL MOREIRA,2474,1815,1116,6083,4967,46,312
MS,91731,ELDORADO,2100,3806,2199,9292,7093,179,432
MS,91758,DEODÁPOLIS,2849,3280,1246,8667,7421,162,426
MS,91782,CHAPADÃO DO SUL,2973,4512,2632,12171,9539,220,419
MS,91790,MUNDO NOVO,4247,4283,1941,12286,10345,227,619
MS,91804,DOIS IRMÃOS DO BURITI,3375,1866,1591,7618,6027,77,273
MS,91820,JUTI,1745,1356,634,4251,3617,44,251
MS,91847,PARANHOS,2426,2238,1679,7207,5528,45,556
MS,91863,SANTA RITA DO PARDO,1216,1680,1169,4733,3564,53,243
MS,91880,SONORA,3519,2819,1963,9836,7873,113,411
MS,91901,VICENTINA,1456,1929,548,4572,4024,119,185
MS,98019,BODOQUENA,2442,1693,1559,6625,5066,44,281
MS,98035,COSTA RICA,3910,4852,2102,12575,10473,183,605
MS,98051,DOURADINA,1067,1727,355,3641,3286,72,157
MS,98078,ITAQUIRAÍ,4405,4055,3234,12950,9716,173,533
MS,98094,SÃO GABRIEL DO OESTE,4872,5645,3387,16127,12740,213,426
MS,98116,SELVÍRIA,2028,1127,958,4920,3962,49,216
MS,98132,SETE QUEDAS,2180,2751,1197,7130,5933,98,524
MS,98159,TACURU,3028,1425,1600,6690,5090,40,342
MS,98175,TAQUARUSSU,760,1153,456,2760,2304,54,169
MS,98590,CORONEL SAPUCAIA,3998,2297,2265,9571,7306,60,577
MT,89788,COLNIZA,5492,5388,4181,16591,12410,362,822
MT,89796,COLÍDER,3949,11180,4900,22120,17220,357,1061
MT,89800,CURVELÂNDIA,979,1694,632,3809,3177,54,232
MT,89818,NOVA BRASILÂNDIA,1332,1109,706,3485,2779,44,171
MT,89826,NOVA SANTA HELENA,928,1058,667,2877,2210,32,140
MT,89834,PARANATINGA,3417,4780,2629,12576,9947,210,653
MT,89843,SANTO ANTÔNIO DO LESTE,637,833,736,2507,1771,26,116
MT,89850,SINOP,19599,30548,16838,75637,58799,1428,2685
MT,89877,ALTA FLORESTA,9469,15598,8093,36032,27939,398,1387
MT,89893,ARAPUTANGA,2961,4382,2376,11547,9171,209,604
MT,89915,JAURU,2000,3052,2233,8359,6126,106,463
MT,89931,SÃO JOSÉ DOS QUATRO MARCOS,4307,4625,3487,14647,11160,442,719
MT,89958,RIO BRANCO,1064,1528,699,3890,3191,56,237
MT,89960,RONDOLÂNDIA,917,603,933,2848,1915,17,148
MT,89974,SALTO DO CÉU,779,1096,391,2604,2213,43,166
MT,89990,PONTES E LACERDA,6919,10755,7185,29150,21965,455,1376
MT,90018,ACORIZAL,2821,954,564,4929,4365,33,277
MT,90026,SÃO JOSÉ DO POVO,1091,787,484,2784,2300,68,193
MT,90042,ALTO BOA VISTA,733,1544,1046,3616,2570,37,188
MT,90050,ALTO ARAGUAIA,2570,4818,2300,11323,9023,197,528
MT,90069,QUERÊNCIA,3011,2391,2152,8492,6340,171,401
MT,90077,ALTO GARÇAS,1980,2528,1300,6674,5374,127,391
MT,90085,CANABRAVA DO NORTE,830,1525,1011,3626,2615,22,151
MT,90093,ALTO PARAGUAI,2276,1530,921,5547,4626,83,353
MT,90107,SANTA CARMEM,891,1193,784,3086,2302,41,91
MT,90123,NOVA MARINGÁ,1094,1374,810,3605,2795,59,203
MT,90140,NOVA GUARITA,1422,1147,822,3721,2899,68,159
MT,90166,NOVA MARILÂNDIA,757,810,513,2367,1854,22,123
MT,90182,PORTO ESTRELA,1501,555,534,2910,2376,20,187
MT,90204,GLÓRIA D'OESTE,843,850,406,2369,1963,53,112
MT,90220,TABAPORÃ,1559,2672,1715,6488,4773,103,244
MT,90239,ARAGUAINHA,328,221,249,933,684,28,43
MT,90247,SÃO JOSÉ DO XINGU,1001,1089,1323,3894,2571,44,159
MT,90255,ARENÁPOLIS,2033,2804,1839,7598,5759,99,368
MT,90263,APIACÁS,1701,2154,889,5142,4253,79,222
MT,90271,ARIPUANÃ,3771,4272,3786,12834,9048,223,530
MT,90280,CONFRESA,5340,4883,4098,15917,11819,188,855
MT,90301,LAMBARI D'OESTE,1148,1558,1158,4329,3171,83,221
MT,90310,BARÃO DE MELGAÇO,3212,895,1235,5969,4734,72,251
MT,90328,SANTO AFONSO,737,797,390,2120,1730,13,114
MT,90336,BARRA DO BUGRES,8993,5483,5557,22696,17139,303,961
MT,90344,PLANALTO DA SERRA,910,469,488,2254,1766,20,162
MT,90352,BARRA DO GARÇAS,12540,10975,9536,40733,31197,724,1758
MT,90360,NOVA MONTE VERDE,1686,1967,1471,5532,4061,120,221
MT,90387,NOVA BANDEIRANTES,2497,3494,2313,8951,6638,153,368
MT,90409,SÃO PEDRO DA CIPA,1061,1203,489,3253,2764,48,152
MT,90425,COTRIGUAÇU,3552,2635,2238,9128,6890,121,384
MT,90441,RIBEIRÃOZINHO,649,435,369,1676,1307,12,85
MT,90468,BRASNORTE,2911,3133,2339,9175,6836,107,343
MT,90476,CÁCERES,22238,16133,14143,60742,46599,656,2279
MT,90484,CAMPO NOVO DO PARECIS,5650,4894,4655,17398,12743,295,551
MT,90506,CAMPO VERDE,8095,6882,5148,23988,18840,383,813
MT,90522,CLÁUDIA,1747,3201,1796,7331,5535,112,313
MT,90549,CASTANHEIRA,1984,1843,949,5279,4330,81,316
MT,90565,JANGADA,2748,1301,1461,6385,4924,65,347
MT,90581,JURUENA,1843,2205,1175,5687,4512,97,247
MT,90590,CHAPADA DOS GUIMARÃES,5519,3139,2709,13686,10977,147,666
MT,90603,LUCAS DO RIO VERDE,8371,9323,5996,27732,21736,617,873
MT,90620,MATUPÁ,3179,3635,1843,9561,7718,147,459
MT,90646,NOVA MUTUM,5254,6597,3817,18113,14296,363,578
MT,90662,RIBEIRÃO CASCALHEIRA,1601,2380,1267,5870,4603,41,358
MT,90670,CUIABÁ,116422,119076,61362,386586,325224,5997,12908
MT,90689,TAPURAH,1744,2199,1682,6289,4607,91,197
MT,90697,DIAMANTINO,4846,4671,3202,14663,11461,219,567
MT,90700,PONTAL DO ARAGUAIA,1465,958,479,3531,3052,36,166
MT,90719,DOM AQUINO,1978,2233,1033,5974,4941,52,293
MT,90727,SAPEZAL,3086,3229,3074,10662,7588,171,342
MT,90743,CAMPOS DE JÚLIO,1156,1286,1488,4387,2899,66,110
MT,90760,CARLINDA,2349,2883,1349,7190,5841,92,315
MT,90778,GENERAL CARNEIRO,1352,905,522,3133,2611,45,168
MT,90786,FELIZ NATAL,1634,2079,1922,6072,4150,48,211
MT,90808,NOVO MUNDO,1743,1561,1365,5125,3760,81,254
MT,90824,GAÚCHA DO NORTE,1038,1185,1135,3939,2804,47,191
MT,90832,GUIRATINGA,2262,3579,1579,8719,7140,135,506
MT,90840,UNIÃO DO SUL,936,750,745,2585,1840,13,75
MT,90867,NOVA LACERDA,1621,958,1054,3987,2933,28,144
MT,90883,NOVA UBIRATÃ,2155,1337,1423,5382,3959,94,145
MT,90905,BOM JESUS DO ARAGUAIA,920,1104,1096,3477,2381,34,198
MT,90913,ITIQUIRA,2441,2211,1602,7301,5699,115,326
MT,90921,SERRA NOVA DOURADA,246,371,356,1167,811,4,71
MT,90948,NOVO SANTO ANTÔNIO,439,507,535,1636,1101,10,102
MT,90956,JACIARA,4854,7475,3956,19301,15345,262,796
MT,90964,NOVA NAZARÉ,481,550,552,1824,1272,12,83
MT,90980,SANTA CRUZ DO XINGU,373,573,367,1483,1116,10,87
MT,91006,CONQUISTA D'OESTE,684,881,513,2391,1878,23,119
MT,91022,VALE DE SÃO DOMINGOS,784,1160,588,2871,2283,36,148
MT,91049,SANTA RITA DO TRIVELATO,397,576,497,1702,1205,19,59
MT,91057,LUCIARA,614,459,498,1884,1386,22,119
MT,91081,IPIRANGA DO NORTE,976,1247,666,3153,2487,60,98
MT,91090,VILA BELA DA SANTÍSSIMA TRINDADE,2765,3068,2378,9130,6752,62,401
MT,91103,ITANHANGÁ,1152,1528,953,3917,2964,42,141
MT,91170,NOBRES,3043,4108,2033,10583,8550,109,535
MT,91197,NORTELÂNDIA,1757,1564,736,4695,3959,68,243
MT,91219,NOSSA SENHORA DO LIVRAMENTO,5613,2108,1894,10909,9015,113,649
MT,91294,POCONÉ,10862,5391,4755,23320,18565,233,1082
MT,91332,PONTE BRANCA,667,467,300,1639,1339,15,100
MT,91359,PORTO DOS GAÚCHOS,783,1708,1085,4010,2925,53,179
MT,91391,POXORÉU,4940,3612,3654,14047,10393,192,775
MT,91510,RONDONÓPOLIS,45502,36777,24535,131219,106684,2571,5403
MT,91537,ROSÁRIO OESTE,5234,3484,3586,14095,10509,191,812
MT,91553,SANTO ANTÔNIO DO LEVERGER,6760,3287,2192,14064,11872,133,545
MT,91618,TESOURO,726,680,599,2307,1708,22,151
MT,91634,TORIXORÉU,1296,1022,535,3297,2762,54,213
MT,91677,VÁRZEA GRANDE,61083,44342,28540,168182,139642,2966,6172
MT,91774,MIRASSOL D'OESTE,5333,6697,4416,18529,14113,371,822
MT,91812,PEDRA PRETA,3852,3716,2581,11990,9409,301,591
MT,91839,SÃO FÉLIX DO ARAGUAIA,1920,1988,2213,6884,4671,53,363
MT,91855,TANGARÁ DA SERRA,16032,20477,12605,57347,44742,985,2341
MT,91898,JUSCIMEIRA,3396,2788,2005,9341,7336,113,435
MT,91910,ÁGUA BOA,3471,5515,2876,13430,10554,218,563
MT,91936,CANARANA,3323,4531,3610,13339,9729,231,726
MT,91952,NOVA XAVANTINA,3937,4955,3759,14630,10871,141,682
MT,91979,SANTA TEREZINHA,2002,791,1373,4642,3269,39,243
MT,91995,SÃO JOSÉ DO RIO CLARO,2822,4282,2605,10685,8080,150,482
MT,98191,JUARA,5406,10566,5239,23252,18013,398,1021
MT,98310,JUÍNA,7914,11485,6900,28699,21799,472,1156
MT,98337,DENISE,2159,1874,1220,5979,4759,89,247
MT,98612,ALTO TAQUARI,1286,2091,1053,5233,4180,77,244
MT,98639,ARAGUAIANA,930,749,684,2709,2025,31,126
MT,98655,CAMPINÁPOLIS,2551,2827,2131,8556,6425,77,390
MT,98671,COCALINHO,1655,779,1640,4628,2988,60,260
MT,98698,ITAÚBA,1093,1335,1145,3919,2774,51,207
MT,98710,MARCELÂNDIA,1402,4618,2897,9531,6634,98,383
MT,98736,NOVA OLÍMPIA,5368,2405,2822,12478,9656,254,544
MT,98752,NOVA CANAÃ DO NORTE,2025,4199,2081,9231,7150,180,473
MT,98779,NOVO SÃO JOAQUIM,1361,1878,1542,5262,3720,54,239
MT,98795,NOVO HORIZONTE DO NORTE,837,1412,434,2915,2481,32,117
MT,98817,PEIXOTO DE AZEVEDO,6275,5584,3760,17494,13734,252,908
MT,98833,PARANAÍTA,2072,3087,1438,7155,5717,122,359
MT,98850,PORTO ALEGRE DO NORTE,1840,2233,1926,6596,4670,56,348
MT,98876,PORTO ESPERIDIÃO,3139,1956,1837,7674,5837,84,402
MT,98892,PRIMAVERA DO LESTE,9623,12649,7138,34870,27732,594,1227
MT,98914,RESERVA DO CABAÇAL,562,719,296,1879,1583,23,103
MT,98930,SORRISO,15218,13256,8125,41781,33656,794,1461
MT,98957,TERRA NOVA DO NORTE,3767,2368,2163,9125,6962,100,343
MT,98973,VERA,1890,2500,1764,6673,4909,87,257
MT,98990,VILA RICA,4100,4678,3838,13823,9985,217,588
MT,99015,COMODORO,3136,5427,3476,13003,9527,124,422
MT,99031,FIGUEIRÓPOLIS D'OESTE,641,1687,526,3256,2730,51,205
MT,99058,GUARANTÃ DO NORTE,5030,7894,5168,19597,14429,297,742
MT,99074,INDIAVAÍ,797,562,345,1947,1602,22,94
PA,4006,GOIANÉSIA DO PARÁ,7220,6488,6611,22663,16052,319,921
PA,4014,ABAETETUBA,46514,21122,13556,88319,74763,716,1949
PA,4022,TAILÂNDIA,8222,15317,9743,37185,27442,464,1869
PA,4030,ACARÁ,15525,7460,6464,32389,25925,294,1234
PA,4049,BOM JESUS DO TOCANTINS,3271,2364,2904,9434,6530,128,381
PA,4057,AFUÁ,7330,5274,4737,18661,13924,95,778
PA,4065,SÃO JOÃO DE PIRABAS,6611,2776,2895,13520,10625,152,537
PA,4073,ALENQUER,10635,11998,6374,31103,24729,157,695
PA,4081,TUCUMÃ,7996,6172,4398,20826,16428,389,608
PA,4090,ALMEIRIM,9464,4836,4325,20475,16150,224,505
PA,4103,MÃE DO RIO,6789,8183,5303,22286,16983,216,761
PA,4111,ALTAMIRA,14988,25129,14609,61581,46972,771,2272
PA,4120,ELDORADO DOS CARAJÁS,6167,3981,4043,15895,11852,342,572
PA,4138,ANAJÁS,4382,5527,3692,14538,10846,41,523
PA,4146,SANTA LUZIA DO PARÁ,6122,4065,3229,14557,11328,130,563
PA,4154,ANANINDEUA,83674,63456,39037,259045,220008,5507,7852
PA,4162,PALESTINA DO PARÁ,2004,1591,1651,5618,3967,52,173
PA,4170,AUGUSTO CORRÊA,12692,6399,7147,29243,22096,245,1299
PA,4189,IPIXUNA DO PARÁ,6378,5245,4002,16701,12699,117,606
PA,4197,AVEIRO,3633,2334,2754,9358,6604,73,301
PA,4200,JACAREACANGA,1858,2460,2528,7418,4890,71,431
PA,4219,BAGRE,4329,2062,2883,10069,7186,69,527
PA,4227,BRASIL NOVO,3144,5473,2505,11853,9348,136,307
PA,4235,BAIÃO,10382,4540,3336,19860,16524,225,494
PA,4243,SANTA BÁRBARA DO PARÁ,4642,3560,1711,11772,10061,182,319
PA,4251,BARCARENA,25559,13975,10925,61338,50413,734,1451
PA,4260,ÁGUA AZUL DO NORTE,2987,2744,2366,8907,6541,144,323
PA,4278,BELÉM,291403,275295,171211,995964,824753,17844,24722
PA,4286,TRAIRÃO,2900,2789,2394,8583,6189,97,317
PA,4294,BENEVIDES,11181,8854,4555,30278,25723,418,885
PA,4308,PAU D'ARCO,2242,1381,1580,5713,4133,67,212
PA,4316,BONITO,4288,2184,1174,8634,7460,152,374
PA,4324,ULIANÓPOLIS,5696,3380,4039,14632,10593,194,465
PA,4332,BRAGANÇA,27854,18942,15754,70781,55027,647,2086
PA,4340,AURORA DO PARÁ,5497,4835,3838,15556,11718,174,628
PA,4359,BREVES,16777,14675,15203,50029,34826,344,1602
PA,4367,TERRA SANTA,4033,2526,2869,10449,7580,82,270
PA,4375,BUJARU,7648,3273,2838,15519,12681,134,461
PA,4383,NOVO PROGRESSO,5477,4507,6075,17013,10938,247,454
PA,4391,CACHOEIRA DO ARARI,8313,2148,3580,15175,11595,100,377
PA,4405,VITÓRIA DO XINGU,2431,3188,1996,8292,6296,81,292
PA,4413,CAMETÁ,39916,17335,11937,73952,62015,448,1549
PA,4421,NOVO REPARTIMENTO,14817,11409,9976,38893,28917,462,1189
PA,4430,CAPANEMA,20085,10799,4515,41872,37357,920,1257
PA,4448,BREU BRANCO,8473,8271,6926,26852,19926,446,1085
PA,4456,CAPITÃO POÇO,11485,11987,7198,33966,26768,562,1338
PA,4464,SÃO DOMINGOS DO ARAGUAIA,5887,3390,4548,15522,10974,198,653
PA,4472,CASTANHAL,27749,39307,17033,104592,87559,1594,2878
PA,4480,NOVA ESPERANÇA DO PIRIÁ,5047,3932,2950,12658,9708,106,480
PA,4499,CHAVES,4160,2202,3741,10985,7244,80,535
PA,4502,ABEL FIGUEIREDO,2177,1243,1574,5477,3903,63,191
PA,4510,COLARES,4209,1560,1556,8456,6900,137,260
PA,4529,CUMARU DO NORTE,1809,1324,2093,5674,3581,38,234
PA,4537,CONCEIÇÃO DO ARAGUAIA,10166,8681,8173,30657,22484,494,1020
PA,4545,TERRA ALTA,3833,2207,1586,8615,7029,79,243
PA,4553,CURRALINHO,8589,2563,3487,15695,12208,85,504
PA,4561,FLORESTA DO ARAGUAIA,4479,2438,3272,11124,7852,137,366
PA,4570,CURUÇÁ,12742,5429,4889,25572,20683,297,771
PA,4588,BANNACH,847,1069,861,2955,2094,16,105
PA,4596,FARO,3077,658,1568,5753,4185,37,119
PA,4600,NOVA IPIXUNA,3525,3342,2910,10665,7755,118,459
PA,4618,GURUPÁ,6782,3980,2841,14196,11355,63,397
PA,4626,PLACAS,3169,4190,2387,10271,7884,136,256
PA,4634,IGARAPÉ-AÇU,10867,6397,3945,24717,20772,450,864
PA,4642,MARITUBA,21926,14509,8590,56269,47679,1069,1583
PA,4650,IGARAPÉ-MIRI,19277,10788,8319,41598,33279,340,1077
PA,4669,TRACUATEUA,10924,3039,3931,19518,15587,165,741
PA,4677,INHANGAPI,2242,2877,1095,7171,6076,67,319
PA,4685,QUATIPURU,3417,2079,2537,8724,6187,91,206
PA,4693,IRITUIA,9911,5624,4576,22087,17511,291,667
PA,4707,CANAÃ DOS CARAJÁS,6501,4717,5462,19329,13867,560,565
PA,4715,ITAITUBA,19522,21912,20080,66331,46251,609,1733
PA,4723,ANAPU,2770,5308,2537,11312,8775,156,420
PA,4731,ITUPIRANGA,13759,6441,9400,32089,22689,419,1190
PA,4740,CURUÁ,4066,2043,1879,8414,6535,24,185
PA,4758,JACUNDÁ,11383,11102,8959,34779,25820,610,1259
PA,4766,CACHOEIRA DO PIRIÁ,4578,2134,3077,10737,7660,109,415
PA,4774,JURUTI,10448,6894,5046,24222,19176,127,545
PA,4782,PIÇARRA,3027,2255,2636,8751,6115,126,352
PA,4790,LIMOEIRO DO AJURU,8260,3752,2512,15424,12912,116,391
PA,4804,BELTERRA,4421,4447,2775,12794,10019,108,349
PA,4812,MAGALHÃES BARATA,3690,986,778,6178,5400,37,145
PA,4820,SÃO JOÃO DA PONTA,2074,1288,851,4685,3834,50,102
PA,4839,MARABÁ,50655,32979,30074,133433,103359,2034,3740
PA,4847,SAPUCAIA,1039,1453,860,3631,2771,56,137
PA,4855,MARACANÃ,9674,4914,3515,20419,16904,263,694
PA,4863,MOJUÍ DOS CAMPOS,3283,7169,3534,14910,11376,113,360
PA,4871,MARAPANIM,8640,5584,3998,20504,16506,180,564
PA,4898,MELGAÇO,3047,3796,4382,12019,7637,63,578
PA,4910,MOCAJUBA,10342,3393,3331,18801,15470,147,454
PA,4936,MOJU,19392,9079,8680,40419,31739,287,1174
PA,4952,MONTE ALEGRE,11506,17238,9037,40507,31470,264,1112
PA,4979,MUANÁ,10443,3209,4075,19053,14978,151,634
PA,4995,NOVA TIMBOTEUA,4847,2420,2189,10759,8570,295,414
PA,5010,ÓBIDOS,15288,5577,8109,31388,23279,315,607
PA,5037,OEIRAS DO PARÁ,8369,3872,2923,16245,13322,63,547
PA,5053,ORIXIMINÁ,14042,9823,10256,39577,29321,369,766
PA,5070,OURÉM,4996,3557,3006,12945,9939,161,541
PA,5096,PARAGOMINAS,16350,21423,15272,60336,45064,647,1851
PA,5118,PEIXE-BOI,2947,1690,1233,6797,5564,120,308
PA,5134,PONTA DE PEDRAS,7528,3222,3332,15626,12294,99,388
PA,5150,PORTEL,8169,8210,9484,28183,18699,205,1154
PA,5177,PORTO DE MOZ,6002,4846,3773,15478,11705,107,454
PA,5193,PRAINHA,5999,6972,4548,18681,14133,101,774
PA,5215,PRIMAVERA,3061,2815,2017,8757,6740,168,315
PA,5231,SALINÓPOLIS,8957,8851,5302,25897,20595,212,531
PA,5258,SALVATERRA,6889,3339,3294,15231,11937,187,337
PA,5274,SANTA CRUZ DO ARARI,2849,1183,1359,5726,4367,33,160
PA,5290,SANTA ISABEL DO PARÁ,12384,10538,5405,34792,29387,800,1066
PA,5312,SANTA MARIA DO PARÁ,6014,6040,3713,17652,13939,312,679
PA,5339,SANTANA DO ARAGUAIA,6124,5536,5650,19464,13814,202,1218
PA,5355,SANTARÉM,45756,69492,39881,184792,144911,1848,3336
PA,5371,SANTARÉM NOVO,2920,931,770,5204,4434,32,239
PA,5398,SANTO ANTÔNIO DO TAUÁ,8321,5171,3412,19333,15921,234,636
PA,5410,SÃO CAETANO DE ODIVELAS,4869,4146,2564,13045,10481,186,299
PA,5436,SÃO DOMINGOS DO CAPIM,7772,6886,4384,20423,16039,129,728
PA,5452,SÃO FÉLIX DO XINGU,9997,10358,9083,32434,23351,418,1357
PA,5479,SÃO FRANCISCO DO PARÁ,4494,3483,1806,11228,9422,192,332
PA,5495,SÃO JOÃO DO ARAGUAIA,4001,1809,2718,9573,6855,115,382
PA,5517,SÃO MIGUEL DO GUAMÁ,10092,12082,6782,32037,25255,275,1071
PA,5533,SÃO SEBASTIÃO DA BOA VISTA,8254,3396,3440,16113,12673,118,406
PA,5550,SENADOR JOSÉ PORFÍRIO,2317,2340,2449,7693,5244,54,326
PA,5576,SOURE,9314,2091,3920,17117,13197,171,366
PA,5592,TOMÉ-AÇU,16107,7893,8843,35807,26964,447,1084
PA,5614,TUCURUÍ,27313,16637,16093,69038,52945,995,1712
PA,5630,VIGIA,13502,7576,6677,32238,25561,593,906
PA,5657,VISEU,20316,3349,9711,36075,26364,224,1183
PA,5673,REDENÇÃO,16109,16501,13026,52699,39673,711,1680
PA,5690,RIO MARIA,4537,3978,2421,12067,9646,175,421
PA,5711,XINGUARA,8105,9669,6976,27536,20560,429,864
PA,5738,RONDON DO PARÁ,10970,6939,9619,30521,20902,396,1219
PA,5754,URUARÁ,4840,12324,6266,25292,19026,292,1160
PA,5770,MEDICILÂNDIA,4596,6452,3520,15836,12316,258,600
PA,5797,SÃO GERALDO DO ARAGUAIA,7057,4845,6290,20709,14419,425,809
PA,5819,CONCÓRDIA DO PARÁ,7016,5439,3465,16861,13396,101,466
PA,5835,PARAUAPEBAS,30174,21052,22089,92209,70120,3418,3190
PA,5851,CURIONÓPOLIS,5547,3076,2963,12978,10015,289,517
PA,5878,GARRAFÃO DO NORTE,8656,3695,4426,18267,13841,190,803
PA,5894,RURÓPOLIS,5075,5312,4042,15464,11422,199,479
PA,5916,PACAJÁ,6255,8540,5904,22202,16298,267,891
PA,5932,BREJO GRANDE DO ARAGUAIA,2238,1130,1802,5648,3846,69,164
PA,5959,OURILÂNDIA DO NORTE,6493,4304,4366,16578,12212,202,418
PA,5975,DOM ELISEU,9834,6292,7952,27869,19917,550,768
PA,5991,SANTA MARIA DAS BARREIRAS,3772,2555,2912,10556,7644,157,599
PB,19003,RIACHÃO DO POÇO,1214,1064,690,3670,2980,157,330
PB,19011,ÁGUA BRANCA,2966,941,1809,6768,4959,131,670
PB,19020,SOBRADO,2266,1500,1558,6385,4827,182,500
PB,19038,AGUIAR,2440,506,814,4473,3659,93,481
PB,19046,SÃO JOSÉ DOS RAMOS,1835,848,919,4273,3354,143,408
PB,19054,ALAGOA GRANDE,9122,3527,6232,22710,16478,635,1880
PB,19062,CAPIM,1806,754,622,3933,3311,152,404
PB,19070,ALAGOA NOVA,4605,3793,3519,15028,11509,515,1447
PB,19089,CUITÉ DE MAMANGUAPE,2504,1164,830,5343,4513,128,530
PB,19097,ALAGOINHA,4323,1849,2576,10547,7971,319,974
PB,19100,CURRAL DE CIMA,1546,1218,1043,4685,3642,190,522
PB,19119,ALHANDRA,6371,2885,2199,14749,12550,562,1220
PB,19127,RIACHÃO DO BACAMARTE,1271,856,700,3649,2949,149,447
PB,19135,SÃO JOÃO DO RIO DO PEIXE,7261,1426,3193,14230,11037,417,1190
PB,19143,MATINHAS,1269,947,543,3511,2968,92,383
PB,19151,ARAÇAGI,5576,2114,4355,14244,9889,482,1199
PB,19160,LOGRADOURO,1256,816,323,2893,2570,60,274
PB,19178,ARARA,3437,1476,2405,8950,6545,195,897
PB,19186,SERTÃOZINHO,1254,1019,624,3508,2884,79,294
PB,19194,ARARUNA,4185,3210,3416,13341,9925,324,1274
PB,19208,RIACHÃO,1264,713,481,2963,2482,47,302
PB,19216,AREIA,7090,3094,4131,18637,14506,903,1624
PB,19224,SÃO DOMINGOS DO CARIRI,908,506,264,2063,1799,36,211
PB,19232,AREIAL,1500,1595,1143,5276,4133,171,462
PB,19240,CARAÚBAS,1858,367,518,3336,2818,56,330
PB,19259,AROEIRAS,5625,3247,3654,15337,11683,470,1542
PB,19267,SANTO ANDRÉ,1162,425,306,2330,2024,64,254
PB,19275,DAMIÃO,1585,748,868,3815,2947,52,403
PB,19283,SOSSÊGO,1181,447,413,2621,2208,34,284
PB,19291,BAÍA DA TRAIÇÃO,2501,824,1010,5372,4362,166,445
PB,19305,BARAÚNA,1459,638,528,3441,2913,98,364
PB,19313,BANANEIRAS,6153,3371,4241,17021,12780,481,1449
PB,19321,ASSUNÇÃO,1182,786,481,3124,2643,79,307
PB,19330,BARRA DE SANTA ROSA,4254,1893,2283,10336,8053,168,1097
PB,19348,ZABELÊ,925,222,237,1758,1521,69,214
PB,19356,BARRA DE SÃO MIGUEL,2344,608,476,4289,3813,141,394
PB,19364,CACIMBAS,1663,922,976,4476,3500,154,637
PB,19372,BAYEUX,27580,10891,11046,68758,57712,2709,4446
PB,19380,CAJAZEIRINHAS,1944,396,548,3372,2824,55,308
PB,19399,BELÉM,4985,2900,2975,13187,10212,345,1019
PB,19402,SÃO BENTINHO,1548,416,666,3194,2528,82,316
PB,19410,BELÉM DO BREJO DO CRUZ,2151,1082,953,5188,4235,169,517
PB,19429,SÃO DOMINGOS DE POMBAL,1506,398,513,2853,2340,53,267
PB,19437,BOA VENTURA,2191,637,1409,5080,3671,82,445
PB,19445,SÃO JOSÉ DE PRINCESA,1765,233,915,3519,2604,49,438
PB,19453,BOM JESUS,1367,109,384,2302,1918,76,218
PB,19461,MARIZÓPOLIS,2695,399,606,4661,4055,115,435
PB,19470,BOM SUCESSO,2227,372,678,3951,3273,102,375
PB,19488,MATO GROSSO,1267,86,404,1966,1562,18,162
PB,19496,BONITO DE SANTA FÉ,3487,958,2104,7702,5598,102,775
PB,19500,BERNARDINO BATISTA,1090,183,504,2171,1667,46,242
PB,19518,BOQUEIRÃO,4564,3582,1257,11833,10576,330,1101
PB,19526,POÇO DE JOSÉ DE MOURA,1878,272,587,3517,2930,64,414
PB,19534,IGARACY,2335,634,1564,5452,3888,92,539
PB,19542,SÃO JOSÉ DO BREJO DO CRUZ,800,207,269,1624,1355,48,158
PB,19550,BORBOREMA,1497,940,1173,4396,3223,126,388
PB,19569,SANTA INÊS,1876,353,876,3639,2763,49,411
PB,19577,BREJO DO CRUZ,3358,2109,1666,8935,7269,347,833
PB,19585,AMPARO,1251,132,244,1987,1743,40,184
PB,19593,BREJO DOS SANTOS,2204,833,666,4813,4147,150,374
PB,19607,CASSERENGUE,2526,736,1507,5546,4039,135,453
PB,19615,CAAPORÃ,6871,2508,3220,16048,12828,755,1122
PB,19623,GADO BRAVO,2411,1567,891,6157,5266,248,737
PB,19631,CABACEIRAS,1642,864,470,4084,3614,141,346
PB,19640,POÇO DANTAS,1801,242,867,3375,2508,59,262
PB,19658,CABEDELO,12106,5481,2599,31071,28472,1220,1856
PB,19666,SANTARÉM,1250,296,498,2423,1925,32,200
PB,19674,CACHOEIRA DOS ÍNDIOS,3768,490,1177,6575,5398,146,719
PB,19682,TENÓRIO,799,663,435,2336,1901,73,214
PB,19690,CACIMBA DE AREIA,1366,530,546,2995,2449,80,311
PB,19704,COXIXOLA,761,286,200,1532,1332,63,128
PB,19712,CACIMBA DE DENTRO,5281,2040,2620,12288,9668,190,1357
PB,19720,PARARI,816,326,152,1623,1471,42,174
PB,19739,CAIÇARA,2195,1467,789,5527,4738,119,573
PB,19747,PEDRO RÉGIS,1453,1009,1078,4286,3208,177,383
PB,19755,CAJAZEIRAS,21011,4665,9472,42691,33219,1178,2793
PB,19763,ALCANTIL,1491,1215,617,4171,3554,132,383
PB,19771,CALDAS BRANDÃO,2183,859,872,4753,3881,118,379
PB,19780,BARRA DE SANTANA,2279,1888,1341,7079,5738,236,720
PB,19798,CAMALAÚ,2641,415,923,4746,3823,125,491
PB,19801,CATURITÉ,1676,897,543,4017,3474,112,382
PB,19810,CAMPINA GRANDE,57841,91227,38995,276480,237485,8254,17054
PB,19828,RIACHO DE SANTO ANTÔNIO,748,388,126,1532,1406,40,114
PB,19836,CARRAPATEIRA,1265,60,421,2005,1584,24,189
PB,19844,APARECIDA,3166,775,1076,6052,4976,197,549
PB,19852,CATINGUEIRA,1356,891,827,3908,3081,101,446
PB,19860,SÃO FRANCISCO,1715,514,384,3150,2766,74,292
PB,19879,CATOLÉ DO ROCHA,8305,3962,3625,20769,17144,562,1393
PB,19887,VIEIRÓPOLIS,2717,301,911,4724,3813,98,486
PB,19895,CONCEIÇÃO,6526,1865,3012,13602,10590,250,1465
PB,19909,AREIA DE BARAÚNAS,663,525,342,1801,1459,38,167
PB,19917,CONDADO,2409,920,878,5209,4331,99,591
PB,19925,ALGODÃO DE JANDAÍRA,1208,330,439,2374,1935,57,202
PB,19933,CONDE,6436,1940,1588,13554,11966,590,1140
PB,19941,BOA VISTA,1687,1419,496,5005,4509,199,360
PB,19950,CONGO,2393,419,817,4168,3351,81,316
PB,19968,MARCAÇÃO,2149,1017,1168,5456,4288,230,497
PB,19976,COREMAS,5713,1364,2984,11790,8806,137,980
PB,19984,MATURÉIA,2124,905,985,4751,3766,82,436
PB,19992,CRUZ DO ESPÍRITO SANTO,6751,1713,2165,13182,11017,562,1248
PB,20001,SANTA CECÍLIA,2020,1496,1443,5812,4369,109,529
PB,20010,CUBATI,2292,1498,588,5550,4962,137,537
PB,20036,CUITÉ,5729,3052,3915,15786,11871,381,1467
PB,20052,CUITEGI,1509,1513,1425,5451,4026,256,463
PB,20079,CURRAL VELHO,747,438,573,2067,1494,28,214
PB,20095,DESTERRO,2583,1415,1635,6591,4956,130,599
PB,20117,VISTA SERRANA,1050,410,564,2615,2051,61,252
PB,20133,DIAMANTE,2612,554,1497,5473,3976,83,534
PB,20150,DONA INÊS,3780,1458,2058,8778,6720,111,958
PB,20176,DUAS ESTRADAS,1104,819,517,3064,2547,114,337
PB,20192,EMAS,1141,715,388,2687,2299,54,287
PB,20214,ESPERANÇA,7278,6001,5596,23831,18235,1084,1921
PB,20230,FAGUNDES,3441,2144,1457,8781,7324,191,1091
PB,20257,FREI MARTINHO,964,593,446,2629,2183,53,240
PB,20273,GUARABIRA,12263,10571,6887,37985,31098,1466,2332
PB,20290,GURINHÉM,4099,2387,2713,11098,8385,469,855
PB,20311,GURJÃO,1111,715,464,2802,2338,51,284
PB,20338,IBIARA,2369,631,840,4686,3846,130,545
PB,20354,IMACULADA,3362,1264,2429,8203,5774,139,781
PB,20370,INGÁ,4954,2859,1998,12493,10495,481,1300
PB,20397,ITABAIANA,8591,3083,3249,19162,15913,638,1518
PB,20419,ITAPORANGA,7874,2074,4084,16647,12563,324,1399
PB,20435,ITAPOROROCA,4611,2779,2505,11848,9343,402,1119
PB,20451,ITATUBA,3221,1401,941,7228,6287,214,730
PB,20478,JACARAÚ,4493,2233,2934,11764,8830,288,1027
PB,20494,JERICÓ,2971,777,1022,5765,4743,164,483
PB,20516,JOÃO PESSOA,151821,84827,65902,467251,401349,12591,23978
PB,20532,JUAREZ TÁVORA,2982,748,1279,6375,5096,298,590
PB,20559,JUAZEIRINHO,4406,2867,2036,11790,9754,339,1063
PB,20575,JUNCO DO SERIDÓ,1805,1267,841,4945,4104,207,439
PB,20591,JURIPIRANGA,3880,1423,1440,8283,6843,217,833
PB,20613,JURU,3921,454,1536,7056,5520,119,800
PB,20630,LAGOA,2324,273,651,3994,3343,91,368
PB,20656,LAGOA DE DENTRO,2191,1249,993,5453,4460,251,498
PB,20672,LAGOA SECA,5385,5640,2769,18303,15534,996,1608
PB,20699,LASTRO,1961,193,320,2865,2545,30,270
PB,20710,LIVRAMENTO,2143,1075,1200,5480,4280,163,510
PB,20737,LUCENA,3705,1401,1978,9510,7532,402,723
PB,20753,MÃE D'ÁGUA,1469,782,641,3347,2706,51,301
PB,20770,MALTA,1839,671,830,4229,3399,110,395
PB,20796,MAMANGUAPE,12437,5431,6726,30454,23728,1008,2217
PB,20818,MANAÍRA,4253,594,2438,8577,6139,152,912
PB,20834,MARI,6394,2875,3501,15805,12304,482,1421
PB,20850,MASSARANDUBA,3418,2279,1343,8982,7639,394,1060
PB,20877,MATARACA,2220,1240,814,5597,4783,198,461
PB,20893,MOGEIRO,4246,2141,2889,10646,7757,259,767
PB,20915,MONTADAS,1184,1122,406,3452,3046,127,369
PB,20931,MONTE HOREBE,1922,232,790,3464,2674,48,332
PB,20958,MONTEIRO,10841,2602,4701,22844,18143,713,2422
PB,20974,MULUNGU,3620,1765,1072,7757,6685,257,655
PB,20990,NATUBA,2476,1013,1787,6707,4920,191,778
PB,21016,NAZAREZINHO,3476,433,789,5645,4856,121,634
PB,21032,NOVA FLORESTA,2340,2185,1382,7291,5909,195,701
PB,21059,NOVA OLINDA,1825,847,1466,5002,3536,112,535
PB,21075,NOVA PALMEIRA,1405,607,423,3080,2657,125,308
PB,21091,OLHO D'ÁGUA,2295,1568,1515,6333,4818,120,631
PB,21113,OLIVEDOS,1141,776,325,2887,2562,148,266
PB,21130,OURO VELHO,1086,576,317,2466,2149,41,238
PB,21156,PASSAGEM,884,434,444,2057,1613,40,156
PB,21172,PATOS,23554,16803,13089,66463,53374,1882,4127
PB,21199,PAULISTA,3835,1828,2078,9626,7548,211,939
PB,21210,PEDRA BRANCA,1579,444,565,3208,2643,44,345
PB,21237,PEDRA LAVRADA,1903,1704,707,5505,4798,171,570
PB,21253,PEDRAS DE FOGO,8999,3273,1377,17074,15697,516,1664
PB,21270,PIANCÓ,4719,2639,1852,11600,9748,274,1282
PB,21296,PICUÍ,4913,3507,2671,14258,11587,301,1256
PB,21318,PILAR,4362,1020,1579,8854,7275,251,758
PB,21334,PILÕES,2467,1317,1591,6497,4906,195,532
PB,21350,PILÕEZINHOS,1539,1096,1364,4965,3601,277,443
PB,21377,PIRPIRITUBA,2785,1723,1804,7528,5724,248,586
PB,21393,PITIMBU,3989,1738,1812,9715,7903,375,691
PB,21415,POCINHOS,3838,4106,2358,12889,10531,561,1144
PB,21431,POMBAL,10944,3854,4732,23978,19246,394,1862
PB,21458,PRATA,1362,570,468,3252,2784,86,318
PB,21474,PRINCESA ISABEL,5815,2750,3683,14927,11244,335,1332
PB,21490,PUXINANÃ,3220,3005,1419,10038,8619,435,918
PB,21512,QUEIMADAS,9790,7915,6170,30345,24175,1277,2645
PB,21539,QUIXABA,802,391,156,1612,1456,41,152
PB,21555,REMÍGIO,5452,2092,3318,13088,9770,311,938
PB,21571,RIACHO DOS CAVALOS,3490,882,821,6236,5415,175,487
PB,21598,RIO TINTO,7125,3279,4061,17845,13784,534,1304
PB,21610,SALGADINHO,903,729,524,2617,2093,65,185
PB,21636,SALGADO DE SÃO FÉLIX,4465,1202,3116,10364,7248,177,934
PB,21652,SANTA CRUZ,3194,390,728,4985,4257,58,437
PB,21679,SANTA HELENA,2672,384,1248,5154,3906,104,502
PB,21695,SANTA LUZIA,3228,3187,2159,11443,9284,323,894
PB,21717,SANTANA DE MANGUEIRA,2624,205,779,4302,3523,56,550
PB,21733,SANTANA DOS GARROTES,2342,955,1890,6221,4331,150,677
PB,21750,SANTA RITA,33123,15141,14739,85237,70498,3554,6324
PB,21776,SANTA TERESINHA,1726,1146,486,4025,3539,98,333
PB,21792,SÃO BENTO,6866,7603,3888,22710,18822,537,1911
PB,21814,SÃO JOÃO DO CARIRI,1606,916,672,3880,3208,88,292
PB,21830,SÃO JOÃO DO TIGRE,1644,374,689,3378,2689,98,412
PB,21857,SÃO JOSÉ DA LAGOA TAPADA,3031,817,1165,6279,5114,148,849
PB,21873,SÃO JOSÉ DE CAIANA,2295,404,1525,4894,3369,67,484
PB,21890,SÃO JOSÉ DE ESPINHARAS,1686,853,492,3752,3260,89,383
PB,21911,SÃO JOSÉ DE PIRANHAS,8339,775,3388,14394,11006,238,1143
PB,21938,SÃO JOSÉ DO BONFIM,1425,699,458,3108,2650,72,274
PB,21954,SÃO JOSÉ DO SABUGI,1223,742,309,3304,2995,75,362
PB,21970,SÃO JOSÉ DOS CORDEIROS,1416,458,510,2918,2408,93,302
PB,21997,SÃO MAMEDE,2201,1814,888,6088,5200,71,532
PB,22012,SÃO MIGUEL DE TAIPU,2444,891,851,4984,4133,107,471
PB,22039,SÃO SEBASTIÃO DE LAGOA DE ROÇA,2077,2506,1965,8529,6564,327,827
PB,22055,SÃO SEBASTIÃO DO UMBUZEIRO,1472,350,375,2699,2324,80,304
PB,22071,SAPÉ,13705,6752,10323,37457,27134,1408,2944
PB,22098,SÃO VICENTE DO SERIDÓ,2714,1648,1786,7558,5772,164,602
PB,22110,SERRA BRANCA,4142,1811,2020,9691,7671,288,821
PB,22136,SERRA DA RAIZ,756,823,326,2359,2033,78,224
PB,22152,SERRA GRANDE,1236,235,501,2434,1933,51,308
PB,22179,SERRA REDONDA,2717,996,1516,6310,4794,196,559
PB,22195,SERRARIA,1644,986,845,4394,3549,121,548
PB,22217,SOLÂNEA,5745,5057,7154,22428,15274,687,1635
PB,22233,SOLEDADE,3506,2940,1727,10306,8579,347,928
PB,22250,SOUSA,22880,5513,9149,46278,37129,1074,3271
PB,22276,SUMÉ,6120,1267,2654,12349,9695,330,1099
PB,22292,CAMPO DE SANTANA,2661,1634,1670,7194,5524,162,697
PB,22314,TAPEROÁ,3845,2570,2533,10561,8028,240,903
PB,22330,TAVARES,4992,895,3031,10676,7645,227,1205
PB,22357,TEIXEIRA,4384,1843,2033,10002,7969,327,868
PB,22373,TRIUNFO,3375,571,2446,7444,4998,147,593
PB,22390,UIRAÚNA,5329,1492,2330,11087,8757,171,1006
PB,22411,UMBUZEIRO,2469,1323,1098,6152,5054,240,695
PB,22438,VÁRZEA,791,330,236,2122,1886,48,209
PE,23000,QUIXABA,3382,171,1344,5446,4102,60,343
PE,23019,AFOGADOS DA INGAZEIRA,11239,4696,7351,26909,19558,720,1753
PE,23027,LAGOA DO CARRO,5133,2720,2205,12295,10090,348,827
PE,23035,AFRÂNIO,8469,1306,1698,14207,12509,385,1489
PE,23043,SANTA CRUZ DA BAIXA VERDE,5752,292,1527,8832,7305,178,833
PE,23051,AGRESTINA,9051,2225,3082,17485,14403,632,1594
PE,23060,XEXÉU,4413,981,3799,11399,7600,482,849
PE,23078,ÁGUA PRETA,9448,2000,6127,21479,15352,656,1610
PE,23086,VERTENTE DO LÉRIO,3102,994,1498,6871,5373,312,612
PE,23094,ÁGUAS BELAS,11893,5184,4565,25917,21352,395,2927
PE,23108,SANTA CRUZ,6529,439,1298,9669,8371,129,987
PE,23116,ALAGOINHA,5895,957,1766,10231,8465,313,976
PE,23124,JUCATI,4802,371,2396,8821,6425,240,731
PE,23132,ALIANÇA,11883,3119,7875,28678,20803,909,2060
PE,23140,DORMENTES,7679,1117,2477,13544,11067,353,1182
PE,23159,ALTINHO,7889,2070,4085,17092,13007,745,1565
PE,23167,CARNAUBEIRA DA PENHA,5755,288,2470,9806,7336,136,967
PE,23175,AMARAJI,7220,1164,4617,17368,12751,785,1223
PE,23183,LAGOA GRANDE,9793,1539,3666,17223,13557,170,1337
PE,23191,ANGELIM,3162,1842,1959,7974,6015,157,601
PE,23205,ARAÇOIABA,6976,1767,2640,14274,11634,378,1013
PE,23213,ARARIPINA,26344,5589,12862,53640,40778,1114,4453
PE,23221,CASINHAS,5179,1417,3490,11997,8507,439,1067
PE,23230,ARCOVERDE,23171,4313,10088,45839,35751,1311,2773
PE,23248,MANARI,5023,1213,2880,10354,7474,193,887
PE,23256,BARRA DE GUABIRABA,4114,1090,2412,9617,7205,375,629
PE,23264,JATOBÁ,6168,612,2766,10810,8044,107,732
PE,23272,BARREIROS,14070,2299,9459,31605,22146,927,1792
PE,23280,TAMANDARÉ,7673,1269,1072,12825,11753,380,967
PE,23299,BELÉM DE MARIA,4834,717,1472,8369,6897,241,793
PE,23302,JAQUEIRA,4059,755,2613,8865,6252,239,787
PE,23310,BELÉM DE SÃO FRANCISCO,9008,804,2036,13898,11862,156,1124
PE,23329,SANTA FILOMENA,5408,715,2425,9898,7473,193,914
PE,23337,BELO JARDIM,21432,11148,12717,54964,42247,2222,4396
PE,23353,BETÂNIA,5452,186,2328,9538,7210,160,1203
PE,23370,BEZERROS,20313,5695,9439,44708,35269,2658,3728
PE,23396,BODOCÓ,13023,1721,4956,23108,18152,536,2235
PE,23418,BOM CONSELHO,15547,2907,9175,32230,23055,712,2762
PE,23434,BOM JARDIM,13396,3995,8549,30706,22157,1001,2337
PE,23450,BONITO,14023,2363,7074,29227,22153,1032,2615
PE,23477,BREJÃO,4409,1118,1558,8410,6852,251,805
PE,23493,BREJINHO,3579,437,1375,6475,5100,173,674
PE,23515,BREJO DA MADRE DE DEUS,12444,4456,6423,27971,21548,912,2233
PE,23531,BUENOS AIRES,5345,1179,1979,10398,8419,399,830
PE,23558,BUÍQUE,17679,1247,10347,34825,24478,805,3775
PE,23574,CABO DE SANTO AGOSTINHO,67342,13281,21869,139461,117592,5557,7654
PE,23590,CABROBÓ,14000,965,4670,22095,17425,233,1346
PE,23612,CACHOEIRINHA,7284,1749,4024,15297,11273,577,1101
PE,23639,CAETÉS,8643,1582,5229,17756,12527,476,1402
PE,23655,CALÇADO,3997,535,1897,7367,5470,175,560
PE,23671,CALUMBI,3748,99,1182,5784,4602,91,559
PE,23698,CAMOCIM DE SÃO FÉLIX,7082,1148,2895,13469,10574,489,1180
PE,23710,CAMUTANGA,2638,1532,1313,6862,5549,266,537
PE,23736,CANHOTINHO,5822,4141,5708,18228,12520,489,1461
PE,23752,CAPOEIRAS,7321,1116,4700,15347,10647,591,1082
PE,23779,CARNAÍBA,7913,1140,3291,14009,10718,277,1054
PE,23795,CARPINA,18273,10794,8818,50713,41895,1734,2807
PE,23817,CARUARU,79368,42082,30972,196564,165592,11265,11403
PE,23833,CATENDE,13231,1824,7125,25985,18860,582,1663
PE,23850,CEDRO,5202,365,2187,8775,6588,103,744
PE,23876,CHÃ DE ALEGRIA,4246,1700,1524,9830,8306,336,851
PE,23892,CHÃ GRANDE,6123,3237,2902,15589,12687,913,1307
PE,23914,CONDADO,7346,2015,4602,18188,13586,609,1142
PE,23930,CORRENTES,6557,640,3899,12611,8712,251,888
PE,23957,CORTÊS,5329,1462,1806,10695,8889,256,940
PE,23973,CUMARU,7400,1810,3825,15162,11337,449,1112
PE,23990,CUPIRA,9120,1423,5363,18947,13584,624,1396
PE,24015,CUSTÓDIA,14238,1212,7491,26035,18544,521,2110
PE,24031,ESCADA,23860,3165,9566,46561,36995,970,2709
PE,24058,EXU,13515,1530,8819,27488,18669,444,2474
PE,24074,FEIRA NOVA,6472,1797,2258,14557,12299,689,1342
PE,24090,FERREIROS,3021,2128,1254,8327,7073,512,722
PE,24112,FLORES,9045,495,3174,14998,11824,315,1539
PE,24139,FLORESTA,12051,1626,4410,20902,16492,225,1436
PE,24155,FREI MIGUELINHO,5252,1921,1524,10554,9030,461,977
PE,24171,GAMELEIRA,7792,1404,4688,16503,11815,379,1108
PE,24198,GARANHUNS,45017,6307,17808,85553,67745,2630,5257
PE,24210,GLÓRIA DO GOITÁ,8265,4004,5846,21981,16135,802,1764
PE,24236,GOIANA,26992,5293,10389,55876,45487,1658,2485
PE,24252,GRANITO,3405,162,836,4985,4149,43,416
PE,24279,GRAVATÁ,22130,11829,10792,55859,45067,2651,3618
PE,24295,IATI,7425,742,4589,14917,10328,287,1472
PE,24317,IBIMIRIM,10309,972,3552,17056,13504,311,1537
PE,24333,IBIRAJUBA,3398,503,1269,6098,4829,180,517
PE,24350,IGARASSU,30638,7213,10101,64655,54554,2149,3176
PE,24376,IGUARACI,4605,966,2814,9695,6881,207,814
PE,24392,INAJÁ,6285,653,2362,10558,8196,149,904
PE,24414,INGAZEIRA,2054,271,640,3455,2815,89,291
PE,24430,IPOJUCA,27559,5337,10491,58257,47766,2174,3562
PE,24457,IPUBI,9600,1679,5390,19757,14367,491,1880
PE,24473,ITACURUBA,2700,129,601,3867,3266,44,260
PE,24490,ITAÍBA,8308,2484,5599,18823,13224,355,1723
PE,24511,ILHA DE ITAMARACÁ,6955,1303,756,11593,10837,311,588
PE,24538,ITAPETIM,5887,866,1975,10370,8395,270,982
PE,24554,ITAQUITINGA,5882,1134,2797,12530,9733,261,810
PE,24570,JABOATÃO DOS GUARARAPES,148738,50649,63103,400330,337227,15328,18204
PE,24597,JATAÚBA,5452,2457,2870,12566,9696,251,1154
PE,24619,JOÃO ALFREDO,10017,3256,3485,20599,17114,874,2149
PE,24635,JOAQUIM NABUCO,5571,1472,2393,11809,9416,423,887
PE,24651,JUPI,6361,476,1950,10307,8357,299,810
PE,24678,JUREMA,5263,842,2868,10613,7745,235,1106
PE,24694,LAGOA DE ITAENGA,6185,3628,2738,16422,13684,749,1256
PE,24716,LAGOA DO OURO,5919,445,1937,9711,7774,205,937
PE,24732,LAGOA DOS GATOS,5936,921,3480,12082,8602,365,989
PE,24759,LAJEDO,11007,4295,4166,24410,20244,1124,1960
PE,24775,LIMOEIRO,20115,6573,10763,46357,35594,2041,2759
PE,24791,MACAPARANA,7823,2492,4066,18223,14157,714,1664
PE,24813,MACHADOS,4240,1269,2052,9295,7243,433,796
PE,24830,MARAIAL,4212,907,3204,9989,6785,242,912
PE,24856,MIRANDIBA,5957,818,2098,10610,8512,340,1048
PE,24872,MORENO,17615,4214,6904,41243,34339,1815,2443
PE,24899,NAZARÉ DA MATA,10608,3289,5184,25275,20091,1245,1644
PE,24910,OLINDA,119506,37308,44443,300670,256227,10426,12733
PE,24937,OROBÓ,7075,2719,5979,18858,12879,691,1443
PE,24953,OROCÓ,5733,1427,2222,10695,8473,177,773
PE,24970,OURICURI,22681,2546,11101,41730,30629,617,3672
PE,24996,PALMARES,20470,2684,12348,44232,31884,1444,2785
PE,25011,PALMEIRINA,3513,298,2020,6819,4799,88,615
PE,25038,PANELAS,10280,1302,6374,20732,14358,343,1884
PE,25054,PARANATAMA,5067,298,1430,8117,6687,181,828
PE,25070,PARNAMIRIM,10653,729,3154,15873,12719,167,890
PE,25097,PASSIRA,11259,3052,6383,24577,18194,892,1890
PE,25119,PAUDALHO,11246,9670,5714,34666,28952,1740,2430
PE,25135,PAULISTA,78066,22112,27388,187219,159831,5627,7090
PE,25151,PEDRA,8253,1094,4626,16983,12357,509,1582
PE,25178,PESQUEIRA,24842,3375,11664,46781,35117,1257,3594
PE,25194,PETROLÂNDIA,13821,1409,4875,22966,18091,407,1452
PE,25216,PETROLINA,89480,15162,28548,164881,136333,3353,8916
PE,25232,POÇÃO,4568,910,1874,8775,6901,301,880
PE,25259,POMBOS,8185,2626,2613,17441,14828,1156,1429
PE,25275,PRIMAVERA,4708,659,2127,9723,7596,286,618
PE,25291,QUIPAPÁ,6955,1222,6231,17255,11024,441,1419
PE,25313,RECIFE,378031,171405,179061,1142321,963260,36306,46200
PE,25330,RIACHO DAS ALMAS,8300,1884,2535,15710,13175,1112,1358
PE,25356,RIBEIRÃO,14044,2251,8675,31109,22434,735,1888
PE,25372,RIO FORMOSO,7808,1415,1380,13382,12002,379,954
PE,25399,SAIRÉ,5675,889,1495,10371,8876,533,1158
PE,25410,SALGADINHO,2620,835,1265,5797,4532,257,546
PE,25437,SALGUEIRO,21305,4010,7621,37145,29524,645,2285
PE,25453,SALOÁ,6304,636,3757,12640,8883,311,1169
PE,25470,SANHARÓ,7557,1320,2609,14051,11442,558,1258
PE,25496,SANTA CRUZ DO CAPIBARIBE,18081,13076,8179,50031,41852,1886,2537
PE,25518,SANTA MARIA DA BOA VISTA,15069,2925,5289,26440,21151,277,1857
PE,25534,SANTA MARIA DO CAMBUCÁ,3862,1960,2073,9694,7621,434,858
PE,25550,SANTA TEREZINHA,4285,681,2260,8203,5943,97,513
PE,25577,SÃO BENEDITO DO SUL,2992,726,2743,7878,5135,183,789
PE,25593,SÃO BENTO DO UNA,16245,3143,9090,33142,24052,1100,2322
PE,25615,SÃO CAITANO,13442,3121,5901,27885,21984,1433,2495
PE,25631,SÃO JOÃO,9290,741,4477,16525,12048,275,1049
PE,25658,SÃO JOAQUIM DO MONTE,7411,2389,4183,16899,12716,608,1696
PE,25674,SÃO JOSÉ DA COROA GRANDE,5292,1952,2478,12098,9620,458,914
PE,25690,SÃO JOSÉ DO BELMONTE,13192,1264,8251,25417,17166,381,1792
PE,25712,SÃO JOSÉ DO EGITO,12484,2098,6278,24073,17795,621,1719
PE,25739,SÃO LOURENÇO DA MATA,30522,9265,11896,71745,59849,2895,3727
PE,25755,SÃO VICENTE FERRÉR,6500,1572,3609,14034,10425,339,1056
PE,25771,SERRA TALHADA,32531,2497,13341,55767,42426,924,4051
PE,25798,SERRITA,7544,1064,3761,14301,10540,222,1352
PE,25810,SERTÂNIA,12954,2791,3333,22451,19118,554,1988
PE,25836,SIRINHAÉM,12399,2678,3133,23584,20451,676,1856
PE,25852,MOREILÂNDIA,5167,362,1323,8046,6723,134,799
PE,25879,SOLIDÃO,2929,267,1167,4985,3818,117,436
PE,25895,SURUBIM,17201,7342,9160,41218,32058,2148,2414
PE,25917,TABIRA,10801,1472,4972,19621,14649,410,1441
PE,25933,TACAIMBÓ,4638,1386,2582,10337,7755,479,855
PE,25950,TACARATU,6645,920,3386,12673,9287,270,950
PE,25976,ITAMBÉ,11309,3440,6219,24889,18670,640,1825
PE,25992,TAQUARITINGA DO NORTE,6813,4145,3370,17521,14151,814,1195
PE,26018,TEREZINHA,3164,410,728,5270,4542,137,586
PE,26034,TERRA NOVA,5017,230,740,6832,6092,99,514
PE,26050,TIMBAÚBA,20375,5570,11005,45310,34305,1450,2780
PE,26077,TORITAMA,10168,3442,4059,21242,17183,969,1211
PE,26093,TRACUNHAÉM,4378,1365,1283,9435,8152,433,712
PE,26115,TRINDADE,9472,1345,5070,18118,13048,300,1398
PE,26131,TRIUNFO,6805,562,2670,11705,9035,283,819
PE,26158,TUPANATINGA,7401,997,5176,15801,10625,321,1502
PE,26174,TUPARETAMA,4396,451,1522,7324,5802,179,561
PE,26190,VENTUROSA,6712,900,2064,11636,9572,353,1020
PE,26212,VERDEJANTE,3932,610,1041,6671,5630,128,747
PE,26239,VERTENTES,5229,3273,2471,13411,10940,634,1106
PE,26255,VICÊNCIA,8532,2498,6188,22946,16758,718,1756
PE,26271,VITÓRIA DE SANTO ANTÃO,41489,15608,16849,93569,76720,3838,5853
PE,26298,CAMARAGIBE,40047,14296,15105,107948,92843,4153,5167
PE,26310,ABREU E LIMA,33352,8717,12190,76154,63964,2565,3577
PE,26336,ITAPISSUMA,7022,2066,893,13588,12695,607,797
PE,30015,FERNANDO DE NORONHA,835,255,464,2095,1631,72,127
PI,10006,BRASILEIRA,3053,765,1375,6155,4780,154,565
PI,10014,AGRICOLÂNDIA,2465,525,941,4563,3622,73,345
PI,10022,ALEGRETE DO PIAUÍ,2185,316,828,3950,3122,57,390
PI,10030,ÁGUA BRANCA,6169,1483,2392,11989,9597,229,794
PI,10049,BAIXA GRANDE DO RIBEIRO,3582,794,1189,6703,5514,51,664
PI,10057,ALTO LONGÁ,5786,1238,2155,10976,8821,153,949
PI,10065,BOM PRINCÍPIO DO PIAUÍ,2437,811,817,5057,4240,89,424
PI,10073,ALTOS,15555,3861,5554,28851,23297,414,1668
PI,10081,BONFIM DO PIAUÍ,2262,279,832,4105,3273,72,500
PI,10090,AMARANTE,7138,1391,3310,13796,10486,211,1020
PI,10103,BURITI DOS MONTES,2936,643,1132,5660,4528,72,487
PI,10111,ANGICAL DO PIAUÍ,3381,663,1149,6296,5147,116,382
PI,10120,CABECEIRAS DO PIAUÍ,4121,606,1582,7293,5711,116,628
PI,10138,ANÍSIO DE ABREU,3264,601,1286,6154,4868,54,623
PI,10146,CALDEIRÃO GRANDE DO PIAUÍ,2368,379,801,4132,3331,78,382
PI,10154,ANTÔNIO ALMEIDA,986,629,583,2730,2147,36,229
PI,10162,CANAVIEIRA,1630,301,794,3188,2394,67,291
PI,10170,AROAZES,2992,396,981,5024,4043,50,419
PI,10189,COIVARAS,2230,532,511,3976,3465,42,285
PI,10197,ARRAIAL,1972,263,991,3896,2905,41,330
PI,10200,COLÔNIA DO GURGUÉIA,2623,348,1051,4768,3717,48,381
PI,10219,AVELINO LOPES,4002,700,2006,8114,6108,121,718
PI,10227,COLÔNIA DO PIAUÍ,3076,296,1756,5932,4176,56,483
PI,10235,BARRAS,12976,6097,7416,30957,23541,489,2318
PI,10243,CORONEL JOSÉ DIAS,2492,500,725,4362,3637,78,351
PI,10251,BARREIRAS DO PIAUÍ,1510,265,792,2902,2110,32,188
PI,10260,FARTURA DO PIAUÍ,2209,289,1103,4220,3117,35,389
PI,10278,BARRO DURO,2717,526,1452,5699,4247,57,378
PI,10286,JACOBINA DO PIAUÍ,2632,192,871,4395,3524,89,328
PI,10294,BATALHA,8341,3715,5691,20392,14701,334,1590
PI,10308,JARDIM DO MULATO,1942,334,503,3443,2940,61,267
PI,10316,BENEDITINOS,4189,1234,1749,8364,6615,109,727
PI,10324,LAGOA ALEGRE,4168,609,1196,6854,5658,73,487
PI,10332,BERTOLÍNIA,2157,470,755,3979,3224,84,290
PI,10340,LAGOA DO BARRO DO PIAUÍ,2008,214,841,3636,2795,61,382
PI,10359,BOCAINA,2394,1303,666,5020,4354,85,296
PI,10367,MARCOLÂNDIA,3104,657,925,5827,4902,151,634
PI,10375,BOM JESUS,6325,2767,2522,13897,11375,194,831
PI,10383,PATOS DO PIAUÍ,2769,562,1028,5307,4279,124,669
PI,10391,BURITI DOS LOPES,6699,2858,2873,14764,11891,194,1161
PI,10405,PASSAGEM FRANCA DO PIAUÍ,1736,258,737,3277,2540,29,320
PI,10413,CAMPINAS DO PIAUÍ,2632,215,923,4468,3545,104,464
PI,10421,QUEIMADA NOVA,3924,217,1442,6404,4962,94,627
PI,10430,CAMPO MAIOR,17194,6065,6190,34395,28205,494,1915
PI,10448,SANTA CRUZ DOS MILAGRES,1533,286,712,2942,2230,19,231
PI,10456,CANTO DO BURITI,7234,2072,3594,14919,11325,237,1115
PI,10464,SANTA ROSA DO PIAUÍ,1930,623,1091,4183,3092,47,391
PI,10472,CAPITÃO DE CAMPOS,4111,924,1939,8331,6392,205,720
PI,10480,SANTANA DO PIAUÍ,1941,521,676,3680,3004,66,315
PI,10499,CARACOL,4018,653,1389,7207,5818,103,680
PI,10502,SÃO BRAZ DO PIAUÍ,1978,268,793,3644,2851,61,353
PI,10510,CASTELO DO PIAUÍ,6564,2287,4397,15574,11177,217,1296
PI,10529,SÃO JOSÉ DO DIVINO,2335,697,1030,4627,3597,62,329
PI,10537,COCAL,6128,4647,5532,19420,13888,801,1524
PI,10545,SIGEFREDO PACHECO,4223,1005,1332,7546,6214,102,527
PI,10553,CONCEIÇÃO DO CANINDÉ,2326,243,866,4148,3282,78,474
PI,10561,SÃO LOURENÇO DO PIAUÍ,2311,302,903,4159,3256,54,317
PI,10570,CORRENTE,8473,1842,3882,17135,13253,182,1257
PI,10588,VÁRZEA BRANCA,1881,327,872,3624,2752,40,413
PI,10596,CRISTALÂNDIA DO PIAUÍ,2448,625,1455,5261,3806,60,527
PI,10600,BARRA D'ALCÂNTARA,1383,454,615,2919,2304,35,298
PI,10618,CRISTINO CASTRO,3288,678,1871,7015,5144,132,632
PI,10626,BELA VISTA DO PIAUÍ,1827,137,265,2645,2380,79,262
PI,10634,CURIMATÁ,3562,1403,1995,8055,6060,95,516
PI,10642,BREJO DO PIAUÍ,1829,133,855,3456,2601,68,452
PI,10650,DEMERVAL LOBÃO,4739,1332,1084,8546,7462,105,680
PI,10669,BOA HORA,2711,441,1150,5070,3920,77,449
PI,10677,DOM EXPEDITO LOPES,3478,842,802,6063,5261,63,526
PI,10685,DOM INOCÊNCIO,4377,419,1441,7070,5629,72,615
PI,10693,ELESBÃO VELOSO,6615,1210,2759,12426,9667,132,1169
PI,10707,CAPITÃO GERVÁSIO OLIVEIRA,1824,259,691,3253,2562,55,346
PI,10715,ELISEU MARTINS,1866,388,839,3773,2934,99,320
PI,10723,CAMPO GRANDE DO PIAUÍ,2525,201,767,4317,3550,71,450
PI,10731,ESPERANTINA,10599,6287,7107,27528,20421,443,1861
PI,10740,CAMPO LARGO DO PIAUÍ,2428,521,1123,4736,3613,100,415
PI,10758,FLORES DO PIAUÍ,1773,473,745,3658,2913,78,416
PI,10766,CURRAIS,2715,374,688,4211,3523,47,204
PI,10774,FLORIANO,19397,6552,8032,40063,32031,626,1876
PI,10782,GEMINIANO,2533,566,754,4630,3876,119,497
PI,10790,FRANCINÓPOLIS,2071,595,1031,4420,3389,81,414
PI,10804,GUARIBAS,2016,193,1016,3663,2647,33,335
PI,10812,FRANCISCO AYRES,2054,425,1101,4174,3073,48,371
PI,10820,ILHA GRANDE,3427,911,1317,6878,5561,150,517
PI,10839,FRANCISCO SANTOS,3596,863,1486,7138,5652,150,540
PI,10847,JUREMA,2153,496,735,3936,3201,72,341
PI,10855,FRONTEIRAS,4634,760,1714,8589,6875,205,628
PI,10863,LAGOA DE SÃO FRANCISCO,2542,267,1159,4695,3536,75,435
PI,10871,GILBUÉS,3659,702,1981,7414,5433,76,561
PI,10880,MORRO CABEÇA NO TEMPO,1422,464,1012,3393,2381,47,344
PI,10898,GUADALUPE,3815,1178,1910,7877,5967,97,394
PI,10901,NOVO SANTO ANTÔNIO,1861,228,588,3199,2611,34,269
PI,10910,HUGO NAPOLEÃO,1966,390,651,3559,2908,74,270
PI,10928,NOSSA SENHORA DE NAZARÉ,2877,400,779,4551,3772,37,229
PI,10936,INHUMA,5658,1279,3071,11916,8845,186,1063
PI,10944,PAQUETÁ,2281,258,564,3562,2998,39,307
PI,10952,IPIRANGA DO PIAUÍ,3694,735,1476,6911,5435,126,642
PI,10960,NOVA SANTA RITA,2075,285,677,3659,2982,68,384
PI,10979,ISAÍAS COELHO,3041,504,1680,6273,4593,139,649
PI,10987,SÃO JOÃO DO ARRAIAL,2377,1419,1319,5696,4377,62,473
PI,10995,ITAINÓPOLIS,4809,676,1636,8710,7074,238,1010
PI,11010,ITAUEIRA,3953,1182,1517,8196,6679,227,903
PI,11037,JAICÓS,5090,1238,3393,11739,8346,260,1130
PI,11053,JERUMENHA,1943,725,796,3983,3187,86,265
PI,11070,JOAQUIM PIRES,4889,1897,2432,10437,8005,154,825
PI,11088,SÃO JOÃO DA CANABRAVA,2064,716,785,4122,3337,51,356
PI,11096,JOSÉ DE FREITAS,16625,3143,5052,28524,23472,433,1672
PI,11118,LANDRI SALES,2102,255,1417,4438,3021,49,360
PI,11134,LUIS CORREIA,9722,5031,5078,22643,17565,330,1531
PI,11150,LUZILÂNDIA,8885,2339,4359,18523,14164,288,1615
PI,11177,MANOEL EMÍDIO,2338,316,976,4340,3364,60,447
PI,11193,MARCOS PARENTE,1504,750,950,3856,2906,67,271
PI,11215,MATIAS OLÍMPIO,3011,1824,2030,8030,6000,171,649
PI,11231,MIGUEL ALVES,10455,3456,6120,23136,17016,382,1847
PI,11258,MIGUEL LEÃO,611,152,182,1114,932,6,71
PI,11274,MONSENHOR GIL,5112,945,1454,8997,7543,115,596
PI,11290,MONSENHOR HIPÓLITO,2999,852,1058,6007,4949,135,619
PI,11312,MONTE ALEGRE DO PIAUÍ,3807,671,2057,7529,5472,50,581
PI,11339,NAZARÉ DO PIAUÍ,3313,475,1431,6161,4730,90,664
PI,11355,NOSSA SENHORA DOS REMÉDIOS,3029,1165,1532,6551,5019,110,505
PI,11371,NOVO ORIENTE DO PIAUÍ,2976,407,1343,5410,4067,45,445
PI,11398,OEIRAS,13174,4165,5215,26360,21145,298,1899
PI,11410,DOMINGOS MOURÃO,1806,463,848,3519,2671,61,250
PI,11436,PADRE MARCOS,2410,1041,1268,5638,4370,118,515
PI,11452,PAES LANDIM,1283,738,662,3303,2641,66,258
PI,11479,PALMEIRA DO PIAUÍ,1979,514,910,4125,3215,75,392
PI,11495,PALMEIRAIS,6012,969,1750,10358,8608,134,871
PI,11517,PARNAGUÁ,3933,444,1526,6703,5177,60,451
PI,11533,PARNAÍBA,35686,21199,18856,92319,73463,1656,4218
PI,11550,PAULISTANA,8632,599,2927,14276,11349,220,1398
PI,11576,PEDRO II,13618,2666,7189,27844,20655,458,2071
PI,11592,PICOS,23479,8331,7303,47071,39768,1024,3187
PI,11614,PIMENTEIRAS,4403,1082,1829,8439,6610,78,772
PI,11630,PIO IX,6707,1663,2387,12810,10423,257,1109
PI,11657,PIRACURUCA,8724,4910,1874,17845,15971,255,1154
PI,11673,PIRIPIRI,18498,8691,4578,38028,33450,1058,3068
PI,11690,PORTO,4530,571,2106,8299,6193,113,645
PI,11711,PRATA DO PIAUÍ,1640,243,771,3166,2395,35,277
PI,11738,REDENÇÃO DO GURGUÉIA,2665,1093,1455,6060,4605,65,385
PI,11754,REGENERAÇÃO,7415,1238,3147,13394,10247,172,868
PI,11770,RIBEIRO GONÇALVES,2250,714,845,4657,3812,49,437
PI,11797,RIO GRANDE DO PIAUÍ,2334,1117,1463,5668,4205,66,491
PI,11819,SANTA CRUZ DO PIAUÍ,2926,598,775,5052,4277,60,508
PI,11835,SANTA FILOMENA,2160,438,1110,4333,3223,72,301
PI,11851,SANTA LUZ,1928,795,819,4237,3418,133,385
PI,11878,SANTO ANTÔNIO DE LISBOA,2574,738,800,4824,4024,129,361
PI,11894,SANTO INÁCIO DO PIAUÍ,1542,306,717,3037,2320,51,303
PI,11916,SÃO FÉLIX DO PIAUÍ,1901,360,535,3250,2715,29,182
PI,11932,SÃO FRANCISCO DO PIAUÍ,2915,430,1152,5219,4067,62,434
PI,11959,SÃO GONÇALO DO PIAUÍ,2364,304,676,4161,3485,59,288
PI,11975,SÃO JOÃO DA SERRA,2504,1098,1442,6048,4606,134,539
PI,11991,SÃO JOÃO DO PIAUÍ,6137,1979,2571,12882,10311,253,1123
PI,12009,SÃO JOÃO DA FRONTEIRA,2394,500,944,4425,3481,47,390
PI,12017,SÃO JOSÉ DO PEIXE,1492,370,752,3063,2311,51,277
PI,12025,SÃO JOÃO DA VARJOTA,2116,381,708,3640,2932,65,247
PI,12033,SÃO JOSÉ DO PIAUÍ,3092,478,1270,5628,4358,130,490
PI,12041,SEBASTIÃO BARROS,1989,470,825,3928,3103,48,403
PI,12050,SÃO JULIÃO,2977,410,964,4997,4033,46,421
PI,12068,SEBASTIÃO LEAL,1599,465,426,3172,2746,133,276
PI,12076,SÃO MIGUEL DO TAPUIO,5863,2520,4587,15034,10447,278,1435
PI,12084,ALVORADA DO GURGUÉIA,2042,236,738,3592,2854,51,296
PI,12092,SÃO PEDRO DO PIAUÍ,4695,1645,2468,10526,8058,187,811
PI,12106,ASSUNÇÃO DO PIAUÍ,2038,1027,1772,5748,3976,217,595
PI,12114,SÃO RAIMUNDO NONATO,9864,3683,3609,20183,16574,336,1368
PI,12122,BETÂNIA DO PIAUÍ,2855,199,955,4759,3804,54,553
PI,12130,SIMÕES,5327,626,2357,10052,7695,255,1024
PI,12149,BOQUEIRÃO DO PIAUÍ,2377,271,1146,4340,3194,73,311
PI,12157,SIMPLÍCIO MENDES,3850,1841,1953,9191,7238,235,704
PI,12165,CARIDADE DO PIAUÍ,2438,302,750,4032,3282,54,369
PI,12173,SOCORRO DO PIAUÍ,1755,584,865,3937,3072,40,364
PI,12181,CURRAL NOVO DO PIAUÍ,2010,128,688,3379,2691,74,358
PI,12190,TERESINA,224518,91393,80157,517490,437333,7479,18546
PI,12203,JÚLIO BORGES,2401,184,1073,4153,3080,41,311
PI,12211,UNIÃO,16059,5777,5845,32039,26194,415,2352
PI,12220,LAGOA DO SÍTIO,2670,231,1004,4572,3568,38,471
PI,12238,URUÇUÍ,3858,4988,3124,14208,11084,298,945
PI,12246,MILTON BRANDÃO,2806,423,1334,5258,3924,78,407
PI,12254,VALENÇA DO PIAUÍ,7938,1427,3708,15704,11996,241,1250
PI,12262,PAJEÚ DO PIAUÍ,1184,448,800,2858,2058,25,288
PI,12270,VÁRZEA GRANDE,1509,773,1061,3903,2842,54,370
PI,12289,PAVUSSU,1923,232,900,3541,2641,68,352
PI,12297,DIRCEU ARCOVERDE,2747,544,1526,5538,4012,83,438
PI,12300,RIACHO FRIO,2336,256,756,3825,3069,28,282
PI,12319,ALAGOINHA DO PIAUÍ,2667,1555,1076,6120,5044,91,603
PI,12327,ACAUÃ,3448,213,548,4911,4363,97,450
PI,12335,BELÉM DO PIAUÍ,1423,205,403,2532,2129,73,230
PI,12343,CAJAZEIRAS DO PIAUÍ,1720,198,491,2779,2288,45,242
PI,12351,CAMPO ALEGRE DO FIDALGO,2336,254,881,4052,3171,36,409
PI,12360,COCAL DE TELHA,2152,217,1227,4164,2937,63,375
PI,12378,FRANCISCO MACEDO,1414,79,419,2220,1801,36,187
PI,12386,JOÃO COSTA,1693,182,491,2838,2347,42,299
PI,12394,JATOBÁ DO PIAUÍ,2779,818,830,5069,4239,52,357
PI,12408,JOCA MARQUES,2085,587,945,4095,3150,70,311
PI,12416,JUAZEIRO DO PIAUÍ,2724,733,1066,5425,4359,108,419
PI,12424,LAGOA DO PIAUÍ,1794,419,300,2962,2662,35,223
PI,12432,LAGOINHA DO PIAUÍ,1276,244,386,2251,1865,38,162
PI,12440,MADEIRO,2380,1003,1551,5773,4222,52,476
PI,12459,MORRO DO CHAPÉU DO PIAUÍ,2371,1133,1640,5836,4196,84,462
PI,12467,MASSAPÊ DO PIAUÍ,2919,489,1232,5522,4290,119,600
PI,12475,MURICI DOS PORTELAS,2703,860,1366,5903,4537,88,631
PI,12483,OLHO D'ÁGUA DO PIAUÍ,1158,168,403,2051,1648,34,174
PI,12491,PEDRO LAURENTINO,1554,148,443,2494,2051,33,182
PI,12505,SÃO FRANCISCO DE ASSIS DO PIAUÍ,2315,291,710,3946,3236,65,424
PI,12513,SUSSUAPARA,2893,743,658,5008,4350,111,369
PI,12521,TANQUE DO PIAUÍ,1138,200,453,2187,1734,33,207
PI,12530,TAMBORIL DO PIAUÍ,921,656,655,2639,1984,41,267
PI,12548,VILA NOVA DO PIAUÍ,1498,169,383,2481,2098,37,248
PI,12556,VERA MENDES,1318,330,605,2781,2176,119,321
PI,12564,WALL FERRAZ,2149,194,635,3487,2852,42,359
PI,12572,CAJUEIRO DA PRAIA,3162,581,1052,5525,4473,71,404
PI,12580,CURRALINHOS,2329,337,548,3793,3245,48,316
PI,12599,PORTO ALEGRE DO PIAUÍ,1009,283,332,1909,1577,16,191
PI,12602,RIBEIRA DO PIAUÍ,2187,145,662,3441,2779,38,307
PI,12610,SÃO GONÇALO DO GURGUÉIA,1156,163,485,2096,1611,11,98
PI,12629,SÃO LUIS DO PIAUÍ,1216,350,409,2343,1934,63,194
PI,12637,FLORESTA DO PIAUÍ,1191,187,572,2352,1780,24,232
PI,12653,SANTO ANTÔNIO DOS MILAGRES,1059,105,273,1667,1394,15,142
PI,12661,SÃO MIGUEL DA BAIXA GRANDE,1213,280,345,2156,1811,24,171
PI,12670,CARAÚBAS DO PIAUÍ,1914,1454,995,4771,3776,31,296
PI,12688,CAXINGÓ,2135,779,762,4304,3542,73,363
PI,12696,COCAL DOS ALVES,2188,552,1273,4682,3409,171,378
PI,12700,SÃO MIGUEL DO FIDALGO,1053,420,571,2487,1916,81,242
PI,12718,PAU D'ARCO DO PIAUÍ,2165,449,656,3790,3134,45,243
PI,12726,NAZÁRIA,5167,842,1542,8799,7257,89,640
PI,12734,AROEIRAS DO ITAIM,1692,395,366,2928,2562,67,305
PR,74004,GODOY MOREIRA,1149,795,448,2728,2280,31,159
PR,74012,ABATIÁ,2020,2188,759,5561,4802,95,203
PR,74020,IBEMA,1960,1191,789,4492,3703,58,158
PR,74039,ADRIANÓPOLIS,2118,951,875,4592,3717,65,316
PR,74047,LINDOESTE,2210,1123,873,4594,3721,59,135
PR,74055,AGUDOS DO SUL,2669,2116,656,6147,5491,134,170
PR,74063,OURO VERDE DO OESTE,1681,1551,397,4029,3632,70,154
PR,74071,ALMIRANTE TAMANDARÉ,20541,16256,7298,59800,52502,2091,2177
PR,74080,SANTA TEREZA DO OESTE,2592,2613,997,7102,6105,125,231
PR,74098,ALTO PARANÁ,3917,2941,1571,9696,8125,146,386
PR,74101,ANAHY,886,918,231,2274,2043,17,91
PR,74110,ALTO PIQUIRI,2956,2078,943,6806,5863,123,324
PR,74128,ÂNGULO,775,968,451,2473,2022,52,85
PR,74136,ALVORADA DO SUL,2579,2024,826,6201,5375,102,239
PR,74144,BOA ESPERANÇA DO IGUAÇU,1347,507,347,2371,2024,32,71
PR,74152,AMAPORÃ,1232,1241,502,3495,2993,73,156
PR,74160,BOM SUCESSO DO SUL,1331,889,227,2671,2444,21,52
PR,74179,AMPÉRE,6823,2414,1764,12286,10522,139,434
PR,74187,BRASILÂNDIA DO SUL,1205,739,365,2620,2255,38,178
PR,74195,ANDIRÁ,5926,5190,3860,17452,13592,493,711
PR,74209,CAFEZAL DO SUL,1243,1244,403,3248,2845,46,104
PR,74217,ANTONINA,3361,5811,3540,15809,12269,227,295
PR,74225,CANDÓI,4998,2796,2459,11314,8855,166,392
PR,74233,ANTONIO OLINTO,2369,2210,878,6031,5153,149,227
PR,74241,CRUZEIRO DO IGUAÇU,1872,508,480,3191,2711,22,121
PR,74250,APUCARANA,18153,41764,15339,90069,74730,2247,3018
PR,74268,DIAMANTE DO SUL,1332,693,492,2782,2290,19,87
PR,74276,ARAPONGAS,14894,33464,12884,76130,63246,2532,2952
PR,74284,ENTRE RIOS DO OESTE,1423,1056,232,2946,2714,28,71
PR,74292,ARAPOTI,4708,8013,3305,18239,14934,346,505
PR,74306,FAROL,795,1124,376,2718,2342,70,149
PR,74314,ARARUNA,3758,3429,1901,10442,8541,239,394
PR,74322,FAZENDA RIO GRANDE,22364,11978,7989,52626,44637,1502,1542
PR,74330,MARILÂNDIA DO SUL,1935,2942,1172,7042,5870,154,294
PR,74349,FLOR DA SERRA DO SUL,2029,968,681,4188,3507,63,123
PR,74357,ARAUCÁRIA,37904,19885,11047,85985,74938,2331,2481
PR,74365,HONÓRIO SERPA,2364,903,1099,4794,3695,51,164
PR,74373,ASSAÍ,2907,5788,1850,12366,10516,296,484
PR,74381,IGUATU,787,674,169,1769,1600,13,53
PR,74390,ASTORGA,5153,8517,3622,20019,16397,512,693
PR,74403,IRACEMA DO OESTE,999,730,395,2368,1973,46,112
PR,74411,ATALAIA,1331,1104,399,3232,2833,50,89
PR,74420,NOVO ITACOLOMI,821,1000,215,2339,2124,45,80
PR,74438,BALSA NOVA,3532,2693,438,8121,7683,271,302
PR,74446,ITAPERUÇU,8593,3483,2291,16769,14478,476,583
PR,74454,BANDEIRANTES,8286,8169,4681,25050,20369,429,973
PR,74462,IVATÉ,2422,1477,658,5160,4502,104,190
PR,74470,BARBOSA FERRAZ,2622,3314,1617,8628,7011,177,527
PR,74489,LIDIANÓPOLIS,1254,1188,791,3651,2860,59,121
PR,74497,BARRACÃO,2805,1854,1025,6458,5433,81,195
PR,74500,MARIPÁ,1221,2417,562,4605,4043,72,137
PR,74519,BARRA DO JACARÉ,798,665,248,2162,1914,53,96
PR,74527,MATO RICO,1387,809,458,2941,2483,37,142
PR,74535,BELA VISTA DO PARAÍSO,3391,5098,1492,11670,10178,261,485
PR,74543,MAUÁ DA SERRA,1502,2693,1142,6142,5000,110,227
PR,74551,BITURUNA,5288,3596,2298,12258,9960,225,370
PR,74560,MERCEDES,1466,1612,503,4079,3576,71,119
PR,74578,BOA ESPERANÇA,988,1816,548,3743,3195,74,104
PR,74586,NOVA LARANJEIRAS,3078,2207,2030,7983,5953,75,279
PR,74594,BOCAIÚVA DO SUL,2882,2375,1086,7567,6481,205,307
PR,74608,NOVA SANTA BÁRBARA,1060,922,376,2867,2491,56,165
PR,74616,BOM SUCESSO,1726,1818,525,4625,4100,93,190
PR,74624,PATO BRAGADO,1736,1421,342,3879,3537,46,99
PR,74632,BORRAZÓPOLIS,1917,2733,1437,6861,5424,128,277
PR,74640,PINHAL DE SÃO BENTO,1367,260,276,2057,1781,18,75
PR,74659,CAFEARA,1004,440,229,1936,1707,40,76
PR,74667,PITANGUEIRAS,713,987,210,2189,1979,40,76
PR,74675,CALIFÓRNIA,1581,2982,1138,6580,5442,177,227
PR,74683,QUATRO PONTES,1059,1345,377,3139,2762,33,81
PR,74691,CAMBARÁ,4373,8375,3400,18727,15327,382,703
PR,74705,RAMILÂNDIA,1263,1032,663,3349,2686,48,158
PR,74713,CAMBÉ,19085,22865,10626,69665,59039,2223,2895
PR,74721,RANCHO ALEGRE D'OESTE,962,745,436,2407,1971,47,111
PR,74730,CAMBIRA,2155,2153,832,6049,5217,169,240
PR,74748,RIO BONITO DO IGUAÇU,4942,1569,2132,9681,7549,87,323
PR,74756,CAMPINA DA LAGOA,3622,4166,2659,12113,9454,186,492
PR,74764,SANTA LÚCIA,1382,802,482,3068,2586,51,153
PR,74772,CAMPINA GRANDE DO SUL,9801,8191,4696,28335,23639,692,964
PR,74780,CAMPO BONITO,1610,976,793,3834,3041,56,126
PR,74799,CAMPO DO TENENTE,1433,2389,631,5064,4433,104,175
PR,74802,SANTA MARIA DO OESTE,4063,1782,2484,9091,6607,94,414
PR,74810,CAMPO LARGO,26068,25387,9911,77250,67339,2752,2807
PR,74829,SANTA MÔNICA,994,940,288,2509,2221,39,109
PR,74837,CAMPO MOURÃO,19617,20671,12398,63283,50885,882,1789
PR,74845,SÃO MANOEL DO PARANÁ,454,878,212,1730,1518,25,88
PR,74853,CÂNDIDO DE ABREU,4342,3999,2796,12493,9697,215,453
PR,74861,SÃO PEDRO DO IGUAÇU,2094,1695,514,4879,4365,98,227
PR,74870,CAPANEMA,6792,3936,2084,14039,11955,186,386
PR,74888,TUNAS DO PARANÁ,1730,1228,672,4145,3473,54,250
PR,74896,CAPITÃO LEÔNIDAS MARQUES,5264,2781,2341,11744,9403,180,337
PR,74900,VENTANIA,2323,2428,1435,6989,5554,171,240
PR,74918,CARLÓPOLIS,3605,3735,2218,10675,8457,198,373
PR,74926,ALTO PARAÍSO,924,845,381,2442,2061,35,83
PR,74934,CASCAVEL,61231,64287,32764,193813,161049,3299,5428
PR,74942,DOUTOR ULYSSES,2347,955,728,4512,3784,99,176
PR,74950,CASTRO,12687,20834,8112,48703,40591,1213,1742
PR,74969,VIRMOND,1332,1181,534,3377,2843,43,98
PR,74977,CATANDUVAS,2515,2503,1555,7357,5802,121,319
PR,74985,LARANJAL,2228,870,1430,4886,3456,45,187
PR,74993,CENTENÁRIO DO SUL,4041,2001,1573,8652,7079,127,361
PR,75000,ITAIPULÂNDIA,3529,1627,1196,7406,6210,100,266
PR,75019,CERRO AZUL,5783,2740,2112,12162,10050,352,518
PR,75027,NOVA ESPERANÇA DO SUDOESTE,2232,805,434,3840,3406,64,118
PR,75035,CHOPINZINHO,6859,3643,2832,15381,12549,304,520
PR,75043,PINHAIS,26102,22604,12552,82957,70405,2296,2572
PR,75051,CIANORTE,12507,19669,9025,50378,41353,1389,2013
PR,75060,SAUDADE DO IGUAÇU,1764,824,722,3851,3129,65,132
PR,75078,CIDADE GAÚCHA,3520,2505,1420,8438,7018,97,297
PR,75086,ARIRANHA DO IVAÍ,949,593,462,2165,1703,16,51
PR,75094,CLEVELÂNDIA,5160,3775,3165,13601,10436,230,487
PR,75108,ARAPUÃ,1356,1029,410,3078,2668,26,143
PR,75116,MANGUEIRINHA,5849,3241,3020,13725,10705,179,541
PR,75124,BELA VISTA DA CAROBA,1583,824,491,3208,2717,43,89
PR,75132,COLOMBO,48392,33702,18149,133379,115230,4218,4543
PR,75140,BOA VENTURA DE SÃO ROQUE,2286,1109,797,4645,3848,54,199
PR,75159,COLORADO,6840,4815,3529,18186,14657,448,745
PR,75167,BOM JESUS DO SUL,1640,825,518,3252,2734,27,96
PR,75175,CONGONHINHAS,2780,1631,1369,6506,5137,95,276
PR,75183,CAMPINA DO SIMÃO,1626,723,685,3292,2607,36,133
PR,75191,CONSELHEIRO MAIRINCK,1032,973,366,2805,2439,29,106
PR,75205,CAMPO MAGRO,5861,4887,1713,15620,13907,495,501
PR,75213,CONTENDA,4575,3251,1341,10657,9316,314,363
PR,75221,CARAMBEÍ,3114,6062,1782,13120,11338,305,401
PR,75230,CORBÉLIA,3903,5819,1672,12726,11054,160,337
PR,75248,CORONEL DOMINGOS SOARES,2299,1093,1093,4893,3800,59,189
PR,75256,CORNÉLIO PROCÓPIO,8256,14300,7193,37550,30357,708,1241
PR,75264,CRUZMALTINA,781,1129,600,2829,2229,64,154
PR,75272,CORONEL VIVIDA,7535,4314,1890,15621,13731,267,440
PR,75280,CORUMBATAÍ DO SUL,1158,1083,614,3299,2685,59,217
PR,75299,CRUZEIRO DO OESTE,6121,4176,1950,14382,12432,279,577
PR,75302,ESPERANÇA NOVA,742,584,181,1675,1494,24,53
PR,75310,CRUZEIRO DO SUL,1660,1224,473,3766,3293,44,118
PR,75329,ESPIGÃO ALTO DO IGUAÇU,1559,1093,906,4020,3114,51,165
PR,75337,CRUZ MACHADO,4400,5529,2162,13488,11326,328,442
PR,75345,FERNANDES PINHEIRO,1961,1687,890,5097,4207,89,192
PR,75353,CURITIBA,281039,468183,192528,1309124,1116596,29026,39719
PR,75361,FOZ DO JORDÃO,1883,632,1084,4028,2944,52,178
PR,75370,CURIÚVA,3001,4034,2567,11091,8524,287,474
PR,75388,GOIOXIM,2725,990,1188,5350,4162,52,188
PR,75396,DIAMANTE DO NORTE,1553,1395,1094,4702,3608,84,215
PR,75400,DIAMANTE D'OESTE,1544,885,591,3661,3070,60,199
PR,75418,DOIS VIZINHOS,13002,6771,4327,26869,22542,397,682
PR,75426,GUAMIRANGA,2714,1899,861,6244,5383,180,217
PR,75434,DOUTOR CAMARGO,1439,2091,686,4797,4111,103,155
PR,75442,IMBAÚ,2958,2181,1673,7759,6086,165,332
PR,75450,ENÉAS MARQUES,2573,1320,377,4698,4321,46,104
PR,75469,MANFRINÓPOLIS,1606,474,438,2774,2336,26,104
PR,75477,ENGENHEIRO BELTRÃO,3547,4072,1867,10819,8952,228,297
PR,75485,MARQUINHO,1628,1119,914,3983,3069,27,134
PR,75493,FAXINAL,3389,4541,1479,10792,9313,157,378
PR,75507,PEROBAL,1666,1581,579,4504,3925,84,148
PR,75515,FÊNIX,1406,1395,709,3919,3210,61,210
PR,75523,PONTAL DO PARANÁ,3729,4452,3504,14580,11076,236,348
PR,75531,FLORAÍ,1509,1612,384,4072,3688,85,165
PR,75540,PORTO BARREIRO,1341,880,509,3002,2493,31,89
PR,75558,FLORESTA,1324,2118,426,4523,4097,69,151
PR,75566,PRADO FERREIRA,1247,808,304,2767,2463,46,93
PR,75574,FLORESTÓPOLIS,3826,2810,1996,9906,7910,104,224
PR,75582,QUARTO CENTENÁRIO,1762,1267,636,3946,3310,51,122
PR,75590,FLÓRIDA,980,480,276,2116,1840,45,72
PR,75604,RESERVA DO IGUAÇU,2495,1024,1372,5365,3993,40,145
PR,75612,FORMOSA DO OESTE,1840,2500,809,5869,5060,171,235
PR,75620,RIO BRANCO DO IVAÍ,992,1007,811,3176,2365,55,165
PR,75639,FOZ DO IGUAÇU,59140,52513,38206,183789,145583,2742,5433
PR,75647,SERRANÓPOLIS DO IGUAÇU,1696,1425,410,3827,3417,45,113
PR,75655,FRANCISCO BELTRÃO,24337,14507,9212,55998,46786,870,1332
PR,75663,TAMARANA,2282,3282,1889,8420,6531,161,205
PR,75671,GENERAL CARNEIRO,3527,3218,2252,10009,7757,206,334
PR,75698,GOIOERÊ,7853,7224,4309,21770,17461,302,747
PR,75710,GUAÍRA,7857,6502,3956,21457,17501,368,659
PR,75736,GUAIRAÇÁ,1378,1943,741,4608,3867,56,205
PR,75744,ROSÁRIO DO IVAÍ,1357,1715,1313,4931,3618,81,244
PR,75752,GUAPIRAMA,960,1281,768,3569,2801,51,171
PR,75760,NOVA TEBAS,2441,1446,991,5487,4496,60,268
PR,75779,GUAPOREMA,745,637,267,1830,1563,18,58
PR,75787,SULINA,1385,727,434,2812,2378,36,81
PR,75795,GUARACI,1360,1762,385,3874,3489,64,87
PR,75809,LUIZIANA,2404,1588,774,5498,4724,97,299
PR,75817,GUARANIAÇU,4038,4008,1702,11353,9651,181,389
PR,75833,GUARAPUAVA,41310,37327,20574,116861,96287,2267,3520
PR,75850,GUARAQUEÇABA,1853,2592,1692,6601,4909,76,118
PR,75876,GUARATUBA,5516,9129,5861,24369,18508,405,651
PR,75892,IBAITI,6746,7817,4427,22117,17690,390,692
PR,75914,IBIPORÃ,7806,14780,6100,35949,29849,1151,1367
PR,75930,ICARAÍMA,2149,2739,1234,6782,5548,134,235
PR,75957,IGUARAÇU,1022,1129,431,3149,2718,57,103
PR,75973,IMBITUVA,6297,8395,2660,20147,17487,556,616
PR,75990,INÁCIO MARTINS,3383,2597,1149,7852,6703,118,326
PR,76015,INAJÁ,1034,600,497,2459,1962,27,128
PR,76031,IPIRANGA,4130,3266,1625,10370,8745,287,395
PR,76058,IPORÃ,3700,4219,1613,11046,9433,211,361
PR,76074,IRATI,13629,15233,6675,42203,35528,1217,1385
PR,76090,IRETAMA,3102,2252,1262,7633,6371,114,443
PR,76112,ITAGUAJÉ,1419,1071,701,3676,2975,75,135
PR,76139,ITAMBARACÁ,1564,2001,747,4942,4195,109,230
PR,76155,ITAMBÉ,1490,1963,664,4646,3982,83,131
PR,76171,ITAPEJARA D'OESTE,4243,1874,1045,8078,7033,157,262
PR,76198,ITAÚNA DO SUL,1205,710,820,3134,2314,51,166
PR,76210,IVAÍ,2914,4267,862,8922,8060,169,285
PR,76236,IVAIPORÃ,7315,8400,4308,23030,18722,336,782
PR,76252,IVATUBA,763,661,651,2495,1844,28,66
PR,76279,JABOTI,1061,1390,608,3678,3070,118,142
PR,76295,JACAREZINHO,9088,9680,6639,30976,24337,505,954
PR,76317,JAGUAPITÃ,2595,3598,1803,9476,7673,233,331
PR,76333,JAGUARIAÍVA,6195,10454,4819,24489,19670,387,629
PR,76350,JANDAIA DO SUL,4654,6320,2444,16012,13568,428,598
PR,76376,JANIÓPOLIS,2215,1593,1454,5935,4481,83,280
PR,76392,JAPIRA,1431,1186,817,3922,3105,42,144
PR,76414,JAPURÁ,2009,2922,612,6430,5818,179,288
PR,76430,JARDIM ALEGRE,3121,3183,1949,9391,7442,135,293
PR,76457,JARDIM OLINDA,566,395,295,1386,1091,11,39
PR,76473,JATAIZINHO,2351,3594,1743,9210,7467,211,395
PR,76490,JOAQUIM TÁVORA,2849,2648,1226,7953,6727,153,337
PR,76511,JUNDIAÍ DO SUL,1010,750,380,2442,2062,33,125
PR,76538,JUSSARA,1811,1694,883,5250,4367,119,213
PR,76554,KALORÉ,1182,1600,437,3659,3222,58,160
PR,76570,LAPA,11826,12308,5084,34625,29541,992,1130
PR,76597,LARANJEIRAS DO SUL,8622,6081,5126,22830,17704,309,708
PR,76619,LEÓPOLIS,1101,1203,622,3468,2846,62,176
PR,76635,LOANDA,4607,5533,3131,15421,12290,241,461
PR,76651,LOBATO,1630,849,446,3474,3028,38,111
PR,76678,LONDRINA,51029,152045,58549,352498,293949,9300,12772
PR,76694,LUPIONÓPOLIS,1587,956,651,3765,3114,61,150
PR,76716,MALLET,3906,3193,1649,10230,8581,290,324
PR,76732,MAMBORÊ,3227,4523,2119,11206,9087,191,347
PR,76759,MANDAGUAÇU,5205,4678,2534,15040,12506,397,570
PR,76775,MANDAGUARI,7509,9693,4567,25899,21332,673,975
PR,76791,MANDIRITUBA,7004,4338,2403,16185,13782,484,463
PR,76813,MANOEL RIBAS,2471,4783,1965,10173,8208,145,301
PR,76830,MARECHAL CÂNDIDO RONDON,12833,12082,5000,34894,29894,662,1069
PR,76856,MARIA HELENA,1898,1439,464,4202,3738,50,139
PR,76872,MARIALVA,7504,9477,4123,25248,21125,650,698
PR,76899,MARILUZ,3467,2214,1619,8015,6396,93,246
PR,76910,MARINGÁ,59665,91740,41866,248348,206482,4668,7035
PR,76937,MARIÓPOLIS,2323,1342,578,4923,4345,81,173
PR,76953,MARMELEIRO,4973,2271,1879,10275,8396,178,251
PR,76970,MARUMBI,1069,1486,301,3341,3040,87,118
PR,76996,MATELÂNDIA,3517,4688,2226,12164,9938,233,363
PR,77011,MEDIANEIRA,11576,9359,5444,30799,25355,560,1062
PR,77038,MIRADOR,819,536,413,1951,1538,20,56
PR,77054,MIRASELVA,659,692,223,1792,1569,14,80
PR,77070,MOREIRA SALES,2873,3599,1344,8854,7510,169,467
PR,77097,MORRETES,3554,4608,3052,14258,11206,260,339
PR,77119,MUNHOZ DE MELO,1244,927,403,3004,2601,68,115
PR,77135,NOSSA SENHORA DAS GRAÇAS,1432,765,569,3194,2625,78,156
PR,77151,NOVA ALIANÇA DO IVAÍ,504,382,238,1363,1125,15,42
PR,77178,NOVA AMÉRICA DA COLINA,1083,898,346,2694,2348,68,96
PR,77194,NOVA CANTU,2405,1665,1884,6636,4752,65,262
PR,77216,NOVA ESPERANÇA,6556,7288,4364,21110,16746,420,664
PR,77232,NOVA FÁTIMA,1950,2037,1345,6272,4927,156,258
PR,77259,NOVA LONDRINA,3103,3173,2626,10082,7456,132,380
PR,77275,ORTIGUEIRA,7207,3633,3245,16153,12908,329,954
PR,77291,OURIZONA,1365,799,305,2809,2504,50,127
PR,77313,PAIÇANDU,9758,6425,4024,24642,20618,733,944
PR,77330,PALMAS,10367,8313,5814,27322,21508,436,909
PR,77356,PALMEIRA,7303,10328,3759,24925,21166,609,694
PR,77372,PALMITAL,4988,2658,3542,12434,8892,115,491
PR,77399,PALOTINA,6849,8369,3867,21633,17766,329,612
PR,77410,PARAÍSO DO NORTE,3740,2608,843,8130,7287,134,270
PR,77437,PARANACITY,2764,2255,1560,7531,5971,115,270
PR,77453,PARANAGUÁ,21283,36749,14110,97970,83860,1838,2170
PR,77470,PARANAPOEMA,870,494,286,1950,1664,31,108
PR,77496,PARANAVAÍ,14905,24070,11789,60228,48439,1034,1570
PR,77518,PATO BRANCO,20729,14239,8196,51757,43561,767,1287
PR,77534,PAULA FREITAS,1442,1679,555,4103,3548,114,111
PR,77550,PAULO FRONTIN,2074,1741,819,5373,4554,181,164
PR,77577,PEABIRU,3467,3414,2244,10480,8236,151,358
PR,77593,PÉROLA D'OESTE,2334,1671,534,5068,4534,74,153
PR,77615,PIÊN,3359,3050,727,8087,7360,159,206
PR,77631,PINHALÃO,2184,1594,1052,5544,4492,71,232
PR,77658,PINHÃO,10276,4977,5166,22592,17426,304,851
PR,77674,PIRAÍ DO SUL,4630,8094,3471,18598,15127,482,604
PR,77690,PIRAQUARA,19761,12756,8006,52936,44930,1616,1639
PR,77712,PITANGA,9444,7696,6290,26024,19734,343,991
PR,77739,PLANALTINA DO PARANÁ,1382,923,590,3318,2728,69,96
PR,77755,PLANALTO,5569,2208,1771,10546,8775,176,287
PR,77771,PONTA GROSSA,46919,91959,33168,219734,186566,5411,6504
PR,77798,PORECATU,4259,2970,2067,11002,8935,224,308
PR,77810,PORTO AMAZONAS,760,1542,559,3526,2967,83,105
PR,77836,PORTO RICO,940,613,297,2136,1839,17,62
PR,77852,PORTO VITÓRIA,1023,1287,565,3162,2597,54,85
PR,77879,PRESIDENTE CASTELO BRANCO,1919,775,642,3949,3307,68,155
PR,77895,PRIMEIRO DE MAIO,2412,3572,902,7822,6920,181,299
PR,77917,PRUDENTÓPOLIS,10463,15292,4786,35129,30343,915,1364
PR,77933,QUATIGUÁ,1832,2751,834,6070,5236,127,218
PR,77950,QUATRO BARRAS,3970,4138,1359,12345,10986,296,422
PR,77976,QUERÊNCIA DO NORTE,3446,2295,1839,8467,6628,107,272
PR,77992,QUINTA DO SOL,1845,1120,881,4444,3563,69,189
PR,78018,QUITANDINHA,4135,4535,1237,11753,10516,379,441
PR,78034,RANCHO ALEGRE,997,1197,385,3068,2683,73,149
PR,78050,REALEZA,5990,3137,2090,12612,10522,236,460
PR,78077,REBOUÇAS,4035,4292,2121,11777,9656,273,367
PR,78093,RENASCENÇA,2541,1193,625,4944,4319,62,175
PR,78115,RESERVA,8171,4959,3228,18480,15252,353,823
PR,78131,RIBEIRÃO CLARO,2563,3195,1340,8690,7350,255,347
PR,78158,RIBEIRÃO DO PINHAL,4247,2872,3120,11427,8307,137,375
PR,78174,RIO AZUL,4216,2946,1468,10501,9033,387,493
PR,78190,RIO BOM,641,1210,353,2627,2274,61,165
PR,78212,RIO BRANCO DO SUL,9859,6410,3097,23179,20082,601,805
PR,78239,RIO NEGRO,5259,10474,3523,22651,19128,505,555
PR,78255,ROLÂNDIA,9229,20079,6965,43541,36576,1341,1334
PR,78271,RONCADOR,3306,2913,1309,8437,7128,115,384
PR,78298,RONDON,2170,3094,1049,7059,6010,78,197
PR,78310,SABÁUDIA,1246,2014,551,4704,4153,136,195
PR,78336,SALGADO FILHO,1711,842,652,3613,2961,63,118
PR,78352,SALTO DO ITARARÉ,1650,1016,585,3873,3288,72,228
PR,78379,SALTO DO LONTRA,5209,1884,1804,9905,8101,200,332
PR,78395,SANTA AMÉLIA,966,1186,424,2959,2535,55,158
PR,78417,SANTA CECÍLIA DO PAVÃO,706,1231,368,2813,2445,44,166
PR,78433,SANTA CRUZ DE MONTE CASTELO,2586,2004,1035,6346,5311,92,224
PR,78450,SANTA FÉ,2816,2655,961,7190,6229,109,216
PR,78476,SANTA INÊS,600,625,314,1749,1435,8,67
PR,78492,SANTA ISABEL DO IVAÍ,2088,2754,1303,6972,5669,102,259
PR,78514,SANTA IZABEL DO OESTE,3974,1885,1264,7994,6730,133,312
PR,78530,SANTA MARIANA,3428,3154,2273,10342,8069,246,434
PR,78557,SANTANA DO ITARARÉ,1836,1168,868,4396,3528,79,198
PR,78573,SANTO ANTÔNIO DO SUDOESTE,6253,3845,2017,13335,11318,167,383
PR,78590,SANTO ANTÔNIO DA PLATINA,7461,13048,4697,30289,25592,969,977
PR,78611,SANTO ANTONIO DO CAIUÁ,951,703,433,2374,1941,31,116
PR,78638,SANTO ANTÔNIO DO PARAÍSO,634,787,427,2187,1760,37,88
PR,78654,SANTO INÁCIO,1632,1259,660,4191,3531,77,175
PR,78670,SÃO CARLOS DO IVAÍ,1445,2060,854,4826,3972,93,124
PR,78697,SÃO JERÔNIMO DA SERRA,3146,2358,2236,8937,6701,121,461
PR,78719,SÃO JOÃO,3567,2043,831,7511,6680,154,357
PR,78735,SÃO JOÃO DO CAIUÁ,1886,1251,1116,4910,3794,78,247
PR,78751,SÃO JOÃO DO IVAÍ,3217,3166,1348,8908,7560,136,434
PR,78778,SÃO JOÃO DO TRIUNFO,4807,2706,1520,10448,8928,465,380
PR,78794,SÃO JORGE DO IVAÍ,1497,1740,536,4279,3743,79,155
PR,78816,SÃO JORGE D'OESTE,3323,1756,674,6772,6098,122,226
PR,78832,SÃO JOSÉ DA BOA VISTA,1154,2217,903,4683,3780,50,187
PR,78859,SÃO JOSÉ DOS PINHAIS,52569,49960,21712,162875,141163,4814,5097
PR,78875,SÃO MATEUS DO SUL,11189,10716,4080,29939,25859,713,877
PR,78891,SÃO MIGUEL DO IGUAÇU,8445,5834,4087,20834,16747,339,673
PR,78913,SÃO PEDRO DO IVAÍ,2735,2427,1113,7146,6033,104,323
PR,78930,SÃO PEDRO DO PARANÁ,689,940,283,2146,1863,35,69
PR,78956,SÃO SEBASTIÃO DA AMOREIRA,2661,1922,1368,6916,5548,143,322
PR,78972,SÃO TOMÉ,1209,1730,422,3971,3549,86,162
PR,78999,SAPOPEMA,2130,1432,1039,5159,4120,83,202
PR,79014,SENGÉS,3951,5138,3164,14675,11511,214,544
PR,79030,SERTANEJA,1343,1968,955,4988,4033,110,175
PR,79057,SERTANÓPOLIS,3085,5240,2492,13055,10563,434,505
PR,79073,SIQUEIRA CAMPOS,5122,4699,2790,14780,11990,308,531
PR,79090,TAMBOARA,1167,1449,383,3513,3130,89,170
PR,79111,TAPEJARA,4683,3122,1772,11017,9245,216,328
PR,79138,TEIXEIRA SOARES,2847,2432,1281,7342,6061,151,250
PR,79154,TELÊMACO BORBA,14266,14651,9331,49254,39923,894,1275
PR,79170,TERRA BOA,3570,5122,2003,12163,10160,259,442
PR,79197,TERRA RICA,3685,3884,2002,11271,9269,196,374
PR,79219,TERRA ROXA,4035,4737,1559,11790,10231,250,504
PR,79235,TIBAGI,4395,5299,3019,14191,11172,193,528
PR,79251,TIJUCAS DO SUL,3933,3230,1720,10193,8473,272,297
PR,79278,TOLEDO,29105,30586,13837,85787,71950,1504,2278
PR,79294,TOMAZINA,2004,2532,1135,6564,5429,106,309
PR,79316,TUNEIRAS DO OESTE,2461,2043,796,6137,5341,108,231
PR,79332,UBIRATÃ,5458,6414,1951,15354,13403,224,529
PR,79359,UMUARAMA,22474,23737,15680,74161,58481,1359,2103
PR,79375,UNIÃO DA VITÓRIA,9627,17358,7665,40156,32491,841,998
PR,79391,UNIFLOR,801,571,169,1818,1649,25,67
PR,79413,URAÍ,2690,3052,982,7979,6997,154,407
PR,79430,WENCESLAU BRAZ,3151,6886,2848,14496,11648,242,538
PR,79456,VERÊ,3461,1774,547,6416,5869,91,202
PR,79472,VITORINO,1917,1531,801,4740,3939,81,140
PR,79499,XAMBRÊ,2176,1512,707,4859,4152,67,123
PR,79510,ALTÔNIA,4894,5288,1690,13828,12138,312,498
PR,79537,ASSIS CHATEAUBRIAND,7903,9372,3023,23665,20642,463,1009
PR,79553,QUEDAS DO IGUAÇU,8644,6473,5754,23232,17478,348,791
PR,79570,CÉU AZUL,2534,3235,1343,8383,7040,137,217
PR,79596,GRANDES RIOS,1435,2066,1329,5460,4131,72,258
PR,79618,INDIANÓPOLIS,970,1362,488,3308,2820,76,189
PR,79634,MATINHOS,6695,6330,5708,22988,17280,335,568
PR,79650,NOVA AURORA,3386,3619,1581,9758,8177,208,358
PR,79677,NOVA OLÍMPIA,1850,1306,491,4144,3653,69,163
PR,79693,PÉROLA,3014,2270,864,7062,6198,169,284
PR,79715,SANTA HELENA,8677,4983,2720,18529,15809,295,618
PR,79731,TAPIRA,1562,1760,512,4305,3793,75,163
PR,79758,MARILENA,2382,1350,1269,5600,4331,88,250
PR,79774,FRANCISCO ALVES,1779,1770,605,4658,4053,104,176
PR,79790,NOVA SANTA ROSA,1616,3238,704,6071,5367,92,148
PR,79812,BOA VISTA DA APARECIDA,2835,1448,1393,6403,5010,127,290
PR,79839,BRAGANEY,2037,1307,489,4233,3744,57,150
PR,79855,CAFELÂNDIA,3883,3467,1449,9876,8427,141,294
PR,79871,TRÊS BARRAS DO PARANÁ,3143,3061,1007,8214,7207,191,326
PR,79898,VERA CRUZ DO OESTE,2130,2664,1208,6728,5520,101,232
PR,79910,PRANCHITA,1978,1566,598,4594,3996,65,118
PR,79936,TUPÃSSI,1972,2700,762,6120,5358,148,218
PR,79952,NOVA PRATA DO IGUAÇU,3938,1782,854,7283,6429,85,250
PR,79979,JESUÍTAS,2226,2701,682,6538,5856,165,351
PR,79995,SÃO JORGE DO PATROCÍNIO,2040,1424,496,4471,3975,72,159
PR,84514,CANTAGALO,4156,2168,2524,9660,7136,100,302
PR,84530,TURVO,5101,2716,1919,10864,8945,172,471
PR,84557,ALTAMIRA DO PARANÁ,1351,1165,1381,4288,2907,26,173
PR,84573,FIGUEIRA,2658,1792,1429,6675,5246,85,268
PR,84590,LUNARDELLI,1137,1753,584,3983,3399,97,206
PR,84611,SARANDI,22260,14277,9877,56260,46383,1493,1689
PR,84638,JURANDA,1845,2497,698,5622,4924,74,180
PR,84654,DOURADINA,2088,1984,518,5136,4618,100,122
PR,84670,SANTA TEREZINHA DE ITAIPU,4776,5721,2788,15807,13019,235,568
PR,84697,MISSAL,3836,2399,765,7836,7071,81,259
PR,84719,SÃO JOSÉ DAS PALMEIRAS,1463,868,317,2954,2637,44,104
RJ,58009,QUISSAMÃ,4684,3362,1950,14464,12514,380,758
RJ,58017,ANGRA DOS REIS,37379,23017,21021,112565,91544,3692,5072
RJ,58025,QUATIS,3633,1996,1340,9384,8044,181,497
RJ,58033,ARARUAMA,18633,17471,16797,82429,65632,2209,4327
RJ,58041,BELFORD ROXO,130089,27208,49714,302628,252914,10165,15779
RJ,58050,BARRA DO PIRAÍ,23289,13201,11470,69781,58311,1567,2864
RJ,58068,CARDOSO MOREIRA,3280,2797,2128,10711,8583,218,613
RJ,58076,BARRA MANSA,43525,22874,17939,127727,109788,3419,6386
RJ,58084,VARRE-SAI,1720,2983,1156,7142,5986,146,570
RJ,58092,BOM JARDIM,5752,5680,3726,20703,16977,723,1557
RJ,58106,GUAPIMIRIM,12835,5552,6679,34820,28141,905,1756
RJ,58114,BOM JESUS DO ITABAPOANA,6707,9798,4903,27536,22633,689,1566
RJ,58122,QUEIMADOS,39733,8866,15200,94116,78916,2757,4617
RJ,58130,CABO FRIO,27299,27521,24288,126945,102657,3297,5503
RJ,58149,JAPERI,27198,7093,11505,64221,52716,1727,3353
RJ,58157,CACHOEIRAS DE MACACU,13981,6287,7645,41278,33633,1156,2266
RJ,58165,COMENDADOR LEVY GASPARIAN,2849,1143,732,6478,5746,121,330
RJ,58173,CAMBUCI,3253,2965,1759,10757,8998,368,691
RJ,58181,APERIBÉ,2360,2461,1108,7829,6721,253,432
RJ,58190,CAMPOS DOS GOYTACAZES,91973,76991,59165,334480,275315,13545,20522
RJ,58203,RIO DAS OSTRAS,16238,10425,12835,62634,49799,1589,2689
RJ,58211,CANTAGALO,4266,5406,2919,16335,13416,422,1051
RJ,58220,AREAL,1992,3416,1068,8740,7672,176,478
RJ,58238,CARMO,5430,2845,1800,13014,11214,301,804
RJ,58246,PINHEIRAL,6165,2089,2054,15286,13232,247,668
RJ,58254,CASIMIRO DE ABREU,5823,5725,4455,24831,20376,672,1244
RJ,58262,IGUABA GRANDE,4678,3722,3707,18223,14516,423,804
RJ,58270,CONCEIÇÃO DE MACABU,4311,4268,3497,16136,12639,451,868
RJ,58289,SÃO FRANCISCO DE ITABAPOANA,7247,10666,9266,34486,25220,1275,1774
RJ,58297,CORDEIRO,3952,4147,2828,15851,13023,438,937
RJ,58300,CARAPEBUS,3448,1738,1492,9631,8139,277,558
RJ,58319,DUAS BARRAS,2699,2354,1274,8485,7211,236,668
RJ,58327,PORTO REAL,4462,2298,1521,12741,11220,332,644
RJ,58335,DUQUE DE CAXIAS,242725,70557,92051,590199,498148,19569,32222
RJ,58343,SÃO JOSÉ DE UBÁ,1972,2305,897,6299,5402,111,388
RJ,58351,ENGENHEIRO PAULO DE FRONTIN,2644,2082,829,8836,8007,230,515
RJ,58360,TANGUÁ,8742,2421,3542,21386,17844,510,1092
RJ,58378,ITABORAÍ,58551,16489,23119,149468,126349,5248,8039
RJ,58386,MACUCO,2121,1538,578,5747,5169,100,354
RJ,58394,ITAGUAÍ,26913,12889,13284,79122,65838,2608,3639
RJ,58408,ARMAÇÃO DOS BÚZIOS,4858,4319,2422,19227,16805,446,848
RJ,58416,ITAOCARA,3755,7051,3275,18527,15252,662,1147
RJ,58424,SEROPÉDICA,17754,6950,8382,49544,41162,1459,2475
RJ,58432,ITAPERUNA,16483,22235,15237,73504,58267,1958,3466
RJ,58440,ITATIAIA,7549,4790,3610,21493,17883,480,855
RJ,58459,LAJE DO MURIAÉ,1939,1752,1569,6810,5241,272,450
RJ,58467,MESQUITA,45933,14119,19686,127520,107834,4113,6751
RJ,58475,MACAÉ,41286,18975,25973,133667,107694,4119,5528
RJ,58491,MAGÉ,64911,18165,27219,161109,133890,4924,8316
RJ,58513,MANGARATIBA,8692,4444,4041,25782,21741,734,1154
RJ,58530,MARICÁ,24653,13523,14677,77304,62627,2377,4340
RJ,58556,MENDES,4169,3146,2259,14359,12100,374,758
RJ,58572,MIGUEL PEREIRA,5354,5104,3654,21031,17377,451,983
RJ,58599,MIRACEMA,6790,5137,5086,21914,16828,604,1209
RJ,58610,NATIVIDADE,3137,3269,1630,10920,9290,258,846
RJ,58637,NILÓPOLIS,46623,14127,13897,122046,108149,3897,6560
RJ,58653,NITERÓI,100642,70851,52002,371165,319163,10685,21427
RJ,58670,NOVA FRIBURGO,31733,41269,24557,145142,120585,5661,9158
RJ,58696,NOVA IGUAÇU,186872,73322,90644,545666,455022,18827,30537
RJ,58718,PARACAMBI,9659,6430,3925,31252,27327,806,1726
RJ,58734,PARAÍBA DO SUL,7569,9358,5846,32509,26663,998,1806
RJ,58750,PARATY,5429,7910,4920,24196,19276,632,1014
RJ,58777,PETRÓPOLIS,51558,60464,41637,238094,196457,8349,12960
RJ,58793,PIRAÍ,7558,3350,2254,18840,16586,350,848
RJ,58815,PORCIÚNCULA,4238,3350,3303,13719,10416,336,744
RJ,58831,RESENDE,23749,20633,15503,83703,68200,2252,3668
RJ,58858,RIO BONITO,11583,9580,7114,42871,35757,1342,2327
RJ,58874,RIO CLARO,6215,2385,2798,14249,11451,357,787
RJ,58890,RIO DAS FLORES,2358,1961,1061,6991,5930,120,382
RJ,58912,SANTA MARIA MADALENA,2524,2168,1449,8104,6655,225,585
RJ,58939,SANTO ANTÔNIO DE PÁDUA,7576,9495,6338,31666,25328,880,1590
RJ,58955,SÃO FIDÉLIS,5378,10710,7269,29706,22437,663,1537
RJ,58971,SÃO GONÇALO,240052,68868,103824,652773,548949,23184,40422
RJ,58998,SÃO JOÃO DA BARRA,8557,8471,3796,27652,23856,1084,1539
RJ,59013,SÃO JOÃO DE MERITI,140999,34192,55508,351284,295776,11861,20540
RJ,59030,SÃO PEDRO DA ALDEIA,13042,9967,10598,53736,43138,1354,2417
RJ,59056,SÃO SEBASTIÃO DO ALTO,2022,2457,1546,7469,5923,219,621
RJ,59072,SAPUCAIA,5455,3772,2779,15495,12716,386,1040
RJ,59099,SAQUAREMA,16397,12263,12698,56166,43468,1331,3021
RJ,59110,SILVA JARDIM,4660,3072,3473,15996,12523,382,895
RJ,59137,SUMIDOURO,3650,4452,2475,13100,10625,418,814
RJ,59153,TERESÓPOLIS,19780,41688,21008,118934,97926,3817,6287
RJ,59170,TRAJANO DE MORAIS,3203,1753,1430,8342,6912,192,677
RJ,59196,TRÊS RIOS,21440,10897,9074,58149,49075,1657,2709
RJ,59218,VALENÇA,21103,10805,10703,56866,46163,1405,2954
RJ,59234,VASSOURAS,7845,6985,5297,28220,22923,672,1490
RJ,59250,VOLTA REDONDA,66307,31363,30663,212384,181721,5227,8753
RJ,59277,ARRAIAL DO CABO,5425,5841,4867,23822,18955,576,889
RJ,59293,ITALVA,3151,2832,1476,10173,8697,267,598
RJ,59315,PATY DO ALFERES,6372,3974,4086,20832,16746,358,894
RJ,59331,SÃO JOSÉ DO VALE DO RIO PRETO,2264,6486,2460,14956,12496,330,578
RJ,60011,RIO DE JANEIRO,1464830,738040,857358,4671660,3814302,151129,286403
RN,16004,TENENTE LAURENTINO CRUZ,2233,467,715,4330,3615,83,405
RN,16012,ACARI,3667,1846,1528,9387,7859,203,646
RN,16020,SERRA DO MEL,3676,1827,1299,8536,7237,216,555
RN,16039,ASSÚ,19042,4768,6617,38861,32244,1163,2935
RN,16047,CAIÇARA DO NORTE,1736,1347,698,4763,4065,171,357
RN,16055,AFONSO BEZERRA,4057,1317,1845,9118,7273,234,824
RN,16063,SÃO MIGUEL DO GOSTOSO,3279,1007,1082,6611,5529,173,549
RN,16071,ÁGUA NOVA,1477,70,402,2329,1927,43,247
RN,16080,ITAJÁ,3757,766,971,6546,5575,135,544
RN,16098,ALEXANDRIA,5643,751,1016,9307,8291,174,939
RN,16101,BODÓ,1469,364,464,2728,2264,62,256
RN,16110,ALMINO AFONSO,2698,530,561,4784,4223,145,391
RN,16128,TRIUNFO POTIGUAR,1666,671,600,3671,3071,84,327
RN,16136,ALTO DO RODRIGUES,4975,1450,1050,9411,8361,258,741
RN,16144,FERNANDO PEDROZA,1047,874,474,3053,2579,74,278
RN,16152,ANGICOS,3863,1937,1355,9334,7979,231,687
RN,16160,MAJOR SALES,1924,160,326,2673,2347,24,149
RN,16179,ANTÔNIO MARTINS,3071,510,629,5368,4739,180,548
RN,16187,VENHA-VER,1368,448,964,3386,2422,66,427
RN,16195,APODI,14057,2414,4579,27125,22546,1101,1770
RN,16209,SERRINHA DOS PINTOS,1783,518,619,3780,3161,85,397
RN,16217,AREIA BRANCA,7127,3571,2140,18569,16429,780,1376
RN,16225,TIBAU,1681,522,570,3614,3044,158,229
RN,16233,ARÊS,3761,2247,1064,9559,8495,462,888
RN,16241,SANTA MARIA,1735,996,654,4290,3636,113,385
RN,16250,CAMPO GRANDE,4117,1012,1440,8025,6585,232,603
RN,16268,RIO DO FOGO,2858,2988,2202,9686,7484,233,665
RN,16276,BAÍA FORMOSA,2232,1721,1553,6891,5338,195,388
RN,16284,PORTO DO MANGUE,2013,645,586,4388,3802,97,344
RN,16292,BARCELONA,1147,1338,442,3816,3374,123,365
RN,16306,JUNDIÁ,1332,547,406,3089,2683,144,291
RN,16314,BENTO FERNANDES,2081,793,529,4299,3770,117,361
RN,16330,BOM JESUS,2695,1783,1691,7633,5942,206,590
RN,16357,BREJINHO,3062,1995,1844,9088,7244,335,875
RN,16373,CAIÇARA DO RIO DO VENTO,1461,690,326,3179,2853,54,328
RN,16390,CAICÓ,19674,5476,6692,43797,37105,1492,2419
RN,16411,CAMPO REDONDO,3947,871,968,7284,6316,231,758
RN,16438,CANGUARETAMA,9997,3502,4770,22586,17816,892,1732
RN,16454,CARAÚBAS,9146,1425,1450,15450,14000,618,1313
RN,16470,CARNAÚBA DOS DANTAS,1998,1648,703,5657,4954,240,425
RN,16497,CARNAUBAIS,3863,1501,1391,8228,6837,210,606
RN,16519,CEARÁ-MIRIM,19922,9722,8270,48090,39820,2000,3491
RN,16535,CERRO CORÁ,3146,1895,1760,8265,6505,130,798
RN,16551,CORONEL EZEQUIEL,2009,667,537,4040,3503,93,419
RN,16578,CORONEL JOÃO PESSOA,1919,288,663,3519,2856,74,435
RN,16594,CRUZETA,3197,1250,1020,6815,5795,229,562
RN,16616,CURRAIS NOVOS,11981,6974,6363,32543,26180,1127,2287
RN,16632,DOUTOR SEVERIANO,2975,351,830,5013,4183,100,536
RN,16659,ENCANTO,2502,165,430,3950,3520,63,449
RN,16675,EQUADOR,2084,533,868,4645,3777,147,447
RN,16691,ESPÍRITO SANTO,2172,1745,1504,6980,5476,216,584
RN,16713,EXTREMOZ,5245,3871,1006,13850,12844,542,928
RN,16730,FELIPE GUERRA,3319,454,621,5800,5179,307,467
RN,16756,FLORÂNIA,3506,1440,932,7344,6412,236,662
RN,16772,FRANCISCO DANTAS,1388,356,354,2613,2259,67,253
RN,16799,GALINHOS,644,634,338,2132,1794,50,141
RN,16810,GOIANINHA,5064,5419,2011,16792,14781,757,1592
RN,16837,GOVERNADOR DIX-SEPT ROSADO,5318,1536,1868,11093,9225,587,931
RN,16853,GROSSOS,3079,1127,967,7382,6415,538,605
RN,16870,GUAMARÉ,4959,1738,1156,10267,9111,273,841
RN,16896,IELMO MARINHO,3984,2203,2173,10237,8064,291,723
RN,16918,IPANGUAÇU,6581,1196,1457,11324,9867,334,937
RN,16934,IPUEIRA,876,211,219,1798,1579,36,137
RN,16950,ITAÚ,2671,280,832,4821,3989,123,395
RN,16977,JAÇANÃ,1952,1908,1247,6228,4981,118,577
RN,16993,JANDAÍRA,2404,1178,924,5522,4598,161,471
RN,17019,JANDUÍS,2184,638,622,4207,3585,169,339
RN,17035,BOA SAÚDE,2528,1990,1304,7359,6055,151,816
RN,17051,JAPI,2198,1119,868,5002,4134,75,433
RN,17078,JARDIM DE ANGICOS,1228,398,268,2477,2209,77,208
RN,17094,JARDIM DE PIRANHAS,5605,1084,2008,10425,8417,389,776
RN,17116,JARDIM DO SERIDÓ,4212,2153,1583,10242,8659,434,772
RN,17132,JOÃO CÂMARA,10326,4227,4669,23972,19303,845,1806
RN,17159,JOÃO DIAS,1568,140,185,2305,2120,45,254
RN,17175,JOSÉ DA PENHA,3091,197,666,4835,4169,100,547
RN,17191,JUCURUTU,6905,2391,2681,15169,12488,442,1425
RN,17213,MESSIAS TARGINO,2149,574,389,3818,3429,123,278
RN,17230,LAGOA D'ANTA,1949,858,742,4608,3866,123,497
RN,17256,LAGOA DE PEDRAS,2360,1313,1111,5915,4804,195,531
RN,17272,LAGOA DE VELHOS,1125,773,402,2926,2524,68,259
RN,17299,LAGOA NOVA,4203,2522,2553,11168,8615,331,943
RN,17310,LAGOA SALGADA,3625,1411,959,7746,6787,314,794
RN,17337,LAJES,3692,1341,1311,8584,7273,164,755
RN,17353,LAJES PINTADAS,2225,593,567,4315,3748,111,432
RN,17370,LUCRÉCIA,1951,112,302,3002,2700,33,250
RN,17396,LUÍS GOMES,4170,583,1979,8145,6166,170,849
RN,17418,MACAÍBA,15353,11147,7291,44896,37605,1532,3709
RN,17434,MACAU,8821,3196,1858,18699,16841,705,1284
RN,17450,MARCELINO VIEIRA,3683,381,991,6199,5208,191,564
RN,17477,MARTINS,2715,1655,1010,6518,5508,144,557
RN,17493,MAXARANGUAPE,2641,2466,1386,8042,6656,212,633
RN,17515,FRUTUOSO GOMES,2247,314,845,4105,3260,106,313
RN,17531,MONTANHAS,3917,959,2387,8956,6569,258,744
RN,17558,MONTE ALEGRE,4651,4308,2832,15057,12225,580,1268
RN,17574,MONTE DAS GAMELEIRAS,1174,367,576,2735,2159,63,307
RN,17590,MOSSORÓ,54856,32745,23888,158920,135032,6624,10426
RN,17612,NATAL,138893,130582,87003,523934,436931,17110,29701
RN,17639,NÍSIA FLORESTA,5487,3494,1119,14041,12922,779,1171
RN,17655,NOVA CRUZ,9019,6205,7434,28214,20780,960,2224
RN,17671,OLHO D'ÁGUA DO BORGES,2157,411,760,4123,3363,145,368
RN,17698,OURO BRANCO,1577,638,410,3767,3357,142,359
RN,17710,PARANÁ,1988,151,566,3245,2679,68,372
RN,17736,PARAÚ,1777,517,466,3761,3295,124,355
RN,17752,PARAZINHO,1725,902,695,4110,3415,124,377
RN,17779,PARELHAS,4634,4750,2556,16267,13711,832,1299
RN,17795,PARNAMIRIM,21509,26323,13906,96331,82425,3094,5229
RN,17817,PASSA E FICA,2768,1706,1799,7670,5871,165,668
RN,17833,PASSAGEM,1588,757,320,3346,3026,47,266
RN,17850,PATU,4142,1099,1226,8452,7226,345,678
RN,17876,PAU DOS FERROS,9923,2141,3265,19156,15891,451,1397
RN,17892,PEDRA GRANDE,1509,901,760,3796,3036,116,281
RN,17914,PEDRA PRETA,1192,598,362,2682,2320,53,249
RN,17930,PEDRO AVELINO,2196,1528,538,5365,4827,151,568
RN,17957,PEDRO VELHO,5227,1295,3021,11962,8941,407,934
RN,17973,PENDÊNCIAS,5304,1365,2101,10635,8534,265,800
RN,17990,PILÕES,2008,124,316,2928,2612,57,259
RN,18015,POÇO BRANCO,4309,1941,1483,9837,8354,452,955
RN,18031,PORTALEGRE,2080,1428,918,5800,4882,185,670
RN,18058,SERRA CAIADA,3441,1180,1287,7083,5796,151,709
RN,18074,PUREZA,3271,976,1301,6865,5564,259,565
RN,18090,RAFAEL FERNANDES,2518,232,625,4141,3516,118,381
RN,18112,RIACHO DA CRUZ,1101,650,224,2503,2279,38,244
RN,18139,RIACHO DE SANTANA,1966,188,807,3497,2690,74,342
RN,18155,RIACHUELO,2395,1050,719,5511,4792,131,475
RN,18171,RODOLFO FERNANDES,2332,581,448,4137,3689,58,483
RN,18198,RUY BARBOSA,843,1251,584,3461,2877,57,317
RN,18210,SÃO FRANCISCO DO OESTE,1577,544,503,3352,2849,79,322
RN,18236,SANTA CRUZ,9373,6007,4330,24840,20510,812,1731
RN,18252,SANTANA DO SERIDÓ,992,342,243,2186,1943,71,145
RN,18279,SANTANA DO MATOS,4723,2443,2314,11757,9443,307,990
RN,18295,SANTO ANTÔNIO,7944,1490,4041,17606,13565,675,1648
RN,18317,SÃO BENTO DO NORTE,1440,582,401,3030,2629,131,237
RN,18333,SÃO BENTO DO TRAIRÍ,1302,917,534,3492,2958,116,330
RN,18350,SÃO FERNANDO,1721,473,116,2926,2810,76,241
RN,18376,SÃO GONÇALO DO AMARANTE,18496,15116,10456,60071,49615,2279,4248
RN,18392,SÃO JOÃO DO SABUGI,3017,319,615,5091,4476,91,321
RN,18414,SÃO JOSÉ DE MIPIBU,10024,5598,1710,23627,21917,1075,2344
RN,18430,SÃO JOSÉ DO CAMPESTRE,3848,2108,2085,10135,8050,481,947
RN,18457,SÃO JOSÉ DO SERIDÓ,1597,559,365,3745,3380,226,363
RN,18473,SÃO MIGUEL,7834,1812,4973,18038,13065,655,2003
RN,18490,SÃO PAULO DO POTENGI,4249,3701,2635,13274,10639,462,1121
RN,18511,SÃO PEDRO,2383,1568,655,5714,5059,149,517
RN,18538,SÃO RAFAEL,3296,1133,1122,7019,5897,242,695
RN,18554,SÃO TOMÉ,4314,1261,1126,8313,7187,166,800
RN,18570,SÃO VICENTE,1960,920,942,4872,3930,163,440
RN,18597,SENADOR ELÓI DE SOUZA,2018,869,1054,4936,3882,136,481
RN,18619,SENADOR GEORGINO AVELINO,896,1136,526,3481,2955,164,269
RN,18635,SERRA DE SÃO BENTO,1945,1155,776,4882,4106,173,481
RN,18651,SERRA NEGRA DO NORTE,2852,875,1313,6201,4888,223,481
RN,18678,SERRINHA,3067,712,1075,6311,5236,233,671
RN,18694,SEVERIANO MELO,3374,714,1662,7160,5498,169,672
RN,18716,SÍTIO NOVO,2193,737,614,4270,3656,111,376
RN,18732,TABOLEIRO GRANDE,918,412,210,2032,1822,53,193
RN,18759,TAIPU,3690,2255,1356,9184,7828,364,908
RN,18775,TANGARÁ,3773,2968,2297,11422,9125,302,901
RN,18791,TENENTE ANANIAS,4486,857,935,7276,6341,87,651
RN,18813,TIBAU DO SUL,2877,2246,1408,8537,7129,312,659
RN,18830,TIMBAÚBA DOS BATISTAS,801,358,239,2089,1850,77,163
RN,18856,TOUROS,8151,5062,3890,21414,17524,723,1717
RN,18872,UMARIZAL,4715,825,1636,9049,7413,236,786
RN,18899,UPANEMA,4327,1014,1552,9933,8381,402,728
RN,18910,VÁRZEA,1820,1114,699,4600,3901,112,415
RN,18937,RAFAEL GODEIRO,1598,338,477,3077,2600,78,260
RN,18953,VERA CRUZ,2945,2411,959,8281,7322,363,838
RN,18970,VIÇOSA,659,205,225,1500,1275,42,177
RN,18996,VILA FLOR,974,432,266,2241,1975,100,206
RN,30031,BARAÚNA,6704,3146,2282,15892,13610,668,1444
RO,19,GUAJARÁ-MIRIM,9239,6755,6606,27365,20759,271,964
RO,35,PORTO VELHO,96236,62047,45553,275936,230383,4664,9038
RO,51,JI-PARANÁ,19369,30350,18390,80693,62303,1138,2808
RO,78,ARIQUEMES,15181,24037,13614,60484,46870,1004,2295
RO,94,CACOAL,14115,22390,12288,56329,44041,897,2060
RO,116,PIMENTA BUENO,6602,8995,5902,25056,19154,410,885
RO,132,VILHENA,12184,17641,10700,48646,37946,944,2048
RO,159,JARU,9524,15874,10270,39872,29602,581,1629
RO,175,OURO PRETO DO OESTE,7958,11398,7732,30447,22715,371,1139
RO,191,PRESIDENTE MÉDICI,4952,5362,4697,17543,12846,360,710
RO,213,COSTA MARQUES,3062,2545,2120,8365,6245,66,270
RO,230,COLORADO DO OESTE,4721,4487,2048,12892,10844,328,517
RO,256,ESPIGÃO DO OESTE,6185,8343,4375,20849,16474,390,685
RO,272,CEREJEIRAS,2982,5935,3283,13683,10400,171,598
RO,299,ROLIM DE MOURA,10435,12965,8030,35900,27870,598,1413
RO,310,ALTA FLORESTA DO OESTE,6497,6581,4775,19456,14681,289,658
RO,337,ALVORADA DO OESTE,3957,4468,3221,12840,9619,150,494
RO,353,SANTA LUZIA DO OESTE,2320,2754,1886,7688,5802,117,335
RO,370,NOVA BRASILÂNDIA DO OESTE,4171,6014,2939,14461,11522,189,611
RO,396,MACHADINHO DO OESTE,6310,7676,6075,21702,15627,271,851
RO,418,SÃO MIGUEL DO GUAPORÉ,4821,5451,2902,14331,11429,182,509
RO,434,NOVA MAMORÉ,3643,5821,3487,14175,10688,199,633
RO,450,CABIXI,1795,1746,1210,5268,4058,83,173
RO,477,CANDEIAS DO JAMARI,5448,2670,2525,13249,10724,224,599
RO,493,ITAPUÃ DO OESTE,2193,1586,1185,5607,4422,79,227
RO,515,NOVO HORIZONTE DO OESTE,2912,2384,1763,7811,6048,99,275
RO,531,CASTANHEIRAS,1354,1019,781,3458,2677,41,135
RO,558,VALE DO PARAÍSO,2046,2556,1524,6675,5151,60,270
RO,566,URUPÁ,2674,3790,2402,9827,7425,133,471
RO,574,MIRANTE DA SERRA,2923,3665,2282,9554,7272,132,284
RO,582,SERINGUEIRAS,3206,2985,1915,8821,6906,147,340
RO,590,THEOBROMA,2238,3361,2000,8261,6261,82,315
RO,604,MINISTRO ANDREAZZA,2396,2621,1498,7072,5574,81,249
RO,612,GOVERNADOR JORGE TEIXEIRA,2136,3439,1642,7852,6210,79,357
RO,620,CACAULÂNDIA,1225,1614,699,4031,3332,59,209
RO,639,ALTO PARAÍSO,3814,4123,2453,11344,8891,195,413
RO,647,RIO CRESPO,739,1156,615,2808,2193,46,116
RO,655,CORUMBIARA,1890,2058,1270,5802,4532,80,209
RO,663,MONTE NEGRO,2681,4140,3053,10873,7820,147,458
RO,671,CAMPO NOVO DE RONDÔNIA,2137,2727,2155,7549,5394,71,281
RO,680,CUJUBIM,2200,3828,2142,8902,6760,122,392
RO,698,VALE DO ANARI,1758,2437,1548,6310,4762,103,310
RO,701,PARECIS,1121,986,506,2848,2342,28,143
RO,710,SÃO FELIPE DO OESTE,1394,2182,1080,5210,4130,89,238
RO,728,PRIMAVERA DE RONDÔNIA,931,1167,749,3299,2550,40,160
RO,736,ALTO ALEGRE DOS PARECIS,2607,3207,1724,8311,6587,119,372
RO,744,NOVA UNIÃO,1975,1924,1134,5465,4331,64,217
RO,752,TEIXEIRÓPOLIS,1167,1721,1023,4228,3205,46,167
RO,779,BURITIS,5363,8927,5725,21706,15981,274,918
RO,787,PIMENTEIRAS DO OESTE,559,679,658,2094,1436,22,89
RO,795,SÃO FRANCISCO DO GUAPORÉ,2968,4063,2467,10264,7797,146,353
RO,809,CHUPINGUAIA,1398,1785,1376,5136,3760,52,264
RR,3000,CAROEBE,1892,2222,714,5524,4810,83,284
RR,3018,BOA VISTA,34041,74545,25552,176904,151352,1803,4411
RR,3026,IRACEMA,1821,1783,681,4968,4287,50,257
RR,3034,CARACARAÍ,2802,4730,1646,10765,9119,89,385
RR,3042,AMAJARI,878,2347,543,4418,3875,25,173
RR,3050,ALTO ALEGRE,2408,3419,776,7885,7109,79,321
RR,3069,CANTÁ,2332,4018,1014,8820,7806,71,379
RR,3077,BONFIM,1585,2833,832,6136,5304,42,220
RR,3085,RORAINÓPOLIS,4847,4165,1708,12420,10712,149,500
RR,3093,MUCAJAÍ,3131,3958,1313,9738,8425,112,319
RR,3107,UIRAMUTÃ,1774,1153,554,3929,3375,40,275
RR,3115,NORMANDIA,1700,1914,528,4687,4159,15,147
RR,3123,PACARAIMA,1336,3030,873,6026,5153,44,237
RR,3131,SÃO JOÃO DA BALIZA,1666,1652,542,4524,3982,64,185
RR,3158,SÃO LUIZ,1714,1832,704,4852,4148,59,177
RS,84735,ÁUREA,1029,1272,306,2987,2681,162,110
RS,84743,TRÊS ARROIOS,1136,806,241,2472,2231,88,66
RS,84751,NOVA ROMA DO SUL,1023,1165,206,2753,2547,112,96
RS,84760,PROGRESSO,2503,1305,694,5101,4407,197,176
RS,84778,PIRAPÓ,1089,588,571,2487,1916,68,108
RS,84786,JABOTICABA,1391,831,668,3225,2557,74,151
RS,84794,SÃO JORGE,1036,910,240,2473,2233,81,80
RS,84808,ALTO ALEGRE,738,532,159,1588,1429,66,48
RS,84816,NOVA HARTZ,6496,3312,1558,13228,11670,412,371
RS,84824,DOIS LAJEADOS,1157,942,299,2790,2491,114,100
RS,84832,SÃO DOMINGOS DO SUL,1084,752,269,2462,2193,107,83
RS,84840,TUNAS,2092,647,523,3594,3071,94,125
RS,84859,SÃO JOÃO DA URTIGA,1673,1123,590,4016,3426,312,155
RS,84867,GUABIJU,461,560,196,1435,1239,89,37
RS,84875,QUINZE DE NOVEMBRO,1322,1221,253,3048,2795,42,68
RS,84883,DOUTOR MAURÍCIO CARDOSO,1775,1745,580,4519,3939,107,151
RS,84891,CAPELA DE SANTANA,3471,2282,1035,7801,6766,273,209
RS,84905,JAQUIRANA,1201,1280,1092,3954,2862,130,119
RS,84913,VANINI,642,588,177,1680,1503,78,62
RS,84921,BOQUEIRÃO DO LEÃO,3235,1112,957,6146,5189,263,190
RS,84930,FAGUNDES VARELA,831,800,182,2132,1950,63,100
RS,84948,ÁGUA SANTA,1183,994,380,2991,2611,102,108
RS,84956,SILVEIRA MARTINS,998,743,239,2277,2038,77,39
RS,84964,IBIRAPUITÃ,1507,1078,480,3374,2894,90,114
RS,84972,IBARAMA,2073,598,256,3379,3123,147,111
RS,84980,PANTANO GRANDE,3635,2239,1650,8501,6851,276,257
RS,84999,IPÊ,1624,2157,585,5009,4424,185,172
RS,85006,TRINDADE DO SUL,2130,1128,559,4359,3800,140,169
RS,85014,AGUDO,6013,3802,1791,13111,11320,473,307
RS,85022,ERNESTINA,1144,979,204,2559,2355,69,55
RS,85030,AJURICABA,2307,2295,855,6040,5185,108,150
RS,85049,DEZESSEIS DE NOVEMBRO,991,727,417,2395,1978,102,82
RS,85057,ALECRIM,2737,1734,738,5904,5166,173,246
RS,85065,BROCHIER,2157,904,389,3795,3406,94,103
RS,85073,ALEGRETE,22082,18940,13647,61265,47618,1159,1083
RS,85081,EREBANGO,920,853,259,2272,2013,66,87
RS,85090,ALPESTRE,3211,1310,927,6205,5278,356,194
RS,85103,ENTRE-IJUÍS,3620,1732,1061,7203,6142,209,193
RS,85111,ALVORADA,49200,42641,17952,133956,116004,5528,4069
RS,85120,NOVA ESPERANÇA DO SUL,1446,1346,395,3706,3311,194,130
RS,85138,ANTA GORDA,1865,1716,848,5185,4337,288,166
RS,85146,PAVERAMA,2825,1553,901,5870,4969,191,132
RS,85154,ANTÔNIO PRADO,3034,4325,1651,10670,9019,366,417
RS,85162,TERRA DE AREIA,2743,2278,1347,7172,5825,190,212
RS,85170,ARATIBA,2414,1921,493,5495,5002,208,180
RS,85189,HARMONIA,1579,1249,336,3607,3271,140,95
RS,85197,ARROIO DO MEIO,6684,4394,1787,15234,13447,537,451
RS,85200,CAMPOS BORGES,1227,849,388,2846,2458,143,102
RS,85219,ARROIO DOS RATOS,3300,3745,2001,10564,8563,379,346
RS,85227,CERRO GRANDE,1048,448,291,2075,1784,54,89
RS,85235,ARROIO DO TIGRE,5516,2010,1354,10135,8781,477,259
RS,85243,IPIRANGA DO SUL,495,878,168,1772,1604,87,66
RS,85251,ARROIO GRANDE,4860,5833,2960,15655,12695,578,428
RS,85260,LAGOÃO,2360,1026,958,4859,3901,183,187
RS,85278,ARVOREZINHA,3445,2395,1380,8304,6924,457,228
RS,85286,ESTAÇÃO,1680,2104,692,5120,4428,197,147
RS,85294,AUGUSTO PESTANA,2694,2043,661,5891,5230,145,161
RS,85308,ARROIO DO SAL,1876,2073,1228,6149,4921,97,165
RS,85316,BAGÉ,27687,31242,15065,87220,72155,2944,2135
RS,85324,SÃO JOSÉ DO HORTÊNCIO,1580,1060,319,3333,3014,125,95
RS,85332,BARÃO DE COTEGIPE,1954,1975,672,5256,4584,199,172
RS,85340,PINHAL,913,548,205,1846,1641,42,78
RS,85359,BARRACÃO,1741,1183,695,4168,3473,195,160
RS,85367,TRÊS CACHOEIRAS,3552,2333,1168,7843,6675,157,144
RS,85375,BARRA DO RIBEIRO,2915,3764,1806,10033,8227,352,263
RS,85383,SÃO VENDELINO,829,646,123,1854,1731,47,51
RS,85391,BARROS CASSAL,3790,2448,1750,9075,7325,366,405
RS,85405,PROTÁSIO ALVES,487,898,231,1903,1672,104,53
RS,85413,BENTO GONÇALVES,26377,29348,10038,80218,70180,3224,2951
RS,85421,POUSO NOVO,687,501,299,1707,1408,84,69
RS,85430,BOA VISTA DO BURICÁ,2524,1825,806,5599,4793,124,104
RS,85448,EUGÊNIO DE CASTRO,1100,788,367,2540,2173,102,76
RS,85456,BOM JESUS,2405,3735,1799,8795,6996,306,244
RS,85464,CRISTAL,2666,1667,1002,5848,4846,170,122
RS,85472,BOM RETIRO DO SUL,3605,3255,1176,9369,8193,395,274
RS,85480,SÃO MIGUEL DAS MISSÕES,2979,1574,949,6004,5055,169,140
RS,85499,BOSSOROCA,2287,1652,1237,5834,4597,229,151
RS,85502,GLORINHA,1812,2471,864,5946,5082,206,181
RS,85510,BRAGA,1439,777,501,3018,2517,104,96
RS,85529,SEGREDO,3193,1075,896,5815,4919,238,181
RS,85537,BUTIÁ,5495,5655,2901,16230,13329,526,485
RS,85545,ALEGRIA,1535,1114,568,3678,3110,141,154
RS,85553,CAÇAPAVA DO SUL,9811,8682,3457,25624,22167,1216,853
RS,85561,SALDANHA MARINHO,1042,1060,280,2611,2331,81,43
RS,85570,CACEQUI,4359,2901,2714,10999,8285,227,236
RS,85588,SÃO JOSÉ DO HERVAL,893,537,427,2084,1657,54,115
RS,85596,CACHOEIRA DO SUL,22111,23136,13943,68612,54669,2095,1436
RS,85600,VISTA ALEGRE,1213,613,270,2348,2078,58,95
RS,85618,CACHOEIRINHA,32901,28669,12112,92483,80371,3545,2758
RS,85626,IVORÁ,759,699,245,1924,1679,74,43
RS,85634,CACIQUE DOBLE,1297,1419,497,3668,3171,168,153
RS,85642,VILA MARIA,1231,1291,363,3400,3037,186,139
RS,85650,CAIBATÉ,1830,969,557,3882,3325,209,107
RS,85669,TAQUARUÇU DO SUL,1081,794,312,2430,2118,75,78
RS,85677,CAIÇARA,1879,1225,362,3881,3519,117,111
RS,85685,IMBÉ,4520,5025,2646,14028,11382,379,307
RS,85693,CAMAQUÃ,17902,17139,7545,48572,41027,1666,1207
RS,85707,SEDE NOVA,1088,724,345,2422,2077,77,80
RS,85715,CAMBARÁ DO SUL,1428,2303,1218,5543,4325,189,192
RS,85723,TUPANDI,1319,1204,275,3130,2855,120,68
RS,85731,CAMPINA DAS MISSÕES,2502,1570,739,5315,4576,110,191
RS,85740,RIOZINHO,1922,1015,530,3838,3308,153,118
RS,85758,CAMPINAS DO SUL,1258,2273,706,4668,3962,125,114
RS,85766,RELVADO,677,726,500,2156,1656,63,110
RS,85774,CAMPO BOM,19207,14508,5778,47564,41786,1340,1254
RS,85782,IMIGRANTE,1111,710,187,2402,2215,93,132
RS,85790,CAMPO NOVO,1993,1033,1088,4771,3683,125,113
RS,85804,CIDREIRA,3061,3086,2292,9583,7291,167,223
RS,85812,CANDELÁRIA,10138,6173,3759,23560,19801,1250,623
RS,85820,MONTAURI,616,484,120,1403,1283,72,58
RS,85839,CÂNDIDO GODÓI,1956,2530,465,5448,4983,155,120
RS,85847,VISTA GAÚCHA,1386,589,385,2566,2181,33,87
RS,85855,CANELA,7046,13226,3787,27850,24063,1042,741
RS,85863,VISTA ALEGRE DO PRATA,640,540,206,1563,1357,50,52
RS,85871,CANGUÇU,16527,14713,6527,43829,37302,2497,1093
RS,85880,CASEIROS,795,1071,294,2491,2197,146,80
RS,85898,CANOAS,87663,69710,13021,216727,203706,7835,6682
RS,85901,ITACURUBI,1241,708,691,2929,2238,91,50
RS,85910,CARAZINHO,15098,16896,7084,45431,38347,1118,1109
RS,85928,ENTRE RIOS DO SUL,1184,838,354,2604,2250,61,100
RS,85936,CARLOS BARBOSA,8272,6366,1986,19637,17651,571,559
RS,85944,CERRO GRANDE DO SUL,3072,2038,884,6785,5901,268,284
RS,85952,CASCA,2552,2564,980,7113,6133,365,229
RS,85960,CAMARGO,724,826,177,2004,1827,106,91
RS,85979,CATUÍPE,2979,2628,894,7733,6839,366,211
RS,85987,PARAÍSO DO SUL,2932,1724,878,6103,5225,168,103
RS,85995,CAXIAS DO SUL,91692,116452,36691,310324,273633,11234,13342
RS,86010,CERRO LARGO,5055,2204,1315,9650,8335,242,282
RS,86029,FAXINALZINHO,851,674,315,2081,1766,53,111
RS,86037,CHAPADA,3396,2765,939,7871,6932,289,187
RS,86045,AMARAL FERRADOR,2493,1073,651,4812,4161,192,161
RS,86053,CHIAPETTA,1370,946,607,3429,2822,68,73
RS,86061,VILA FLORES,791,1318,244,2842,2598,153,149
RS,86070,CIRÍACO,1648,1213,496,3879,3383,219,119
RS,86088,CERRO BRANCO,1913,884,426,3630,3204,124,122
RS,86096,COLORADO,967,1501,377,3106,2729,94,81
RS,86100,ANDRÉ DA ROCHA,388,591,282,1410,1128,65,22
RS,86118,CONDOR,2327,1625,484,5099,4615,127,142
RS,86126,POÇO DAS ANTAS,829,615,189,1799,1610,50,44
RS,86134,CONSTANTINA,2743,2643,1242,7609,6367,272,305
RS,86142,TRÊS PALMEIRAS,1491,963,481,3406,2925,162,157
RS,86150,CORONEL BICACO,2914,1611,1260,6392,5132,160,198
RS,86169,NOVA ALVORADA,988,986,169,2443,2274,106,101
RS,86177,CRISSIUMAL,5360,3230,1345,11109,9764,360,325
RS,86185,MORRO REDONDO,1774,1932,639,5047,4408,235,133
RS,86193,CRUZ ALTA,16309,15759,10181,48712,38531,1173,1165
RS,86207,SANTA MARIA DO HERVAL,2433,1769,340,4993,4653,159,126
RS,86215,CRUZEIRO DO SUL,4250,3045,1043,9474,8431,301,262
RS,86223,BARÃO,1785,1673,449,4389,3940,137,122
RS,86231,DAVID CANABARRO,1524,1315,538,3941,3403,259,137
RS,86240,ELDORADO DO SUL,8511,6851,3515,23061,19546,712,644
RS,86258,DOIS IRMÃOS,9791,6621,1992,20647,18655,474,453
RS,86274,DOM FELICIANO,4720,2931,1716,10636,8920,471,380
RS,86282,ALTO FELIZ,954,962,201,2374,2173,75,79
RS,86290,DOM PEDRITO,12119,8975,6217,30067,23850,693,639
RS,86304,AMETISTA DO SUL,2298,1694,1425,6030,4605,222,168
RS,86312,DONA FRANCISCA,1060,1153,402,3044,2642,98,95
RS,86320,ARAMBARÉ,1089,1127,609,3248,2639,66,114
RS,86339,ENCANTADO,6158,5141,2370,16215,13845,578,642
RS,86347,BARÃO DO TRIUNFO,1727,1837,783,4969,4186,162,194
RS,86355,ENCRUZILHADA DO SUL,7639,5802,3884,20084,16200,946,662
RS,86363,BARRA DO GUARITA,1019,751,438,2507,2069,69,108
RS,86371,ERECHIM,27015,23956,11008,72161,61153,2256,2028
RS,86380,BARRA DO RIO AZUL,796,682,201,1855,1654,47,50
RS,86398,HERVAL,2526,1384,1145,5670,4525,168,185
RS,86401,BARRA FUNDA,1016,728,243,2249,2006,70,53
RS,86410,ERVAL GRANDE,1757,1259,375,3921,3546,187,165
RS,86428,BOA VISTA DAS MISSÕES,848,541,336,1919,1583,26,49
RS,86436,ERVAL SECO,2810,1572,1298,6182,4884,143,194
RS,86444,BOM PROGRESSO,1041,563,389,2189,1800,34,39
RS,86452,ESMERALDA,739,1090,491,2525,2034,86,39
RS,86460,CAMPESTRE DA SERRA,825,1024,345,2501,2156,130,67
RS,86479,ESPUMOSO,4067,4941,1251,11584,10333,402,297
RS,86487,CANDIOTA,3439,1602,1130,6956,5826,178,142
RS,86495,ESTÂNCIA VELHA,12524,9751,3424,30476,27052,1138,948
RS,86509,CAPITÃO,1215,585,178,2293,2115,142,66
RS,86517,ESTEIO,27910,17023,9170,66219,57049,1949,1670
RS,86525,CARLOS GOMES,593,578,239,1540,1301,62,38
RS,86533,ESTRELA,9093,7996,3137,23695,20558,693,587
RS,86541,CENTENÁRIO,1035,1059,227,2497,2270,63,54
RS,86550,FARROUPILHA,17271,18999,5825,49626,43801,1886,1647
RS,86568,CHARRUA,940,1111,475,2771,2296,46,128
RS,86576,FAXINAL DO SOTURNO,2218,1849,626,5409,4783,161,144
RS,86584,COLINAS,877,768,204,2149,1945,45,75
RS,86592,FELIZ,4176,3273,1148,10006,8858,377,349
RS,86606,COQUEIROS DO SUL,865,987,246,2268,2022,65,41
RS,86614,FLORES DA CUNHA,5582,9249,2897,22034,19137,1003,1004
RS,86622,CORONEL BARROS,978,864,200,2184,1984,30,48
RS,86630,FONTOURA XAVIER,3683,2281,1981,8740,6759,297,268
RS,86649,COXILHA,1134,864,279,2483,2204,57,50
RS,86657,FORMIGUEIRO,1888,2263,953,6030,5077,230,296
RS,86665,DERRUBADAS,1117,1027,289,2642,2353,32,101
RS,86673,FREDERICO WESTPHALEN,9423,6947,3890,22777,18887,654,606
RS,86681,DOIS IRMÃOS DAS MISSÕES,902,586,292,1931,1639,42,69
RS,86690,GARIBALDI,7246,9581,3044,23691,20647,937,908
RS,86703,ENGENHO VELHO,501,431,230,1263,1033,22,49
RS,86711,GAURAMA,1799,2120,627,5156,4529,229,137
RS,86720,GARRUCHOS,1427,559,799,3015,2216,58,71
RS,86738,GENERAL CÂMARA,2786,1914,1217,6824,5607,216,182
RS,86746,GENTIL,520,628,125,1437,1312,60,42
RS,86754,SÃO VICENTE DO SUL,2676,1932,1490,6933,5443,222,182
RS,86762,GRAMADO DOS LOUREIROS,980,366,237,1786,1549,47,69
RS,86770,GETÚLIO VARGAS,3763,5625,2069,12864,10795,378,390
RS,86789,GRAMADO XAVIER,1454,623,255,2756,2501,125,85
RS,86797,GIRUÁ,5102,4570,1625,12600,10975,289,393
RS,86800,HULHA NEGRA,2020,1254,454,4168,3714,101,113
RS,86819,GRAMADO,6066,12445,3789,26851,23062,970,869
RS,86827,INHACORÁ,894,494,425,2061,1636,57,77
RS,86835,GRAVATAÍ,58555,57313,21015,173883,152868,7578,5942
RS,86843,ITAPUCA,843,544,334,1885,1551,75,40
RS,86851,GUAÍBA,23342,22778,9015,69336,60321,2668,2073
RS,86860,LAJEADO DO BUGRE,947,378,302,1854,1552,57,97
RS,86878,GUAPORÉ,6211,5819,2281,17099,14818,778,573
RS,86886,LAGOA DOS TRÊS CANTOS,450,673,110,1371,1261,41,40
RS,86894,GUARANI DAS MISSÕES,3067,1905,1048,6711,5663,196,187
RS,86908,LINDOLFO COLLOR,2296,934,419,4078,3659,112,106
RS,86916,HORIZONTINA,6294,4583,1990,14478,12488,258,299
RS,86924,LINHA NOVA,520,457,111,1281,1170,63,42
RS,86932,CHARQUEADAS,8249,7472,2883,22818,19935,792,683
RS,86940,MANOEL VIANA,2685,1401,1347,5848,4501,146,120
RS,86959,HUMAITÁ,1938,1175,482,4092,3610,123,127
RS,86967,MAQUINÉ,2890,1489,998,5866,4868,151,158
RS,86975,IBIAÇÁ,1392,1393,413,3675,3262,161,91
RS,86983,MARATÁ,1098,699,170,2160,1990,43,44
RS,86991,IBIRAIARAS,1772,2299,773,5650,4877,310,200
RS,87009,MARIANA PIMENTEL,1167,1275,542,3434,2892,124,110
RS,87017,IBIRUBÁ,6269,5394,2277,15654,13377,448,364
RS,87025,MATO CASTELHANO,904,982,280,2388,2108,77,67
RS,87033,IGREJINHA,10041,7361,2716,23833,21117,775,559
RS,87041,MATO LEITÃO,1619,951,240,3102,2862,84,69
RS,87050,IJUÍ,24949,18247,9739,60224,50485,1181,1339
RS,87068,MINAS DO LEÃO,1502,2782,862,6121,5259,233,209
RS,87076,ILÓPOLIS,1253,1097,618,3434,2816,151,108
RS,87084,MONTE BELO DO SUL,850,1118,319,2747,2428,149,146
RS,87092,INDEPENDÊNCIA,2308,1909,1031,5879,4848,163,163
RS,87106,MORMAÇO,930,814,246,2238,1992,101,90
RS,87114,IRAÍ,2847,1650,925,6056,5131,228,170
RS,87122,MORRINHOS DO SUL,1426,1057,516,3326,2810,83,59
RS,87130,ITAQUI,10297,8207,5498,27006,21508,499,520
RS,87149,MORRO REUTER,1869,1872,306,4660,4354,178,148
RS,87157,ITATIBA DO SUL,1869,1036,371,3589,3218,112,111
RS,87165,MULITERNO,724,548,190,1667,1477,100,37
RS,87173,IVOTI,6130,4834,1386,14347,12961,325,325
RS,87181,NICOLAU VERGUEIRO,469,805,251,1724,1473,97,58
RS,87190,JACUTINGA,928,1224,427,2957,2530,127,107
RS,87203,NOVA BOA VISTA,737,783,182,1880,1698,65,39
RS,87211,JAGUARÃO,6930,8211,4642,22504,17862,729,651
RS,87220,NOVA PÁDUA,410,1173,173,2119,1946,102,105
RS,87238,JAGUARI,3856,3016,1653,10004,8351,541,326
RS,87246,NOVA SANTA RITA,7097,4199,2022,15774,13752,522,408
RS,87254,JÚLIO DE CASTILHOS,6307,4719,3054,15753,12699,359,348
RS,87262,NOVO BARREIRO,1560,1145,368,3430,3062,70,150
RS,87270,LAGOA VERMELHA,6388,8133,3603,20627,17024,713,531
RS,87289,NOVO MACHADO,1140,1561,296,3247,2951,66,114
RS,87297,LAJEADO,20904,16356,6595,51718,45123,1512,1342
RS,87300,NOVO TIRADENTES,847,410,435,1913,1478,49,88
RS,87319,LAVRAS DO SUL,2391,2018,1045,6215,5170,209,215
RS,87327,PARECI NOVO,1110,1041,342,2855,2513,100,71
RS,87335,LIBERATO SALZANO,1970,1204,615,4346,3731,227,216
RS,87343,PASSO DO SOBRADO,2888,798,454,4728,4274,228,107
RS,87351,MACHADINHO,1898,1244,529,4245,3716,153,204
RS,87360,PICADA CAFÉ,1503,1597,422,4023,3601,81,118
RS,87378,MARAU,8805,10832,3500,26664,23164,934,730
RS,87386,PINHAL GRANDE,1743,876,650,3784,3134,107,82
RS,87394,MARCELINO RAMOS,1874,1413,546,4220,3674,72,93
RS,87408,PINHEIRINHO DO VALE,1613,899,323,3144,2821,94,123
RS,87416,MARIANO MORO,945,487,225,1958,1733,136,58
RS,87424,PONTÃO,1435,1141,373,3203,2830,71,69
RS,87432,MATA,1454,1474,775,4294,3519,261,115
RS,87440,PONTE PRETA,642,734,155,1688,1533,41,37
RS,87459,MAXIMILIANO DE ALMEIDA,1416,1438,660,4059,3399,193,161
RS,87467,PORTO MAUÁ,904,830,302,2245,1943,64,57
RS,87475,MIRAGUAÍ,1988,883,484,3717,3233,95,115
RS,87483,PORTO VERA CRUZ,861,468,287,1785,1498,32,76
RS,87491,MONTENEGRO,15286,14543,6011,43144,37133,1632,1355
RS,87505,PRESIDENTE LUCENA,801,817,110,1977,1867,47,53
RS,87513,MOSTARDAS,2848,3363,1558,9071,7513,345,268
RS,87521,QUEVEDOS,977,637,272,2094,1822,93,45
RS,87530,MUÇUM,1278,1545,377,3868,3491,239,142
RS,87548,RIO DOS ÍNDIOS,1508,761,418,3042,2624,108,128
RS,87556,NÃO-ME-TOQUE,4869,4587,1542,12436,10894,362,345
RS,87564,SAGRADA FAMÍLIA,1030,478,325,2108,1783,45,109
RS,87572,NONOAI,3894,2327,2208,9568,7360,267,368
RS,87580,SALVADOR DAS MISSÕES,997,941,242,2385,2143,52,74
RS,87599,NOVA ARAÇÁ,1097,1050,354,3065,2711,177,126
RS,87602,SANTA CLARA DO SUL,2321,1293,300,4521,4221,182,157
RS,87610,NOVA BASSANO,2572,2617,881,6898,6017,298,182
RS,87629,SANTA TEREZA,671,585,165,1663,1498,111,70
RS,87637,NOVA BRÉSCIA,889,1064,225,2588,2363,109,104
RS,87645,SANTO ANTÔNIO DO PALMA,787,599,186,1804,1618,42,66
RS,87653,NOVA PALMA,2224,1819,490,5098,4608,129,115
RS,87661,SANTO ANTÔNIO DO PLANALTO,581,848,148,1753,1605,44,36
RS,87670,NOVA PETRÓPOLIS,5200,5977,1984,15700,13716,453,509
RS,87688,SANTO EXPEDITO DO SUL,925,676,174,2100,1926,126,84
RS,87696,NOVA PRATA,5496,6544,2508,17329,14821,558,469
RS,87700,SÃO JOÃO DO POLÊSINE,801,954,372,2412,2040,52,57
RS,87718,NOVO HAMBURGO,64447,57057,22674,175946,153272,5688,5014
RS,87726,SÃO JOSÉ DOS AUSENTES,1031,1002,656,2960,2304,72,115
RS,87734,OSÓRIO,12679,9811,4824,32103,27279,1095,925
RS,87742,SÃO JOSÉ DO INHACORÁ,1041,612,232,2073,1841,47,64
RS,87750,PAIM FILHO,1685,1227,459,3678,3219,90,124
RS,87769,SÃO JOSÉ DAS MISSÕES,1306,494,262,2348,2086,49,89
RS,87777,PALMEIRA DAS MISSÕES,9178,7884,4420,24393,19973,603,808
RS,87785,SÃO MARTINHO DA SERRA,987,1094,387,2835,2448,109,53
RS,87793,PALMITINHO,2850,1458,892,5665,4773,120,160
RS,87807,SÃO PEDRO DA SERRA,1264,901,288,2726,2438,75,67
RS,87815,PANAMBI,10603,9379,4338,28023,23685,632,527
RS,87823,SÃO PEDRO DO BUTIÁ,1058,782,351,2432,2081,56,88
RS,87831,PARAÍ,1970,2017,655,5564,4909,324,195
RS,87840,SÃO VALENTIM DO SUL,851,814,262,2217,1955,99,76
RS,87858,PASSO FUNDO,53717,42155,18405,133122,114717,3351,2623
RS,87866,SÃO VALÉRIO DO SUL,974,462,474,2067,1593,44,60
RS,87874,PEDRO OSÓRIO,2264,2095,1059,6446,5387,281,170
RS,87882,SENTINELA DO SUL,1535,1435,558,4071,3513,192,130
RS,87890,PEJUÇARA,1325,1164,418,3214,2796,94,82
RS,87904,SÉRIO,1172,458,170,2084,1914,109,69
RS,87912,PELOTAS,78873,82382,40199,247376,207177,8004,6921
RS,87920,SERTÃO SANTANA,1733,1812,762,4879,4117,183,130
RS,87939,PINHEIRO MACHADO,4063,3271,2036,10934,8898,521,260
RS,87947,SINIMBU,5023,1005,1188,7968,6780,176,184
RS,87955,PIRATINI,6191,4672,3140,16278,13138,822,473
RS,87963,TIRADENTES DO SUL,2553,1459,575,4971,4396,110,133
RS,87971,PLANALTO,3369,2211,1171,7811,6640,401,248
RS,87980,TRAVESSEIRO,940,683,177,1971,1794,47,64
RS,87998,PORTÃO,9585,6211,2644,21605,18961,724,694
RS,88005,TRÊS FORQUILHAS,1306,844,366,2744,2378,90,48
RS,88013,PORTO ALEGRE,328041,338754,166693,1063761,897068,32623,31657
RS,88021,TUPANCI DO SUL,517,459,227,1349,1122,69,40
RS,88030,PORTO LUCENA,2015,1407,498,4325,3827,115,126
RS,88048,UNIÃO DA SERRA,613,546,203,1582,1379,96,45
RS,88056,PORTO XAVIER,4096,1896,2099,8951,6852,233,312
RS,88064,VALE DO SOL,5603,869,915,8240,7325,266,151
RS,88072,PUTINGA,1515,1197,755,4016,3261,210,177
RS,88080,VALE REAL,1889,1461,434,4239,3805,160,134
RS,88099,QUARAÍ,7542,4989,4112,18520,14408,354,369
RS,88102,VILA NOVA DO SUL,1403,1236,661,3767,3106,125,153
RS,88110,REDENTORA,2683,1247,1424,6110,4686,163,303
RS,88129,VITÓRIA DAS MISSÕES,1841,670,316,3062,2746,48,71
RS,88137,RESTINGA SÊCA,4056,5046,2550,13450,10900,363,352
RS,88145,XANGRI-LÁ,2616,3269,1048,8026,6978,197,188
RS,88153,RIO GRANDE,58459,35090,22246,143620,121374,4866,3779
RS,88161,BOA VISTA DO SUL,966,907,262,2440,2178,110,47
RS,88170,RIO PARDO,13977,7404,4937,30078,25141,991,816
RS,88188,DILERMANDO DE AGUIAR,1009,1081,436,2778,2342,41,80
RS,88196,ROCA SALES,3063,2532,679,7410,6731,408,244
RS,88200,CAPIVARI DO SUL,1171,1046,425,2918,2493,49,83
RS,88218,RODEIO BONITO,2171,1161,496,4344,3848,133,164
RS,88226,NOVA CANDELÁRIA,1120,727,153,2234,2081,109,59
RS,88234,ROLANTE,6160,4638,1667,14469,12802,508,421
RS,88242,FLORIANO PEIXOTO,863,742,242,2002,1760,49,60
RS,88250,RONDA ALTA,3403,2356,936,7291,6355,186,174
RS,88269,CHUVISCA,1840,1222,355,3895,3540,201,133
RS,88277,RONDINHA,1994,1672,414,4476,4062,137,103
RS,88285,ESPERANÇA DO SUL,1440,773,339,2827,2488,54,78
RS,88293,ROQUE GONZALES,2864,1432,924,5828,4904,189,222
RS,88307,DOUTOR RICARDO,931,495,281,1981,1700,77,81
RS,88315,ROSÁRIO DO SUL,11460,10291,7161,32198,25037,728,702
RS,88323,HERVEIRAS,1794,234,341,2530,2189,43,48
RS,88331,SALVADOR DO SUL,2065,1854,443,5142,4699,215,204
RS,88340,CARAÁ,2298,2226,905,6060,5155,251,178
RS,88358,SANANDUVA,4453,4770,1204,11830,10626,546,351
RS,88366,FAZENDA VILANOVA,1256,910,284,2818,2534,113,104
RS,88374,SANTA BÁRBARA DO SUL,2750,2570,1433,7542,6109,206,156
RS,88382,ITAARA,1178,1681,678,4038,3360,76,92
RS,88390,SANTA CRUZ DO SUL,41614,19460,11469,91298,79829,3604,2423
RS,88404,ESTRELA VELHA,1588,844,536,3302,2766,137,70
RS,88412,SANTA MARIA,64606,63143,31883,192860,160977,4809,3883
RS,88420,BENJAMIN CONSTANT DO SUL,941,457,414,1943,1529,51,40
RS,88439,SANTANA DA BOA VISTA,2855,1881,1298,7105,5807,429,258
RS,88447,MAÇAMBARÁ,1544,1121,938,4033,3095,65,115
RS,88455,SANTANA DO LIVRAMENTO,26388,17429,15901,69207,53306,1403,1207
RS,88463,DOM PEDRO DE ALCÂNTARA,1641,874,479,3335,2856,78,57
RS,88471,SANTA ROSA,18306,18806,8047,51000,42953,979,1068
RS,88480,UNISTALDA,1181,808,459,2710,2251,71,51
RS,88498,SANTA VITÓRIA DO PALMAR,7975,7938,5142,24344,19202,849,707
RS,88501,TURUÇU,1080,1374,407,3186,2779,88,82
RS,88510,SANTIAGO,13713,11808,7978,38781,30803,1415,875
RS,88528,CRISTAL DO SUL,1153,544,276,2318,2042,98,129
RS,88536,SANTO ÂNGELO,25237,14926,11657,60472,48815,1484,1349
RS,88544,MUITOS CAPÕES,535,1128,505,2419,1914,116,64
RS,88552,SANTO ANTÔNIO DA PATRULHA,11414,10421,4565,30567,26002,1543,1062
RS,88560,NOVA RAMADA,764,839,240,2089,1849,47,59
RS,88579,SANTO ANTÔNIO DAS MISSÕES,4156,2137,2387,9516,7129,215,209
RS,88587,JARI,1369,855,514,3128,2614,193,82
RS,88595,SANTO AUGUSTO,5377,2915,1795,11214,9419,271,312
RS,88609,UBIRETAMA,605,979,225,1983,1758,46,49
RS,88617,SANTO CRISTO,5636,3962,1434,12198,10764,287,319
RS,88625,BARRA DO QUARAÍ,1153,1033,852,3255,2403,32,49
RS,88633,SÃO BORJA,20994,12196,10704,48435,37731,704,802
RS,88641,CERRITO,1941,1931,734,5409,4675,271,147
RS,88650,SÃO FRANCISCO DE ASSIS,7000,3975,3545,16243,12698,660,441
RS,88668,VALE VERDE,1344,565,499,2883,2384,116,93
RS,88676,SÃO FRANCISCO DE PAULA,5198,6105,1923,15250,13327,622,591
RS,88684,NOVO CABRAIS,1847,931,298,3374,3076,89,71
RS,88692,SÃO GABRIEL,15747,14846,9036,46006,36970,1238,1021
RS,88706,SETE DE SETEMBRO,854,598,131,1737,1606,49,47
RS,88714,SÃO JERÔNIMO,5412,5780,1795,15171,13376,513,528
RS,88722,TABAÍ,1439,974,381,3225,2844,152,79
RS,88730,SÃO JOSÉ DO NORTE,7871,7269,2987,20644,17657,615,636
RS,88749,VILA LÂNGARO,828,874,215,2174,1959,88,78
RS,88757,SÃO JOSÉ DO OURO,2001,2079,769,5668,4899,298,169
RS,88765,SENADOR SALGADO FILHO,766,1262,310,2518,2208,39,66
RS,88773,SÃO LEOPOLDO,65492,40610,20542,155191,134649,4906,4088
RS,88781,VESPASIANO CORRÊA,634,959,455,2333,1878,125,57
RS,88790,SÃO LOURENÇO DO SUL,15838,10239,5760,35162,29402,820,669
RS,88803,MONTE ALEGRE DOS CAMPOS,739,1304,581,2968,2387,171,58
RS,88811,SÃO LUIZ GONZAGA,10751,6920,6277,26843,20566,755,713
RS,88820,MARQUES DE SOUZA,1616,1050,420,3550,3130,137,102
RS,88838,SÃO MARCOS,3713,7527,2393,16311,13918,598,585
RS,88846,CHUÍ,1475,1012,666,3588,2922,108,74
RS,88854,SÃO MARTINHO,2268,1403,511,4720,4209,150,121
RS,88862,ARARICÁ,2071,1088,389,4057,3668,101,114
RS,88870,SÃO NICOLAU,1999,1094,1186,4773,3587,163,183
RS,88889,PASSA SETE,2480,654,372,3934,3562,151,117
RS,88897,SÃO PAULO DAS MISSÕES,2690,1444,595,5143,4548,83,100
RS,88900,TOROPI,945,1046,343,2606,2263,122,54
RS,88919,SÃO PEDRO DO SUL,4761,4818,2141,13422,11281,556,365
RS,88927,BALNEÁRIO PINHAL,2161,2550,1696,7457,5761,183,213
RS,88935,SÃO SEBASTIÃO DO CAÍ,6991,6026,2485,18111,15626,589,573
RS,88943,MAMPITUBA,1298,856,390,2784,2394,42,61
RS,88951,SÃO SEPÉ,7474,6187,3906,19718,15812,603,496
RS,88978,SÃO VALENTIM,1148,1279,337,3128,2791,129,117
RS,88986,ACEGUÁ,1320,1489,395,3591,3196,70,73
RS,88994,SAPIRANGA,24045,16648,7129,56469,49340,1908,1372
RS,89001,ALMIRANTE TAMANDARÉ DO SUL,832,684,230,1901,1671,45,44
RS,89010,SAPUCAIA DO SUL,48348,21979,12214,99078,86864,3525,2829
RS,89028,ARROIO DO PADRE,1000,1006,206,2465,2259,30,36
RS,89036,SARANDI,6438,5305,2949,16705,13756,446,430
RS,89044,BOA VISTA DO CADEADO,646,898,306,2045,1739,61,53
RS,89052,SEBERI,3940,2567,868,8312,7444,276,227
RS,89060,BOA VISTA DO INCRA,851,729,239,1963,1724,37,38
RS,89079,SELBACH,1460,1805,638,4263,3625,76,111
RS,89087,BOZANO,769,956,203,2109,1906,34,33
RS,89095,SERAFINA CORRÊA,3859,3594,1494,10781,9287,529,375
RS,89109,CANUDOS DO VALE,1213,343,263,1983,1720,57,49
RS,89117,SERTÃO,1961,2069,452,5077,4625,151,170
RS,89125,CAPÃO BONITO DO SUL,687,660,255,1799,1544,66,52
RS,89133,SEVERIANO DE ALMEIDA,1347,1141,341,3222,2881,130,150
RS,89141,CAPÃO DO CIPÓ,1247,746,341,2557,2216,69,72
RS,89150,CAPÃO DA CANOA,9123,11051,5048,29156,24108,847,757
RS,89168,COQUEIRO BAIXO,377,614,182,1318,1136,47,65
RS,89176,SOBRADINHO,4085,3562,1913,11026,9113,364,292
RS,89184,CORONEL PILAR,633,591,195,1584,1389,78,38
RS,89192,SOLEDADE,8337,7810,4166,22723,18557,643,694
RS,89206,CRUZALTENSE,640,930,257,2032,1775,72,73
RS,89214,TAPEJARA,4430,5886,1731,14052,12321,487,527
RS,89222,FORQUETINHA,1427,645,292,2600,2308,74,83
RS,89230,TAPERA,3343,2806,1201,8104,6903,190,209
RS,89247,SANTA CECÍLIA DO SUL,781,511,228,1755,1527,89,62
RS,89249,ITATI,1083,963,458,2771,2313,69,71
RS,89257,TAPES,4289,4423,2762,13323,10561,436,435
RS,89265,JACUIZINHO,1030,565,379,2197,1818,68,78
RS,89273,TAQUARA,13807,14200,6050,39602,33552,1260,1175
RS,89281,LAGOA BONITA DO SUL,1145,568,191,2209,2018,96,91
RS,89290,TAQUARI,7523,7024,2812,20211,17399,734,416
RS,89303,MATO QUEIMADO,818,449,249,1660,1411,34,45
RS,89311,TENENTE PORTELA,4409,3188,2041,10504,8463,211,321
RS,89320,NOVO XINGU,665,458,210,1481,1271,38,46
RS,89338,TORRES,8589,8590,4522,25766,21244,782,768
RS,89346,PAULO BENTO,686,808,187,1909,1722,69,52
RS,89354,TRAMANDAÍ,9963,9931,6443,30618,24175,987,855
RS,89362,PINHAL DA SERRA,882,500,451,2042,1591,76,53
RS,89370,TRÊS COROAS,6696,5620,1856,16870,15014,643,528
RS,89389,QUATRO IRMÃOS,729,460,205,1542,1337,39,63
RS,89397,TRÊS DE MAIO,6667,7352,3603,19372,15769,475,386
RS,89400,ROLADOR,1280,504,481,2549,2068,101,62
RS,89419,TRÊS PASSOS,8427,4983,1690,17017,15327,452,479
RS,89435,TRIUNFO,6926,7950,2696,21263,18567,882,728
RS,89443,SANTA MARGARIDA DO SUL,778,932,219,2229,2010,47,75
RS,89451,TUCUNDUVA,1486,2153,576,4758,4182,116,159
RS,89460,SÃO JOSÉ DO SUL,732,642,114,1698,1584,78,54
RS,89478,TUPANCIRETÃ,5996,5913,3216,17055,13839,561,434
RS,89486,SÃO PEDRO DAS MISSÕES,773,446,206,1654,1448,76,79
RS,89494,TUPARENDI,2776,2626,752,6907,6155,208,162
RS,89508,TIO HUGO,1086,682,169,2097,1928,57,52
RS,89516,URUGUAIANA,25548,33448,17988,88910,70922,1350,1327
RS,89524,WESTFALIA,1287,631,278,2407,2129,67,37
RS,89532,VACARIA,11755,18837,7496,43924,36428,1761,1037
RS,89559,VENÂNCIO AIRES,27839,9600,6589,51343,44754,2084,1244
RS,89567,PEDRAS ALTAS,840,587,543,2107,1564,28,26
RS,89575,VERA CRUZ,10286,2969,1904,17802,15898,556,423
RS,89591,VERANÓPOLIS,3941,7946,2655,17977,15322,1048,759
RS,89613,VIADUTOS,1601,1634,416,4251,3835,187,151
RS,89630,VIAMÃO,55917,51453,22279,158759,136480,6530,4847
RS,89656,VICENTE DUTRA,1775,1196,954,4307,3353,128,125
RS,89672,PALMARES DO SUL,3748,3333,2153,10375,8222,213,288
RS,89699,VICTOR GRAEFF,967,1096,299,2598,2299,73,56
RS,89710,TAVARES,1955,1294,627,4349,3722,121,132
RS,89737,CAPÃO DO LEÃO,6551,5493,2729,17575,14846,692,463
RS,89753,SALTO DO JACUÍ,3582,2304,1851,8873,7022,271,292
RS,89770,COTIPORÃ,1141,1301,415,3527,3112,249,118
RS,98213,TEUTÔNIA,9995,5539,2300,20751,18451,621,525
RS,98230,BOM PRINCÍPIO,3595,3100,828,8707,7879,374,298
RS,98256,PAROBÉ,18125,8458,4196,35154,30958,1010,930
RS,98272,FORTALEZA DOS VALOS,1721,1245,551,3830,3279,78,88
RS,98299,JÓIA,3152,1685,1067,6506,5439,149,154
SC,80004,MONTE CARLO,2761,2139,1302,6880,5578,152,266
SC,80012,ABELARDO LUZ,5080,3391,2416,12154,9738,218,383
SC,80020,IPORÃ DO OESTE,2982,2018,556,6166,5610,105,174
SC,80039,AGROLÂNDIA,2634,2519,782,6833,6051,217,199
SC,80047,LINDÓIA DO SUL,1518,1189,316,3457,3141,139,104
SC,80055,AGRONÔMICA,1455,1290,341,3530,3189,93,112
SC,80063,APIÚNA,3052,2169,992,6984,5992,171,205
SC,80071,ÁGUA DOCE,1777,2020,933,5382,4449,110,210
SC,80080,DOUTOR PEDRINHO,922,1127,213,2576,2363,60,105
SC,80098,ÁGUAS DE CHAPECÓ,2194,964,739,4523,3784,131,184
SC,80101,JOSÉ BOITEUX,1538,1076,618,3778,3160,129,161
SC,80110,ÁGUAS MORNAS,1788,2171,301,4888,4587,163,203
SC,80128,VITOR MEIRELES,1627,1486,767,4311,3544,82,149
SC,80136,ALFREDO WAGNER,2556,3334,513,6979,6466,126,219
SC,80144,UNIÃO DO OESTE,1100,742,292,2438,2146,46,88
SC,80152,ANCHIETA,2180,1545,744,5022,4278,124,155
SC,80160,URUPEMA,538,1015,278,2141,1863,34,86
SC,80179,ANGELINA,2310,1377,397,4574,4177,84,149
SC,80187,IRACEMINHA,1250,1328,327,3270,2943,83,86
SC,80195,ANITA GARIBALDI,2814,2042,1919,7562,5643,195,283
SC,80209,TIMBÓ GRANDE,1755,1931,947,5103,4156,69,178
SC,80217,ANITÁPOLIS,1072,1006,391,2753,2362,69,87
SC,80225,ABDON BATISTA,726,956,162,2131,1969,32,81
SC,80233,ANTÔNIO CARLOS,1740,3006,443,6055,5612,154,279
SC,80241,SANTA ROSA DO SUL,2304,2021,894,6423,5529,168,193
SC,80250,ARAQUARI,4703,4707,2294,13822,11528,314,459
SC,80268,CELSO RAMOS,1089,722,396,2530,2134,53,73
SC,80276,ARARANGUÁ,15763,13920,6389,44517,38128,853,1313
SC,80284,SERRA ALTA,1287,671,206,2496,2290,68,95
SC,80292,ARMAZÉM,2420,1855,560,5620,5060,147,205
SC,80306,COCAL DO SUL,3964,3811,1617,11774,10157,305,473
SC,80314,ARROIO TRINTA,962,1316,360,2911,2551,34,99
SC,80322,NOVA ITABERABA,1949,901,226,3447,3221,51,87
SC,80330,ASCURRA,1838,2374,755,5768,5013,179,217
SC,80349,SANTA TEREZINHA,3460,1634,1035,6774,5739,188,170
SC,80357,ATALANTA,941,1078,311,2791,2480,78,93
SC,80365,MIRIM DOCE,683,884,182,1986,1804,24,77
SC,80373,AURORA,2089,1201,286,4063,3777,106,109
SC,80381,CERRO NEGRO,1442,705,429,2920,2491,65,175
SC,80390,BALNEÁRIO CAMBORIÚ,18177,30444,15793,80169,64376,1502,2336
SC,80403,PASSO DE TORRES,1620,1698,800,4863,4063,131,156
SC,80411,BARRA VELHA,3933,5537,3031,15229,12198,371,542
SC,80420,BRAÇO DO TROMBUDO,1047,1087,389,2889,2500,53,102
SC,80438,BENEDITO NOVO,2278,3642,902,7849,6947,279,283
SC,80446,SUL BRASIL,1052,658,175,2207,2032,32,85
SC,80454,BIGUAÇU,10964,14282,4876,39422,34546,1437,1805
SC,80462,VARGEM,1027,832,433,2577,2144,34,110
SC,80470,BLUMENAU,53407,89543,29054,222292,193238,5848,9379
SC,80489,ARABUTÃ,1804,926,400,3441,3041,84,112
SC,80497,BOM RETIRO,1783,3224,1224,6921,5697,130,238
SC,80500,ÁGUAS FRIAS,1058,710,164,2113,1949,19,56
SC,80519,BOTUVERÁ,1397,1198,185,3371,3186,215,138
SC,80527,GUATAMBÚ,2013,1171,369,4059,3690,90,161
SC,80535,BRAÇO DO NORTE,6260,9907,2362,21045,18683,469,672
SC,80543,PLANALTO ALEGRE,1164,725,212,2336,2124,34,83
SC,80551,BRUSQUE,16178,34345,8342,72922,64580,2231,2890
SC,80560,RIQUEZA,1740,1002,382,3585,3203,107,159
SC,80578,CAÇADOR,17434,15976,8433,49914,41481,1321,1996
SC,80586,LAJEADO GRANDE,745,356,203,1463,1260,17,39
SC,80594,CAIBI,2035,1386,570,4752,4182,95,253
SC,80608,RIO RUFINO,725,871,387,2224,1837,47,77
SC,80616,CAMBORIÚ,10373,10498,5341,32616,27275,859,1083
SC,80624,PASSOS MAIA,1625,759,649,3278,2629,33,95
SC,80632,CAMPO ALEGRE,1902,4668,1364,9165,7801,217,369
SC,80640,SÃO JOÃO DO OESTE,2041,1788,345,4715,4370,89,191
SC,80659,CAMPO BELO DO SUL,1671,2639,808,5623,4815,92,261
SC,80667,CALMON,1125,953,731,3136,2405,48,128
SC,80675,CAMPO ERÊ,3365,1347,1384,6878,5494,147,263
SC,80683,BALNEÁRIO BARRA DO SUL,1789,2569,1478,6933,5455,108,221
SC,80691,CAMPOS NOVOS,7127,9388,4346,24241,19895,677,940
SC,80705,PARAÍSO,1656,877,436,3327,2891,59,135
SC,80713,CANELINHA,2495,3118,1191,8014,6823,213,295
SC,80721,SANTA HELENA,966,643,243,2143,1900,34,65
SC,80730,CANOINHAS,10990,17145,6620,39675,33055,848,1124
SC,80748,BELMONTE,741,866,195,2046,1851,52,70
SC,80756,CAPINZAL,5909,4749,2232,15236,13004,474,622
SC,80764,NOVO HORIZONTE,942,630,279,2274,1995,50,89
SC,80772,CATANDUVAS,2617,2194,946,6787,5841,183,231
SC,80780,SÃO MIGUEL DA BOA VISTA,742,511,204,1644,1440,43,64
SC,80799,CAXAMBU DO SUL,1749,1140,429,3868,3439,84,144
SC,80802,ARVOREDO,897,559,109,1801,1692,35,77
SC,80810,CHAPECÓ,48277,43796,15532,123955,108423,2164,3419
SC,80829,IPUAÇU,2443,787,626,4203,3577,41,161
SC,80837,CONCÓRDIA,16759,19900,7889,52553,44664,1413,1617
SC,80845,OURO VERDE,804,678,197,1893,1696,43,71
SC,80853,CORONEL FREITAS,3479,2607,964,8007,7043,197,250
SC,80861,IRATI,744,584,195,1726,1531,24,56
SC,80870,CORUPÁ,4333,3336,1312,10588,9276,254,440
SC,80888,FORMOSA DO SUL,1140,526,207,2088,1881,49,69
SC,80896,CRICIÚMA,38465,48584,18815,137658,118843,3314,4554
SC,80900,MACIEIRA,810,483,186,1643,1457,34,65
SC,80918,CUNHA PORÃ,2545,3677,1031,8323,7292,228,310
SC,80926,PONTE ALTA DO NORTE,771,1034,544,2629,2085,48,121
SC,80934,CURITIBANOS,7815,12290,5801,29279,23478,601,1158
SC,80942,SÃO CRISTÓVÃO DO SUL,1072,1232,699,3358,2659,39,155
SC,80950,DESCANSO,2585,2630,588,6615,6027,174,204
SC,80969,VARGEM BONITA,1501,1230,593,3866,3273,56,115
SC,80977,DIONÍSIO CERQUEIRA,4593,3041,1918,10865,8947,218,440
SC,80985,BOMBINHAS,2365,3611,1782,9689,7907,227,387
SC,80993,DONA EMMA,1299,668,244,2612,2368,58,84
SC,81000,SANGÃO,3082,2067,1009,7095,6086,155,252
SC,81019,ERVAL VELHO,1094,1416,289,3277,2988,78,146
SC,81027,CAPIVARI DE BAIXO,6353,3929,1660,15269,13609,346,533
SC,81035,FAXINAL DOS GUEDES,4302,1779,1110,7927,6817,148,227
SC,81043,CORDILHEIRA ALTA,1585,880,232,3021,2789,77,88
SC,81051,FLORIANÓPOLIS,67109,101482,49765,314719,264954,7041,13219
SC,81060,FORQUILHINHA,6424,5317,1549,16044,14495,334,541
SC,81078,FRAIBURGO,8945,8353,5133,26309,21176,680,966
SC,81086,MORRO GRANDE,778,1289,296,2724,2428,55,79
SC,81094,GALVÃO,1060,993,551,2927,2376,60,128
SC,81108,CORONEL MARTINS,815,691,220,1937,1717,43,70
SC,81116,GOVERNADOR CELSO RAMOS,2350,5212,1758,11739,9981,337,493
SC,81124,SÃO JOÃO DO ITAPERIÚ,917,1088,357,2710,2353,59,118
SC,81132,GAROPABA,4055,4961,2242,13858,11616,329,476
SC,81140,JARDINÓPOLIS,653,404,138,1438,1300,37,49
SC,81159,GARUVA,2873,3847,1679,9746,8067,215,314
SC,81167,ERMO,773,1064,222,2476,2254,52,85
SC,81175,GASPAR,11760,15112,4468,38129,33661,968,1365
SC,81183,SÃO PEDRO DE ALCÂNTARA,1125,1495,315,3547,3232,58,159
SC,81191,GRÃO-PARÁ,1832,2434,462,5412,4950,132,209
SC,81205,SANTIAGO DO SUL,584,352,158,1255,1097,28,54
SC,81213,GRAVATAL,2217,3658,907,8034,7127,137,318
SC,81221,BELA VISTA DO TOLDO,1620,1970,565,4666,4101,99,172
SC,81230,GUABIRUBA,3709,5390,1011,11968,10957,380,504
SC,81248,CAPÃO ALTO,633,1436,370,2776,2406,37,130
SC,81256,GUARACIABA,3590,2851,676,8013,7337,219,235
SC,81264,PAINEL,847,942,286,2325,2039,31,81
SC,81272,GUARAMIRIM,9220,7587,2993,23761,20768,575,787
SC,81280,BOCAINA DO SUL,925,1133,204,2587,2383,22,136
SC,81299,GUARUJÁ DO SUL,1731,1112,438,3755,3317,84,122
SC,81302,ALTO BELA VISTA,775,586,141,1683,1542,23,60
SC,81310,HERVAL D'OESTE,5339,5884,2295,15958,13663,329,489
SC,81329,FREI ROGÉRIO,653,918,417,2222,1805,27,92
SC,81337,IBICARÉ,904,1160,243,2696,2453,50,85
SC,81345,TREVISO,1046,1414,363,3450,3087,93,151
SC,81353,IBIRAMA,4884,4274,2010,13262,11252,352,590
SC,81361,IOMERÊ,898,969,265,2442,2177,53,75
SC,81370,IÇARA,17204,10932,5212,42333,37121,1088,1535
SC,81388,BOM JESUS,999,454,291,2044,1753,49,110
SC,81396,ILHOTA,3027,3256,1298,9346,8048,267,382
SC,81400,IBIAM,683,709,138,1732,1594,38,64
SC,81418,IMARUÍ,3676,2712,1397,9376,7979,268,471
SC,81426,ENTRE RIOS,1218,403,486,2388,1902,42,85
SC,81434,IMBITUBA,10746,9410,5120,31249,26129,642,1123
SC,81442,PAIAL,766,444,193,1625,1432,34,58
SC,81450,IMBUIA,1918,1371,315,4187,3872,168,170
SC,81469,BOM JESUS DO OESTE,857,540,156,1750,1594,50,62
SC,81477,INDAIAL,11062,14855,4703,37236,32533,1303,1599
SC,81485,SÃO BERNARDINO,1093,529,192,2029,1837,33,71
SC,81493,IPIRA,1554,989,498,3483,2985,113,123
SC,81507,SANTA TEREZINHA DO PROGRESSO,1173,516,379,2375,1996,75,105
SC,81515,IPUMIRIM,2457,1674,467,5279,4812,182,203
SC,81523,SALTINHO,1655,526,352,2956,2604,101,115
SC,81531,IRANI,2748,2256,961,6863,5902,163,246
SC,81540,JUPIÁ,811,555,215,1779,1564,41,52
SC,81558,IRINEÓPOLIS,3299,2281,1098,7456,6358,127,221
SC,81566,PALMEIRA,778,1089,278,2468,2190,53,125
SC,81574,ITÁ,2228,1725,952,5623,4671,100,188
SC,81582,BANDEIRANTE,1037,941,236,2435,2199,50,69
SC,81590,ITAIÓPOLIS,4981,5870,2418,15285,12867,537,642
SC,81604,FLOR DO SERTÃO,753,362,189,1439,1250,27,57
SC,81612,ITAJAÍ,35578,43459,18955,125483,106528,3574,4507
SC,81620,CUNHATAÍ,756,492,103,1499,1396,35,52
SC,81639,ITAPEMA,6080,12723,5000,28849,23849,559,898
SC,81647,PRINCESA,1074,634,198,2166,1968,53,63
SC,81655,ITAPIRANGA,4711,3878,1130,11114,9984,216,339
SC,81663,ITAPOÁ,2744,2838,2500,9997,7497,180,368
SC,81671,ITUPORANGA,6169,6128,1450,15979,14529,388,585
SC,81680,TIGRINHOS,865,346,220,1572,1352,36,41
SC,81698,JABORÁ,1307,1326,324,3440,3116,79,108
SC,81701,CHAPADÃO DO LAGEADO,947,746,198,2140,1942,51,80
SC,81710,JACINTO MACHADO,2382,4036,1065,8642,7577,252,297
SC,81728,BALNEÁRIO ARROIO DO SILVA,2390,2026,1129,6757,5628,89,217
SC,81736,JAGUARUNA,5411,3484,1775,12631,10856,232,387
SC,81744,BALNEÁRIO GAIVOTA,2107,1803,1080,5999,4919,105,216
SC,81752,JARAGUÁ DO SUL,37205,32374,12571,101270,88699,2469,3349
SC,81760,BARRA BONITA,851,570,179,1837,1658,40,67
SC,81779,JOAÇABA,5562,8767,3314,21093,17779,367,585
SC,81787,BRUNÓPOLIS,1198,670,244,2417,2173,30,119
SC,81795,JOINVILLE,85492,145858,44308,357956,313648,9176,14403
SC,81809,LUZERNA,1474,1866,346,4442,4096,83,153
SC,81817,LACERDÓPOLIS,714,656,219,1924,1705,61,57
SC,81825,ZORTÉA,1071,688,167,2204,2037,38,93
SC,81833,LAGES,24738,54605,19504,116992,97488,2303,4007
SC,81850,LAGUNA,12030,14410,5422,38459,33037,799,1262
SC,81876,LAURENTINO,1616,1816,442,4648,4206,204,181
SC,81892,LAURO MÜLLER,3073,5327,1410,11662,10252,263,435
SC,81914,LEBON RÉGIS,3362,2475,1906,8808,6902,222,389
SC,81930,LEOBERTO LEAL,1341,910,234,2837,2603,63,133
SC,81957,LONTRAS,3135,2222,972,7211,6239,237,236
SC,81973,LUÍS ALVES,2421,3438,823,7549,6726,138,262
SC,81990,MAFRA,8970,18922,5992,40806,34814,1223,1488
SC,82015,MAJOR GERCINO,1008,1018,398,2781,2383,74,87
SC,82031,MAJOR VIEIRA,2126,1959,484,5241,4757,110,216
SC,82058,MARAVILHA,7026,4807,1880,15953,14073,394,532
SC,82066,MAREMA,971,551,235,1959,1724,47,49
SC,82074,MASSARANDUBA,4137,4891,1367,11658,10291,238,386
SC,82090,MATOS COSTA,912,657,603,2408,1805,36,85
SC,82112,MELEIRO,1495,2811,608,5632,5024,122,184
SC,82139,MODELO,1332,1045,247,2966,2719,51,130
SC,82155,MONDAÍ,3590,1642,733,6835,6102,136,260
SC,82171,MONTE CASTELO,2267,2115,1337,6612,5275,169,227
SC,82198,MORRO DA FUMAÇA,4155,3921,1172,11453,10281,306,498
SC,82210,NAVEGANTES,11691,12398,6310,36907,30597,853,1119
SC,82236,NOVA ERECHIM,1444,1126,276,3268,2992,60,94
SC,82252,NOVA TRENTO,3095,3272,728,8629,7901,402,380
SC,82279,NOVA VENEZA,3541,4145,1153,10507,9354,211,350
SC,82295,ORLEANS,4707,8237,2175,17411,15236,456,563
SC,82317,OURO,2135,2336,729,5873,5144,101,158
SC,82333,PALHOÇA,26069,29490,10202,87257,77055,3047,3689
SC,82350,PALMA SOLA,2965,959,1209,5875,4666,119,222
SC,82376,PALMITOS,5192,3991,1755,12412,10657,286,468
SC,82392,PAPANDUVA,6591,3523,2381,14034,11653,329,480
SC,82414,PAULO LOPES,1824,1810,450,5108,4658,124,190
SC,82430,PEDRAS GRANDES,1565,1299,497,3859,3362,82,128
SC,82457,PENHA,3748,6457,3085,16059,12974,339,549
SC,82473,PERITIBA,925,1115,254,2677,2423,62,87
SC,82490,PETROLÂNDIA,1920,1604,511,4767,4256,196,233
SC,82511,BALNEÁRIO PIÇARRAS,3045,4233,2363,11667,9304,228,380
SC,82538,PINHALZINHO,5139,3954,1600,12103,10503,257,412
SC,82554,PINHEIRO PRETO,868,980,363,2569,2206,47,91
SC,82570,PIRATUBA,1880,1165,618,4386,3768,142,170
SC,82597,POMERODE,7305,7422,2254,20605,18351,527,849
SC,82619,PONTE ALTA,1141,1613,805,4038,3233,60,202
SC,82635,PONTE SERRADA,3662,2118,1608,8371,6763,140,340
SC,82651,PORTO BELO,2408,4255,1781,10062,8281,181,338
SC,82678,PORTO UNIÃO,5802,9997,4824,24415,19591,503,763
SC,82694,POUSO REDONDO,4129,3315,1598,10433,8835,234,382
SC,82716,PRAIA GRANDE,2082,2032,591,5479,4888,115,232
SC,82732,PRESIDENTE CASTELO BRANCO,538,790,217,1685,1468,26,43
SC,82759,PRESIDENTE GETÚLIO,4956,3138,1330,11021,9691,379,403
SC,82775,PRESIDENTE NEREU,996,543,409,2204,1795,51,76
SC,82791,QUILOMBO,3541,2590,1232,8385,7153,208,243
SC,82813,RANCHO QUEIMADO,1018,972,316,2726,2410,76,81
SC,82830,RIO DAS ANTAS,1603,2332,896,5697,4801,140,268
SC,82856,RIO DO CAMPO,1884,1952,481,4910,4429,93,139
SC,82872,RIO DO OESTE,2058,2002,414,5040,4626,143,156
SC,82899,RIO DOS CEDROS,2515,3011,700,7492,6792,225,388
SC,82910,RIO DO SUL,13074,18732,6604,45923,39319,1083,1457
SC,82937,RIO FORTUNA,1685,1557,226,3938,3712,87,108
SC,82953,RIO NEGRINHO,5718,15169,5360,31215,25855,615,1068
SC,82970,RODEIO,2532,3933,1052,8729,7677,293,340
SC,82996,ROMELÂNDIA,1973,1109,589,4240,3651,136,160
SC,83011,SALETE,2181,2329,915,5954,5039,126,178
SC,83038,SALTO VELOSO,1300,1184,457,3392,2935,48,139
SC,83054,SANTA CECÍLIA,3619,4991,2468,12305,9837,306,438
SC,83070,SANTA ROSA DE LIMA,907,633,163,1928,1765,46,53
SC,83097,SANTO AMARO DA IMPERATRIZ,4827,5678,1394,14554,13160,388,625
SC,83119,SÃO BENTO DO SUL,16896,22913,7311,56543,49232,1224,1767
SC,83135,SÃO BONIFÁCIO,665,1291,216,2479,2263,80,92
SC,83151,SÃO CARLOS,3246,2437,778,7292,6514,148,255
SC,83178,SÃO DOMINGOS,3079,2270,800,6858,6058,162,242
SC,83194,SÃO FRANCISCO DO SUL,7897,11330,5500,30951,25451,676,880
SC,83216,SÃO JOÃO BATISTA,4399,6740,2198,16898,14700,599,571
SC,83232,SÃO JOÃO DO SUL,1818,2297,511,5631,5120,127,162
SC,83259,SÃO JOAQUIM,4453,9633,2149,18296,16147,433,847
SC,83275,SÃO JOSÉ,36496,47185,18258,140700,122442,4256,6108
SC,83291,SÃO JOSÉ DO CEDRO,4670,3214,1360,10480,9120,220,304
SC,83313,SÃO JOSÉ DO CERRITO,2829,2217,834,6565,5731,143,254
SC,83330,SÃO LOURENÇO DO OESTE,6847,5314,2059,16338,14279,437,473
SC,83356,SÃO LUDGERO,3118,2846,942,7825,6883,208,203
SC,83372,SÃO MARTINHO,1102,1168,183,2806,2623,76,116
SC,83399,SÃO MIGUEL DO OESTE,9956,9191,4624,27282,22658,486,774
SC,83410,SAUDADES,3157,2366,450,6648,6198,113,220
SC,83437,SCHROEDER,5078,2732,1192,10730,9538,213,330
SC,83453,SEARA,5729,4634,1943,13714,11771,319,394
SC,83470,SIDERÓPOLIS,3226,3678,1548,10453,8905,227,347
SC,83496,SOMBRIO,6304,6244,2811,19418,16607,466,709
SC,83518,TAIÓ,4087,5293,1361,12461,11100,339,470
SC,83534,TANGARÁ,2169,3042,871,6876,6005,169,239
SC,83550,TIJUCAS,6593,9538,3571,23272,19701,575,906
SC,83577,TIMBÓ,6747,12268,3049,27171,24122,842,1110
SC,83593,TRÊS BARRAS,3775,5191,2631,13716,11085,281,590
SC,83615,TREZE DE MAIO,2362,1943,656,5764,5108,147,219
SC,83631,TREZE TÍLIAS,1229,2083,753,4655,3902,90,165
SC,83658,TROMBUDO CENTRAL,1822,1802,546,4931,4385,98,197
SC,83674,TUBARÃO,22380,23596,10422,73014,62592,1862,2627
SC,83682,TUNÁPOLIS,1221,1551,318,3540,3222,82,114
SC,83690,TURVO,2691,4206,1015,9475,8460,206,360
SC,83712,URUBICI,2085,3352,1418,7777,6359,123,319
SC,83739,URUSSANGA,4459,5986,2677,16222,13545,414,649
SC,83755,VARGEÃO,1373,605,426,2649,2223,54,78
SC,83771,VIDAL RAMOS,1978,1462,431,4489,4058,148,191
SC,83798,VIDEIRA,12572,11231,5694,34793,29099,979,1323
SC,83810,WITMARSUM,1361,790,375,2936,2561,84,99
SC,83836,XANXERÊ,15176,7600,4814,31688,26874,625,989
SC,83852,XAVANTINA,1543,1189,267,3341,3074,66,96
SC,83879,XAXIM,9524,4762,2771,19610,16839,437,630
SC,83895,BOM JARDIM DA SERRA,1015,1590,502,3408,2906,53,133
SC,83917,MARACAJÁ,2225,1504,399,4986,4587,115,157
SC,83933,TIMBÉ DO SUL,1741,1631,371,4331,3960,104,131
SC,83950,CORREIA PINTO,3449,4450,1992,11843,9851,278,481
SC,83976,OTACÍLIO COSTA,3624,4651,1961,12055,10094,217,473
SE,31003,SANTANA DO SÃO FRANCISCO,2157,1360,813,5003,4190,229,205
SE,31011,AMPARO DE SÃO FRANCISCO,1015,480,334,2104,1770,45,111
SE,31038,AQUIDABÃ,4462,4923,3302,15401,12099,436,1150
SE,31054,ARACAJU,103289,118609,57297,377848,320551,9407,15742
SE,31070,ARAUÁ,3584,2315,1748,8806,7058,241,500
SE,31097,AREIA BRANCA,3647,4527,1427,11241,9814,339,738
SE,31119,BARRA DOS COQUEIROS,4137,4583,1062,12486,11424,354,689
SE,31135,BREJO GRANDE,2221,1271,950,5295,4345,251,384
SE,31151,BOQUIM,8568,4494,3912,20004,16092,649,1138
SE,31194,CAMPO DO BRITO,5645,3059,2713,13239,10526,390,902
SE,31216,CANHOBA,1724,786,517,3679,3162,153,264
SE,31232,CANINDÉ DE SÃO FRANCISCO,9144,3008,3129,17871,14742,287,988
SE,31259,CAPELA,6935,6662,4052,21248,17196,827,1407
SE,31275,CARIRA,5380,4522,3340,15376,12036,435,1224
SE,31291,CARMÓPOLIS,4995,2632,1768,11141,9373,319,551
SE,31313,CEDRO DE SÃO JOÃO,1919,1172,705,4505,3800,128,202
SE,31330,CRISTINÁPOLIS,5932,1501,3236,12088,8852,235,614
SE,31356,NOSSA SENHORA APARECIDA,2979,1613,1011,6436,5425,180,413
SE,31372,CUMBE,1440,705,338,3011,2673,107,218
SE,31399,DIVINA PASTORA,1250,897,446,3136,2690,142,183
SE,31410,ESTÂNCIA,18143,8817,7722,43108,35386,1680,2220
SE,31437,FEIRA NOVA,1677,1605,641,4574,3933,99,290
SE,31453,FREI PAULO,3876,3727,1526,10439,8913,266,658
SE,31470,GENERAL MAYNARD,819,525,243,1950,1707,59,103
SE,31496,GARARU,4193,1627,1324,8314,6990,209,538
SE,31518,GRACCHO CARDOSO,2120,1023,918,5065,4147,206,345
SE,31534,ILHA DAS FLORES,2591,1740,1812,7039,5227,260,357
SE,31550,INDIAROBA,5372,1290,1998,10445,8447,245,704
SE,31577,ITABAIANA,21544,21831,9220,60912,51692,1691,3472
SE,31593,ITABAIANINHA,11627,6153,5755,27471,21716,801,1651
SE,31615,ITABI,1556,1150,792,4273,3481,165,321
SE,31631,ITAPORANGA D'AJUDA,7542,7027,3353,22328,18975,795,1565
SE,31658,JAPARATUBA,5406,3109,2429,12881,10452,380,627
SE,31674,JAPOATÃ,4280,2548,1651,9909,8258,357,682
SE,31690,LAGARTO,22246,20382,12728,66275,53547,2257,3982
SE,31712,LARANJEIRAS,6612,5852,2428,18928,16500,844,1137
SE,31739,MACAMBIRA,2293,1590,660,5288,4628,159,343
SE,31755,MALHADA DOS BOIS,1471,706,522,3179,2657,93,166
SE,31771,MALHADOR,3127,2804,1221,8744,7523,375,732
SE,31798,MARUIM,4657,2967,1854,11644,9790,492,666
SE,31810,MOITA BONITA,3139,2767,1176,8337,7161,308,673
SE,31836,MONTE ALEGRE DE SERGIPE,3861,2428,1336,8965,7629,198,615
SE,31852,MURIBECA,1927,2143,1120,6240,5120,243,377
SE,31879,NEÓPOLIS,5785,3185,2566,14021,11455,600,800
SE,31895,NOSSA SENHORA DA GLÓRIA,9612,5844,3527,22163,18636,512,1269
SE,31917,NOSSA SENHORA DAS DORES,6368,5599,3322,18503,15181,867,1317
SE,31933,NOSSA SENHORA DE LOURDES,2301,1262,617,4966,4349,108,348
SE,31950,NOSSA SENHORA DO SOCORRO,22160,30849,10559,81853,71294,2809,3946
SE,31976,PACATUBA,4875,1749,2515,10554,8039,407,610
SE,31992,PEDRA MOLE,1211,624,320,2522,2202,59,191
SE,32018,PEDRINHAS,2794,1467,1610,6865,5255,167,410
SE,32034,PINHÃO,2153,1362,566,4804,4238,110,395
SE,32050,PIRAMBU,2233,2140,1162,6782,5620,198,363
SE,32077,POÇO REDONDO,6992,4446,3685,17115,13430,360,1193
SE,32093,POÇO VERDE,6901,3777,4265,17445,13180,461,1101
SE,32115,PORTO DA FOLHA,8175,5237,3932,19976,16044,579,1246
SE,32131,PROPRIÁ,7062,6947,3907,20689,16782,510,865
SE,32158,RIACHÃO DO DANTAS,7781,2288,3440,15723,12283,597,818
SE,32174,RIACHUELO,2890,1672,829,6745,5916,295,413
SE,32190,RIBEIRÓPOLIS,4927,4334,1732,12701,10969,300,862
SE,32212,ROSÁRIO DO CATETE,2708,2074,889,6772,5883,183,389
SE,32239,SALGADO,6188,2954,2097,13978,11881,629,928
SE,32255,SANTA LUZIA DO ITANHY,3693,2319,2193,9635,7442,335,647
SE,32298,SANTA ROSA DE LIMA,1401,772,509,3281,2772,191,192
SE,32310,SANTO AMARO DAS BROTAS,4292,1090,1870,8304,6434,222,472
SE,32336,SÃO CRISTÓVÃO,15797,14422,6517,48502,41985,1860,2433
SE,32352,SÃO DOMINGOS,2696,2169,1703,7442,5739,164,526
SE,32379,SÃO FRANCISCO,1233,693,295,2628,2333,56,156
SE,32395,SÃO MIGUEL DO ALEIXO,1212,747,534,3053,2519,119,256
SE,32417,SIMÃO DIAS,11921,6883,5248,30258,25010,1340,2462
SE,32433,SIRIRI,2181,1788,1017,5973,4956,258,388
SE,32450,TELHA,1064,847,351,2604,2253,57,176
SE,32476,TOBIAS BARRETO,17806,6223,8383,37586,29203,682,2011
SE,32492,TOMAR DO GERU,4178,1904,2852,10309,7457,198,670
SE,32514,UMBAÚBA,5710,3987,2924,15356,12432,485,861
SP,61000,EUCLIDES DA CUNHA PAULISTA,3146,1654,2213,7826,5613,98,199
SP,61018,ADAMANTINA,6496,9523,5890,27226,21336,960,630
SP,61026,BOREBI,470,700,196,1690,1494,25,32
SP,61034,ADOLFO,1182,1005,580,3178,2598,113,83
SP,61042,TARUMÃ,3507,2956,1729,9754,8025,210,193
SP,61050,AGUAÍ,7089,7002,4838,23419,18581,784,856
SP,61069,MOTUCA,1131,1038,806,3561,2755,78,91
SP,61077,ÁGUAS DA PRATA,1349,2435,1208,6092,4884,138,166
SP,61085,IARAS,1338,866,868,3523,2655,73,91
SP,61093,ÁGUAS DE LINDÓIA,2118,6036,2582,12936,10354,306,421
SP,61107,GUATAPARÁ,1790,1399,1050,4816,3766,124,101
SP,61115,ÁGUAS DE SÃO PEDRO,490,1516,567,3172,2605,50,76
SP,61123,DIRCE REIS,554,487,185,1445,1260,57,26
SP,61131,AGUDOS,6174,8917,4900,27576,22676,780,1035
SP,61140,ESPÍRITO SANTO DO TURVO,1373,1002,524,3216,2692,49,70
SP,61158,ALFREDO MARCONDES,1162,972,438,3256,2818,127,104
SP,61166,ROSANA,6397,2728,5401,16794,11393,273,357
SP,61174,ALTAIR,1194,762,708,3089,2381,140,90
SP,61182,EMBAÚBA,628,856,377,2233,1856,66,52
SP,61190,ALTINÓPOLIS,3682,4415,2687,13105,10418,442,374
SP,61204,ILHA SOLTEIRA,6032,4508,5052,20661,15609,416,734
SP,61212,ALTO ALEGRE,1109,1174,502,3563,3061,169,102
SP,61220,ALUMÍNIO,4980,3335,1916,13433,11517,329,369
SP,61239,ÁLVARES FLORENCE,784,1432,495,3192,2697,101,102
SP,61247,PEDRINHAS PAULISTA,768,973,486,2590,2104,24,56
SP,61255,ÁLVARES MACHADO,4892,5471,3090,16544,13454,510,436
SP,61263,ARAÇARIGUAMA,3140,4124,2526,12245,9719,305,312
SP,61271,ÁLVARO DE CARVALHO,1040,872,743,3161,2418,90,147
SP,61280,BERTIOGA,10249,10090,8873,35972,27099,705,969
SP,61298,ALVINLÂNDIA,1021,644,504,2488,1984,47,56
SP,61301,SUZANÁPOLIS,1155,738,396,2583,2187,94,104
SP,61310,AMERICANA,50412,45697,23551,163738,140187,5183,5402
SP,61328,SANTO ANTÔNIO DO ARACANGUÁ,2176,1881,578,5126,4548,58,112
SP,61336,AMÉRICO BRASILIENSE,9686,6020,4356,25130,20774,752,922
SP,61344,CANITAR,785,1402,686,3489,2803,110,137
SP,61352,AMÉRICO DE CAMPOS,923,2303,525,4376,3851,147,112
SP,61360,BARRA DO CHAPÉU,1992,864,1150,4385,3235,105,145
SP,61379,AMPARO,9556,23116,8471,50519,42048,1552,1758
SP,61387,EMILIANÓPOLIS,893,656,347,2377,2030,84,79
SP,61395,ANALÂNDIA,701,1987,1218,4678,3460,103,111
SP,61409,NOVAIS,966,1126,657,3248,2591,112,146
SP,61417,ANDRADINA,12850,12477,9207,43276,34069,1206,1070
SP,61425,NOVA CANAÃ PAULISTA,718,632,275,1837,1562,44,46
SP,61433,ANGATUBA,4670,5974,3117,16715,13598,414,464
SP,61441,SALTINHO,843,3004,419,5263,4844,198,128
SP,61450,ANHEMBI,1004,1910,1267,4962,3695,115,74
SP,61468,UBARANA,1620,1035,822,4052,3230,112,125
SP,61476,ANHUMAS,991,1042,434,3001,2567,65,67
SP,61484,CAJATI,6785,6441,6027,22630,16603,400,572
SP,61492,APARECIDA,6405,10728,4086,27925,23839,632,582
SP,61506,CAMPINA DO MONTE ALEGRE,1122,1723,896,4420,3524,87,100
SP,61514,APARECIDA D'OESTE,1378,1283,752,3867,3115,98,97
SP,61522,ASPÁSIA,633,692,210,1660,1450,27,25
SP,61530,APIAÍ,6647,5057,5795,20499,14704,487,601
SP,61549,VARGEM,1437,2676,1495,6672,5177,232,218
SP,61557,ARAÇATUBA,30776,48070,25063,134878,109815,2917,3785
SP,61565,POTIM,2839,3827,1885,10778,8893,205,225
SP,61573,ARAÇOIABA DA SERRA,4579,7188,2778,18601,15823,580,539
SP,61581,ALAMBARI,859,1618,426,3347,2921,67,65
SP,61590,ARAMINA,1676,1160,673,4171,3498,107,114
SP,61603,ITAOCA,1176,601,664,2740,2076,50,96
SP,61611,ARANDU,1590,1879,802,5037,4235,147,154
SP,61620,TUIUTI,850,2192,627,4408,3781,133,169
SP,61638,ARARAQUARA,42672,47185,25601,151206,125605,4279,5654
SP,61646,ARAPEÍ,765,676,489,2291,1802,32,66
SP,61654,ARARAS,17823,33048,14213,89032,74819,3259,3149
SP,61662,ESTIVA GERBI,2523,2272,1136,7649,6513,218,254
SP,61670,AREALVA,1486,2175,1116,5878,4762,283,204
SP,61689,ENGENHEIRO COELHO,3962,2066,2089,10079,7990,248,200
SP,61697,AREIAS,1207,918,690,3271,2581,47,94
SP,61700,RIBEIRÃO GRANDE,2507,1775,1315,6536,5221,196,190
SP,61719,AREIÓPOLIS,2480,2387,1470,8168,6698,394,244
SP,61727,HORTOLÂNDIA,53410,20349,18129,123157,105028,3577,3563
SP,61735,ARIRANHA,1654,2942,1176,7045,5869,302,205
SP,61743,HOLAMBRA,1981,4106,1209,8915,7706,218,226
SP,61751,ARTUR NOGUEIRA,9388,7885,4612,28366,23754,856,801
SP,61760,ELISIÁRIO,986,782,372,2493,2121,63,57
SP,61778,ARUJÁ,16811,16748,8849,56789,47940,1503,1926
SP,61786,BOM SUCESSO DE ITARARÉ,1094,979,703,2944,2241,34,61
SP,61794,ASSIS,16115,18331,14026,67911,53885,1903,1939
SP,61808,PONTALINDA,1263,909,730,3312,2582,130,48
SP,61816,ATIBAIA,16063,39892,17441,94164,76723,2990,2948
SP,61824,PARISI,525,813,286,1919,1633,57,40
SP,61832,AURIFLAMA,4210,2615,2071,11068,8997,422,321
SP,61840,TAQUARIVAÍ,1044,2173,1047,4584,3537,56,89
SP,61859,AVAÍ,1180,1239,570,3710,3140,64,74
SP,61867,MARAPOAMA,677,1029,328,2330,2002,72,51
SP,61875,AVANHANDAVA,2425,2065,1466,7459,5993,196,169
SP,61883,SÃO JOÃO DE IRACEMA,620,451,246,1507,1261,24,56
SP,61891,AVARÉ,12169,21957,11569,59766,48197,1969,2091
SP,61905,SÃO LOURENÇO DA SERRA,3052,3234,1929,10114,8185,329,342
SP,61913,BADY BASSITT,3332,3861,2011,11004,8993,280,323
SP,61921,ZACARIAS,736,669,292,1994,1702,46,78
SP,61930,BALBINOS,366,416,308,1390,1082,58,46
SP,61948,ITAPIRAPUÃ PAULISTA,1174,897,659,3004,2345,43,69
SP,61956,BÁLSAMO,1532,2831,825,6361,5536,273,150
SP,61964,MESÓPOLIS,534,534,371,1638,1267,46,15
SP,61972,BANANAL,2088,2726,1505,8031,6526,198,346
SP,61980,NOVA CAMPINA,2051,2474,1356,6473,5117,72,142
SP,61999,BARBOSA,1295,1888,716,4569,3853,80,135
SP,62006,ILHA COMPRIDA,1866,2252,1658,6929,5271,100,172
SP,62014,BARÃO DE ANTONINA,660,859,426,2292,1866,77,101
SP,62022,LOURDES,602,754,354,1928,1574,26,45
SP,62030,BARIRI,3841,9455,5055,23541,18486,1052,761
SP,62049,TORRE DE PEDRA,476,948,658,2428,1770,50,49
SP,62057,BARRA BONITA,6911,10869,5444,29833,24389,949,919
SP,62065,ARCO-ÍRIS,627,736,297,1873,1576,32,36
SP,62073,BARRA DO TURVO,2660,1097,2543,6974,4431,83,228
SP,62081,BREJO ALEGRE,948,513,285,2022,1737,55,62
SP,62090,BARRETOS,21368,28389,15067,82151,67084,2006,2026
SP,62103,CANAS,647,1414,502,3244,2742,54,67
SP,62111,BARRINHA,8121,3686,4064,20347,16283,794,671
SP,62120,PRACINHA,423,541,230,1352,1122,22,43
SP,62138,BARUERI,68523,54596,28095,198261,170166,5306,5564
SP,62146,PRATÂNIA,958,1337,816,3945,3129,125,91
SP,62154,BASTOS,3516,7447,3634,17165,13531,446,357
SP,62162,QUADRA,560,1266,605,2713,2108,48,60
SP,62170,BATATAIS,9667,16568,7047,41351,34304,1256,1256
SP,62189,SANTA CRUZ DA ESPERANÇA,420,659,365,1720,1355,25,85
SP,62197,BAURU,61580,69907,41017,243516,202499,7037,8332
SP,62200,SANTA SALETE,488,455,169,1352,1183,64,24
SP,62219,BEBEDOURO,11659,22250,11377,56410,45033,1957,1769
SP,62227,VITÓRIA BRASIL,477,552,211,1497,1286,55,43
SP,62235,BENTO DE ABREU,601,610,365,2058,1693,79,90
SP,62243,IPIGUÁ,916,1269,543,3162,2619,115,60
SP,62251,BERNARDINO DE CAMPOS,1874,3074,1721,8421,6700,209,190
SP,62260,TAQUARAL,570,794,453,2162,1709,86,53
SP,62278,BILAC,1133,2471,1154,5769,4615,186,160
SP,62286,FERNÃO,389,592,239,1371,1132,33,30
SP,62294,BIRIGUI,17408,29037,11889,76075,64186,2656,3056
SP,62308,GAVIÃO PEIXOTO,1193,1092,380,3297,2917,98,116
SP,62316,BIRITIBA MIRIM,4965,8258,3953,20972,17019,596,586
SP,62324,JUMIRIM,479,882,354,2030,1676,41,46
SP,62332,BOA ESPERANÇA DO SUL,3943,2843,1929,10043,8114,218,319
SP,62340,NANTES,818,656,384,2121,1737,34,54
SP,62359,BOCAINA,1559,3208,1423,8054,6631,268,212
SP,62367,NOVA CASTILHO,402,470,196,1214,1018,18,16
SP,62375,BOFETE,1978,2255,2092,7408,5316,228,217
SP,62383,OUROESTE,2535,1580,1276,6624,5348,160,207
SP,62391,BOITUVA,6908,14003,6055,33625,27570,1043,1135
SP,62405,PAULISTÂNIA,368,552,277,1472,1195,31,59
SP,62413,BOM JESUS DOS PERDÕES,3623,5050,2484,13876,11392,391,481
SP,62421,RIBEIRÃO DOS ÍNDIOS,740,636,325,1966,1641,70,43
SP,62430,BORÁ,324,300,134,951,817,19,23
SP,62448,TRABIJU,411,598,209,1372,1163,12,24
SP,62456,BORACÉIA,999,1143,484,3307,2823,125,123
SP,62472,BORBOREMA,2258,4337,2511,11334,8823,471,363
SP,62499,BOTUCATU,18594,26375,15653,88612,72959,2836,3868
SP,62510,BRAGANÇA PAULISTA,19998,46994,18426,109472,91046,3143,3774
SP,62553,BRAÚNA,734,1786,562,3754,3192,117,90
SP,62570,BRODOWSKI,3959,5264,2535,14762,12227,446,476
SP,62596,BROTAS,3088,6516,3678,16613,12935,590,530
SP,62618,BURI,3577,5461,3135,14202,11067,368,267
SP,62634,BURITAMA,3695,3856,2667,12049,9382,383,369
SP,62650,BURITIZAL,534,1487,353,2879,2526,86,115
SP,62677,CABRÁLIA PAULISTA,1243,807,848,3655,2807,103,102
SP,62693,CABREÚVA,9657,8829,4827,28903,24076,961,818
SP,62715,CAÇAPAVA,12989,24732,10141,64375,54234,1915,1889
SP,62731,CACHOEIRA PAULISTA,6673,6242,4389,23576,19187,536,526
SP,62758,CACONDE,3397,5623,3195,13858,10663,315,340
SP,62774,CAFELÂNDIA,3050,4602,2928,13170,10242,361,316
SP,62790,CAIABU,1406,961,611,3534,2923,112,61
SP,62812,CAIEIRAS,19996,14640,7783,58263,50480,2025,2088
SP,62839,CAIUÁ,1532,998,931,3946,3015,46,149
SP,62855,CAJAMAR,18645,11772,7040,48853,41813,1497,1531
SP,62871,CAJOBI,2323,2657,1600,7896,6296,259,178
SP,62898,CAJURU,5330,5968,3738,17938,14200,612,569
SP,62910,CAMPINAS,220181,209003,125730,761315,635585,21010,26869
SP,62936,CAMPO LIMPO PAULISTA,18922,13598,8751,56040,47289,1496,2099
SP,62952,CAMPOS DO JORDÃO,5637,16774,8611,37447,28836,1172,1079
SP,62979,CAMPOS NOVOS PAULISTA,835,1319,643,3443,2800,85,77
SP,62995,CANANÉIA,2260,3062,2911,9864,6953,181,267
SP,63010,CÂNDIDO MOTA,5981,8717,5073,24442,19369,855,576
SP,63037,CÂNDIDO RODRIGUES,734,827,378,2383,2005,166,79
SP,63053,CAPÃO BONITO,8447,12570,8315,35866,27551,936,842
SP,63070,CAPELA DO ALTO,2964,4660,2138,11958,9820,384,235
SP,63096,CAPIVARI,6882,13312,5771,33437,27666,1115,1042
SP,63118,CARAGUATATUBA,16946,22093,14671,68781,54110,1756,2156
SP,63134,CARAPICUÍBA,104006,56479,36633,260967,224334,7787,7615
SP,63150,CARDOSO,3450,2717,2339,9910,7571,297,326
SP,63177,CASA BRANCA,4203,7014,4667,20505,15838,640,674
SP,63193,CÁSSIA DOS COQUEIROS,597,949,633,2595,1962,85,119
SP,63215,CASTILHO,5437,2660,1727,12196,10469,287,273
SP,63231,CATANDUVA,19309,30260,13795,81132,67337,2522,2911
SP,63258,CATIGUÁ,1893,1563,750,5511,4761,276,222
SP,63274,CEDRAL,1423,2623,829,5912,5083,211,200
SP,63290,CERQUEIRA CÉSAR,2996,5080,2839,13174,10335,417,340
SP,63312,CERQUILHO,5950,12805,4094,28349,24255,952,1111
SP,63339,CESÁRIO LANGE,2078,4908,2061,11035,8974,478,467
SP,63355,CHARQUEADA,2639,4857,2172,12135,9963,362,363
SP,63371,CHAVANTES,2365,3234,1769,9403,7634,288,240
SP,63398,CLEMENTINA,1386,1803,979,4983,4004,112,192
SP,63410,COLINA,4268,4632,3120,14112,10992,388,442
SP,63436,COLÔMBIA,1560,1599,1290,5247,3957,112,141
SP,63452,CONCHAL,4321,7673,3417,18726,15309,719,565
SP,63479,CONCHAS,3106,4708,3411,13475,10064,380,419
SP,63495,CORDEIRÓPOLIS,4052,5586,2358,15808,13450,516,528
SP,63517,COROADOS,1041,1438,719,3926,3207,104,100
SP,63533,CORONEL MACEDO,1790,1293,655,4136,3481,68,91
SP,63550,CORUMBATAÍ,517,1512,744,3303,2559,84,92
SP,63576,COSMÓPOLIS,15682,7752,6827,40830,34003,1459,1311
SP,63592,COSMORAMA,1599,2508,894,5660,4766,159,102
SP,63614,COTIA,44956,37692,19203,131999,112796,3862,4046
SP,63630,CRAVINHOS,3987,10767,4188,23552,19364,861,946
SP,63657,CRISTAIS PAULISTA,1662,2469,1117,6103,4986,133,169
SP,63673,CRUZÁLIA,684,843,340,2164,1824,35,27
SP,63690,CRUZEIRO,11373,21721,9448,57418,47970,1542,1964
SP,63711,CUBATÃO,35205,19650,15447,93290,77843,2059,2260
SP,63738,CUNHA,6620,4322,4956,19124,14168,472,511
SP,63754,DESCALVADO,3915,11136,4489,24623,20134,1011,885
SP,63770,DIADEMA,139005,57578,44513,312300,267787,9111,10879
SP,63797,DIVINOLÂNDIA,1846,4530,2135,10010,7875,479,361
SP,63819,DOBRADA,1835,1693,627,5037,4410,163,147
SP,63835,DOIS CÓRREGOS,3410,7620,3757,18273,14516,607,445
SP,63851,DOLCINÓPOLIS,972,552,297,2070,1773,53,39
SP,63878,DOURADO,1398,3070,1431,7229,5798,373,259
SP,63894,DRACENA,8603,11646,4288,30790,26502,836,728
SP,63916,DUARTINA,2815,3068,1402,9406,8004,308,304
SP,63932,DUMONT,1509,2430,919,5904,4985,232,189
SP,63959,ECHAPORÃ,1378,1710,1333,5307,3974,114,176
SP,63975,ELDORADO,3973,2777,3384,11590,8206,162,287
SP,63991,ELIAS FAUSTO,3741,3937,2574,12477,9903,423,370
SP,64017,EMBU,66428,40290,23785,170578,146793,5470,5267
SP,64033,EMBU-GUAÇU,16990,12361,8302,46903,38601,1265,1264
SP,64050,ESTRELA D'OESTE,1904,2446,1116,6740,5624,290,213
SP,64076,ESTRELA DO NORTE,644,852,389,2307,1918,63,47
SP,64092,FARTURA,3115,4660,2800,12375,9575,307,279
SP,64114,FERNANDÓPOLIS,17947,13427,9668,49450,39782,1356,1105
SP,64130,FERNANDO PRESTES,1198,1670,866,4679,3813,317,149
SP,64157,FERRAZ DE VASCONCELOS,44151,20548,15970,109865,93895,3334,3673
SP,64173,FLORA RICA,636,525,343,1725,1382,32,14
SP,64190,FLOREAL,903,815,390,2508,2118,88,70
SP,64211,FLÓRIDA PAULISTA,2892,2781,1030,8000,6970,292,215
SP,64238,FLORÍNEA,948,736,447,2559,2112,72,49
SP,64254,FRANCA,58278,87859,31870,218769,186899,4913,5413
SP,64270,FRANCISCO MORATO,45054,18045,15869,99210,83341,3399,3355
SP,64297,FRANCO DA ROCHA,35221,17078,12797,87010,74213,3095,3473
SP,64319,GABRIEL MONTEIRO,407,1300,400,2490,2090,66,126
SP,64335,GÁLIA,1377,2000,1387,5519,4132,163,154
SP,64351,GARÇA,5710,14588,7629,34141,26512,1178,928
SP,64378,GASTÃO VIDIGAL,1388,660,723,3252,2529,124,80
SP,64394,GENERAL SALGADO,2850,2739,1066,7951,6885,215,194
SP,64416,GETULINA,2305,2635,2171,8487,6316,242,269
SP,64432,GLICÉRIO,1290,1145,724,3794,3070,97,95
SP,64459,GUAIÇARA,2524,2374,1583,7947,6364,267,166
SP,64475,GUAIMBÉ,1344,1441,796,4233,3437,106,152
SP,64491,GUAÍRA,9492,10040,6122,28855,22733,586,515
SP,64513,GUAPIAÇU,4391,4804,2476,13588,11112,414,323
SP,64530,GUAPIARA,5882,3779,4493,15622,11129,253,497
SP,64556,GUARÁ,5945,4175,3042,14995,11953,321,330
SP,64572,GUARAÇAÍ,2314,1892,1577,7036,5459,261,242
SP,64599,GUARACI,2836,2453,1921,8180,6259,166,197
SP,64610,GUARANI D'OESTE,573,447,276,1513,1237,38,40
SP,64637,GUARANTÃ,1593,1553,1161,5318,4157,185,124
SP,64653,GUARARAPES,6261,7622,5381,24117,18736,658,740
SP,64670,GUARAREMA,5691,7233,3010,19974,16964,460,590
SP,64696,GUARATINGUETÁ,17175,27947,14265,86092,71827,2314,2226
SP,64718,GUAREÍ,2044,3260,1804,8876,7072,466,314
SP,64734,GUARIBA,8801,8329,4502,26733,22231,625,595
SP,64750,GUARUJÁ,70676,50361,35489,211242,175753,6432,6610
SP,64777,GUARULHOS,248526,220441,104373,788677,684304,24217,30366
SP,64793,GUZOLÂNDIA,1478,989,537,3478,2941,98,100
SP,64815,HERCULÂNDIA,2540,1740,1394,6723,5329,132,208
SP,64831,IACANGA,1579,2485,980,6645,5665,219,137
SP,64858,IACRI,1408,1917,1069,5239,4170,141,148
SP,64874,IBATÉ,5956,7943,3754,22879,19125,892,687
SP,64890,IBIRÁ,1465,3739,1502,7778,6276,267,229
SP,64912,IBIRAREMA,1041,1918,756,4806,4050,253,136
SP,64939,IBITINGA,9420,14544,7170,39957,32787,1524,1288
SP,64955,IBIÚNA,9364,25128,11382,54043,42661,1262,1764
SP,64971,ICÉM,2245,1802,1480,6437,4957,126,187
SP,64998,IEPÊ,1254,2641,1075,5798,4723,110,154
SP,65013,IGARAÇU DO TIETÊ,5955,5317,3178,18441,15263,882,701
SP,65030,IGARAPAVA,6626,5645,5416,21711,16295,703,532
SP,65056,IGARATÁ,2144,2409,1030,6786,5756,144,261
SP,65072,IGUAPE,6235,6905,6371,22827,16456,433,523
SP,65099,ILHABELA,3673,7986,4378,20204,15826,327,412
SP,65110,INDAIATUBA,41159,36548,19912,133413,113501,4732,5223
SP,65137,INDIANA,1282,1361,775,4278,3503,159,123
SP,65153,INDIAPORÃ,1129,974,396,2922,2526,51,81
SP,65170,INÚBIA PAULISTA,646,1279,444,2842,2398,104,77
SP,65196,IPAUSSU,2038,3942,1967,10029,8062,319,201
SP,65218,IPERÓ,5589,4624,3078,16245,13167,436,477
SP,65234,IPEÚNA,1032,1599,930,4584,3654,94,133
SP,65250,IPORANGA,1440,598,1056,3504,2448,46,97
SP,65277,IPUÃ,3633,3397,2087,10333,8246,278,224
SP,65293,IRACEMÁPOLIS,3647,5455,1932,14856,12924,393,432
SP,65315,IRAPUÃ,1474,1992,1228,5574,4346,241,185
SP,65331,IRAPURU,1448,1958,1058,5341,4283,144,118
SP,65358,ITABERÁ,5098,4577,2598,13746,11148,336,266
SP,65374,ITAÍ,5477,5134,3520,16312,12792,457,452
SP,65390,ITAJOBI,2594,5280,2357,12211,9854,574,408
SP,65412,ITAJU,477,1089,576,2665,2089,112,79
SP,65439,ITANHAÉM,16101,18733,17124,63544,46420,1412,1635
SP,65455,ITAPECERICA DA SERRA,40688,24309,15542,102029,86487,2958,2737
SP,65471,ITAPETININGA,18480,39007,17287,98917,81630,2972,2790
SP,65498,ITAPEVA,14969,26954,12780,64563,51783,1458,1291
SP,65510,ITAPEVI,54573,24890,19031,128169,109138,4111,3562
SP,65536,ITAPIRA,8645,24181,8600,52892,44292,2043,1944
SP,65552,ITÁPOLIS,7132,10475,6827,30351,23524,1469,1028
SP,65579,ITAPORANGA,2734,4402,1832,10491,8659,290,380
SP,65595,ITAPUÍ,1895,3379,1509,8314,6805,277,207
SP,65617,ITAPURA,1507,439,946,3361,2415,88,105
SP,65633,ITAQUAQUECETUBA,75914,40504,29519,191064,161545,6440,7103
SP,65650,ITARARÉ,7916,13954,8800,36904,28104,922,894
SP,65676,ITARIRI,2409,2761,2420,8963,6543,169,220
SP,65692,ITATIBA,13658,29731,11058,68134,57076,2422,2374
SP,65714,ITATINGA,2860,4968,2489,12902,10413,454,387
SP,65730,ITIRAPINA,2416,3267,2094,9482,7388,281,307
SP,65757,ITIRAPUÃ,1838,1335,915,4693,3778,111,145
SP,65773,ITOBI,1987,1855,1309,6137,4828,237,169
SP,65790,ITU,25855,39067,18703,112493,93790,3475,4146
SP,65811,ITUPEVA,7587,8839,4737,27205,22468,848,962
SP,65838,ITUVERAVA,8505,9804,7007,30016,23009,748,768
SP,65854,JABORANDI,1937,1270,638,4642,4004,247,145
SP,65870,JABOTICABAL,9706,20831,10705,51957,41252,1454,1278
SP,65897,JACAREÍ,39792,48445,23531,151377,127846,3401,3954
SP,65919,JACI,1570,1699,694,4496,3802,114,119
SP,65935,JACUPIRANGA,2831,4896,3576,13503,9927,206,352
SP,65951,JAGUARIÚNA,7614,11426,5511,31330,25819,1091,1017
SP,65978,JALES,9817,12921,7343,37334,29991,1210,970
SP,65994,JAMBEIRO,834,1686,537,3920,3383,94,90
SP,66010,JANDIRA,27291,18936,10589,73535,62946,2250,2009
SP,66036,JARDINÓPOLIS,5645,9671,5008,25231,20223,978,898
SP,66052,JARINU,4121,6106,3517,16867,13350,436,583
SP,66079,JAÚ,19968,37585,14542,93262,78720,3488,2922
SP,66095,JERIQUARA,1085,962,845,3261,2416,72,56
SP,66117,JOANÓPOLIS,1917,3593,1731,8822,7091,327,278
SP,66133,JOÃO RAMALHO,1012,1233,921,3718,2797,77,135
SP,66150,JOSÉ BONIFÁCIO,6019,9195,4129,23518,19389,1022,556
SP,66176,JÚLIO MESQUITA,1423,1072,455,3463,3008,94,95
SP,66192,JUNDIAÍ,70868,87637,39193,270141,230948,6900,10969
SP,66214,JUNQUEIRÓPOLIS,3554,5029,1749,12565,10816,337,271
SP,66230,JUQUIÁ,4170,5229,5443,17222,11779,217,423
SP,66257,JUQUITIBA,6389,6603,4901,21530,16629,529,671
SP,66273,LAGOINHA,891,2359,1015,5067,4052,183,106
SP,66290,LARANJAL PAULISTA,3403,9760,3358,19503,16145,553,567
SP,66311,LAVÍNIA,1700,1009,647,3927,3280,101,137
SP,66338,LAVRINHAS,1404,2285,866,5522,4656,142,147
SP,66354,LEME,19124,21157,10390,66481,56091,2776,2397
SP,66370,LENÇÓIS PAULISTA,7530,18020,6705,44111,37406,1504,1428
SP,66397,LIMEIRA,51008,57472,30984,195463,164479,6965,7040
SP,66419,LINDÓIA,781,2524,781,4934,4153,114,147
SP,66435,LINS,10954,19090,11183,53631,42448,1678,1542
SP,66451,LORENA,11110,20505,11381,61817,50436,1529,1409
SP,66478,LOUVEIRA,6829,10070,4894,28156,23262,822,704
SP,66494,LUCÉLIA,4214,4851,3463,14907,11444,364,426
SP,66516,LUCIANÓPOLIS,626,607,315,1876,1561,43,50
SP,66532,LUÍS ANTÔNIO,2971,2117,1284,7775,6491,207,242
SP,66559,LUIZIÂNIA,1350,1338,897,4018,3121,66,80
SP,66575,LUPÉRCIO,1270,1143,818,3697,2879,92,72
SP,66591,LUTÉCIA,882,676,477,2429,1952,49,74
SP,66613,MACATUBA,3124,4202,2444,12906,10462,472,329
SP,66630,MACAUBAL,1122,2875,901,5888,4987,337,126
SP,66656,MACEDÔNIA,1026,914,529,2966,2437,79,82
SP,66672,MAGDA,994,749,546,2850,2304,99,72
SP,66699,MAIRINQUE,11666,10066,5998,34518,28520,951,1005
SP,66710,MAIRIPORÃ,13029,18059,9167,52095,42928,1582,1741
SP,66737,MANDURI,1838,2576,1404,7174,5770,252,223
SP,66753,MARABÁ PAULISTA,1221,874,844,3459,2615,73,105
SP,66770,MARACAÍ,3567,2646,1483,10245,8762,230,208
SP,66796,MARIÁPOLIS,1119,1001,612,3237,2625,142,85
SP,66818,MARÍLIA,31910,56765,28831,157597,128766,5221,5290
SP,66834,MARINÓPOLIS,619,702,387,2021,1634,95,57
SP,66850,MARTINÓPOLIS,3637,6892,4055,18172,14117,525,542
SP,66877,MATÃO,17363,20846,9442,60249,50807,1914,1999
SP,66893,MAUÁ,106827,67343,38865,283964,245099,9040,11968
SP,66915,MENDONÇA,1488,1176,629,3669,3040,107,67
SP,66931,MERIDIANO,1223,1034,693,3381,2688,89,72
SP,66958,MIGUELÓPOLIS,5646,4918,4206,16553,12347,356,434
SP,66974,MINEIROS DO TIETÊ,2106,3528,1661,8933,7272,354,284
SP,66990,MIRACATU,4781,4745,5092,16809,11717,316,442
SP,67016,MIRA ESTRELA,937,665,407,2358,1951,75,69
SP,67032,MIRANDÓPOLIS,5722,5166,4536,20178,15642,829,813
SP,67059,MIRANTE DO PARANAPANEMA,5399,3014,3648,14053,10405,339,343
SP,67075,MIRASSOL,10190,14632,6949,38889,31940,1254,1181
SP,67091,MIRASSOLÂNDIA,856,1540,530,3408,2878,106,77
SP,67113,MOCOCA,7439,24894,11222,52733,41511,1864,1660
SP,67130,MOGI DAS CRUZES,66927,91808,39180,268113,228933,8159,8840
SP,67156,MOGI GUAÇU,28014,32733,15748,103631,87883,3793,3786
SP,67172,MOGI MIRIM,10466,26114,10835,63449,52614,2584,2340
SP,67199,MOMBUCA,610,1097,377,2615,2238,134,95
SP,67210,MONÇÕES,627,566,238,1792,1554,129,57
SP,67237,MONGAGUÁ,10056,10159,9454,35367,25913,635,855
SP,67253,MONTE ALEGRE DO SUL,1145,2405,643,5115,4472,172,252
SP,67270,MONTE ALTO,8280,13795,6954,35843,28889,1629,1115
SP,67296,MONTE APRAZÍVEL,4625,5236,2075,14765,12690,586,495
SP,67318,MONTE AZUL PAULISTA,3508,5863,3270,15565,12295,680,501
SP,67334,MONTE CASTELO,1501,681,461,3099,2638,64,82
SP,67350,MONTEIRO LOBATO,798,1353,462,3213,2751,48,87
SP,67377,MONTE MOR,13130,6681,6449,34527,28078,1127,1089
SP,67393,MORRO AGUDO,5654,6819,3601,19847,16246,625,723
SP,67415,MORUNGABA,1586,4761,1236,8991,7755,290,300
SP,67431,MURUTINGA DO SUL,1142,1049,702,3432,2730,78,108
SP,67458,NARANDIBA,1162,1158,706,3556,2850,86,85
SP,67474,NATIVIDADE DA SERRA,1407,2432,1639,6446,4807,153,181
SP,67490,NAZARÉ PAULISTA,3753,4041,2792,12825,10033,446,478
SP,67512,NEVES PAULISTA,2460,2456,1315,7331,6016,317,217
SP,67539,NHANDEARA,2051,3130,1088,7613,6525,309,207
SP,67555,NIPOÃ,1110,1250,608,3500,2892,109,102
SP,67571,NOVA ALIANÇA,1532,1744,696,4778,4082,199,201
SP,67598,NOVA EUROPA,2520,2376,1586,7577,5991,179,243
SP,67610,NOVA GRANADA,4452,4766,3033,14655,11622,503,504
SP,67636,NOVA GUATAPORANGA,801,416,230,1680,1450,46,55
SP,67652,NOVA INDEPENDÊNCIA,902,714,339,2346,2007,57,56
SP,67679,NOVA LUZITÂNIA,1063,977,374,2642,2268,36,48
SP,67695,NOVA ODESSA,13897,7953,5221,37688,32467,1008,1092
SP,67717,NOVO HORIZONTE,6428,9963,5209,27073,21864,913,629
SP,67733,NUPORANGA,1075,2362,459,4927,4468,175,132
SP,67750,OCAUÇU,871,1110,626,3313,2687,137,143
SP,67776,ÓLEO,549,1058,469,2584,2115,118,81
SP,67792,OLÍMPIA,8888,14484,7400,37219,29819,1121,899
SP,67814,ONDA VERDE,1167,1019,507,3190,2683,77,104
SP,67830,ORIENTE,1408,1809,548,4648,4100,144,170
SP,67857,ORINDIÚVA,1350,1783,840,4503,3663,97,127
SP,67873,ORLÂNDIA,6633,12750,5063,29826,24763,895,1033
SP,67890,OSASCO,182365,131188,75896,531952,456056,13834,17663
SP,67911,OSCAR BRESSANE,587,1051,518,2463,1945,57,63
SP,67938,OSVALDO CRUZ,5803,8962,5385,24147,18762,658,649
SP,67954,OURINHOS,18340,23782,14518,73780,59262,2193,2126
SP,67970,OURO VERDE,2576,1425,772,5477,4705,113,140
SP,67997,PACAEMBU,2328,3282,1860,8849,6989,191,178
SP,68012,PALESTINA,1993,3338,1164,7667,6503,256,273
SP,68039,PALMARES PAULISTA,2792,1874,1181,7014,5833,313,245
SP,68055,PALMEIRA D'OESTE,2903,2268,1557,7781,6224,312,206
SP,68071,PALMITAL,3931,6064,3598,16759,13161,645,390
SP,68098,PANORAMA,3558,3333,2175,10240,8065,234,193
SP,68110,PARAGUAÇU PAULISTA,9409,9300,6628,31318,24690,956,772
SP,68136,PARAIBUNA,4168,4377,2745,13648,10903,217,334
SP,68152,PARAÍSO,1419,1598,826,4826,4000,242,169
SP,68179,PARANAPANEMA,4729,4261,2674,13191,10517,249,312
SP,68195,PARANAPUÃ,1073,961,303,2725,2422,116,40
SP,68217,PARAPUÃ,2293,2744,2008,8680,6672,300,298
SP,68233,PARDINHO,1049,1779,954,4620,3666,164,159
SP,68250,PARIQUERA-AÇU,3796,5222,3506,14601,11095,321,369
SP,68276,PATROCÍNIO PAULISTA,2287,4464,1737,9952,8215,208,274
SP,68292,PAULICÉIA,1720,1498,853,4616,3763,153,81
SP,68314,PAULÍNIA,17608,12321,5778,51649,45871,1574,1576
SP,68330,PAULO DE FARIA,2330,2113,1216,6483,5267,105,243
SP,68357,PEDERNEIRAS,8121,9268,5170,29973,24803,1051,906
SP,68373,PEDRA BELA,1213,1843,926,4571,3645,132,175
SP,68390,PEDRANÓPOLIS,850,650,249,2005,1756,60,55
SP,68411,PEDREGULHO,4737,3619,3300,13502,10202,400,428
SP,68438,PEDREIRA,7943,11491,4915,31239,26324,1217,1319
SP,68454,PEDRO DE TOLEDO,2302,1748,2216,7638,5422,128,193
SP,68470,PENÁPOLIS,11985,13361,9198,44539,35341,1337,1403
SP,68497,PEREIRA BARRETO,5769,6220,5030,20069,15039,415,537
SP,68519,PEREIRAS,1435,2358,1515,6318,4803,195,168
SP,68535,PERUÍBE,12000,15290,13304,49506,36202,1079,1340
SP,68551,PIACATU,1035,1795,727,4179,3452,93,125
SP,68578,PIEDADE,8212,16851,7282,37847,30565,1121,865
SP,68594,PILAR DO SUL,5398,7655,3454,19439,15985,529,444
SP,68616,PINDAMONHANGABA,21183,37438,16064,100754,84690,2474,2923
SP,68632,PINDORAMA,3115,3897,1947,11121,9174,458,369
SP,68659,ESPÍRITO SANTO DO PINHAL,6095,14632,6496,33144,26648,1175,973
SP,68675,PINHALZINHO,2185,3900,1937,9631,7694,333,380
SP,68691,PIQUEROBI,1172,737,562,2943,2381,99,81
SP,68713,PIQUETE,2067,3325,1460,10566,9106,206,303
SP,68730,PIRACAIA,4274,8299,4143,20131,15988,548,529
SP,68756,PIRACICABA,52909,102216,40661,263707,223046,8800,8850
SP,68772,PIRAJU,5100,7831,4979,22370,17391,691,755
SP,68799,PIRAJUÍ,3388,4838,3534,15402,11868,576,426
SP,68810,PIRANGI,1760,3064,1494,7779,6285,411,256
SP,68837,PIRAPORA DO BOM JESUS,3401,2885,1585,9744,8159,226,283
SP,68853,PIRAPOZINHO,5261,5780,4033,19375,15342,482,512
SP,68870,PIRASSUNUNGA,9845,18366,10488,52779,42291,1871,1747
SP,68896,PIRATININGA,1931,2933,1001,7992,6991,260,236
SP,68918,PITANGUEIRAS,7796,7851,5725,25566,19841,913,842
SP,68934,PLANALTO,1237,1178,588,3481,2893,116,117
SP,68950,PLATINA,765,897,500,2572,2072,77,72
SP,68977,POÁ,29198,17436,12412,84046,71634,2131,2364
SP,68993,POLONI,1073,1714,842,4378,3536,183,117
SP,69019,POMPÉIA,3044,6586,1773,14406,12633,390,401
SP,69035,PONGAÍ,663,1376,459,3064,2605,98,86
SP,69051,PONTAL,9508,7675,5551,27270,21719,1005,983
SP,69078,PONTES GESTAL,646,827,359,2142,1783,48,41
SP,69094,POPULINA,1357,928,529,3331,2802,112,115
SP,69116,PORANGABA,1793,2017,1328,6324,4996,181,195
SP,69132,PORTO FELIZ,9062,12417,6292,36411,30119,1244,992
SP,69159,PORTO FERREIRA,7956,15153,6374,38571,32197,1262,1051
SP,69175,POTIRENDABA,3088,4552,2474,12126,9652,637,416
SP,69191,PRADÓPOLIS,3902,4029,2419,12948,10529,477,424
SP,69213,PRAIA GRANDE,46955,50380,34405,166897,132492,4229,4883
SP,69230,PRESIDENTE ALVES,966,1193,474,3245,2771,57,98
SP,69256,PRESIDENTE BERNARDES,3174,3651,2695,11217,8522,333,249
SP,69272,PRESIDENTE EPITÁCIO,9408,7907,6881,30575,23694,761,770
SP,69299,PRESIDENTE PRUDENTE,34249,53923,31828,157120,125292,4262,4495
SP,69310,PRESIDENTE VENCESLAU,6673,9717,6281,29132,22851,796,871
SP,69337,PROMISSÃO,9840,5628,5547,26640,21093,890,637
SP,69353,QUATÁ,2118,3835,2256,10223,7967,248,245
SP,69370,QUEIROZ,1115,577,416,2357,1941,41,69
SP,69396,QUELUZ,2498,2127,1721,7597,5876,140,174
SP,69418,QUINTANA,1553,1578,869,4797,3928,120,152
SP,69434,RAFARD,1684,2855,1007,6989,5982,223,205
SP,69450,RANCHARIA,5656,8304,5033,23486,18453,574,546
SP,69477,REDENÇÃO DA SERRA,800,1575,722,3735,3013,114,116
SP,69493,REGENTE FEIJÓ,3456,5439,2620,14502,11882,306,309
SP,69515,REGINÓPOLIS,906,1547,727,4272,3545,119,162
SP,69531,REGISTRO,9979,15679,9920,42320,32400,766,879
SP,69558,RESTINGA,2343,1496,950,5480,4530,127,116
SP,69574,RIBEIRA,1023,822,476,2640,2164,31,80
SP,69590,RIBEIRÃO BONITO,2074,3170,1370,8392,7022,320,301
SP,69612,RIBEIRÃO BRANCO,6212,3218,3793,14416,10623,235,381
SP,69639,RIBEIRÃO CORRENTE,1215,1301,603,3506,2903,76,127
SP,69655,RIBEIRÃO DO SUL,1553,1064,550,3621,3071,83,83
SP,69671,RIBEIRÃO PIRES,25184,24486,13043,85082,72039,2494,3245
SP,69698,RIBEIRÃO PRETO,92269,135969,71133,405917,334784,11955,17954
SP,69710,RIVERSUL,1727,1249,1105,4855,3750,164,171
SP,69736,RIFAINA,1108,1298,1013,3932,2919,74,71
SP,69752,RINCÃO,2332,2818,1490,7749,6259,294,276
SP,69779,RINÓPOLIS,1844,3172,1563,7713,6150,229,230
SP,69795,RIO CLARO,27877,48231,22300,135463,113163,4329,6023
SP,69817,RIO DAS PEDRAS,5906,7432,3845,22727,18882,833,613
SP,69833,RIO GRANDE DA SERRA,10938,8501,5331,32130,26799,913,1020
SP,69850,RIOLÂNDIA,2101,2644,1716,7152,5436,145,211
SP,69876,ROSEIRA,1630,2871,1300,7356,6056,146,128
SP,69892,RUBIÁCEA,602,873,457,2291,1834,57,67
SP,69914,RUBINÉIA,842,673,347,2224,1877,62,78
SP,69930,SABINO,1791,1081,962,4622,3660,171,150
SP,69957,SAGRES,704,664,319,1900,1581,27,41
SP,69973,SALES,925,1965,819,4285,3466,101,126
SP,69990,SALES OLIVEIRA,1975,3150,1257,7710,6453,262,232
SP,70017,SALESÓPOLIS,3399,5296,2683,13977,11294,403,400
SP,70033,SALMOURÃO,1215,1427,770,3863,3093,101,145
SP,70050,SALTO,25917,21660,11408,77256,65848,2161,2529
SP,70076,SALTO DE PIRAPORA,8082,8373,4689,26572,21883,1018,882
SP,70092,SALTO GRANDE,1507,2508,1612,6745,5133,182,208
SP,70114,SANDOVALINA,1015,1008,645,3107,2462,31,86
SP,70130,SANTA ADÉLIA,3211,3858,2137,11282,9145,402,323
SP,70157,SANTA ALBERTINA,1417,1580,836,4458,3622,160,91
SP,70173,SANTA BÁRBARA D'OESTE,50318,27069,18157,129517,111360,4936,4487
SP,70190,ÁGUAS DE SANTA BÁRBARA,1181,1550,1174,4670,3496,125,163
SP,70211,SANTA BRANCA,2611,3913,2352,11463,9111,239,273
SP,70238,SANTA CLARA D'OESTE,629,671,335,2003,1668,83,56
SP,70254,SANTA CRUZ DA CONCEIÇÃO,917,1175,489,3219,2730,100,106
SP,70270,SANTA CRUZ DAS PALMEIRAS,4834,8865,4184,21759,17575,780,609
SP,70297,SANTA CRUZ DO RIO PARDO,5224,14726,6191,32781,26590,1126,843
SP,70319,SANTA ERNESTINA,1647,1423,771,4693,3922,139,115
SP,70335,SANTA FÉ DO SUL,6047,8021,4906,23343,18437,806,680
SP,70351,SANTA GERTRUDES,4651,4809,2302,15420,13118,587,540
SP,70378,SANTA ISABEL,10027,13492,5645,36937,31292,1173,1372
SP,70394,SANTA LÚCIA,3352,1596,1471,7728,6257,284,253
SP,70416,SANTA MARIA DA SERRA,1123,1613,529,3804,3275,127,130
SP,70432,SANTA MERCEDES,832,696,547,2311,1764,32,35
SP,70459,SANTANA DA PONTE PENSA,487,481,210,1445,1235,72,55
SP,70475,SANTANA DE PARNAÍBA,20486,21072,8897,64702,55805,1790,2019
SP,70491,SANTA RITA D'OESTE,855,680,353,2186,1833,67,66
SP,70513,SANTA RITA DO PASSA QUATRO,4511,7350,4324,21411,17087,737,870
SP,70530,SANTA ROSA DE VITERBO,5171,6072,3662,18811,15149,603,668
SP,70556,SANTO ANASTÁCIO,4757,4379,3849,16913,13064,682,554
SP,70572,SANTO ANDRÉ,167303,155926,85066,546589,461523,13830,23860
SP,70599,SANTO ANTÔNIO DA ALEGRIA,1575,1685,1075,5291,4216,150,173
SP,70610,SANTO ANTÔNIO DE POSSE,3327,6731,2719,15080,12361,636,395
SP,70637,SANTO ANTÔNIO DO JARDIM,1201,2304,891,5204,4313,187,168
SP,70653,SANTO ANTÔNIO DO PINHAL,1311,2376,1182,5757,4575,160,140
SP,70670,SANTO EXPEDITO,932,709,363,2379,2016,37,103
SP,70696,SANTÓPOLIS DO AGUAPEÍ,1037,962,531,3105,2574,101,91
SP,70718,SANTOS,73681,112845,51023,324013,272990,6709,10596
SP,70734,SÃO BENTO DO SAPUCAÍ,1693,3450,1843,8583,6740,226,236
SP,70750,SÃO BERNARDO DO CAMPO,205712,144964,78654,560759,482105,13613,22561
SP,70777,SÃO CAETANO DO SUL,22332,50330,9499,111407,101908,2363,4362
SP,70793,SÃO CARLOS,32361,62565,25040,162490,137450,5003,6519
SP,70815,SÃO FRANCISCO,802,716,476,2383,1907,108,94
SP,70831,SÃO JOÃO DA BOA VISTA,14008,26474,10763,63728,52965,1993,2173
SP,70858,SÃO JOÃO DAS DUAS PONTES,927,558,340,2180,1840,83,58
SP,70874,SÃO JOÃO DO PAU D'ALHO,629,646,217,1720,1503,47,39
SP,70890,SÃO JOAQUIM DA BARRA,9499,12493,6004,34634,28630,1155,1044
SP,70912,SÃO JOSÉ DA BELA VISTA,2055,2109,1624,6701,5077,320,172
SP,70939,SÃO JOSÉ DO BARREIRO,889,1332,632,3437,2805,72,94
SP,70955,SÃO JOSÉ DO RIO PARDO,8472,17125,7532,40431,32899,1361,1014
SP,70971,SÃO JOSÉ DO RIO PRETO,72334,109072,48480,291214,242734,7367,9442
SP,70998,SÃO JOSÉ DOS CAMPOS,111431,142941,63503,438237,374734,8887,10689
SP,71013,SÃO LUÍS DO PARAITINGA,2051,4254,1480,9110,7630,314,278
SP,71030,SÃO MANUEL,6769,8680,5364,29655,24291,1310,1253
SP,71056,SÃO MIGUEL ARCANJO,5705,9462,4932,23843,18911,486,597
SP,71072,SÃO PAULO,2532225,2677318,1303084,8479626,7176542,220998,316488
SP,71099,SÃO PEDRO,3753,10557,5010,23443,18433,641,712
SP,71110,SÃO PEDRO DO TURVO,1280,2096,854,5042,4188,151,148
SP,71137,SÃO ROQUE,13220,20984,9251,54046,44795,1569,1538
SP,71153,SÃO SEBASTIÃO,15753,13446,10849,52105,41256,1136,1358
SP,71170,SÃO SEBASTIÃO DA GRAMA,2050,3630,2215,9342,7127,284,303
SP,71196,SÃO SIMÃO,2479,4468,2326,11407,9081,257,339
SP,71218,SÃO VICENTE,75264,58690,40875,242863,201988,7391,8397
SP,71234,SARAPUÍ,2043,2299,1425,6701,5276,181,167
SP,71250,SARUTAIÁ,1237,944,653,3193,2540,65,113
SP,71277,SEBASTIANÓPOLIS DO SUL,634,1230,355,2636,2281,102,52
SP,71293,SERRA AZUL,2148,1972,1315,6390,5075,201,229
SP,71315,SERRANA,8236,10441,4728,28124,23396,980,940
SP,71331,SERRA NEGRA,3624,9456,4678,21273,16595,509,629
SP,71358,SERTÃOZINHO,22824,23246,13780,78909,65129,3255,3173
SP,71374,SETE BARRAS,3396,3038,3250,11110,7860,191,399
SP,71390,SEVERÍNIA,3205,4646,2216,11671,9455,370,271
SP,71412,SILVEIRAS,1387,1743,905,4923,4018,162,156
SP,71439,SOCORRO,4057,13287,6023,27901,21878,739,1007
SP,71455,SOROCABA,111184,120874,56862,406966,350104,11428,15068
SP,71471,SUD MENNUCCI,2363,2020,1121,6133,5012,170,184
SP,71498,SUMARÉ,59989,34126,23718,156368,132650,4704,4782
SP,71510,SUZANO,57665,53259,27683,186323,158640,5317,5728
SP,71536,TABAPUÃ,2247,3704,1363,8550,7187,344,294
SP,71552,TABATINGA,3248,3904,2390,11433,9043,509,405
SP,71579,TABOÃO DA SERRA,64975,44742,27657,185783,158126,5888,6514
SP,71595,TACIBA,1808,1452,870,4778,3908,63,98
SP,71617,TAGUAÍ,2388,2927,1429,7603,6174,177,134
SP,71633,TAIAÇU,1303,1446,954,4485,3531,159,122
SP,71650,TAIÚVA,904,1990,939,4602,3663,135,96
SP,71676,TAMBAÚ,4070,6795,2789,16744,13955,490,482
SP,71692,TANABI,4815,7477,3765,19471,15706,459,385
SP,71714,TAPIRAÍ,1234,2296,1823,6298,4475,130,164
SP,71730,TAPIRATIBA,3123,3418,1899,10085,8186,270,278
SP,71757,TAQUARITINGA,9387,14476,7950,39656,31706,1633,1128
SP,71773,TAQUARITUBA,6438,5858,3843,18180,14337,465,377
SP,71790,TARABAI,1841,1339,939,5130,4191,92,149
SP,71811,TATUÍ,13471,33503,13778,76495,62717,2567,2852
SP,71838,TAUBATÉ,44219,66852,36327,206496,170169,5930,6225
SP,71854,TEJUPÁ,1405,1243,1007,4088,3081,80,116
SP,71870,TEODORO SAMPAIO,5489,4535,3874,16038,12164,285,378
SP,71897,TERRA ROXA,2259,2143,1347,6681,5334,229,147
SP,71919,TIETÊ,4544,11804,4563,26678,22115,733,865
SP,71935,TIMBURI,562,985,515,2490,1975,64,105
SP,71951,TORRINHA,1567,2909,1364,7163,5799,318,188
SP,71978,TREMEMBÉ,4471,8212,3966,23075,19109,539,718
SP,71994,TRÊS FRONTEIRAS,1662,1330,845,4397,3552,121,116
SP,72010,TUPÃ,11778,17384,10331,49368,39037,1053,1235
SP,72036,TUPI PAULISTA,3226,3886,1873,10670,8797,235,238
SP,72052,TURIÚBA,429,714,219,1612,1393,36,49
SP,72079,TURMALINA,674,426,451,1879,1428,68,76
SP,72095,UBATUBA,12675,20132,13338,58396,45058,1289,1645
SP,72117,UBIRAJARA,977,1206,444,3197,2753,81,110
SP,72133,UCHOA,2121,3124,1472,7706,6234,274,221
SP,72150,UNIÃO PAULISTA,470,603,460,1701,1241,41,33
SP,72176,URÂNIA,2365,1828,949,6245,5296,279,184
SP,72192,URU,361,483,284,1331,1047,38,46
SP,72214,URUPÊS,2449,4152,2076,10246,8170,352,265
SP,72230,VALENTIM GENTIL,2272,3143,1476,8199,6723,294,203
SP,72257,VALINHOS,17485,26757,12936,77687,64751,2780,3162
SP,72273,VALPARAÍSO,4814,4462,3267,15037,11770,312,347
SP,72311,VARGEM GRANDE DO SUL,4947,14804,5276,29134,23858,993,716
SP,72338,VÁRZEA PAULISTA,28859,14823,9627,74288,64661,2047,2437
SP,72354,VERA CRUZ,2392,2977,1763,8659,6896,186,344
SP,72370,VINHEDO,8713,20669,8063,50218,42155,1600,1523
SP,72397,VIRADOURO,4394,4379,2495,13548,11053,464,328
SP,72419,VISTA ALEGRE DO ALTO,1545,1464,732,4677,3945,250,162
SP,72435,VOTORANTIM,26723,20259,11274,79228,67954,2594,2590
SP,72451,VOTUPORANGA,15157,25057,11223,64769,53546,1707,1813
SP,72737,VARGEM GRANDE PAULISTA,9922,9344,5084,31205,26121,903,970
TO,73008,ABREULÂNDIA,935,318,446,2008,1562,9,144
TO,73016,PIRAQUÊ,810,640,532,2594,2062,11,151
TO,73024,RIACHINHO,1674,394,700,3421,2721,19,273
TO,73032,DARCINÓPOLIS,1379,586,622,3608,2986,35,261
TO,73040,PALMEIRAS DO TOCANTINS,1759,760,768,3912,3144,42,253
TO,73059,MAURILÂNDIA DO TOCANTINS,1288,443,597,2770,2173,37,192
TO,73067,CACHOEIRINHA,658,403,444,1836,1392,9,129
TO,73075,ANGICO,924,710,341,2400,2059,18,174
TO,73083,PALMEIRANTE,1489,657,647,3252,2605,16,201
TO,73091,CAMPOS LINDOS,2048,1197,1144,5104,3960,40,301
TO,73105,SÃO FÉLIX DO TOCANTINS,480,108,102,948,846,2,50
TO,73113,LAGOA DO TOCANTINS,1486,189,254,2352,2098,20,212
TO,73121,BOM JESUS DO TOCANTINS,1298,507,210,2431,2221,16,135
TO,73130,SANTA MARIA DO TOCANTINS,1078,569,136,2093,1957,12,115
TO,73148,NOVO ALEGRE,780,236,170,1503,1333,22,99
TO,73156,SANDOLÂNDIA,1193,692,679,3033,2354,20,227
TO,73164,TAIPAS DO TOCANTINS,701,283,338,1578,1240,10,122
TO,73172,NOVO JARDIM,785,454,428,1995,1567,12,150
TO,73180,SÃO MIGUEL DO TOCANTINS,2983,951,1272,6455,5183,40,382
TO,73199,FORTALEZA DO TABOCÃO,679,568,201,1860,1659,26,125
TO,73202,ITAPIRATINS,1042,646,545,2668,2123,33,205
TO,73210,CENTENÁRIO,856,386,450,2024,1574,12,149
TO,73229,RECURSOLÂNDIA,1158,369,618,2737,2119,21,357
TO,73237,TUPIRATINS,775,180,240,1450,1210,19,113
TO,73245,BRASILÂNDIA DO TOCANTINS,769,395,136,1543,1407,16,114
TO,73253,JUARINA,706,479,125,1562,1437,18,108
TO,73261,PAU D'ARCO,1421,859,803,3574,2771,26,215
TO,73270,MATEIROS,632,237,331,1490,1159,12,151
TO,73288,SÃO BENTO DO TOCANTINS,1694,915,482,3547,3065,21,226
TO,73296,ESPERANTINA,2758,731,1440,5900,4460,74,440
TO,73300,CARIRI DO TOCANTINS,1101,521,362,2477,2115,22,131
TO,73318,ARAGUANÃ,1672,1020,1146,4566,3420,38,289
TO,73326,CARMOLÂNDIA,714,541,378,2143,1765,19,115
TO,73334,ARAGOMINAS,1504,1083,1163,4582,3419,34,288
TO,73342,MURICILÂNDIA,830,406,189,1779,1590,15,135
TO,73350,SANTA FÉ DO ARAGUAIA,1340,1069,369,3963,3594,38,313
TO,73369,JAÚ DO TOCANTINS,1402,674,488,2897,2409,22,169
TO,73377,SUCUPIRA,508,444,183,1406,1223,13,107
TO,73385,LAGOA DA CONFUSÃO,2816,986,1204,6059,4855,43,285
TO,73393,SÃO SALVADOR DO TOCANTINS,1276,304,738,2671,1933,14,166
TO,73407,LAJEADO,876,305,127,1725,1598,18,94
TO,73415,RIO DOS BOIS,885,304,176,1706,1530,22,118
TO,73423,CARRASCO BONITO,1286,675,659,3004,2345,30,241
TO,73431,RIO DA CONCEIÇÃO,737,249,219,1445,1226,8,86
TO,73440,PALMAS,45622,27422,21679,140025,118346,1524,3971
TO,73458,TUPIRAMA,562,294,63,1059,996,3,58
TO,73466,OLIVEIRA DE FÁTIMA,466,276,84,1108,1024,16,52
TO,73474,CHAPADA DE AREIA,558,451,132,1376,1244,21,73
TO,73482,CHAPADA DA NATIVIDADE,1347,416,772,3035,2263,21,233
TO,73504,TALISMÃ,884,282,139,1569,1430,19,125
TO,73512,AGUIARNÓPOLIS,1355,676,560,3313,2753,36,205
TO,73520,LUZINÓPOLIS,984,376,409,2181,1772,22,188
TO,73539,SANTA TEREZINHA DO TOCANTINS,889,484,316,1988,1672,12,97
TO,73547,SANTA RITA DO TOCANTINS,520,453,127,1302,1175,12,83
TO,73555,CRIXÁS DO TOCANTINS,491,264,70,1005,935,7,51
TO,73563,MONTE SANTO DO TOCANTINS,826,412,93,1558,1465,22,97
TO,73571,PUGMIL,855,344,377,1869,1492,10,107
TO,73580,BANDEIRANTES DO TOCANTINS,873,575,167,1996,1829,17,135
TO,73598,IPUEIRAS,585,426,151,1432,1281,15,90
TO,73601,LAVANDEIRA,548,262,193,1363,1170,9,139
TO,73610,BARRA DO OURO,1498,390,760,3234,2474,26,207
TO,92002,BERNARDO SAYÃO,1152,1074,654,3361,2707,31,158
TO,92045,BURITI DO TOCANTINS,2425,1379,1462,6225,4763,52,397
TO,92070,ALMAS,2086,1266,1293,5400,4107,40,390
TO,92088,CASEARA,1520,699,742,3524,2782,24,224
TO,92134,ALVORADA,2878,1217,576,5707,5131,78,389
TO,92142,COMBINADO,1371,656,837,3621,2784,35,228
TO,92185,DIVINÓPOLIS DO TOCANTINS,2181,1064,815,4864,4049,35,289
TO,92193,ANANÁS,3240,1210,1628,7330,5702,66,397
TO,92240,GOIANORTE,1403,1185,482,3750,3268,46,295
TO,92304,MARIANÓPOLIS DO TOCANTINS,1256,615,641,2962,2321,41,189
TO,92371,ARAGUACEMA,2028,701,1017,4479,3462,18,245
TO,92398,ARAGUAÇU,2021,2192,1602,7011,5409,82,416
TO,92401,NOVA ROSALÂNDIA,863,740,436,2522,2086,32,100
TO,92410,ARAGUAÍNA,25890,20604,16369,92255,75886,1114,4018
TO,92436,ARAGUATINS,6411,5084,4287,19232,14945,140,1116
TO,92452,ARAPOEMA,2073,982,973,5099,4126,76,299
TO,92479,ARRAIAS,3475,887,2286,8130,5844,80,686
TO,92487,PEQUIZEIRO,1557,876,814,3851,3037,24,242
TO,92509,PORTO ALEGRE DO TOCANTINS,926,333,500,2122,1622,19,147
TO,92525,PRAIA NORTE,2237,941,1470,5659,4189,46,401
TO,92533,AURORA DO TOCANTINS,1295,614,503,2856,2353,26,214
TO,92541,SAMPAIO,1346,637,520,2926,2406,38,231
TO,92576,AXIXÁ DO TOCANTINS,3261,1792,1460,7943,6483,95,560
TO,92584,SANTA ROSA DO TOCANTINS,1436,891,756,3618,2862,23,274
TO,92592,BABAÇULÂNDIA,2767,1437,1208,6600,5392,68,526
TO,92606,SANTA TEREZA DO TOCANTINS,1190,243,324,2164,1840,18,107
TO,92681,SÃO VALÉRIO DA NATIVIDADE,1850,636,1035,4086,3051,37,299
TO,92738,BREJINHO DE NAZARÉ,1822,710,485,3844,3359,38,262
TO,93114,COLINAS DO TOCANTINS,7524,6575,4535,21664,17129,243,972
TO,93130,CONCEIÇÃO DO TOCANTINS,1322,573,740,3221,2481,17,266
TO,93211,COUTO DE MAGALHÃES,1528,821,441,3127,2686,17,197
TO,93238,CRISTALÂNDIA,2170,1065,1181,5601,4420,58,257
TO,93416,DIANÓPOLIS,4653,2632,2532,12059,9527,110,701
TO,93459,DOIS IRMÃOS DO TOCANTINS,2438,676,1173,5172,3999,50,365
TO,93475,DUERÉ,1263,642,308,2710,2402,28,194
TO,93556,FILADÉLFIA,2395,1403,1384,6558,5174,46,485
TO,93653,FORMOSO DO ARAGUAIA,5527,2944,3379,14103,10724,153,746
TO,93858,GURUPI,17275,12058,9792,52581,42789,803,2310
TO,94056,ITACAJÁ,2186,1340,776,5096,4320,58,410
TO,94099,ITAGUATINS,2046,782,1207,4968,3761,48,370
TO,94170,ITAPORÃ DO TOCANTINS,945,519,235,1978,1743,25,116
TO,94617,MIRACEMA DO TOCANTINS,6741,2026,3022,14795,11773,142,799
TO,94633,MIRANORTE,3835,1975,2174,10094,7920,141,559
TO,94692,MONTE DO CARMO,1863,910,688,4482,3794,28,327
TO,94811,NATIVIDADE,2369,1784,1626,7006,5380,61,454
TO,94838,NAZARÉ,1787,678,677,3846,3169,48,252
TO,94994,NOVO ACORDO,1299,674,426,3092,2666,22,187
TO,95192,PARAÍSO DO TOCANTINS,9183,9361,5082,30193,25111,384,1200
TO,95214,PARANÃ,3692,726,1853,7388,5535,55,699
TO,95257,PEDRO AFONSO,3263,1727,641,6981,6340,88,320
TO,95273,PEIXE,3249,1297,1200,6957,5757,98,480
TO,95290,COLMÉIA,1897,2177,1506,6802,5296,74,409
TO,95338,GOIATINS,3625,1128,1887,7981,6094,44,736
TO,95370,PINDORAMA DO TOCANTINS,1408,899,699,3669,2970,18,251
TO,95478,PIUM,2134,1358,818,5023,4205,24,258
TO,95516,PONTE ALTA DO BOM JESUS,1402,534,411,2905,2494,16,276
TO,95532,PONTE ALTA DO TOCANTINS,2266,831,1037,5092,4055,39,356
TO,95591,PORTO NACIONAL,11774,5838,5431,32110,26679,335,1380
TO,95699,LIZARDA,1477,259,441,2749,2308,32,270
TO,96032,SÃO SEBASTIÃO DO TOCANTINS,1416,436,784,3181,2397,48,208
TO,96130,SÍTIO NOVO DO TOCANTINS,3205,915,1999,7508,5509,64,513
TO,96156,TAGUATINGA,4947,1345,2620,10509,7889,98,805
TO,96199,TOCANTÍNIA,2250,560,879,4523,3644,24,299
TO,96210,TOCANTINÓPOLIS,7741,2001,2946,15293,12347,184,909
TO,96270,GUARAÍ,5772,3708,3083,16481,13398,173,1026
TO,96296,PRESIDENTE KENNEDY,1065,609,242,2338,2096,40,165
TO,96431,XAMBIOÁ,3270,1499,928,7289,6361,88,441
TO,96490,PALMEIRÓPOLIS,2015,1391,756,4965,4209,60,284
TO,96598,SILVANÓPOLIS,1596,962,533,3745,3212,42,267
TO,96636,NOVA OLINDA,2865,1574,1839,7705,5866,84,562
TO,96652,WANDERLÂNDIA,2668,1557,1731,7369,5638,115,476
TO,96679,FIGUEIRÓPOLIS,1753,763,294,3560,3266,48,207
TO,96792,RIO SONO,1968,737,280,3528,3248,24,176
TO,96830,FÁTIMA,1113,767,673,3232,2559,39,149
TO,96857,AUGUSTINÓPOLIS,4515,2608,2262,11431,9169,159,747
TO,96954,ALIANÇA DO TOCANTINS,1999,743,1077,4589,3512,44,215
TO,96970,APARECIDA DO RIO NEGRO,1443,836,497,3436,2939,28,177
TO,96997,BARROLÂNDIA,2238,845,668,4596,3928,66,280