STATE,CD_MUN,NM_MUN,VOTES_INCUMBENT,VOTES_CHALLENGER,QT_ABST,QT_APT,QT_ATTEND,QT_BLANK,QT_NULL
AC,1007,BUJARI,1274,4676,2485,8684,6199,104,145
AC,1015,CAPIXABA,1086,3895,1696,6829,5133,66,86
AC,1023,PORTO ACRE,2059,7150,2787,12323,9536,115,212
AC,1031,SANTA ROSA DO PURUS,975,847,1408,3332,1924,25,77
AC,1040,MARECHAL THAUMATURGO,2451,2548,4337,9541,5204,58,147
AC,1058,BRASILÉIA,3208,8711,3710,16027,12317,142,256
AC,1066,PORTO WALTER,1208,1897,2878,6089,3211,37,69
AC,1074,CRUZEIRO DO SUL,7818,31147,13678,54490,40812,720,1127
AC,1082,RODRIGUES ALVES,1682,4762,4314,11011,6697,108,145
AC,1090,MÂNCIO LIMA,2334,5225,4567,12425,7858,115,184
AC,1104,JORDÃO,1415,1375,1929,4795,2866,14,62
AC,1112,EPITACIOLÂNDIA,2026,6284,2187,10783,8596,120,166
AC,1120,ACRELÂNDIA,1300,5165,2111,8808,6697,65,167
AC,1139,FEIJÓ,5256,6296,8562,20548,11986,149,285
AC,1392,RIO BRANCO,32937,158264,54692,255560,200868,3799,5868
AC,1457,SENA MADUREIRA,3711,12051,12022,28314,16292,222,308
AC,1473,TARAUACÁ,5267,8292,11468,25562,14094,167,368
AC,1490,XAPURI,3400,4929,2762,11399,8637,100,208
AC,1511,PLÁCIDO DE CASTRO,1837,6531,2715,11453,8738,144,226
AC,1538,SENADOR GUIOMARD,2452,10247,3873,17102,13229,225,305
AC,1554,MANOEL URBANO,1621,2274,2690,6788,4098,57,146
AC,1570,ASSIS BRASIL,1660,2333,1590,5727,4137,42,102
AL,27006,PARIPUEIRA,3164,3554,2118,9425,7307,141,448
AL,27014,ÁGUA BRANCA,9520,812,4120,14874,10754,64,358
AL,27022,PARICONHA,5777,374,1851,8279,6428,48,229
AL,27030,ANADIA,6182,1711,4147,12605,8458,95,470
AL,27049,ESTRELA DE ALAGOAS,6783,851,3557,11618,8061,60,367
AL,27057,ARAPIRACA,56755,48375,27404,140980,113576,1949,6497
AL,27065,JEQUIÁ DA PRAIA,2639,2184,2117,7262,5145,60,262
AL,27073,ATALAIA,13524,6287,9040,30366,21326,380,1135
AL,27081,CAMPESTRE,2594,745,1633,5250,3617,69,209
AL,27090,BARRA DE SANTO ANTÔNIO,4923,2893,3042,11459,8417,121,480
AL,27111,BARRA DE SÃO MIGUEL,2346,2400,1375,6466,5091,78,267
AL,27138,BATALHA,6261,2072,3360,12164,8804,93,378
AL,27154,BELÉM,2511,684,1373,4793,3420,68,157
AL,27170,BELO MONTE,2928,486,1535,5133,3598,38,146
AL,27197,BOCA DA MATA,7788,4521,6165,19523,13358,227,822
AL,27219,BRANQUINHA,3756,1160,2826,8059,5233,74,243
AL,27235,CACIMBINHAS,4166,1125,2439,8026,5587,51,245
AL,27251,CAJUEIRO,6380,2652,4549,14264,9715,138,545
AL,27278,CAMPO ALEGRE,11526,4239,7027,23922,16895,233,897
AL,27294,CAMPO GRANDE,5022,843,2053,8142,6089,44,180
AL,27316,CANAPI,7618,905,4196,13116,8920,70,327
AL,27332,CAPELA,5192,3222,3825,12857,9032,110,508
AL,27359,CARNEIROS,3873,547,1692,6341,4649,27,202
AL,27375,CHÃ PRETA,2994,788,1785,5861,4076,38,256
AL,27391,COITÉ DO NÓIA,5010,964,2045,8375,6330,63,293
AL,27413,COLÔNIA LEOPOLDINA,5582,3559,5041,14943,9902,118,643
AL,27430,COQUEIRO SECO,2016,1265,936,4546,3610,76,253
AL,27456,CORURIPE,11098,13819,10777,38397,27620,464,2239
AL,27472,DELMIRO GOUVEIA,22523,4009,9253,37050,27797,200,1065
AL,27499,DOIS RIACHOS,4444,1072,2729,8521,5792,53,223
AL,27510,FEIRA GRANDE,10412,2144,3598,16907,13309,150,603
AL,27537,FELIZ DESERTO,1417,689,1159,3415,2256,23,127
AL,27553,FLEXEIRAS,2780,2526,2698,8467,5769,79,384
AL,27570,GIRAU DO PONCIANO,15898,2338,6459,25532,19073,174,663
AL,27596,IBATEGUARA,4865,2464,2769,10720,7951,109,513
AL,27618,IGACI,11111,1901,5546,19257,13711,146,553
AL,27634,IGREJA NOVA,9410,2427,4170,16755,12585,162,586
AL,27650,INHAPI,7102,918,3833,12297,8464,92,352
AL,27677,JACARÉ DOS HOMENS,2981,434,1236,4764,3528,22,91
AL,27693,JACUÍPE,2736,715,1714,5386,3672,35,186
AL,27715,JAPARATINGA,2066,1962,1904,6320,4416,82,306
AL,27731,JARAMATAIA,2806,462,1163,4635,3472,32,172
AL,27758,JOAQUIM GOMES,6950,2138,3752,13422,9670,108,474
AL,27774,JUNDIÁ,1547,855,1595,4184,2589,24,163
AL,27790,JUNQUEIRO,8973,3609,5505,18954,13449,191,676
AL,27812,LAGOA DA CANOA,8222,2297,3028,14186,11158,168,471
AL,27839,LIMOEIRO DE ANADIA,9971,2362,4568,17622,13054,160,561
AL,27855,MACEIÓ,166838,268027,115939,595686,479747,9995,34887
AL,27871,MAJOR ISIDORO,7264,2379,4217,14389,10172,88,441
AL,27898,MARAGOGI,6265,7462,4941,19880,14939,258,954
AL,27910,MARAVILHA,4341,810,2348,7794,5446,47,248
AL,27936,MARECHAL DEODORO,10713,14007,9305,35888,26583,395,1468
AL,27952,MARIBONDO,4667,2017,2950,10238,7288,118,486
AL,27979,MAR VERMELHO,1788,563,844,3327,2483,22,110
AL,27995,MATA GRANDE,9558,1537,5134,16830,11696,109,492
AL,28010,MATRIZ DE CAMARAGIBE,6213,5879,5506,18625,13119,233,794
AL,28037,MESSIAS,5415,3367,3318,12673,9355,153,420
AL,28053,MINADOR DO NEGRÃO,2607,591,1196,4606,3410,30,182
AL,28070,MONTEIRÓPOLIS,3247,574,1703,5736,4033,29,183
AL,28096,MURICI,7965,4584,5676,19155,13479,268,662
AL,28118,NOVO LINO,3108,2233,3642,9457,5815,100,374
AL,28134,OLHO D ÁGUA DAS FLORES,7149,3090,3964,14842,10878,100,539
AL,28150,OLHO D ÁGUA DO CASADO,4494,319,1804,6830,5026,32,181
AL,28177,OLHO D ÁGUA GRANDE,2687,374,1256,4456,3200,30,109
AL,28193,OLIVENÇA,5134,1002,2338,8821,6483,43,304
AL,28215,OURO BRANCO,5156,828,1927,8198,6271,48,239
AL,28231,PALESTINA,2291,428,1451,4301,2850,25,106
AL,28258,PALMEIRA DOS ÍNDIOS,23153,11083,13282,50143,36861,462,2163
AL,28274,PÃO DE AÇÚCAR,9356,2301,5713,17968,12255,123,475
AL,28290,PASSO DE CAMARAGIBE,4712,2470,3376,11197,7821,107,532
AL,28312,PAULO JACINTO,2868,1086,1744,6040,4296,49,293
AL,28339,PENEDO,17029,9490,12598,40797,28199,392,1288
AL,28355,PIAÇABUÇU,6070,2306,4109,13052,8943,88,479
AL,28371,PILAR,9463,8313,6395,25632,19237,366,1095
AL,28398,PINDOBA,1210,475,685,2482,1797,21,91
AL,28410,PIRANHAS,11252,1250,4656,17746,13090,72,516
AL,28436,POÇO DAS TRINCHEIRAS,6226,625,2606,9791,7185,45,289
AL,28452,PORTO CALVO,5982,5950,7014,20084,13070,236,902
AL,28479,PORTO DE PEDRAS,2367,1683,2178,6559,4381,70,261
AL,28495,PORTO REAL DO COLÉGIO,8966,1759,3553,14805,11252,114,413
AL,28517,QUEBRANGULO,5053,1429,2882,9791,6909,78,349
AL,28533,RIO LARGO,19803,19583,11544,54489,42945,941,2618
AL,28550,ROTEIRO,2183,1102,1448,4997,3549,42,222
AL,28576,SANTA LUZIA DO NORTE,2586,1635,1203,5781,4578,79,278
AL,28592,SANTANA DO IPANEMA,17425,4678,7362,30728,23366,176,1087
AL,28614,SANTANA DO MUNDAÚ,4729,1105,2163,8343,6180,58,288
AL,28630,SÃO BRÁS,3103,879,1671,5903,4232,65,185
AL,28657,SÃO JOSÉ DA LAJE,7192,4203,4374,16682,12308,194,719
AL,28673,SÃO JOSÉ DA TAPERA,12282,1826,5516,20485,14969,125,736
AL,28690,SÃO LUÍS DO QUITUNDE,8142,5877,6673,21861,15188,260,909
AL,28711,SÃO MIGUEL DOS CAMPOS,13156,13765,9353,38978,29625,552,2152
AL,28738,SÃO MIGUEL DOS MILAGRES,2093,2021,1951,6444,4493,83,296
AL,28754,SÃO SEBASTIÃO,13577,3483,6310,24353,18043,252,731
AL,28770,SATUBA,3531,3681,2014,9870,7856,169,475
AL,28797,TANQUE D ARCA,2987,504,1534,5223,3689,49,149
AL,28819,TAQUARANA,7341,1986,3321,13434,10113,155,631
AL,28835,TRAIPU,9658,1508,5386,17184,11798,112,520
AL,28851,UNIÃO DOS PALMARES,19928,9943,12137,44381,32244,487,1886
AL,28878,VIÇOSA,8972,4105,5557,19633,14076,205,794
AL,28894,CRAÍBAS,11200,2099,3736,17775,14039,156,584
AL,28916,SENADOR RUI PALMEIRA,5287,776,2442,8828,6386,50,273
AL,28932,TEOTÔNIO VILELA,12110,6684,8624,29104,20480,356,1330
AM,2003,APUÍ,3046,3218,3947,10664,6717,91,362
AM,2011,NOVO AIRÃO,4289,3033,2441,10330,7889,68,499
AM,2020,GUAJARÁ,2782,2836,3401,9521,6120,88,414
AM,2038,ANORI,3681,2253,3388,9719,6331,64,333
AM,2046,CAREIRO DA VÁRZEA,7239,2795,4532,15290,10758,117,607
AM,2054,ATALAIA DO NORTE,4020,851,2756,7920,5164,27,266
AM,2070,AUTAZES,12407,4509,7230,25316,18086,153,1017
AM,2097,BARCELOS,3608,1913,4595,10492,5897,58,318
AM,2119,BARREIRINHA,11611,1036,4978,18308,13330,75,608
AM,2135,BENJAMIN CONSTANT,12275,2026,5205,20445,15240,94,845
AM,2151,BOCA DO ACRE,6782,6129,6759,20963,14204,202,1091
AM,2178,BORBA,10727,2238,6546,20293,13747,86,696
AM,2194,CANUTAMA,3359,1691,2948,8361,5413,51,312
AM,2216,CARAUARI,9617,2370,6565,19308,12743,147,609
AM,2232,CAREIRO,9464,4160,6273,21035,14762,168,970
AM,2259,COARI,21399,9690,16765,50269,33504,342,2073
AM,2275,CODAJÁS,5455,3044,5462,14420,8958,51,408
AM,2291,EIRUNEPÉ,8836,3137,7620,20738,13118,175,970
AM,2313,ENVIRA,4870,1405,4569,11439,6870,126,469
AM,2330,FONTE BOA,7837,1645,4832,14872,10040,73,485
AM,2356,HUMAITÁ,10398,7609,9371,28551,19180,201,972
AM,2372,SANTA ISABEL DO RIO NEGRO,2637,1430,3622,7951,4329,28,234
AM,2399,IPIXUNA,5055,1312,3783,10761,6978,108,503
AM,2410,ITACOATIARA,29226,15412,18715,66337,47622,507,2477
AM,2437,ITAPIRANGA,2843,1831,2323,7230,4907,46,187
AM,2453,JAPURÁ,1912,648,1678,4395,2717,32,125
AM,2470,JURUÁ,2829,1185,2677,7120,4443,54,375
AM,2496,JUTAÍ,6049,1373,4336,12386,8050,65,563
AM,2518,LÁBREA,11291,3633,8215,24275,16060,152,984
AM,2534,MANACAPURU,27255,17778,17741,66242,48501,553,2915
AM,2550,MANAUS,358364,686999,177157,1321445,1144288,22114,76811
AM,2577,MANICORÉ,12543,5016,9449,27973,18524,149,816
AM,2593,MARAÃ,4114,835,4364,9607,5243,28,266
AM,2615,MAUÉS,16543,3080,10300,30936,20636,123,890
AM,2631,NHAMUNDÁ,7447,1280,3984,13060,9076,41,308
AM,2658,NOVA OLINDA DO NORTE,8303,2016,5806,16898,11092,120,653
AM,2674,NOVO ARIPUANÃ,5923,1383,4527,12333,7806,66,434
AM,2690,PARINTINS,38970,8266,18486,68206,49720,492,1992
AM,2712,PAUINI,4437,1593,3746,10219,6473,40,403
AM,2739,SANTO ANTÔNIO DO IÇÁ,7998,1662,3520,13906,10386,72,654
AM,2755,SÃO PAULO DE OLIVENÇA,10907,1535,3572,16914,13342,96,804
AM,2771,SILVES,3966,784,2174,7167,4993,23,220
AM,2798,TAPAUÁ,5288,2457,4524,12718,8194,73,376
AM,2810,TEFÉ,18878,8159,12127,40979,28852,284,1531
AM,2836,SÃO GABRIEL DA CACHOEIRA,13369,3864,11140,29140,18000,89,678
AM,2852,URUCARÁ,5785,1547,3854,11573,7719,69,318
AM,2879,URUCURITUBA,6256,1466,4162,12201,8039,59,258
AM,2895,ALVARÃES,5295,1380,2727,9758,7031,37,319
AM,2917,AMATURÁ,3400,846,1296,5909,4613,32,335
AM,2933,ANAMÃ,4077,1771,1261,7457,6196,51,297
AM,2950,BERURI,5670,1831,3769,11752,7983,72,410
AM,2976,BOA VISTA DO RAMOS,6666,808,3011,10834,7823,48,301
AM,2992,CAAPIRANGA,3449,1387,2979,8146,5167,35,296
AM,98353,IRANDUBA,14447,8757,5428,30595,25167,304,1659
AM,98370,ITAMARATI,3497,691,2192,6701,4509,51,270
AM,98396,MANAQUIRI,6076,1744,4693,13161,8468,98,550
AM,98418,PRESIDENTE FIGUEIREDO,8669,6337,6594,22755,16161,206,949
AM,98434,RIO PRETO DA EVA,5368,4751,4225,15133,10908,113,676
AM,98450,SÃO SEBASTIÃO DO UATUMÃ,2430,1803,2066,6637,4571,65,273
AM,98477,TABATINGA,15809,7061,8471,33188,24717,227,1620
AM,98493,UARINI,3692,1089,2226,7347,5121,46,294
AM,98515,TONANTINS,5410,1013,2439,9222,6783,28,332
AP,6009,PRACUÚBA,1438,747,983,3280,2297,21,91
AP,6017,AMAPÁ,2610,1423,1823,6064,4241,34,174
AP,6025,PORTO GRANDE,5250,3681,3962,13494,9532,118,483
AP,6033,CALÇOENE,3140,1671,2454,7569,5115,47,257
AP,6041,ITAUBAL,2530,1250,1658,5638,3980,42,158
AP,6050,MACAPÁ,98083,120603,58169,293287,235118,4433,11999
AP,6068,CUTIAS,1961,800,1360,4251,2891,19,111
AP,6076,MAZAGÃO,7628,3361,3543,15089,11546,111,446
AP,6084,PEDRA BRANCA DO AMAPARI,3317,2234,2928,8857,5929,53,325
AP,6092,OIAPOQUE,7335,3589,7704,19378,11674,133,617
AP,6106,SERRA DO NAVIO,1240,1196,999,3596,2597,30,131
AP,6114,FERREIRA GOMES,2143,1659,2661,6724,4063,51,210
AP,6122,VITÓRIA DO JARI,4565,1704,3050,9722,6672,68,335
AP,6130,LARANJAL DO JARI,11044,7703,8680,28728,20048,235,1066
AP,6157,SANTANA,27662,31383,14355,77418,63063,1131,2887
AP,6173,TARTARUGALZINHO,3670,2092,2849,9022,6173,63,348
BA,30007,LUÍS EDUARDO MAGALHÃES,15773,22509,12516,53071,40555,545,1728
BA,30058,EUNÁPOLIS,29184,28502,13480,76019,62539,818,4035
BA,30660,IUIU,4823,946,2274,8397,6123,97,257
BA,30678,JABORANDI,4627,1252,1892,8163,6271,72,320
BA,30694,JUSSARI,1898,1102,1732,4900,3168,39,129
BA,30716,AMÉRICA DOURADA,7472,1037,3884,12782,8898,68,321
BA,30732,ARATACA,3076,1152,1442,5916,4474,41,205
BA,30759,BARRO ALTO,5893,1091,2280,9808,7528,82,462
BA,30775,BARROCAS,8478,1420,2055,12565,10510,79,533
BA,30791,BURITIRAMA,8175,1958,4338,14949,10611,86,392
BA,30813,CAPELA DO ALTO ALEGRE,4610,1478,2572,9266,6694,116,490
BA,30830,CAPIM GROSSO,10375,4900,5909,22612,16703,218,1210
BA,30856,CANUDOS,7222,1142,3514,12341,8827,57,406
BA,30872,DIAS D ÁVILA,26227,8750,9966,48594,38628,624,3027
BA,30899,FÁTIMA,9416,1204,3948,15096,11148,102,426
BA,30910,FILADÉLFIA,7417,1959,4240,14327,10087,157,554
BA,30937,GAVIÃO,2108,785,1204,4312,3108,39,176
BA,30953,GUAJERU,3851,560,2795,7452,4657,57,189
BA,30970,HELIÓPOLIS,7429,913,1795,10476,8681,92,247
BA,30996,JOÃO DOURADO,8736,3697,4694,17869,13175,125,617
BA,33014,ABAÍRA,2694,1742,1926,6907,4981,88,457
BA,33030,ABARÉ,7453,2077,2642,12723,10081,107,444
BA,33057,ACAJUTIBA,5944,1476,3127,11134,8007,119,468
BA,33065,ADUSTINA,7361,1188,2108,11110,9002,105,348
BA,33073,ÁGUA FRIA,6496,1241,3491,12001,8510,94,679
BA,33090,ÉRICO CARDOSO,4018,1128,3320,8918,5598,95,357
BA,33111,AIQUARA,2096,475,987,3788,2801,45,185
BA,33138,ALAGOINHAS,51668,24844,17310,103301,85991,1503,7976
BA,33154,ALCOBAÇA,7839,2487,5949,17002,11053,115,612
BA,33170,ALMADINA,2527,628,1678,5027,3349,50,144
BA,33197,AMARGOSA,12470,6203,6161,26503,20342,275,1394
BA,33219,AMÉLIA RODRIGUES,10510,2568,3893,18138,14245,186,981
BA,33235,ANAGÉ,9762,2543,5164,18350,13186,149,732
BA,33251,ANDARAÍ,6057,867,3238,10607,7369,56,389
BA,33260,ANDORINHA,8339,717,2137,11611,9474,86,332
BA,33278,ANGICAL,7552,1628,2777,12402,9625,66,379
BA,33294,ANGUERA,5502,883,2093,8827,6734,65,284
BA,33316,ANTAS,5717,1445,2984,10609,7625,61,402
BA,33332,ANTÔNIO CARDOSO,7844,931,1519,10723,9204,80,349
BA,33359,ANTÔNIO GONÇALVES,4445,1308,2073,8193,6120,61,306
BA,33375,APORÁ,6763,1643,4077,13231,9154,113,635
BA,33383,ARAÇÁS,5945,1237,1562,9200,7638,86,370
BA,33391,ARACATU,7154,1704,1625,10998,9373,105,410
BA,33405,APUAREMA,3019,921,884,5177,4293,49,304
BA,33413,ARACI,22617,3290,12612,39973,27361,211,1243
BA,33430,ARAMARI,5643,797,1591,8561,6970,111,419
BA,33456,ARATUÍPE,4635,827,1993,7851,5858,81,315
BA,33472,AURELINO LEAL,5154,1270,2424,9263,6839,54,361
BA,33499,BAIANÓPOLIS,6478,1804,2821,11582,8761,102,377
BA,33510,BAIXA GRANDE,7344,2551,4609,15507,10898,182,821
BA,33529,BANZAÊ,5815,1531,1453,9194,7741,80,315
BA,33537,BARRA,20502,3628,10359,35717,25358,216,1012
BA,33553,BARRA DA ESTIVA,10421,3149,4088,18848,14760,190,1000
BA,33570,BARRA DO CHOÇA,15363,3762,7590,28285,20695,237,1333
BA,33596,BARRA DO MENDES,7691,779,3426,12316,8890,66,354
BA,33618,BARRA DO ROCHA,1901,657,1120,3876,2756,28,170
BA,33634,BARREIRAS,43898,29915,13529,92196,78667,981,3873
BA,33650,BARRO PRETO,2715,1096,1696,5835,4139,57,271
BA,33677,BELMONTE,7351,2713,4484,15266,10782,103,615
BA,33693,BELO CAMPO,7092,2443,4737,14890,10153,133,485
BA,33715,BIRITINGA,8405,877,1765,11672,9907,82,543
BA,33731,BOA NOVA,6603,889,4962,13013,8051,81,478
BA,33758,BOA VISTA DO TUPIM,6496,2315,3709,13314,9605,121,673
BA,33774,BOM JESUS DA LAPA,24779,6165,12643,45576,32933,365,1624
BA,33782,BOM JESUS DA SERRA,4964,534,3168,9004,5836,59,279
BA,33790,BONINAL,5100,1598,3119,10430,7311,99,514
BA,33804,BONITO,7245,1225,3166,12232,9066,100,496
BA,33812,BOQUIRA,10054,873,4600,16090,11490,75,488
BA,33839,BOTUPORÃ,5404,956,3000,9722,6722,73,289
BA,33855,BREJÕES,5247,1550,3718,11041,7323,107,419
BA,33871,BREJOLÂNDIA,3924,1221,2499,7979,5480,110,225
BA,33898,BROTAS DE MACAÚBAS,4502,1613,2416,9013,6597,71,411
BA,33910,BRUMADO,25911,12294,6411,47703,41292,458,2629
BA,33936,BUERAREMA,3803,4698,2973,12208,9235,126,608
BA,33952,CAATIBA,3030,1521,2981,7906,4925,35,339
BA,33960,CABACEIRAS DO PARAGUAÇU,7782,1214,2367,11942,9575,80,499
BA,33979,CACHOEIRA,14904,2874,6177,25102,18925,227,920
BA,33995,CACULÉ,8317,3692,3786,16781,12995,210,776
BA,34010,CAEM,4839,695,1409,7318,5909,48,327
BA,34029,CAETANOS,5974,573,2831,9651,6820,42,231
BA,34037,CAETITÉ,23063,6006,8226,39472,31246,342,1835
BA,34053,CAFARNAUM,7181,2123,3426,13393,9967,139,524
BA,34070,CAIRU,6230,2661,2792,12536,9744,125,728
BA,34096,CALDEIRÃO GRANDE,5852,774,2681,9704,7023,70,327
BA,34118,CAMACÃ,7323,4265,5206,17791,12585,173,824
BA,34134,CAMAÇARI,84052,45483,20367,165476,145109,2432,13142
BA,34150,CAMAMU,9733,5178,8360,24811,16451,263,1277
BA,34177,CAMPO ALEGRE DE LOURDES,13064,1542,6884,22084,15200,97,497
BA,34193,CAMPO FORMOSO,28718,8852,12835,52911,40076,512,1994
BA,34215,CANÁPOLIS,4796,1057,2120,8329,6209,58,298
BA,34231,CANARANA,10898,2149,4197,18128,13931,128,756
BA,34258,CANAVIEIRAS,10644,5176,5961,23027,17066,197,1049
BA,34274,CANDEAL,4392,1028,1443,7209,5766,51,295
BA,34290,CANDEIAS,39448,7101,11724,62359,50635,710,3376
BA,34312,CANDIBA,6489,1632,1617,10413,8796,106,569
BA,34339,CÂNDIDO SALES,10012,2888,4310,18046,13736,127,709
BA,34355,CANSANÇÃO,16747,1971,7457,27043,19586,185,683
BA,34363,CARAÍBAS,4323,1167,2523,8363,5840,56,294
BA,34371,CARAVELAS,6443,2690,4099,13935,9836,106,597
BA,34398,CARDEAL DA SILVA,4410,448,2057,7300,5243,63,322
BA,34410,CARINHANHA,10147,4264,6258,21550,15292,167,714
BA,34436,CASA NOVA,32131,6359,10923,51722,40799,293,2016
BA,34452,CASTRO ALVES,13090,2156,6099,22331,16232,141,845
BA,34479,CATOLÂNDIA,2118,511,759,3512,2753,27,97
BA,34495,CATU,22901,5989,7721,40277,32556,643,3023
BA,34509,CATURAMA,4403,673,2184,7561,5377,62,239
BA,34517,CENTRAL,7630,1808,3133,13136,10003,128,437
BA,34533,CHORROCHÓ,5341,798,2524,8942,6418,47,232
BA,34550,CÍCERO DANTAS,14002,3724,6379,25285,18906,258,922
BA,34576,CIPÓ,6361,2402,3812,13387,9575,138,674
BA,34592,COARACI,7163,3523,5098,16743,11645,188,771
BA,34614,COCOS,7742,3180,3134,14596,11462,119,421
BA,34630,CONCEIÇÃO DA FEIRA,9922,2533,2965,16647,13682,204,1023
BA,34657,CONCEIÇÃO DO ALMEIDA,8718,1608,3489,14380,10891,93,472
BA,34673,CONCEIÇÃO DO COITÉ,24197,13094,10418,50854,40436,480,2665
BA,34690,CONCEIÇÃO DO JACUÍPE,12952,4475,4598,23828,19230,239,1564
BA,34711,CONDE,9353,2235,4927,17296,12369,117,664
BA,34738,CONDEÚBA,6823,2788,4837,15351,10514,134,769
BA,34754,CONTENDAS DO SINCORÁ,2099,541,941,3789,2848,29,179
BA,34770,CORAÇÃO DE MARIA,12511,2490,4859,20987,16128,157,970
BA,34797,CORDEIROS,2914,1552,2127,6987,4860,73,321
BA,34819,CORIBE,6538,1784,3004,11775,8771,94,355
BA,34835,CORONEL JOÃO SÁ,8211,1130,1746,11529,9783,77,365
BA,34851,CORRENTINA,13658,3753,7661,26346,18685,207,1067
BA,34878,COTEGIPE,6312,1259,3356,11201,7845,52,222
BA,34894,CRAVOLÂNDIA,2251,416,1305,4238,2933,46,220
BA,34916,CRISÓPOLIS,9384,1515,5378,16837,11459,106,454
BA,34932,CRISTÓPOLIS,6381,1712,3162,11802,8640,106,441
BA,34959,CRUZ DAS ALMAS,25147,10681,5148,44024,38876,553,2495
BA,34975,CURAÇÁ,15160,2484,6358,25070,18712,211,857
BA,34991,DÁRIO MEIRA,4273,865,1977,7550,5573,67,368
BA,35017,DOM BASÍLIO,6708,805,1863,9808,7945,96,336
BA,35033,DOM MACEDO COSTA,2162,738,751,3891,3140,26,214
BA,35050,ELÍSIO MEDRADO,3684,980,2393,7471,5078,76,338
BA,35076,ENCRUZILHADA,7657,2368,3628,14396,10768,119,624
BA,35092,ENTRE RIOS,16995,3797,9171,31961,22790,325,1673
BA,35114,ESPLANADA,13746,3320,6360,24817,18457,242,1149
BA,35130,EUCLIDES DA CUNHA,25434,4674,10988,42701,31713,276,1329
BA,35149,FEIRA DA MATA,2192,1145,1513,4994,3481,36,108
BA,35157,FEIRA DE SANTANA,194826,115156,41567,384150,342583,4628,27973
BA,35173,FIRMINO ALVES,2258,836,1484,4813,3329,39,196
BA,35190,FLORESTA AZUL,3691,1253,2229,7590,5361,68,349
BA,35211,FORMOSA DO RIO PRETO,8943,3281,5436,18304,12868,132,512
BA,35238,GANDU,9436,5526,5349,21701,16352,218,1172
BA,35254,GENTIO DO OURO,5661,1020,2031,8957,6926,48,197
BA,35270,GLÓRIA,8662,894,2823,12803,9980,65,359
BA,35297,GONGOGI,2629,505,1594,4951,3357,37,186
BA,35319,GOVERNADOR MANGABEIRA,9480,2490,3039,15831,12792,168,654
BA,35335,GUANAMBI,32336,15405,8660,60318,51658,709,3208
BA,35351,GUARATINGA,7054,2484,4563,14868,10305,113,654
BA,35378,IAÇU,11236,2169,7752,22072,14320,152,763
BA,35394,IBIASSUCÊ,4198,1813,2339,8780,6441,84,346
BA,35416,IBICARAÍ,7615,4587,5340,18502,13162,182,778
BA,35432,IBICOARA,6576,2544,3091,13141,10050,133,797
BA,35459,IBICUÍ,5354,1773,3317,10975,7658,89,442
BA,35475,IBIPEBA,8410,1122,3286,13372,10086,84,470
BA,35491,SANTA RITA DE CÁSSIA,11482,2968,7077,22467,15390,228,712
BA,35513,IBIPITANGA,6328,1711,4184,12695,8511,61,411
BA,35530,IBIQUERA,1777,268,1217,3413,2196,29,122
BA,35556,IBIRAPITANGA,7291,2236,2294,12646,10352,132,693
BA,35572,IBIRAPUÃ,2475,2191,1851,6787,4936,49,221
BA,35599,IBIRATAIA,6796,3264,3532,14534,11002,156,786
BA,35610,IBITIARA,5962,2019,1856,10478,8622,98,543
BA,35637,IBITITÁ,9149,1371,3222,14216,10994,92,382
BA,35653,IBOTIRAMA,9651,4085,5191,19649,14458,150,572
BA,35670,ICHU,3265,773,917,5260,4343,44,261
BA,35696,IGAPORÃ,7844,997,2283,11645,9362,94,427
BA,35700,IGRAPIÚNA,4674,1250,3387,9856,6469,131,414
BA,35718,IGUAÍ,8184,3490,7108,19686,12578,127,777
BA,35734,ILHÉUS,54505,35315,17961,116801,98840,1358,7662
BA,35750,INHAMBUPE,14299,3496,6536,25858,19322,271,1256
BA,35777,IPECAETÁ,8417,1435,2790,13246,10456,76,528
BA,35793,IPIAÚ,14489,6627,6755,29850,23095,293,1686
BA,35815,IPIRÁ,26759,5709,8147,43561,35414,360,2586
BA,35831,IPUPIARA,4059,1511,1882,7808,5926,88,268
BA,35858,IRAJUBA,3055,618,1112,5048,3936,52,211
BA,35874,IRAMAIA,4202,1138,2950,8692,5742,64,338
BA,35890,IRAQUARA,11729,968,3370,16625,13255,96,462
BA,35912,IRARÁ,13492,2698,6093,23478,17385,171,1024
BA,35939,IRECÊ,25824,9137,6496,44016,37520,488,2071
BA,35947,ITABELA,9637,4654,6996,22433,15437,213,933
BA,35955,ITABERABA,22358,7473,9582,42308,32726,416,2479
BA,35971,ITABUNA,53396,50668,40459,154454,113995,1768,8163
BA,35998,ITACARÉ,7618,2371,4410,15124,10714,137,588
BA,36013,ITAETÉ,5405,1679,3200,10710,7510,68,358
BA,36030,ITAGI,4868,1875,2166,9543,7377,99,535
BA,36056,ITAGIBÁ,5367,2136,2907,11037,8130,91,536
BA,36072,ITAGIMIRIM,2603,1372,1412,5694,4282,40,267
BA,36080,ITAGUAÇU DA BAHIA,6050,736,2608,9653,7045,47,212
BA,36099,ITAJU DO COLÔNIA,1767,1398,1732,5102,3370,29,176
BA,36110,ITAJUÍPE,7686,3474,4942,16980,12038,126,752
BA,36137,ITAMARAJU,16393,13312,12377,44305,31928,488,1735
BA,36153,ITAMARI,2957,1097,2004,6435,4431,46,331
BA,36170,ITAMBÉ,8003,3317,6135,18231,12096,130,646
BA,36196,ITANAGRA,3217,491,1664,5587,3923,35,180
BA,36218,ITANHÉM,6182,3911,5019,15903,10884,121,670
BA,36234,ITAPARICA,10223,2363,3001,16591,13590,112,892
BA,36250,ITAPÉ,4073,1998,2986,9542,6556,67,418
BA,36277,ITAPEBI,4032,1247,1758,7368,5610,49,282
BA,36293,ITAPETINGA,14784,17138,11860,46517,34657,488,2247
BA,36315,ITAPICURU,13503,1549,7223,23265,16042,171,819
BA,36331,ITAPITANGA,2870,1011,2439,6580,4141,46,214
BA,36358,ITAQUARA,3274,1122,1432,6169,4737,62,279
BA,36374,ITARANTIM,5406,3656,4402,14163,9761,131,568
BA,36382,ITATIM,5934,2019,2878,11572,8694,145,596
BA,36390,ITIRUÇU,4337,1622,2757,9312,6555,89,507
BA,36412,ITIÚBA,13970,4548,9357,29237,19880,282,1080
BA,36439,ITORORÓ,6523,3620,5401,16480,11079,122,814
BA,36455,ITUAÇU,7430,3045,3106,14596,11490,178,837
BA,36471,ITUBERÁ,8178,3786,6165,19251,13086,198,924
BA,36498,JACARACI,6223,1581,3622,11999,8377,105,468
BA,36510,JACOBINA,31586,9815,8837,53582,44745,555,2789
BA,36536,JAGUAQUARA,15962,6871,7028,32595,25567,393,2341
BA,36552,JAGUARARI,12539,3532,4808,22096,17288,275,942
BA,36579,JAGUARIPE,8024,1221,3034,13039,10005,184,576
BA,36595,JANDAÍRA,4441,755,2718,8247,5529,51,282
BA,36617,JEQUIÉ,54000,27012,15249,105233,89984,1233,7739
BA,36633,JEREMOABO,16180,2675,6902,26737,19835,181,799
BA,36650,JIQUIRIÇÁ,5522,1469,3059,10690,7631,141,499
BA,36676,JITAÚNA,5783,1969,2541,11096,8555,128,675
BA,36692,JUAZEIRO,79982,34740,17986,140552,122566,1465,6379
BA,36706,JUCURUÇU,3875,1190,2542,7959,5417,71,281
BA,36714,JUSSARA,7998,592,3122,12138,9016,77,349
BA,36730,JUSSIAPE,3387,1016,1834,6673,4839,87,349
BA,36757,LAFAIETE COUTINHO,2359,391,573,3530,2957,26,181
BA,36765,LAGOA REAL,6647,792,2646,10476,7830,51,340
BA,36773,LAJE,9992,3294,4576,19040,14464,176,1002
BA,36790,LAJEDÃO,1733,1186,1753,4816,3063,36,108
BA,36811,LAJEDINHO,1938,309,850,3234,2384,13,124
BA,36820,LAJEDO DO TABOCAL,3455,754,1659,6216,4557,53,295
BA,36838,LAMARÃO,4325,487,2782,7888,5106,38,256
BA,36854,LAURO DE FREITAS,62336,32596,24902,129240,104338,1605,7801
BA,36870,LENÇÓIS,4376,694,2214,7600,5386,40,276
BA,36897,LICÍNIO DE ALMEIDA,5119,1643,2024,9270,7246,130,354
BA,36919,LIVRAMENTO DE NOSSA SENHORA,19346,4674,8037,33560,25523,323,1180
BA,36935,MACAJUBA,4457,1319,3506,9772,6266,73,417
BA,36951,MACARANI,5177,3179,4504,13742,9238,159,723
BA,36978,MACAÚBAS,17824,3933,10571,33778,23207,234,1216
BA,36994,MACURURÉ,3676,559,2078,6533,4455,34,186
BA,37010,MAIQUINIQUE,2914,1848,2118,7287,5169,61,346
BA,37036,MAIRI,7235,1864,4495,14353,9858,116,643
BA,37052,MALHADA,6556,2121,3833,13033,9200,138,385
BA,37079,MALHADA DE PEDRAS,4028,1283,1105,6724,5619,63,245
BA,37095,MANOEL VITORINO,7455,1203,2456,11617,9161,84,419
BA,37117,MARACÁS,10867,2804,6585,21452,14867,200,996
BA,37133,MARAGOGIPE,19520,3915,7857,32559,24702,231,1036
BA,37150,MARAÚ,6695,1436,4131,12939,8808,123,554
BA,37176,MARCIONÍLIO SOUZA,4191,793,2382,7696,5314,58,272
BA,37192,MASCOTE,4133,1457,3062,9024,5962,53,319
BA,37214,MATA DE SÃO JOÃO,21916,6152,8721,39629,30908,506,2334
BA,37222,MATINA,5915,529,2189,8983,6794,49,301
BA,37230,MEDEIROS NETO,7044,4883,5490,18432,12942,172,843
BA,37257,MIGUEL CALMON,10224,3564,6712,21528,14816,153,875
BA,37273,MILAGRES,4573,1267,2415,8657,6242,45,357
BA,37290,MIRANGABA,6851,1338,1946,10732,8786,77,520
BA,37303,MIRANTE,4000,842,2400,7532,5132,69,221
BA,37311,MONTE SANTO,25788,2546,13320,43108,29788,278,1176
BA,37338,MORPARÁ,3584,1298,2084,7213,5129,58,189
BA,37354,MORRO DO CHAPÉU,13763,3146,5926,24019,18093,196,988
BA,37370,MORTUGABA,3645,2549,2872,9524,6652,77,381
BA,37397,MUCUGÊ,4574,1575,2081,8857,6776,80,547
BA,37419,MUCURI,9901,6847,9823,27864,18041,275,1018
BA,37427,MULUNGU DO MORRO,6686,707,2700,10532,7832,76,363
BA,37435,MUNDO NOVO,8149,1637,4985,15493,10508,115,607
BA,37451,MUNIZ FERREIRA,4375,1104,1133,6932,5799,34,286
BA,37460,MUQUÉM DO SÃO FRANCISCO,4952,1071,2672,8962,6290,45,222
BA,37478,MURITIBA,13169,2693,3965,21092,17127,251,1014
BA,37494,MUTUÍPE,8139,3653,4955,18015,13060,197,1071
BA,37516,NAZARÉ,12299,3186,4822,21442,16620,222,913
BA,37532,NILO PEÇANHA,4765,1212,2229,8855,6626,112,537
BA,37559,NOVA CANAÃ,6150,1334,4171,12186,8015,81,450
BA,37567,NOVA FÁTIMA,3858,1217,1700,7212,5512,72,365
BA,37575,NOVA ITARANA,3042,765,1557,5647,4090,50,233
BA,37583,NOVA REDENÇÃO,3836,369,1649,6156,4507,34,268
BA,37591,NOVA SOURE,12266,1515,5632,20194,14562,118,663
BA,37613,NOVA VIÇOSA,10087,8462,9217,29070,19853,255,1049
BA,37621,NOVO TRIUNFO,4166,760,2865,8052,5187,31,230
BA,37630,OLINDINA,11325,1485,6657,20123,13466,108,548
BA,37656,OLIVEIRA DOS BREJINHOS,9734,1801,4371,16553,12182,142,505
BA,37672,OURIÇANGAS,3625,694,1983,6770,4787,52,416
BA,37680,OUROLÂNDIA,6716,2537,1995,11890,9895,125,517
BA,37699,PALMAS DE MONTE ALTO,10786,1604,3983,17089,13106,129,587
BA,37710,PALMEIRAS,4331,562,1515,6664,5149,46,210
BA,37737,PARAMIRIM,9048,1979,4712,16393,11681,126,528
BA,37753,PARATINGA,13574,2306,5999,22642,16643,171,592
BA,37770,PARIPIRANGA,13786,2761,4158,21764,17606,207,852
BA,37796,PAU BRASIL,3064,1753,2099,7205,5106,50,239
BA,37818,PAULO AFONSO,45685,12010,20322,81015,60693,539,2459
BA,37834,PEDRÃO,3584,378,1789,5970,4181,25,194
BA,37850,PEDRO ALEXANDRE,5800,623,2813,9596,6783,64,296
BA,37877,PIATÃ,8169,2423,4861,16454,11593,107,894
BA,37893,PILÃO ARCADO,15767,2188,6775,25491,18716,129,632
BA,37915,PINDAÍ,7536,1550,2686,12370,9684,107,491
BA,37931,PINDOBAÇU,7370,2682,3921,14737,10816,164,600
BA,37940,PIRAÍ DO NORTE,3483,1035,1367,6300,4933,66,349
BA,37958,PIRIPÁ,4032,1282,3464,9084,5620,48,258
BA,37974,PIRITIBA,7142,2054,3787,13719,9932,86,650
BA,37990,PLANALTINO,4010,593,1610,6573,4963,73,287
BA,38016,PLANALTO,9874,3334,4271,18739,14468,175,1085
BA,38032,POÇÕES,17322,5524,11203,35758,24555,305,1404
BA,38059,POJUCA,14811,4270,5331,26795,21464,464,1919
BA,38067,PONTO NOVO,6770,1514,4266,13186,8920,123,513
BA,38075,PORTO SEGURO,38222,28354,15081,88293,73212,975,5661
BA,38091,POTIRAGUÁ,3372,1714,3381,8823,5442,67,289
BA,38113,PRADO,8143,4946,7430,21401,13971,198,684
BA,38130,PRESIDENTE DUTRA,7605,874,1368,10266,8898,85,334
BA,38156,PRESIDENTE JÂNIO QUADROS,5414,1081,4575,11418,6843,63,285
BA,38164,PRESIDENTE TANCREDO NEVES,9629,3923,4748,19778,15030,220,1258
BA,38172,QUEIMADAS,10431,2670,5673,19827,14154,157,896
BA,38199,QUINJINGUE,11907,2487,5324,20703,15379,198,787
BA,38210,REMANSO,18005,3356,7656,30218,22562,221,980
BA,38237,RETIROLÂNDIA,7296,1388,2499,11821,9322,107,531
BA,38253,RIACHÃO DAS NEVES,10056,2446,5280,18435,13155,95,558
BA,38270,RIACHÃO DO JACUÍPE,17152,2839,4616,25876,21260,223,1046
BA,38296,RIACHO DE SANTANA,14886,2105,5750,23709,17959,167,801
BA,38318,RIBEIRA DO AMPARO,7060,785,3647,11954,8307,78,384
BA,38334,RIBEIRA DO POMBAL,22235,6955,6680,37621,30941,347,1404
BA,38342,RIBEIRÃO DO LARGO,4022,1167,1995,7559,5564,52,323
BA,38350,RIO DE CONTAS,6244,1722,3317,11912,8595,136,493
BA,38377,RIO DO ANTÔNIO,6208,1105,3362,11224,7862,103,446
BA,38393,RIO DO PIRES,4459,1176,3992,10042,6050,89,326
BA,38415,RIO REAL,14587,4807,8128,29188,21060,373,1293
BA,38431,RODELAS,4025,649,1547,6446,4899,44,181
BA,38458,RUY BARBOSA,11766,3202,7559,23782,16223,180,1075
BA,38474,SALINAS DA MARGARIDA,7395,1109,2510,11640,9130,103,523
BA,38490,SALVADOR,985532,451273,223047,1828189,1605142,25513,142824
BA,38512,SANTA BÁRBARA,10716,2396,3981,17849,13868,109,647
BA,38539,SANTA BRÍGIDA,7110,934,3520,12027,8507,89,374
BA,38555,SANTA CRUZ CABRÁLIA,7788,5186,3833,18034,14201,198,1029
BA,38571,SANTA CRUZ DA VITÓRIA,1634,889,1889,4658,2769,29,217
BA,38598,SANTA INÊS,4681,681,2516,8225,5709,67,280
BA,38610,SANTALUZ,16173,4611,7603,30062,22459,242,1433
BA,38636,SANTA MARIA DA VITÓRIA,15090,4946,8568,29907,21339,211,1092
BA,38652,SANTANA,10309,3825,5267,20252,14985,134,717
BA,38679,SANTANÓPOLIS,4881,751,2309,8383,6074,77,365
BA,38695,SANTA TEREZINHA,4715,856,2815,8845,6030,71,388
BA,38717,SANTO AMARO,28707,4665,10565,46516,35951,459,2120
BA,38733,SANTO ANTÔNIO DE JESUS,34032,17154,11205,67549,56344,684,4474
BA,38750,SANTO ESTEVÃO,23419,4379,5796,35724,29928,276,1854
BA,38776,SÃO DESIDÉRIO,12390,4193,4056,21455,17399,132,684
BA,38792,SÃO FÉLIX,6214,1093,2341,10117,7776,78,391
BA,38806,SÃO DOMINGOS,4013,1201,1653,7304,5651,78,359
BA,38814,SÃO FELIPE,9016,2913,4230,17023,12793,157,707
BA,38822,SÃO FÉLIX DO CORIBE,5358,2513,2364,10822,8458,93,494
BA,38830,SÃO FRANCISCO DO CONDE,21780,3204,4379,31154,26775,312,1479
BA,38857,SÃO GONÇALO DOS CAMPOS,17663,3953,4627,27902,23275,264,1395
BA,38865,SÃO JOSÉ DO JACUÍPE,4467,886,2045,7909,5864,102,409
BA,38873,SÃO MIGUEL DAS MATAS,5137,1324,1748,8588,6840,47,332
BA,38890,SÃO SEBASTIÃO DO PASSÉ,22150,3310,6558,33754,27196,274,1462
BA,38911,SAPEAÇU,8774,2263,2034,13896,11862,153,672
BA,38938,SÁTIRO DIAS,6992,1422,4489,13558,9069,131,524
BA,38946,SAUBARA,6200,1563,3223,11512,8289,88,438
BA,38954,SAÚDE,4664,1046,2586,8786,6200,107,383
BA,38970,SEABRA,21761,3077,4087,30314,26227,183,1206
BA,38997,SEBASTIÃO LARANJEIRAS,3704,1114,1829,7001,5172,59,295
BA,39012,SENHOR DO BONFIM,24241,11791,9114,48369,39255,582,2641
BA,39039,SENTO SÉ,14681,3970,8820,28370,19550,263,636
BA,39047,SERRA DO RAMALHO,12645,2662,7131,23307,16176,150,719
BA,39055,SERRA DOURADA,6343,3570,4593,15048,10455,135,407
BA,39071,SERRA PRETA,9968,1576,4745,16943,12198,119,535
BA,39098,SERRINHA,34236,9579,8031,55761,47730,409,3506
BA,39110,SERROLÂNDIA,5459,1760,1622,9500,7878,102,557
BA,39136,SIMÕES FILHO,42380,15305,14836,78294,63458,1000,4773
BA,39144,SÍTIO DO MATO,5079,1196,3002,9504,6502,50,177
BA,39152,SOUTO SOARES,8807,854,2981,12995,10014,68,285
BA,39179,TABOCAS DO BREJO VELHO,5802,1086,3004,10261,7257,79,290
BA,39195,TANHAÇU,9485,3125,3365,16811,13446,118,718
BA,39217,TANQUINHO,4365,1036,1490,7153,5663,48,214
BA,39233,TAPEROÁ,7037,1787,3042,12658,9616,113,679
BA,39250,TAPIRAMUTÁ,5458,1216,3871,11254,7383,73,636
BA,39276,TEODORO SAMPAIO,4008,409,1693,6436,4743,56,270
BA,39292,TEOFILÂNDIA,10197,1296,4893,17148,12255,117,645
BA,39314,TEOLÂNDIA,5519,1739,2655,10552,7897,104,535
BA,39330,TERRA NOVA,5785,940,2444,9865,7421,79,617
BA,39357,TREMEDAL,7658,1831,6045,16077,10032,107,436
BA,39373,TUCANO,23170,4339,6843,36133,29290,285,1496
BA,39390,UAUÁ,12716,1711,5847,21065,15218,151,640
BA,39411,UBAÍRA,7950,2947,4412,16298,11886,157,832
BA,39438,UBAITABA,6565,2986,3539,13877,10338,130,657
BA,39454,UBATÃ,5746,2780,1957,11235,9278,119,633
BA,39470,UIBAÍ,6564,1935,2598,11533,8935,99,337
BA,39489,UMBURANAS,5659,1685,1977,9743,7766,73,349
BA,39497,UNA,6683,3304,4273,15163,10890,155,748
BA,39519,URANDI,7249,1504,3368,12714,9346,122,471
BA,39535,URUÇUCA,7114,4036,5124,17263,12139,161,828
BA,39551,UTINGA,6985,1598,3860,13081,9221,109,529
BA,39578,VALENÇA,31374,13897,9701,60685,50984,871,4842
BA,39594,VALENTE,9419,4591,3809,19277,15468,209,1249
BA,39616,VÁRZEA DO POÇO,3219,1067,1886,6548,4662,74,302
BA,39624,VARZEDO,4442,1665,1361,7902,6541,64,370
BA,39632,VERA CRUZ,17888,4875,4626,29259,24633,308,1562
BA,39640,VEREDA,2707,1184,2111,6228,4117,39,187
BA,39659,VITÓRIA DA CONQUISTA,100751,72763,30412,221857,191445,3071,14860
BA,39675,WAGNER,3537,1005,2372,7193,4821,38,241
BA,39691,WENCESLAU GUIMARÃES,8044,2583,4177,15572,11395,133,635
BA,39713,XIQUE-XIQUE,18982,4804,9672,34725,25053,245,1022
BA,39730,LAPÃO,12866,2751,4905,21302,16397,152,628
BA,39748,MADRE DE DEUS,9663,2180,1945,14488,12543,124,576
BA,39756,MAETINGA,2806,1034,2631,6789,4158,51,267
BA,39772,MANSIDÃO,4908,811,3762,9695,5933,58,156
BA,39799,NORDESTINA,5630,933,3339,10373,7034,71,400
BA,39810,PÉ DE SERRA,5609,2378,2597,11241,8644,149,508
BA,39837,PINTADAS,3776,2282,1421,7919,6498,97,343
BA,39845,QUIXABEIRA,3693,1660,2253,8097,5844,113,378
BA,39853,RAFAEL JAMBEIRO,8554,2742,5427,17631,12204,163,745
BA,39870,SANTA LUZIA,3530,1489,3722,9099,5377,60,298
BA,39896,SÃO GABRIEL,10769,1031,2178,14528,12350,96,454
BA,39900,SÍTIO DO QUINTO,5595,890,2802,9636,6834,50,299
BA,39918,TANQUE NOVO,8013,1370,2838,12917,10079,173,523
BA,39926,SÃO JOSÉ DA VITÓRIA,2134,968,1147,4510,3363,38,223
BA,39934,TEIXEIRA DE FREITAS,33442,34772,31764,105007,73243,1022,4007
BA,39942,NOVO HORIZONTE,5187,1257,1159,8113,6954,83,427
BA,39950,VÁRZEA NOVA,4960,1122,2637,9240,6603,101,420
BA,39969,NOVA IBIÁ,2155,1104,1752,5290,3538,55,224
BA,39977,VÁRZEA DA ROÇA,5911,1332,2903,10826,7923,120,560
BA,39985,SOBRADINHO,10296,2811,3652,17590,13938,149,682
BA,39993,WANDERLEY,5167,1891,2843,10194,7351,55,238
CE,13005,JIJOCA DE JERICOACOARA,8073,2631,1916,13405,11489,144,641
CE,13013,ABAIARA,4665,681,1038,6709,5671,65,260
CE,13021,MADALENA,8536,1200,2554,12708,10154,90,328
CE,13030,ACARAÚ,23661,6154,7740,39790,32050,474,1761
CE,13048,PIRES FERREIRA,4564,970,2089,7900,5811,55,222
CE,13056,ACOPIARA,23614,3629,9170,38088,28918,388,1287
CE,13064,GRAÇA,7600,905,4341,13302,8961,113,343
CE,13072,AIUABA,7000,654,3391,11365,7974,57,263
CE,13080,TURURU,8370,1916,1867,12834,10967,130,551
CE,13099,ALCÂNTARAS,5599,883,1964,8936,6972,125,365
CE,13102,QUITERIANÓPOLIS,9349,1562,5019,16638,11619,138,570
CE,13110,ALTANEIRA,3999,435,807,5467,4660,43,183
CE,13129,BARREIRA,9374,3413,2151,16117,13966,251,928
CE,13137,ALTO SANTO,7572,1134,3272,12324,9052,86,260
CE,13145,ACARAPE,5839,2769,1377,10713,9336,165,563
CE,13153,ANTONINA DO NORTE,3905,481,2335,6934,4599,45,168
CE,13161,CHOROZINHO,9598,2879,2337,15877,13540,227,836
CE,13170,APUIARÉS,7423,1501,1925,11252,9327,74,329
CE,13188,HORIZONTE,26643,13407,8445,52577,44132,722,3360
CE,13196,AQUIRAZ,29499,13121,8807,54863,46056,773,2663
CE,13200,ERERÊ,3094,506,1601,5410,3809,50,159
CE,13218,ARACATI,28880,11455,7361,50636,43275,725,2215
CE,13226,EUSÉBIO,19575,12560,7257,41868,34611,551,1925
CE,13234,ARACOIABA,14469,3529,3750,22614,18864,202,664
CE,13242,GUAIÚBA,11614,3022,2452,17899,15447,183,628
CE,13250,ARARIPE,10887,1026,5261,17708,12447,82,452
CE,13269,POTIRETAMA,3579,433,1225,5390,4165,32,121
CE,13277,ARATUBA,6409,1427,1990,10402,8412,142,434
CE,13285,PINDORETAMA,10051,3272,2455,16608,14153,160,670
CE,13293,ARNEIROZ,3742,659,2238,6870,4632,32,199
CE,13307,OCARA,13020,3650,4192,21860,17668,258,740
CE,13315,ASSARÉ,11387,1584,5464,19152,13688,128,589
CE,13323,TEJUÇUOCA,9214,1624,2473,13847,11374,119,417
CE,13331,AURORA,12526,2110,3599,19080,15481,193,652
CE,13340,IPAPORANGA,5121,1415,2087,8993,6906,83,287
CE,13358,BAIXIO,3487,419,1383,5438,4055,29,120
CE,13366,TARRAFAS,4730,508,2095,7613,5518,71,209
CE,13374,BARBALHA,25379,8953,6530,43229,36699,507,1860
CE,13382,BANABUIÚ,8841,1376,3209,13867,10658,79,362
CE,13390,BARRO,10421,1391,3203,15561,12358,127,419
CE,13404,BARROQUINHA,8284,1216,2164,12149,9985,123,362
CE,13412,BATURITÉ,15675,3707,4556,25042,20486,286,818
CE,13420,ARARENDÁ,4720,1332,2578,8954,6376,87,237
CE,13439,BEBERIBE,22228,7113,10322,42450,32128,489,2298
CE,13447,CATUNDA,5242,744,1325,7583,6258,65,207
CE,13455,BELA CRUZ,11141,3113,3782,19346,15564,244,1066
CE,13463,CHORÓ,6714,938,2384,10388,8004,89,263
CE,13471,BOA VIAGEM,25403,2900,7628,37466,29838,288,1247
CE,13480,ITAITINGA,14614,6493,3636,26497,22861,346,1408
CE,13498,BREJO SANTO,21561,4703,5432,32898,27466,221,981
CE,13501,FORTIM,6831,2708,2342,12537,10195,118,538
CE,13510,CAMOCIM,25255,8274,8229,43879,35650,522,1599
CE,13536,CAMPOS SALES,12132,1878,6325,21059,14734,138,586
CE,13552,CANINDÉ,34530,6907,9937,53581,43644,567,1640
CE,13579,CAPISTRANO,9534,1681,3043,14806,11763,168,380
CE,13595,CARIDADE,9796,1698,3159,15182,12023,145,384
CE,13617,CARIRÉ,7414,2865,2591,13781,11190,206,705
CE,13633,CARIRIAÇU,13592,3142,4097,21866,17769,171,864
CE,13650,CARIÚS,9428,1601,2475,14095,11620,138,453
CE,13676,CARNAUBAL,6827,2176,2207,12126,9919,159,757
CE,13692,CASCAVEL,28742,11211,8132,51800,43668,685,3030
CE,13714,CATARINA,4691,780,3227,8946,5719,52,196
CE,13730,CAUCAIA,107263,62133,24692,209150,184458,2733,12329
CE,13757,CEDRO,12605,2066,3499,18984,15485,138,676
CE,13773,CHAVAL,6756,1016,1757,9868,8111,102,237
CE,13811,COREAÚ,10974,2559,3545,17967,14422,236,653
CE,13838,CRATEÚS,32592,8323,11274,54633,43359,465,1979
CE,13854,CRATO,59204,10784,9790,83053,73263,706,2569
CE,13870,FARIAS BRITO,10416,1552,2093,14798,12705,169,568
CE,13897,FORTALEZA,739265,590033,327401,1776126,1448725,26251,93176
CE,13919,FRECHEIRINHA,6818,1980,1818,11363,9545,153,594
CE,13935,GENERAL SAMPAIO,4308,836,1392,6832,5440,89,207
CE,13951,GRANJA,27406,3557,6066,38855,32789,356,1470
CE,13978,GRANJEIRO,3375,430,1211,5151,3940,26,109
CE,13994,GROAÍRAS,4265,1972,1242,8171,6929,189,503
CE,14010,GUARACIABA DO NORTE,17067,5182,5272,29497,24225,369,1607
CE,14036,GUARAMIRANGA,3479,628,861,5165,4304,41,156
CE,14052,HIDROLÂNDIA,8618,2278,2350,13948,11598,117,585
CE,14060,IBARETAMA,7174,1245,2034,10859,8825,100,306
CE,14079,IBIAPINA,9176,2992,3611,16980,13369,221,980
CE,14095,ICÓ,29416,5862,9304,46330,37026,348,1400
CE,14117,IGUATU,42462,8806,9671,63512,53841,624,1949
CE,14133,INDEPENDÊNCIA,11782,2639,6585,21756,15171,176,574
CE,14150,IPAUMIRIM,5964,819,2268,9444,7176,77,316
CE,14176,IPU,18089,4171,10088,33673,23585,289,1036
CE,14192,IPUEIRAS,15504,4150,12041,33061,21020,327,1039
CE,14214,IRACEMA,6923,1232,3281,11770,8489,71,263
CE,14230,IRAUÇUBA,10821,1878,2692,16132,13440,164,577
CE,14257,ITAIÇABA,3848,1209,1039,6441,5402,61,284
CE,14273,ITAPAJÉ,20248,8117,5214,35564,30350,461,1524
CE,14290,ITAPIPOCA,54153,12622,12911,83592,70681,824,3082
CE,14311,ITAPIÚNA,9161,1821,3081,14667,11586,158,446
CE,14338,ITATIRA,11040,1654,3569,16765,13196,104,398
CE,14354,JAGUARETAMA,8993,1294,4665,15501,10836,111,438
CE,14370,JAGUARIBARA,4871,868,1830,7918,6088,51,298
CE,14397,JAGUARIBE,17204,3553,5396,27310,21914,204,953
CE,14419,JAGUARUANA,14425,5117,4485,26226,21741,581,1618
CE,14435,JARDIM,12855,2047,4199,20036,15837,162,773
CE,14451,JATI,4325,583,1206,6431,5225,44,273
CE,14478,JUAZEIRO DO NORTE,101288,31793,26951,169155,142204,1967,7156
CE,14494,JUCÁS,10933,2503,4032,18405,14373,222,715
CE,14516,LAVRAS DA MANGABEIRA,14370,2237,4379,21836,17457,160,690
CE,14532,LIMOEIRO DO NORTE,26481,7081,6335,42348,36013,443,2008
CE,14559,MARANGUAPE,40475,18147,10191,73270,63079,890,3567
CE,14575,MARCO,9221,6175,3697,20571,16874,346,1132
CE,14591,MARTINÓPOLE,6177,846,1345,8766,7421,87,311
CE,14613,MASSAPÊ,15280,5460,6859,29644,22785,497,1548
CE,14630,MAURITI,19565,5458,5240,31983,26743,265,1455
CE,14656,MERUOCA,6346,1928,1426,10735,9309,294,741
CE,14672,MILAGRES,14447,1782,3960,20902,16942,143,570
CE,14680,MIRAÍMA,7162,820,2251,10521,8270,64,224
CE,14699,MISSÃO VELHA,18181,3141,4203,26738,22535,260,953
CE,14710,MOMBAÇA,18968,3283,6470,30073,23603,305,1047
CE,14737,MONSENHOR TABOSA,8761,1576,4522,15404,10882,121,424
CE,14753,MORADA NOVA,29611,8656,9206,50692,41486,532,2687
CE,14770,MORAÚJO,4244,1028,1272,6911,5639,89,278
CE,14796,MORRINHOS,6766,5016,4121,16634,12513,194,537
CE,14818,MUCAMBO,6787,1504,4313,13335,9022,152,579
CE,14834,MULUNGU,5021,1050,1527,7920,6393,79,243
CE,14850,NOVA OLINDA,7890,1372,1727,11475,9748,107,379
CE,14877,NOVA RUSSAS,11951,3936,7315,24139,16824,227,710
CE,14893,NOVO ORIENTE,13380,1813,6525,22610,16085,195,697
CE,14915,ORÓS,10598,1986,5447,18740,13293,140,569
CE,14931,PACAJUS,24236,11715,6282,46347,40065,745,3369
CE,14958,PACATUBA,22267,12249,5079,42392,37313,512,2285
CE,14974,PACOTI,6179,1187,1940,9765,7825,95,364
CE,14990,PACUJÁ,3573,499,1629,5985,4356,49,235
CE,15016,PALHANO,4475,1798,1340,8056,6716,107,336
CE,15032,PALMÁCIA,5120,1258,1766,8553,6787,72,337
CE,15059,PARACURU,16352,5963,4341,28405,24064,369,1380
CE,15075,PARAMBU,12140,4353,10202,28003,17801,276,1032
CE,15091,PARAMOTI,5691,1289,1758,9089,7331,77,274
CE,15113,PEDRA BRANCA,21268,2474,6410,31476,25066,245,1079
CE,15130,PENAFORTE,5026,828,1139,7368,6229,75,300
CE,15156,PENTECOSTE,19234,4817,4693,30041,25348,229,1068
CE,15172,PEREIRO,8301,1352,4325,14606,10281,124,504
CE,15199,PIQUET CARNEIRO,7134,927,2547,11017,8470,67,342
CE,15210,PORANGA,5778,867,3090,10080,6990,55,290
CE,15237,PORTEIRAS,8829,1047,2499,12809,10310,71,363
CE,15253,POTENGI,4750,500,1938,7449,5511,58,203
CE,15270,QUIXADÁ,28670,13272,9004,54225,45221,774,2505
CE,15296,QUIXERAMOBIM,32322,6571,15339,56458,41119,445,1781
CE,15318,QUIXERÉ,9781,2645,2797,16429,13632,182,1024
CE,15334,REDENÇÃO,13184,3772,3417,21874,18457,313,1188
CE,15350,RERIUTABA,8634,1665,5215,16377,11162,178,685
CE,15377,RUSSAS,30874,11203,8055,53361,45306,530,2699
CE,15393,SABOEIRO,7398,1153,4350,13423,9073,106,416
CE,15415,SANTANA DO ACARAÚ,14893,3008,6140,25155,19015,274,840
CE,15431,SANTANA DO CARIRI,9102,899,1979,12411,10432,72,359
CE,15440,SALITRE,8150,1389,3114,13119,10005,86,380
CE,15458,SANTA QUITÉRIA,19557,3940,5539,30558,25019,403,1119
CE,15474,SÃO BENEDITO,19673,5830,5374,33220,27846,571,1772
CE,15490,SÃO GONÇALO DO AMARANTE,21207,10333,6128,40187,34059,425,2094
CE,15512,SÃO JOÃO DO JAGUARIBE,4079,742,1820,6935,5115,61,233
CE,15539,SÃO LUÍS DO CURU,6442,1680,2019,10666,8647,134,391
CE,15555,SENADOR POMPEU,10736,3634,6160,21462,15302,201,731
CE,15571,SENADOR SÁ,3553,804,1447,6050,4603,64,182
CE,15598,SOBRAL,69923,34651,21373,137692,116319,3184,8561
CE,15610,SOLONÓPOLE,8443,1371,4579,14839,10260,105,341
CE,15636,TABULEIRO DO NORTE,14930,3380,5810,25424,19614,339,965
CE,15652,TAMBORIL,12380,2170,6131,21275,15144,139,455
CE,15679,TAUÁ,21691,7921,13570,45694,32124,477,2035
CE,15695,TIANGUÁ,26590,13126,7134,51118,43984,1041,3227
CE,15717,TRAIRI,24614,5946,7669,40353,32684,491,1633
CE,15733,UBAJARA,12393,4837,3682,22832,19150,481,1439
CE,15750,UMARI,3285,1085,1720,6354,4634,63,201
CE,15776,URUBURETAMA,10062,2739,2102,15894,13792,169,822
CE,15792,URUOCA,6424,1397,1704,9976,8272,90,361
CE,15814,VÁRZEA ALEGRE,18717,3596,5541,29334,23793,283,1197
CE,15830,VIÇOSA DO CEARÁ,25585,6440,7343,42110,34767,510,2232
CE,15857,MARACANAÚ,74823,48472,17249,151233,133984,1995,8694
CE,15873,AMONTADA,18328,3789,6814,30144,23330,253,960
CE,15881,CROATÁ,8377,1577,1674,12657,10983,164,865
CE,15890,CRUZ,9882,4293,2928,18354,15426,198,1053
CE,15911,FORQUILHA,9447,3871,2893,17491,14598,301,979
CE,15920,IBICUITINGA,6823,1484,1896,10727,8831,107,417
CE,15938,ICAPUÍ,8792,3230,2234,15132,12898,235,641
CE,15954,ITAREMA,16100,5086,6273,29046,22773,343,1244
CE,15970,MILHÃ,6894,829,3447,11524,8077,52,302
CE,15989,DEPUTADO IRAPUAN PINHEIRO,4638,448,1836,7226,5390,64,240
CE,15997,PARAIPABA,12404,5796,3550,23244,19694,264,1230
CE,98531,QUIXELÔ,8979,1580,1620,12723,11103,128,416
CE,98558,UMIRIM,8904,1958,2513,13930,11417,126,429
CE,98574,VARJOTA,7079,2833,4657,15560,10903,229,762
DF,97012,BRASÍLIA,463340,1080411,394690,2086086,1691396,44657,102988
ES,56006,SÃO DOMINGOS DO NORTE,2678,2765,1140,6904,5764,117,204
ES,56014,AFONSO CLÁUDIO,6007,10484,7552,25455,17903,391,1021
ES,56022,ÁGUA DOCE DO NORTE,3822,3386,2390,10033,7643,135,300
ES,56030,ALEGRE,6621,9243,6036,23092,17056,402,790
ES,56049,IRUPI,2190,4799,3057,10600,7543,235,319
ES,56057,ALFREDO CHAVES,1835,6816,2814,12162,9348,228,469
ES,56065,ALTO RIO NOVO,2315,1979,1693,6290,4597,106,197
ES,56073,ANCHIETA,5813,10240,3002,20319,17317,435,829
ES,56081,VILA PAVÃO,2845,2650,1115,6943,5828,100,233
ES,56090,APIACÁ,1897,2243,1637,6082,4445,91,214
ES,56103,MARECHAL FLORIANO,2775,6734,1916,12328,10412,310,593
ES,56111,ARACRUZ,18253,30832,16806,69626,52820,1129,2606
ES,56120,MARATAÍZES,5766,13957,7260,28138,20878,465,690
ES,56138,ATÍLIO VIVÁCQUA,2762,3733,1864,8766,6902,145,262
ES,56146,BREJETUBA,2725,3247,3230,9725,6495,187,336
ES,56154,BAIXO GUANDU,5739,10313,5465,22802,17337,364,921
ES,56162,SÃO ROQUE DO CANAÃ,2334,4675,1500,9063,7563,171,383
ES,56170,BARRA DE SÃO FRANCISCO,9975,12932,9855,33945,24090,363,820
ES,56189,SOORETAMA,6269,6491,5381,19093,13712,288,664
ES,56197,BOA ESPERANÇA,3897,3690,2273,10385,8112,168,357
ES,56200,PONTO BELO,2638,1475,1768,6152,4384,90,181
ES,56219,BOM JESUS DO NORTE,2065,2903,1578,6988,5410,85,357
ES,56227,VILA VALÉRIO,4985,3953,2097,11625,9528,158,432
ES,56235,CACHOEIRO DE ITAPEMIRIM,24792,75462,31715,138703,106988,3035,3699
ES,56251,CARIACICA,76814,117219,50639,259645,209006,5044,9929
ES,56278,CASTELO,4124,16286,6612,28533,21921,545,966
ES,56294,COLATINA,17848,46700,20327,89509,69182,1449,3185
ES,56308,GOVERNADOR LINDENBERG,2972,3174,2289,8866,6577,104,327
ES,56316,CONCEIÇÃO DA BARRA,8355,5405,7798,22684,14886,329,797
ES,56332,CONCEIÇÃO DO CASTELO,1539,4950,2629,9840,7211,185,537
ES,56359,DIVINO DE SÃO LOURENÇO,1015,1685,813,3784,2971,125,146
ES,56375,DOMINGOS MARTINS,4831,15930,4455,26932,22477,601,1115
ES,56391,DORES DO RIO PRETO,1810,2254,1369,5760,4391,92,235
ES,56413,ECOPORANGA,6912,5903,5473,19015,13542,235,492
ES,56430,FUNDÃO,4262,5768,3215,14037,10822,245,547
ES,56456,GUAÇUÍ,4887,9516,6202,21677,15475,370,702
ES,56472,GUARAPARI,17993,46417,22189,91949,69760,1766,3584
ES,56499,IBIRAÇU,2349,4461,2014,9412,7398,126,462
ES,56502,IBITIRAMA,1792,3003,1296,6500,5204,142,267
ES,56510,ICONHA,2484,5571,2213,11081,8868,227,586
ES,56537,ITAGUAÇU,3314,4708,2618,11305,8687,176,489
ES,56553,ITAPEMIRIM,7489,15785,5898,30472,24574,506,794
ES,56570,ITARANA,2098,4652,1826,9179,7353,160,443
ES,56596,IÚNA,4398,9747,5762,21121,15359,444,770
ES,56618,JERÔNIMO MONTEIRO,2505,4159,2466,9745,7279,170,445
ES,56626,JOÃO NEIVA,3142,6311,2265,12549,10284,224,607
ES,56634,LINHARES,26360,51015,27901,112500,84599,2188,5036
ES,56650,MANTENÓPOLIS,2945,4304,3226,10961,7735,117,369
ES,56677,MIMOSO DO SUL,7031,7119,3695,18936,15241,411,680
ES,56693,MONTANHA,5351,4330,4315,14636,10321,180,460
ES,56715,MUCURICI,2096,1317,1327,4909,3582,57,112
ES,56731,MUNIZ FREIRE,3833,5841,3634,14113,10479,255,550
ES,56758,MUQUI,3501,4508,2344,11035,8691,239,443
ES,56774,NOVA VENÉCIA,11649,14677,10344,38539,28195,603,1266
ES,56790,PANCAS,4842,5812,5103,16315,11212,183,375
ES,56812,PINHEIROS,7275,5077,4850,17856,13006,200,454
ES,56839,PIÚMA,3855,7339,4195,16245,12050,231,625
ES,56855,PRESIDENTE KENNEDY,3272,5378,1881,10958,9077,157,270
ES,56871,RIO NOVO DO SUL,1638,4974,1472,8612,7140,219,309
ES,56898,SANTA LEOPOLDINA,3094,4066,2022,9910,7888,223,505
ES,56910,SANTA TERESA,3606,10121,4032,19019,14987,319,941
ES,56936,SÃO GABRIEL DA PALHA,6890,11016,6351,25429,19078,328,844
ES,56952,SÃO JOSÉ DO CALÇADO,2850,2994,1439,7800,6361,155,362
ES,56979,SÃO MATEUS,27104,29517,21852,82614,60762,1261,2880
ES,56995,SERRA,98707,137878,65692,320956,255264,5991,12688
ES,57010,VIANA,14884,21818,8471,47912,39441,999,1740
ES,57037,VILA VELHA,77613,166300,36505,299159,262654,6466,12275
ES,57053,VITÓRIA,72064,123734,36737,247347,210610,5719,9093
ES,57070,MARILÂNDIA,2505,4974,1478,9659,8181,162,540
ES,57096,IBATIBA,4037,8640,2820,16601,13781,339,765
ES,57118,RIO BANANAL,4689,5902,3788,15247,11459,224,644
ES,57134,JAGUARÉ,8841,6435,5144,21335,16191,315,600
ES,57150,PEDRO CANÁRIO,6658,4783,6054,18227,12173,194,538
ES,57916,LARANJA DA TERRA,2444,4314,1180,8504,7324,140,426
ES,57932,SANTA MARIA DE JETIBÁ,5721,16375,5078,28767,23689,471,1122
ES,57959,VARGEM ALTA,2526,8568,3567,15456,11889,344,451
ES,57975,VENDA NOVA DO IMIGRANTE,2428,10375,4353,18175,13822,342,677
ES,57991,ÁGUIA BRANCA,3528,2504,1558,7869,6311,85,194
GO,92010,ABADIÂNIA,1781,5204,1600,9077,7477,140,352
GO,92029,BONFINÓPOLIS,1677,2563,667,5192,4525,69,216
GO,92037,ÁGUA LIMPA,580,859,642,2208,1566,26,101
GO,92053,ALEXÂNIA,3979,9723,2998,17734,14736,307,727
GO,92061,CAMPOS VERDES,1865,704,790,3506,2716,38,109
GO,92096,ALOÂNDIA,506,801,346,1790,1444,45,92
GO,92100,CEZARINA,2025,2979,1641,7138,5497,61,432
GO,92118,ALTO PARAÍSO DE GOIÁS,2379,1454,1466,5548,4082,40,209
GO,92126,COLINAS DO SUL,1424,539,1023,3096,2073,36,74
GO,92150,ALVORADA DO NORTE,2083,2066,1818,6229,4411,60,202
GO,92169,MORRO AGUDO DE GOIÁS,637,1198,375,2324,1949,30,84
GO,92177,AMORINÓPOLIS,1172,1398,612,3359,2747,30,147
GO,92207,EDEALINA,937,1796,927,3842,2915,29,153
GO,92215,ANÁPOLIS,39442,154907,59573,268607,209034,3507,11178
GO,92223,FAINA,2473,1736,1629,6048,4419,54,156
GO,92231,ANHANGÜERA,391,374,233,1050,817,6,46
GO,92258,ANICUNS,3453,6906,2399,13574,11175,167,649
GO,92266,GOUVELÂNDIA,1400,1286,588,3488,2900,32,182
GO,92274,APARECIDA DE GOIÂNIA,71561,145366,64626,298016,233390,4160,12303
GO,92282,ITAGUARI,1479,1831,941,4504,3563,60,193
GO,92290,APORÉ,912,1124,844,3034,2190,35,119
GO,92312,ARAÇU,1144,1702,651,3739,3088,31,211
GO,92320,MATRINCHÃ,1186,1257,684,3256,2572,45,84
GO,92339,ARAGARÇAS,3557,4941,2125,11171,9046,123,425
GO,92347,MIMOSO DE GOIÁS,872,984,528,2466,1938,14,68
GO,92355,ARAGOIÂNIA,2027,3509,1811,7709,5898,87,275
GO,92363,MONTIVIDIU,1898,4496,2016,8871,6855,91,370
GO,92444,NOVO PLANALTO,1268,1079,729,3222,2493,36,110
GO,92460,PALESTINA DE GOIÁS,932,1193,1001,3241,2240,21,94
GO,92495,ARUANÃ,1697,2038,1980,5935,3955,44,176
GO,92517,AURILÂNDIA,1230,1060,787,3205,2418,21,107
GO,92550,AVELINÓPOLIS,737,1455,448,2750,2302,24,86
GO,92568,SANTA FÉ DE GOIÁS,1130,1311,929,3509,2580,24,115
GO,92614,BALIZA,1104,589,548,2332,1784,16,75
GO,92622,SÃO JOÃO DA PARAÚNA,431,908,392,1825,1433,22,72
GO,92630,BARRO ALTO,2587,3382,2375,8769,6394,75,350
GO,92649,SÃO LUIZ DO NORTE,1432,1339,910,3907,2997,45,181
GO,92657,BELA VISTA DE GOIÁS,4976,10089,5374,21551,16177,259,853
GO,92665,SÃO MIGUEL DO PASSA QUATRO,1082,1441,486,3174,2688,30,135
GO,92673,BOM JARDIM DE GOIÁS,2600,2027,1151,6024,4873,32,214
GO,92690,BOM JESUS DE GOIÁS,4667,6665,3807,16004,12197,199,666
GO,92703,SENADOR CANEDO,19197,31951,15936,71047,55111,1007,2956
GO,92711,BRAZABRANTES,762,1383,774,3082,2308,52,111
GO,92720,SIMOLÂNDIA,2092,1505,1508,5378,3870,61,212
GO,92754,BRITÂNIA,1221,1790,1005,4217,3212,40,161
GO,92762,TERESINA DE GOIÁS,1085,461,657,2293,1636,22,68
GO,92770,BURITI ALEGRE,1907,3396,2147,7937,5790,108,379
GO,92789,TROMBAS,987,905,731,2740,2009,17,100
GO,92797,CABECEIRAS,2275,1889,1272,5736,4464,62,238
GO,92800,TURVELÂNDIA,1655,1458,337,3680,3343,33,197
GO,92819,CACHOEIRA ALTA,2448,2806,1897,7604,5707,88,365
GO,92827,RIO QUENTE,773,1627,829,3399,2570,39,131
GO,92835,CACHOEIRA DE GOIÁS,520,649,501,1732,1231,20,42
GO,92851,CAÇU,2429,4610,2134,9781,7647,103,505
GO,92860,GUARINOS,964,537,489,2056,1567,16,50
GO,92878,CAIAPÔNIA,3814,4970,3414,12837,9423,98,541
GO,92886,COCALZINHO DE GOIÁS,3718,6608,3789,14892,11103,212,565
GO,92894,CALDAS NOVAS,11573,29977,13773,58677,44904,775,2579
GO,92908,SANTO ANTÔNIO DE GOIÁS,1433,2422,1427,5558,4131,61,215
GO,92916,CAMPESTRE DE GOIÁS,1069,1436,978,3604,2626,31,90
GO,92924,CHAPADÃO DO CÉU,1652,3672,1672,7289,5617,69,224
GO,92932,CAMPINORTE,2071,4217,1992,8702,6710,98,324
GO,92940,ALTO HORIZONTE,1386,2429,1672,5651,3979,39,125
GO,92959,CAMPO ALEGRE DE GOIÁS,1623,1893,1103,4912,3809,41,252
GO,92967,CASTELÂNDIA,1262,1073,949,3383,2434,16,83
GO,92975,CAMPOS BELOS,5442,3526,3748,13504,9756,128,660
GO,92983,JESÚPOLIS,454,1212,438,2196,1758,22,70
GO,92991,CARMO DO RIO VERDE,1929,3228,1246,6767,5521,62,302
GO,93009,APARECIDA DO RIO DOCE,838,873,543,2413,1870,28,131
GO,93017,CATALÃO,21312,28634,14883,69413,54530,827,3757
GO,93025,CIDADE OCIDENTAL,10624,17644,6801,36963,30162,652,1242
GO,93033,CATURAÍ,1368,1650,889,4175,3286,45,223
GO,93041,PROFESSOR JAMIL,948,1054,564,2676,2112,24,86
GO,93050,CAVALCANTE,3484,627,1787,6154,4367,48,208
GO,93068,PEROLÂNDIA,995,950,900,2959,2059,17,97
GO,93076,CERES,3531,8541,2310,15311,13001,205,724
GO,93084,NOVA IGUAÇU DE GOIÁS,808,1097,818,2822,2004,22,77
GO,93092,DIVINÓPOLIS DE GOIÁS,2102,1418,636,4464,3828,47,261
GO,93106,BURITI DE GOIÁS,584,1419,591,2702,2111,30,78
GO,93122,CALDAZINHA,752,1354,787,3029,2242,36,100
GO,93149,GUARAÍTA,859,968,486,2424,1938,25,86
GO,93157,CÓRREGO DO OURO,409,1377,471,2358,1887,25,76
GO,93165,INACIOLÂNDIA,1751,1265,680,4042,3362,38,308
GO,93173,CORUMBÁ DE GOIÁS,1781,3221,1980,7361,5381,88,291
GO,93181,MONTIVIDIU DO NORTE,1272,991,784,3168,2384,28,93
GO,93190,CORUMBAÍBA,1691,2666,1570,6333,4763,75,331
GO,93203,SANTO ANTÔNIO DA BARRA,1508,1294,785,3726,2941,27,112
GO,93220,TEREZÓPOLIS DE GOIÁS,1630,2735,1212,5870,4658,61,232
GO,93246,UIRAPURU,996,659,518,2264,1746,22,69
GO,93254,CRISTALINA,7459,15610,6708,31464,24756,521,1166
GO,93262,BURITINÓPOLIS,1166,917,998,3222,2224,25,116
GO,93270,CRISTIANÓPOLIS,717,1563,749,3146,2397,43,74
GO,93289,VILA BOA,1631,721,1065,3557,2492,33,107
GO,93297,CRIXÁS,4654,3964,2665,11869,9204,113,473
GO,93300,VALPARAÍSO DE GOIÁS,20509,38332,13945,76999,63054,1356,2857
GO,93319,CROMÍNIA,846,1570,555,3166,2611,50,145
GO,93327,NOVO GAMA,11971,20034,6002,40441,34439,762,1672
GO,93335,CUMARI,997,799,484,2413,1929,25,108
GO,93343,ÁGUAS LINDAS DE GOIÁS,27817,38057,14617,85365,70748,1673,3201
GO,93351,DAMIANÓPOLIS,1051,1253,941,3450,2509,47,158
GO,93360,ABADIA DE GOIÁS,1928,4285,1868,8373,6505,91,201
GO,93378,DAMOLÂNDIA,787,1503,720,3259,2539,55,194
GO,93386,AMARALINA,1204,813,791,2916,2125,22,86
GO,93394,DAVINÓPOLIS,1338,1225,367,3130,2763,25,175
GO,93408,BONÓPOLIS,1234,777,652,2741,2089,15,63
GO,93424,PORTEIRÃO,922,1070,625,2763,2138,33,113
GO,93432,DIORAMA,605,941,424,2091,1667,17,104
GO,93440,SANTA RITA DO NOVO DESTINO,932,1000,551,2594,2043,35,76
GO,93483,SÃO PATRÍCIO,492,1087,497,2185,1688,19,90
GO,93491,EDÉIA,2566,4148,2099,9214,7115,80,321
GO,93505,VILA PROPÍCIO,1608,1575,1254,4677,3423,67,173
GO,93513,ESTRELA DO NORTE,965,1083,594,2756,2162,23,91
GO,93530,FAZENDA NOVA,1474,2019,1021,4752,3731,42,196
GO,93548,IPIRANGA DE GOIÁS,762,1173,497,2606,2109,31,143
GO,93564,GAMELEIRA DE GOIÁS,862,1322,437,2760,2323,27,112
GO,93572,FIRMINÓPOLIS,1550,4372,1611,7848,6237,74,241
GO,93580,CAMPO LIMPO DE GOIÁS,1259,2772,1232,5543,4311,63,217
GO,93599,FLORES DE GOIÁS,2430,1779,1817,6286,4469,48,212
GO,93602,LAGOA SANTA,343,587,486,1473,987,15,42
GO,93610,FORMOSA,19936,31609,12345,68263,55918,1053,3320
GO,93637,FORMOSO,1588,1237,1106,4091,2985,33,127
GO,93670,GOIANÁPOLIS,1807,5695,2314,10239,7925,100,323
GO,93696,GOIANDIRA,1522,1478,566,3882,3316,36,280
GO,93718,GOIANÉSIA,13307,23211,10821,50510,39689,734,2437
GO,93734,GOIÂNIA,183731,528525,211529,977844,766315,13608,40451
GO,93750,GOIANIRA,8161,14468,9252,33459,24207,404,1174
GO,93777,GOIÁS,6957,6345,4540,18640,14100,223,575
GO,93793,GOIATUBA,5328,12780,4734,24644,19910,376,1426
GO,93815,GUAPÓ,3471,5273,3130,12580,9450,157,549
GO,93831,GUARANI DE GOIÁS,1676,946,669,3459,2790,26,142
GO,93874,HEITORAÍ,1126,1358,653,3291,2638,39,115
GO,93890,HIDROLÂNDIA,4099,7323,3842,16154,12312,207,683
GO,93912,HIDROLINA,1179,1194,712,3288,2576,38,165
GO,93939,IACIARA,3117,1994,1478,6959,5481,75,295
GO,93955,INHUMAS,9838,18186,9231,39817,30586,522,2040
GO,93971,IPAMERI,5486,8356,4550,19435,14885,243,800
GO,93998,IPORÁ,6777,11074,5028,24144,19116,297,968
GO,94013,ISRAELÂNDIA,821,968,653,2570,1917,12,116
GO,94030,ITABERAÍ,9395,12060,6042,29013,22971,359,1157
GO,94072,ITAGUARU,1817,2023,1027,5140,4113,68,205
GO,94110,ITAJÁ,940,1475,928,3521,2593,35,143
GO,94137,ITAPACI,4651,5798,3328,14605,11277,140,688
GO,94153,ITAPIRAPUÃ,2338,2382,1548,6497,4949,58,171
GO,94196,ITAPURANGA,7224,8082,4109,20606,16497,282,909
GO,94218,ITARUMÃ,1301,1634,970,4144,3174,32,207
GO,94234,ITAUÇU,1809,3109,1050,6358,5308,84,306
GO,94250,ITUMBIARA,16542,34589,15799,71487,55688,1011,3546
GO,94277,IVOLÂNDIA,916,865,704,2578,1874,21,72
GO,94293,JANDAIA,1389,2650,1165,5596,4431,56,336
GO,94315,JARAGUÁ,5483,16996,5207,28978,23771,357,935
GO,94331,JATAÍ,16570,31326,16654,68351,51697,770,3031
GO,94358,JAUPACI,907,936,636,2601,1965,22,100
GO,94374,JOVIÂNIA,1481,2351,1028,5194,4166,69,265
GO,94390,JUSSARA,3863,6082,2873,13547,10674,124,605
GO,94439,LEOPOLDO DE BULHÕES,1631,2457,1088,5545,4457,84,285
GO,94455,LUZIÂNIA,27501,58032,18468,111062,92594,1929,5132
GO,94471,MAIRIPOTABA,548,1011,492,2147,1655,23,73
GO,94498,MAMBAÍ,1668,2241,1331,5511,4180,63,208
GO,94510,MARA ROSA,2457,2847,2029,7697,5668,85,279
GO,94536,MARZAGÃO,639,842,529,2143,1614,19,114
GO,94552,PARANAIGUARA,2638,2424,1576,7085,5509,66,381
GO,94579,MAURILÂNDIA,2475,2603,1623,7077,5454,67,309
GO,94595,MINEIROS,11335,18443,8314,40723,32409,515,2116
GO,94650,MOIPORÁ,478,831,646,2049,1403,31,63
GO,94676,MONTE ALEGRE DE GOIÁS,2402,993,1604,5219,3615,32,188
GO,94714,MONTES CLAROS DE GOIÁS,1922,2756,1343,6260,4917,47,192
GO,94730,MORRINHOS,8178,16158,7946,34240,26294,439,1519
GO,94757,MOSSÂMEDES,1696,1507,993,4408,3415,60,152
GO,94773,MOZARLÂNDIA,2891,4384,3386,11113,7727,102,350
GO,94790,MUTUNÓPOLIS,998,1347,762,3249,2487,31,111
GO,94854,NAZÁRIO,1664,3228,1398,6655,5257,75,290
GO,94870,NERÓPOLIS,5233,9868,5529,21876,16347,237,1009
GO,94897,NIQUELÂNDIA,8189,9865,7863,27599,19736,299,1383
GO,94919,NOVA AMÉRICA,520,1048,418,2099,1681,21,92
GO,94935,NOVA AURORA,678,709,304,1854,1550,24,139
GO,94951,NOVA ROMA,1159,549,657,2492,1835,28,99
GO,94978,NOVA VENEZA,2085,3297,1369,7113,5744,74,288
GO,95010,NOVO BRASIL,965,1339,617,3084,2467,41,122
GO,95036,ORIZONA,2934,5494,2342,11647,9305,213,664
GO,95052,OURO VERDE DE GOIÁS,758,1765,698,3450,2752,46,183
GO,95079,OUVIDOR,2497,2937,1536,7422,5886,68,384
GO,95095,PADRE BERNARDO,5051,7591,3520,17046,13526,239,645
GO,95117,PALMEIRAS DE GOIÁS,4454,9745,4873,20200,15327,217,911
GO,95133,PALMELO,533,957,476,2104,1628,18,120
GO,95150,PALMINÓPOLIS,812,1944,768,3681,2913,30,127
GO,95176,PANAMÁ,712,928,631,2416,1785,46,99
GO,95230,PARAÚNA,2252,3701,2051,8426,6375,68,354
GO,95311,PETROLINA DE GOIÁS,1540,3748,1378,7042,5664,85,291
GO,95354,PILAR DE GOIÁS,1027,946,747,2840,2093,30,90
GO,95397,PIRACANJUBA,4833,8475,4633,18844,14211,201,702
GO,95419,PIRANHAS,3133,3363,2225,9170,6945,64,385
GO,95435,PIRENÓPOLIS,5235,8368,3272,18026,14754,239,912
GO,95451,PIRES DO RIO,4136,10771,3904,20226,16322,282,1133
GO,95494,PONTALINA,3646,6222,2678,13403,10725,189,668
GO,95559,PORANGATU,9612,11934,6696,29468,22772,323,903
GO,95575,PORTELÂNDIA,1131,1050,608,3052,2444,45,218
GO,95613,POSSE,8402,8222,4444,22209,17765,255,886
GO,95630,QUIRINÓPOLIS,9923,13693,5872,31667,25795,475,1704
GO,95656,RIALMA,1757,4457,1643,8252,6609,98,297
GO,95672,RIANÁPOLIS,746,1887,809,3652,2843,42,168
GO,95710,RIO VERDE,31363,64085,26250,129055,102805,1941,5416
GO,95737,RUBIATABA,2868,7982,2804,14509,11705,159,696
GO,95753,SANCLERLÂNDIA,1852,3023,1171,6420,5249,62,312
GO,95770,SANTA BÁRBARA DE GOIÁS,1411,2439,988,5063,4075,62,163
GO,95796,SANTA CRUZ DE GOIÁS,742,1123,658,2652,1994,29,100
GO,95818,SANTA HELENA DE GOIÁS,8692,12118,5544,28329,22785,440,1535
GO,95834,SANTA RITA DO ARAGUAIA,1260,1636,853,3947,3094,39,159
GO,95850,SANTA ROSA DE GOIÁS,828,1249,445,2718,2273,43,153
GO,95877,SANTA TEREZA DE GOIÁS,934,1084,775,2954,2179,50,111
GO,95893,SANTA TEREZINHA DE GOIÁS,2972,2230,1360,6866,5506,72,232
GO,95915,SÃO DOMINGOS,2792,1672,1852,6584,4732,73,195
GO,95931,SÃO FRANCISCO DE GOIÁS,1036,2146,655,4149,3494,58,254
GO,95958,PLANALTINA,16631,22659,9715,54157,44442,1231,3921
GO,95974,SÃO JOÃO D ALIANÇA,2407,2015,1228,6042,4814,65,327
GO,95990,SÃO LUÍS DE MONTES BELOS,3838,13093,4651,22787,18136,266,939
GO,96016,SÃO MIGUEL DO ARAGUAIA,5022,7009,4203,16964,12761,143,587
GO,96059,SÃO SIMÃO,5336,4395,3036,13484,10448,109,608
GO,96075,SERRANÓPOLIS,1813,2142,1535,5919,4384,72,357
GO,96091,SILVÂNIA,4049,7116,2802,14817,12015,242,608
GO,96113,SÍTIO D ABADIA,1034,607,1060,2819,1759,18,100
GO,96172,TAQUARAL DE GOIÁS,1102,1759,1188,4349,3161,39,261
GO,96237,TRÊS RANCHOS,1182,1183,936,3496,2560,35,160
GO,96253,TRINDADE,19604,39180,18225,81137,62912,1092,3036
GO,96318,TURVÂNIA,992,2237,1118,4496,3378,45,104
GO,96334,URUAÇU,7855,11467,6545,27351,20806,368,1116
GO,96350,URUANA,2704,4321,1731,9325,7594,110,459
GO,96377,URUTAÍ,887,1193,530,2798,2268,34,154
GO,96393,VARJÃO,744,1696,957,3573,2616,39,137
GO,96415,VIANÓPOLIS,2167,5515,1804,10004,8200,133,385
GO,96458,ACREÚNA,4278,6063,2583,13679,11096,149,606
GO,96474,MINAÇU,6986,7944,5538,21339,15801,189,682
GO,96512,MUNDO NOVO,1615,1591,1018,4397,3379,43,130
GO,96539,NOVA CRIXÁS,3206,2586,2721,8770,6049,59,198
GO,96555,NOVA GLÓRIA,1957,2607,1238,6242,5004,63,377
GO,96571,VICENTINÓPOLIS,1808,2428,1014,5599,4585,53,296
GO,96610,AMERICANO DO BRASIL,1559,1934,737,4453,3716,62,161
GO,96695,ARAGUAPAZ,2058,1980,1715,5970,4255,57,160
GO,96717,ARENÓPOLIS,1157,1031,751,3054,2303,28,87
GO,96733,CACHOEIRA DOURADA,2563,2146,1904,7028,5124,56,359
GO,96750,DOVERLÂNDIA,2126,2154,1375,5953,4578,69,229
GO,96776,SANTO ANTÔNIO DO DESCOBERTO,10306,17921,8788,39472,30684,764,1693
GO,96814,INDIARA,3531,4236,2074,10596,8522,139,616
GO,96873,CAMPINAÇU,1029,904,647,2727,2080,33,114
GO,96890,SANTA ISABEL,906,1533,767,3347,2580,25,116
GO,96911,ADELÂNDIA,430,1387,414,2314,1900,24,59
GO,96938,ÁGUA FRIA DE GOIÁS,1025,1868,1237,4333,3096,59,144
MA,7005,ÁGUA DOCE DO MARANHÃO,6279,1027,3614,11207,7593,73,214
MA,7013,AFONSO CUNHA,4048,374,1658,6176,4518,22,74
MA,7021,ALTO ALEGRE DO MARANHÃO,10064,2010,4921,17465,12544,91,379
MA,7030,ALCÂNTARA,9125,1504,6616,17681,11065,124,312
MA,7048,ALTO ALEGRE DO PINDARÉ,11513,1741,6996,20811,13815,110,451
MA,7056,ALDEIAS ALTAS,9719,1899,5371,17531,12160,92,450
MA,7064,APICUM-AÇU,6014,1649,4089,11965,7876,62,151
MA,7072,ALTAMIRA DO MARANHÃO,2730,664,1824,5383,3559,33,132
MA,7080,AMAPÁ DO MARANHÃO,2571,697,1758,5188,3430,35,127
MA,7099,ALTO PARNAÍBA,3744,1453,2584,8037,5453,44,212
MA,7102,ARAGUANÃ,4315,580,2676,7705,5029,18,116
MA,7110,AMARANTE DO MARANHÃO,12451,5186,7189,25496,18307,185,485
MA,7129,BACABEIRA,8712,1618,1816,12601,10785,101,354
MA,7137,ANAJATUBA,10794,1690,2979,16028,13049,102,463
MA,7145,BACURITUBA,2728,338,1836,4979,3143,27,50
MA,7153,ANAPURUS,8094,1394,2615,12477,9862,74,300
MA,7161,BELÁGUA,4358,295,1118,5911,4793,34,106
MA,7170,ARAIOSES,19425,2476,9936,32858,22922,253,768
MA,7188,BELA VISTA DO MARANHÃO,5266,1026,2797,9303,6506,42,172
MA,7196,ARARI,12390,3346,6538,22998,16460,174,550
MA,7200,BERNARDO DO MEARIM,2645,845,1530,5139,3609,22,97
MA,7218,AXIXÁ,5448,1049,1218,7965,6747,70,180
MA,7226,CACHOEIRA GRANDE,4284,531,2787,7759,4972,34,123
MA,7234,BACABAL,30586,15311,8246,58468,50222,678,3647
MA,7242,DAVINÓPOLIS,5126,2739,3313,11481,8168,96,207
MA,7250,BACURI,7290,930,5060,13573,8513,62,231
MA,7269,BOM JESUS DAS SELVAS,9651,3412,5746,19204,13458,117,278
MA,7277,BALSAS,23547,19170,12475,57257,44782,592,1473
MA,7285,BOM LUGAR,5541,1131,1750,8644,6894,53,169
MA,7293,BARÃO DE GRAJAÚ,9080,1110,3442,14086,10644,92,362
MA,7307,BREJO DE AREIA,3969,879,2000,7055,5055,32,175
MA,7315,BARRA DO CORDA,28593,11710,13888,55929,42041,385,1353
MA,7323,BOA VISTA DO GURUPI,3038,734,1535,5430,3895,33,90
MA,7331,BARREIRINHAS,26149,4877,5490,37477,31987,252,709
MA,7340,BURITICUPU,21505,7300,5808,35605,29797,262,730
MA,7358,BENEDITO LEITE,2439,439,924,3905,2981,16,87
MA,7366,BURITIRANA,5179,2363,3151,11009,7858,88,228
MA,7374,BEQUIMÃO,9026,1519,6317,17433,11116,160,411
MA,7382,CAMPESTRE DO MARANHÃO,4543,1957,2860,9640,6780,79,201
MA,7390,BREJO,13236,2663,3974,20497,16523,148,476
MA,7404,CAPINZAL DO NORTE,4850,1276,2335,8708,6373,51,196
MA,7412,BURITI,12504,1608,6196,20901,14705,129,464
MA,7420,CENTRAL DO MARANHÃO,3669,313,2867,6993,4126,23,121
MA,7439,BURITI BRAVO,10332,1470,5615,17900,12285,103,380
MA,7447,CENTRO DO GUILHERME,4258,650,1800,6837,5037,22,107
MA,7455,CAJAPIÓ,4956,422,3500,9068,5568,34,156
MA,7463,CENTRO NOVO DO MARANHÃO,6495,1150,2974,10890,7916,42,229
MA,7471,CAJARI,8836,881,3948,13945,9997,71,209
MA,7480,CIDELÂNDIA,5674,1739,3070,10716,7646,69,164
MA,7498,CÂNDIDO MENDES,7542,1942,5556,15329,9773,60,229
MA,7501,CONCEIÇÃO DO LAGO-AÇU,5890,1436,3003,10598,7595,69,200
MA,7510,CANTANHEDE,7311,1179,4140,13023,8883,69,324
MA,7528,FEIRA NOVA DO MARANHÃO,3083,1216,1113,5671,4558,56,203
MA,7536,CAROLINA,7481,4032,5363,17497,12134,119,502
MA,7544,FERNANDO FALCÃO,4812,993,1536,7454,5918,12,101
MA,7552,CARUTAPERA,8274,2893,5652,17352,11700,100,433
MA,7560,FORMOSA DA SERRA NEGRA,6215,2707,1745,11155,9410,129,359
MA,7579,CAXIAS,58289,18488,16210,96386,80176,975,2424
MA,7595,CEDRAL,4260,877,3332,8705,5373,52,184
MA,7609,GOVERNADOR EDISON LOBÃO,6128,3627,3733,13884,10151,107,289
MA,7617,CHAPADINHA,29774,8385,6950,46850,39900,403,1338
MA,7625,GOVERNADOR LUIZ ROCHA,3049,876,1989,6082,4093,29,139
MA,7633,CODÓ,39224,11473,17228,70404,53176,553,1926
MA,7641,GOVERNADOR NEWTON BELLO,4138,757,2720,7788,5068,29,144
MA,7650,COELHO NETO,19510,3734,4314,28596,24282,232,806
MA,7668,GOVERNADOR NUNES FREIRE,8543,2633,5338,16972,11634,86,372
MA,7676,COLINAS,15648,2917,4032,23389,19357,174,618
MA,7684,IGARAPÉ DO MEIO,6680,957,3585,11430,7845,55,153
MA,7692,COROATÁ,22054,8436,8864,40769,31905,339,1076
MA,7706,ITAIPAVA DO GRAJAÚ,5254,1178,1478,8089,6611,43,136
MA,7714,CURURUPU,12685,2196,9834,25213,15379,150,348
MA,7722,ITINGA DO MARANHÃO,6602,4905,5198,17185,11987,120,360
MA,7730,DOM PEDRO,8585,3588,5391,18127,12736,165,398
MA,7749,JATOBÁ,3852,650,1926,6561,4635,19,114
MA,7757,DUQUE BACELAR,5931,591,2637,9345,6708,32,154
MA,7765,JENIPAPO DOS VIEIRAS,6844,1291,2443,10944,8501,54,312
MA,7773,ESPERANTINÓPOLIS,8042,1781,2594,12844,10250,98,329
MA,7781,JUNCO DO MARANHÃO,2997,518,983,4637,3654,26,113
MA,7790,FORTALEZA DOS NOGUEIRAS,5029,1879,1737,9025,7288,114,266
MA,7803,LAGO DOS RODRIGUES,4598,1217,2054,8031,5977,46,116
MA,7811,FORTUNA,6981,1263,3584,12198,8614,73,297
MA,7820,LAGOA DO MATO,5144,576,2395,8351,5956,33,203
MA,7838,GODOFREDO VIANA,3340,1195,3188,7863,4675,42,98
MA,7846,LAGOA GRANDE DO MARANHÃO,5200,1141,2279,8827,6548,41,166
MA,7854,GONÇALVES DIAS,6930,1619,3944,12844,8900,76,275
MA,7862,LAJEADO NOVO,2872,1386,928,5338,4410,39,113
MA,7870,GOVERNADOR ARCHER,4478,911,2621,8293,5672,50,233
MA,7889,MARACAÇUMÉ,7034,2229,3044,12710,9666,100,303
MA,7897,GOVERNADOR EUGÊNIO BARROS,6396,1250,3605,11512,7907,58,203
MA,7900,MARAJÁ DO SENA,3643,654,2007,6413,4406,23,86
MA,7919,GRAÇA ARANHA,3207,643,1755,5727,3972,26,96
MA,7927,MARANHÃOZINHO,4380,825,2061,7473,5412,36,171
MA,7935,GRAJAÚ,22150,9502,6354,39098,32744,317,775
MA,7943,MATÕES DO NORTE,3974,491,800,5478,4678,42,171
MA,7951,GUIMARÃES,5285,686,2510,8860,6350,79,300
MA,7960,MILAGRES DO MARANHÃO,3340,418,1849,5742,3893,30,105
MA,7978,HUMBERTO DE CAMPOS,10553,1958,8579,21532,12953,92,350
MA,7986,NOVA COLINAS,2368,723,934,4180,3246,40,115
MA,7994,ICATU,11097,1551,4068,17155,13087,104,335
MA,8001,NOVA OLINDA DO MARANHÃO,7010,1341,4157,12877,8720,98,271
MA,8010,IGARAPÉ GRANDE,4024,1853,1054,7173,6119,65,177
MA,8028,OLINDA NOVA DO MARANHÃO,5384,869,3620,10158,6538,52,233
MA,8036,IMPERATRIZ,58054,70936,26237,162605,136368,2466,4912
MA,8044,PAULINO NEVES,7811,1025,4047,13284,9237,102,299
MA,8052,SÃO LUÍS GONZAGA DO MARANHÃO,10954,1359,2998,15732,12734,84,337
MA,8060,PEDRO DO ROSÁRIO,9700,1146,5584,16892,11308,110,352
MA,8079,ITAPECURU MIRIM,25857,5407,7207,39949,32742,345,1133
MA,8087,PERITORÓ,9674,1457,2513,14031,11518,74,313
MA,8095,JOÃO LISBOA,9181,4185,2683,16783,14100,225,509
MA,8109,PORTO RICO DO MARANHÃO,2554,745,3031,6475,3444,49,96
MA,8117,JOSELÂNDIA,6176,1382,1666,9538,7872,63,251
MA,8125,PRESIDENTE MÉDICI,2944,484,1686,5240,3554,27,99
MA,8133,LAGO DA PEDRA,14504,8142,4778,28329,23551,239,666
MA,8141,PRESIDENTE SARNEY,8456,1002,4474,14212,9738,59,221
MA,8150,LAGO DO JUNCO,4898,1262,2064,8351,6287,32,95
MA,8168,RAPOSA,9840,3693,3790,18080,14290,207,550
MA,8176,LAGO VERDE,7240,957,3648,12140,8492,72,223
MA,8184,RIBAMAR FIQUENE,2942,1459,1834,6375,4541,41,99
MA,8192,LIMA CAMPOS,4796,2060,2742,9903,7161,62,243
MA,8206,SANTA FILOMENA DO MARANHÃO,3287,605,714,4719,4005,27,86
MA,8214,LORETO,4674,1014,2431,8391,5960,67,205
MA,8222,SANTANA DO MARANHÃO,4383,694,3021,8291,5270,36,157
MA,8230,LUÍS DOMINGUES,2407,1116,2042,5710,3668,24,121
MA,8249,SANTO AMARO DO MARANHÃO,5381,684,3403,9661,6258,41,152
MA,8257,MAGALHÃES DE ALMEIDA,6261,1697,4376,12716,8340,105,277
MA,8265,SÃO DOMINGOS DO AZEITÃO,3571,639,1170,5518,4348,23,115
MA,8273,MATA ROMA,8737,1652,1923,12677,10754,64,301
MA,8281,SÃO FRANCISCO DO BREJÃO,3085,1776,1984,7022,5038,60,117
MA,8290,MATINHA,10451,2162,3811,16939,13128,169,346
MA,8303,SÃO JOÃO DO CARÚ,5198,1101,3511,10012,6501,60,142
MA,8311,MATÕES,14552,2144,5115,22371,17256,126,434
MA,8320,SÃO JOÃO DO PARAÍSO,4058,1717,2137,8183,6046,76,195
MA,8338,MIRADOR,8886,1514,2701,13577,10876,71,405
MA,8346,SÃO JOÃO DO SOTER,7948,822,2233,11283,9050,59,221
MA,8354,MIRINZAL,5740,1360,2210,9649,7439,79,260
MA,8362,SÃO JOSÉ DOS BASÍLIOS,3743,439,877,5167,4290,21,87
MA,8370,MONÇÃO,11864,1875,3985,18201,14216,102,375
MA,8389,SÃO PEDRO DA ÁGUA BRANCA,4047,1857,3243,9313,6070,38,128
MA,8397,MONTES ALTOS,3634,1243,953,6097,5144,60,207
MA,8400,SÃO PEDRO DOS CRENTES,1191,1611,988,3889,2901,34,65
MA,8419,MORROS,8239,1575,4650,14838,10188,83,291
MA,8427,SÃO RAIMUNDO DO DOCA BEZERRA,2935,517,1698,5286,3588,33,103
MA,8435,NINA RODRIGUES,5104,777,2846,8917,6071,29,161
MA,8443,SÃO ROBERTO,2758,417,1270,4540,3270,15,80
MA,8451,NOVA IORQUE,2311,364,913,3683,2770,17,78
MA,8460,SATUBINHA,3138,741,1688,5757,4069,31,159
MA,8478,OLHO D ÁGUA DAS CUNHÃS,8004,1606,4894,14996,10102,92,400
MA,8486,SENADOR ALEXANDRE COSTA,4216,908,2306,7595,5289,39,126
MA,8494,PAÇO DO LUMIAR,30503,18343,10952,62895,51943,965,2132
MA,8508,SENADOR LA ROCQUE,6100,2093,3605,12148,8543,88,262
MA,8516,PALMEIRÂNDIA,9139,984,5757,16212,10455,88,244
MA,8524,SERRANO DO MARANHÃO,4743,322,2984,8279,5295,34,196
MA,8532,PARAIBANO,8298,1372,3160,13294,10134,59,405
MA,8540,SUCUPIRA DO RIACHÃO,2538,298,1329,4284,2955,22,97
MA,8559,PARNARAMA,14918,1676,9093,26373,17280,144,542
MA,8567,TRIZIDELA DO VALE,7680,3426,3731,15296,11565,84,375
MA,8575,PASSAGEM FRANCA,7677,1672,2312,12110,9798,79,370
MA,8583,TUFILÂNDIA,3436,528,1548,5634,4086,23,99
MA,8591,PASTOS BONS,7930,1504,3113,12983,9870,70,366
MA,8605,TURILÂNDIA,7558,1252,5613,14780,9167,103,254
MA,8613,PEDREIRAS,13147,6758,8889,29643,20754,218,631
MA,8621,VILA NOVA DOS MARTÍRIOS,3205,1650,2458,7506,5048,47,146
MA,8630,PENALVA,13696,1628,10049,25877,15828,113,391
MA,8656,PERI MIRIM,5827,744,4659,11438,6779,45,163
MA,8672,PINDARÉ-MIRIM,13705,3370,4883,22678,17795,161,559
MA,8699,PINHEIRO,29419,8749,8591,48350,39759,520,1071
MA,8710,PIO XII,11317,2003,6118,19947,13829,90,419
MA,8737,PIRAPEMAS,7233,1136,2589,11259,8670,49,252
MA,8753,POÇÃO DE PEDRAS,8116,2159,2852,13572,10720,114,331
MA,8770,PORTO FRANCO,7740,4369,2856,15527,12671,155,407
MA,8796,PRESIDENTE DUTRA,13964,5581,4515,24873,20358,212,601
MA,8818,PRESIDENTE JUSCELINO,5297,752,3159,9385,6226,46,131
MA,8834,PRESIDENTE VARGAS,5785,597,2905,9543,6638,63,193
MA,8850,PRIMEIRA CRUZ,5131,542,4318,10159,5841,35,133
MA,8877,RIACHÃO,8274,2330,3256,14392,11136,112,420
MA,8893,SÃO JOSÉ DE RIBAMAR,49761,26235,19569,100238,80669,1496,3177
MA,8915,ROSÁRIO,16994,4140,3946,26143,22197,284,779
MA,8931,SAMBAÍBA,2392,928,1740,5181,3441,20,101
MA,8958,SANTA HELENA,12055,2667,4411,19759,15348,158,468
MA,8974,SANTA LUZIA,26299,5352,5659,38433,32774,287,836
MA,8990,SANTA QUITÉRIA DO MARANHÃO,12201,1668,6504,20867,14363,116,378
MA,9016,SANTA RITA,13813,2720,4366,21785,17419,220,666
MA,9032,SANTO ANTÔNIO DOS LOPES,7425,2324,3516,13700,10184,86,349
MA,9059,SÃO BENEDITO DO RIO PRETO,9034,1116,2054,12528,10474,77,247
MA,9075,SÃO BENTO,14591,2907,7656,25852,18196,212,486
MA,9091,SÃO BERNARDO,11827,2167,6349,20969,14620,110,516
MA,9113,SÃO DOMINGOS DO MARANHÃO,13118,5483,8089,27643,19554,215,738
MA,9130,SÃO FÉLIX DE BALSAS,2190,370,1276,3931,2655,24,71
MA,9156,SÃO FRANCISCO DO MARANHÃO,5748,662,2727,9437,6710,67,233
MA,9172,SÃO JOÃO BATISTA,10398,1036,6961,18758,11797,80,283
MA,9199,SÃO JOÃO DOS PATOS,10007,2841,6362,19944,13582,162,572
MA,9210,SÃO LUÍS,306690,224108,124235,693426,569191,11871,26522
MA,9237,SÃO MATEUS DO MARANHÃO,14805,3483,3726,22841,19115,168,659
MA,9253,SÃO RAIMUNDO DAS MANGABEIRAS,6857,2985,4567,14832,10265,111,312
MA,9270,SÃO VICENTE FERRER,8352,1111,5502,15442,9940,109,368
MA,9296,SÍTIO NOVO,7484,2800,1293,11989,10696,150,262
MA,9318,SUCUPIRA DO NORTE,4801,1024,2369,8412,6043,59,159
MA,9334,TASSO FRAGOSO,3045,1333,1892,6527,4635,28,229
MA,9350,TIMBIRAS,11438,1936,4753,18653,13900,131,395
MA,9377,TIMON,62087,21797,16104,104319,88215,933,3398
MA,9393,TUNTUM,13549,4365,4278,23050,18772,202,656
MA,9415,TURIAÇU,14412,2348,9850,27048,17198,123,315
MA,9431,TUTÓIA,20863,4055,4755,31181,26426,327,1181
MA,9458,URBANO SANTOS,14355,1835,3555,20287,16732,128,414
MA,9474,VARGEM GRANDE,17890,3081,4800,26730,21930,189,770
MA,9490,VIANA,19698,5289,8365,34480,26115,271,857
MA,9512,VITÓRIA DO MEARIM,13071,3367,8715,25777,17062,164,460
MA,9539,VITORINO FREIRE,12628,3722,7442,24498,17056,160,546
MA,9555,BOM JARDIM,14225,3095,9060,27092,18032,140,572
MA,9571,SANTA INÊS,28127,12991,10102,53022,42920,499,1303
MA,9598,PAULO RAMOS,8221,2262,3222,14115,10893,89,321
MA,9610,AÇAILÂNDIA,25808,27430,14377,70244,55867,812,1817
MA,9636,ESTREITO,9599,6238,3787,20333,16546,201,508
MA,9652,SANTA LUZIA DO PARUÁ,8679,2640,4990,16867,11877,145,413
MA,9679,ARAME,11202,3040,6603,21289,14686,85,359
MA,9695,MIRANDA DO NORTE,8016,2209,5074,15761,10687,118,344
MA,9717,ZÉ DOCA,17495,4658,4722,27785,23063,228,682
MG,40002,ALFREDO VASCONCELOS,1955,1922,825,5479,4654,112,665
MG,40010,ABADIA DOS DOURADOS,1821,2117,1224,5772,4548,83,527
MG,40029,ARAPORÃ,1767,2442,1028,5728,4700,68,423
MG,40037,ABAETÉ,4289,7581,4970,18605,13635,375,1390
MG,40045,BRASILÂNDIA DE MINAS,4341,2976,3015,11208,8193,134,742
MG,40053,ABRE CAMPO,3954,3260,2349,10626,8277,211,852
MG,40061,CAPITÃO ANDRADE,1115,1414,1229,4133,2904,48,327
MG,40070,ACAIACA,1377,782,1026,3549,2523,57,307
MG,40088,CARNEIRINHO,2871,2623,1731,7698,5967,65,408
MG,40096,AÇUCENA,2410,2103,3392,8783,5391,147,731
MG,40100,CATUJI,3374,1242,2334,7649,5315,83,616
MG,40118,ÁGUA BOA,4205,2190,4780,12102,7322,104,823
MG,40126,DIVISA ALEGRE,1586,1278,1508,4869,3361,36,461
MG,40134,ÁGUA COMPRIDA,526,991,632,2377,1745,34,194
MG,40142,DIVISÓPOLIS,2856,1272,1637,6322,4685,65,492
MG,40150,AGUANIL,1080,1399,1014,3973,2959,86,394
MG,40169,DURANDÉ,2517,1729,1733,6534,4801,114,441
MG,40177,ÁGUAS FORMOSAS,5099,3995,5067,15394,10327,134,1099
MG,40185,ENTRE FOLHAS,1657,1870,1699,5728,4029,113,389
MG,40193,ÁGUAS VERMELHAS,4014,1592,3784,10301,6517,120,791
MG,40207,FERVEDOURO,3215,2200,2242,8486,6244,112,717
MG,40215,AIMORÉS,4715,7712,5451,19365,13914,276,1211
MG,40223,FRANCISCÓPOLIS,1697,840,2072,5026,2954,33,384
MG,40231,AIURUOCA,1393,1701,1474,5143,3669,99,476
MG,40240,ICARAÍ DE MINAS,3828,1259,2284,7826,5542,67,388
MG,40258,ALAGOA,462,1165,624,2499,1875,62,186
MG,40266,IPABA,3825,5175,3883,13971,10088,157,931
MG,40274,ALBERTINA,352,1419,615,2635,2020,54,195
MG,40282,JAÍBA,9618,5479,5962,23280,17318,274,1947
MG,40290,ALÉM PARAÍBA,9318,9512,7407,28464,21057,472,1755
MG,40304,JAMPRUCA,1727,842,1215,4190,2975,51,355
MG,40312,ALFENAS,12837,27671,14018,59546,45528,1149,3871
MG,40320,JUATUBA,5311,8705,4477,20969,16492,472,2004
MG,40339,ALMENARA,12687,5418,9211,29715,20504,303,2096
MG,40347,LAGOA GRANDE,2492,2307,1772,7121,5349,113,437
MG,40355,ALPERCATA,1961,2076,1791,6351,4560,99,424
MG,40363,LIMEIRA DO OESTE,2345,1831,1061,5667,4606,56,374
MG,40371,ALPINÓPOLIS,4332,6205,3432,15481,12049,280,1232
MG,40380,LONTRA,3635,1109,2583,7916,5333,86,503
MG,40398,ALTEROSA,3275,5079,2406,11856,9450,215,881
MG,40401,MAMONAS,2579,1169,1584,5774,4190,40,402
MG,40410,ALTO RIO DOCE,4166,1908,3298,10361,7063,171,818
MG,40428,MATA VERDE,2348,1730,1490,6179,4689,58,553
MG,40436,ALVARENGA,1473,1422,1229,4424,3195,59,241
MG,40444,MATIAS CARDOSO,3074,859,2116,6615,4499,42,524
MG,40452,ALVINÓPOLIS,5331,3100,3305,13220,9915,220,1264
MG,40460,MONTEZUMA,2369,1014,1683,5625,3942,52,507
MG,40479,ALVORADA DE MINAS,1662,573,1482,4140,2658,49,374
MG,40487,NAQUE,1611,1633,1505,5321,3816,98,474
MG,40495,AMPARO DO SERRA,2161,817,1248,4645,3397,70,349
MG,40509,NOVO ORIENTE DE MINAS,3303,1315,3342,8839,5497,90,789
MG,40517,ANDRADAS,4563,15971,6357,29807,23450,735,2181
MG,40525,PALMÓPOLIS,2222,1048,2280,6148,3868,63,535
MG,40533,CACHOEIRA DE PAJEÚ,2698,1403,2198,6887,4689,88,500
MG,40541,PEDRAS DE MARIA DA CRUZ,3656,876,2827,7830,5003,63,408
MG,40550,ANDRELÂNDIA,2698,3252,2788,9860,7072,209,913
MG,40568,PERIQUITO,1770,2005,2084,6370,4286,96,415
MG,40576,ANTÔNIO CARLOS,3626,2788,1988,9547,7559,212,933
MG,40584,PONTO DOS VOLANTES,3304,1748,2868,8768,5900,116,732
MG,40592,ANTÔNIO DIAS,2578,2765,2488,8859,6371,148,880
MG,40606,RIACHINHO,2314,1052,1707,5414,3707,35,306
MG,40614,ANTÔNIO PRADO DE MINAS,692,675,457,1965,1508,33,108
MG,40622,ROSÁRIO DA LIMEIRA,1962,1346,1042,4955,3913,100,505
MG,40630,ARAÇAÍ,684,860,891,2752,1861,49,268
MG,40649,SANTA BÁRBARA DO LESTE,2039,2438,1782,7045,5263,115,671
MG,40657,ARACITABA,794,539,748,2350,1602,60,209
MG,40665,SANTA RITA DE MINAS,1528,2274,1461,5901,4440,98,540
MG,40673,ARAÇUAÍ,9420,6278,10211,28193,17982,349,1935
MG,40681,SANTANA DO PARAÍSO,4340,9626,5069,20861,15792,327,1499
MG,40690,ARAGUARI,19055,41697,20622,88150,67528,1240,5536
MG,40703,SÃO JOÃO DA LAGOA,2042,892,1407,4741,3334,42,358
MG,40711,ARANTINA,1081,697,500,2560,2060,40,242
MG,40720,SÃO JOÃO DO MANHUAÇU,3211,2895,1723,8548,6825,147,572
MG,40738,ARAPONGA,3228,947,1815,6675,4860,150,535
MG,40746,SÃO JOÃO DO MANTENINHA,1454,1854,1300,5005,3705,98,299
MG,40754,ARAPUÁ,573,1434,754,3165,2411,83,321
MG,40762,SÃO JOÃO DO PACUÍ,1797,520,1234,3835,2601,34,250
MG,40770,ARAÚJOS,1234,3172,1291,6395,5104,164,534
MG,40789,SÃO JOSÉ DA LAPA,4735,8141,3276,18003,14727,406,1445
MG,40797,ARAXÁ,18890,33021,16700,76772,60072,1862,6299
MG,40800,SARZEDO,5246,9815,3367,20886,17519,517,1941
MG,40819,ARCEBURGO,1486,3245,1565,7190,5625,149,745
MG,40827,SEM PEIXE,1213,573,1423,3508,2085,49,250
MG,40835,ARCOS,7726,13571,6144,31574,25430,908,3225
MG,40843,SENADOR AMARAL,1348,2346,1034,5126,4092,73,325
MG,40851,AREADO,2224,5579,2608,11660,9052,275,974
MG,40860,UBAPORANGA,2458,3808,3070,10162,7092,138,688
MG,40878,ARGIRITA,1154,687,711,2820,2109,49,219
MG,40886,URUCUIA,3170,1341,2335,7342,5007,54,442
MG,40894,ARINOS,4986,2892,4719,13564,8845,122,845
MG,40908,VARGEM ALEGRE,1694,1956,2278,6431,4153,65,438
MG,40916,ASTOLFO DUTRA,3309,4224,2300,10839,8539,171,835
MG,40924,JOSENÓPOLIS,1302,451,1610,3658,2048,19,276
MG,40932,ATALÉIA,4321,1836,4397,11415,7018,94,767
MG,40940,JUVENÍLIA,2315,991,1974,5636,3662,49,307
MG,40959,AUGUSTO DE LIMA,1367,1053,1517,4349,2832,64,348
MG,40967,LEME DO PRADO,1581,776,1360,4068,2708,55,296
MG,40975,BAEPENDI,3106,7578,3312,15572,12260,308,1268
MG,40983,LUISBURGO,1608,2070,1199,5451,4252,91,483
MG,40991,BALDIM,1905,2562,1810,6927,5117,140,510
MG,41009,LUISLÂNDIA,3156,570,2081,6169,4088,36,326
MG,41017,BAMBUÍ,6120,6090,5009,19164,14155,382,1563
MG,41025,MÁRIO CAMPOS,2747,4822,2198,11145,8947,301,1077
MG,41033,BANDEIRA,1988,506,1458,4322,2864,42,328
MG,41041,MARTINS SOARES,2488,2047,1800,6936,5136,133,468
MG,41050,BANDEIRA DO SUL,1061,2609,1046,5302,4256,112,474
MG,41068,MIRAVÂNIA,1623,522,1507,3916,2409,28,236
MG,41076,BARÃO DE COCAIS,7043,8352,4893,23594,18701,555,2751
MG,41084,MONTE FORMOSO,1784,613,1671,4460,2789,34,358
MG,41092,BARÃO DE MONTE ALTO,2287,1480,1356,5532,4176,56,353
MG,41106,NATALÂNDIA,1247,674,847,2958,2111,32,158
MG,41114,BARBACENA,32411,35585,19517,98327,78810,2026,8788
MG,41122,NINHEIRA,2546,1535,2896,7822,4926,135,710
MG,41130,BARRA LONGA,2272,1063,1703,5624,3921,86,500
MG,41149,NOVA BELÉM,1172,1049,926,3412,2486,31,234
MG,41157,TRÊS MARIAS,5797,8862,6452,23351,16899,415,1825
MG,41165,NOVA PORTEIRINHA,2539,1366,916,5350,4434,57,472
MG,41173,BARROSO,5530,5575,3817,17297,13480,409,1966
MG,41181,NOVORIZONTE,1705,1023,1355,4470,3115,59,328
MG,41190,BELA VISTA DE MINAS,2997,2374,1529,7789,6260,151,738
MG,41203,OLHOS D ÁGUA,2387,708,1589,5062,3473,37,341
MG,41211,BELMIRO BRAGA,1368,719,662,2998,2336,44,205
MG,41220,ORATÓRIOS,1950,746,1155,4328,3173,57,420
MG,41238,BELO HORIZONTE,472887,901513,403945,1958854,1554909,42776,137733
MG,41246,ORIZÂNIA,2481,1625,1706,6460,4754,107,541
MG,41254,BELO ORIENTE,5200,6702,5208,19169,13961,353,1706
MG,41262,PADRE CARVALHO,1884,640,1962,4850,2888,41,323
MG,41270,BELO VALE,2656,2705,1480,7690,6210,203,646
MG,41289,PAI PEDRO,2380,762,1489,5029,3540,39,359
MG,41297,BERILO,3534,1118,3898,9418,5520,112,756
MG,41300,PATIS,2376,608,1660,4986,3326,31,311
MG,41319,BERTÓPOLIS,1704,796,1310,4092,2782,37,245
MG,41327,PEDRA BONITA,2084,1763,929,5249,4320,104,369
MG,41335,BETIM,75026,122576,28440,259534,231094,6513,26979
MG,41343,PIEDADE DE CARATINGA,1848,2876,1882,7329,5447,119,604
MG,41351,BIAS FORTES,1645,681,1033,3618,2585,66,193
MG,41360,PINGO D ÁGUA,1388,1024,1331,4155,2824,45,367
MG,41378,BICAS,3512,4066,2960,11591,8631,151,902
MG,41386,PINTÓPOLIS,2731,871,2265,6288,4023,68,353
MG,41394,BIQUINHAS,746,934,963,2967,2004,63,261
MG,41408,PONTO CHIQUE,1632,505,1327,3785,2458,39,282
MG,41416,BOA ESPERANÇA,7496,12864,8221,31751,23530,723,2447
MG,41424,REDUTO,1798,1998,1481,5700,4219,78,345
MG,41432,BOCAINA DE MINAS,1345,1600,1099,4486,3387,116,326
MG,41440,SANTA BÁRBARA DO MONTE VERDE,1287,868,644,3057,2413,26,232
MG,41459,BOCAIÚVA,15564,7772,9717,36011,26294,456,2502
MG,41467,SANTA CRUZ DE MINAS,1464,3011,1266,6560,5294,161,658
MG,41475,BOM DESPACHO,6441,19194,8660,38159,29499,983,2881
MG,41483,SANTA CRUZ DE SALINAS,2034,418,1530,4361,2831,58,321
MG,41491,BOM JARDIM DE MINAS,1948,2010,1308,5813,4505,89,458
MG,41505,SANTA HELENA DE MINAS,2189,742,1613,5012,3399,54,414
MG,41513,BOM JESUS DA PENHA,657,1627,730,3420,2690,89,317
MG,41521,SANTO ANTÔNIO DO RETIRO,2756,699,1920,5978,4058,49,554
MG,41530,BOM JESUS DO AMPARO,1708,1401,1031,4858,3827,119,599
MG,41548,SÃO DOMINGOS DAS DORES,1600,1801,983,4937,3954,102,451
MG,41556,BOM JESUS DO GALHO,3754,3778,3251,12118,8867,222,1113
MG,41564,SÃO FÉLIX DE MINAS,992,1178,1132,3546,2414,27,217
MG,41572,BOM REPOUSO,2568,3621,1465,8615,7150,207,754
MG,41580,SÃO GERALDO DO BAIXIO,1008,975,958,3150,2192,34,175
MG,41599,BOM SUCESSO,3899,5548,3911,15402,11491,420,1624
MG,41602,SÃO JOÃO DAS MISSÕES,4425,1271,2343,8892,6549,70,783
MG,41610,BONFIM,2035,2415,1529,6849,5320,220,650
MG,41629,SÃO JOAQUIM DE BICAS,6033,6701,4272,19230,14958,394,1830
MG,41637,BONFINÓPOLIS DE MINAS,1736,1267,1776,5113,3337,70,264
MG,41645,SÃO JOSÉ DA BARRA,1742,2302,1596,6226,4630,122,464
MG,41653,BORDA DA MATA,2440,6615,2913,13374,10461,233,1173
MG,41661,ALTO CAPARAÓ,789,2350,736,4161,3425,69,217
MG,41670,BOTELHOS,4129,4289,3073,12757,9684,244,1022
MG,41688,ANGELÂNDIA,1938,1485,2490,6591,4101,136,542
MG,41696,BOTUMIRIM,2278,719,1856,5245,3389,52,340
MG,41700,ARICANDUVA,1907,759,1505,4654,3149,90,393
MG,41718,BRASÍLIA DE MINAS,10990,4982,8407,26694,18287,303,2012
MG,41726,BERIZAL,1768,647,1029,3771,2742,46,281
MG,41734,BRÁS PIRES,1426,1166,1455,4493,3038,65,381
MG,41742,BONITO DE MINAS,3741,680,2704,7671,4967,61,485
MG,41750,BRAÚNAS,1356,1216,1287,4309,3022,85,365
MG,41769,BUGRE,1020,1616,1242,4225,2983,63,284
MG,41777,BRAZÓPOLIS,2508,5836,3374,13060,9686,305,1037
MG,41785,CABECEIRA GRANDE,1448,1957,1527,5351,3824,81,338
MG,41793,BRUMADINHO,7164,12215,5559,28171,22612,596,2637
MG,41807,CAMPO AZUL,1763,453,1488,3953,2465,20,229
MG,41815,BUENO BRANDÃO,1535,4440,2051,8939,6888,201,712
MG,41823,CANTAGALO,1367,721,1335,3863,2528,68,372
MG,41831,BUENÓPOLIS,2480,1870,3450,8534,5084,132,602
MG,41840,CATAS ALTAS,1382,1591,977,4627,3650,82,595
MG,41858,BURITIS,5110,6521,5613,18520,12907,218,1058
MG,41866,CATUTI,2054,653,1236,4309,3073,41,325
MG,41874,BURITIZEIRO,6497,4703,5802,19095,13293,295,1798
MG,41882,CHAPADA GAÚCHA,3729,1501,2405,8206,5801,69,502
MG,41890,CABO VERDE,3221,3367,2256,9714,7458,183,687
MG,41904,CÔNEGO MARINHO,3152,566,1780,5912,4132,39,375
MG,41912,CACHOEIRA DA PRATA,978,1461,760,3518,2758,77,242
MG,41920,CONFINS,1425,2985,1080,6138,5058,144,504
MG,41939,CACHOEIRA DE MINAS,1654,4859,1866,9421,7555,190,852
MG,41947,CÓRREGO FUNDO,1311,1927,959,5169,4210,147,825
MG,41955,CACHOEIRA DOURADA,956,515,613,2208,1595,13,111
MG,41963,CRISÓLITA,2182,656,1660,4885,3225,36,351
MG,41971,CAETANÓPOLIS,1640,3748,1845,8364,6519,178,953
MG,41980,CUPARAQUE,726,1853,1362,4204,2842,37,226
MG,41998,CAETÉ,8544,13593,7376,33651,26275,820,3318
MG,42005,CURRAL DE DENTRO,2113,1457,1903,6069,4166,61,535
MG,42013,CAIANA,1594,1014,945,3920,2975,66,301
MG,42021,DELTA,2066,1893,1555,6093,4538,96,483
MG,42030,CAJURI,1986,976,801,4215,3414,90,362
MG,42048,DOM BOSCO,1012,1131,1044,3400,2356,44,169
MG,42056,CALDAS,2390,5172,2409,11057,8648,210,876
MG,42064,FREI LAGONEGRO,1393,652,804,3242,2438,43,350
MG,42072,CAMACHO,1245,908,885,3416,2531,104,274
MG,42080,FRUTA DE LEITE,1976,503,2171,5046,2875,52,344
MG,42099,CAMANDUCAIA,3403,7870,4194,17209,13015,451,1291
MG,42102,GAMELEIRAS,1985,814,1197,4333,3136,28,309
MG,42110,CAMBUÍ,4163,9755,5053,21386,16333,359,2056
MG,42129,GLAUCILÂNDIA,1624,773,982,3658,2676,39,240
MG,42137,CAMBUQUIRA,2235,4315,2576,10315,7739,235,954
MG,42145,GOIABEIRA,689,1218,897,3027,2130,35,188
MG,42153,CAMPANÁRIO,1195,728,1192,3389,2197,34,240
MG,42161,GOIANÁ,1188,1342,1004,3869,2865,54,281
MG,42170,CAMPANHA,1824,6041,3075,12177,9102,277,960
MG,42188,GUARACIAMA,2648,651,954,4671,3717,51,367
MG,42196,CAMPESTRE,3168,8136,3396,16624,13228,507,1417
MG,42200,IBIRACATU,2585,751,2199,5967,3768,66,366
MG,42218,CAMPINA VERDE,4312,5744,4131,15209,11078,150,872
MG,42226,IMBÉ DE MINAS,2119,1506,1819,5985,4166,77,464
MG,42234,CAMPO BELO,7805,17661,10062,40085,30023,813,3744
MG,42242,INDAIABIRA,1899,1564,2254,6229,3975,64,448
MG,42250,CAMPO DO MEIO,3342,3074,2636,10108,7472,231,825
MG,42269,JAPONVAR,3757,916,2769,8022,5253,65,515
MG,42277,CAMPO FLORIDO,1901,2074,1380,5767,4387,61,351
MG,42285,JENIPAPO DE MINAS,1948,772,2479,5696,3217,47,450
MG,42293,CAMPOS ALTOS,2320,3941,3169,10449,7280,230,789
MG,42307,JOSÉ GONÇALVES DE MINAS,1384,632,1420,3906,2486,45,425
MG,42315,CAMPOS GERAIS,4940,8022,5420,20719,15299,605,1732
MG,42323,JOSÉ RAYDAN,1485,790,1677,4302,2625,37,313
MG,42331,CANAÃ,2099,862,805,4199,3394,78,355
MG,42340,SÃO SEBASTIÃO DA VARGEM ALEGRE,1062,777,374,2515,2141,48,254
MG,42358,CANÁPOLIS,3176,2475,2568,8933,6365,112,602
MG,42366,SÃO SEBASTIÃO DO ANTA,1574,1782,1621,5404,3783,44,383
MG,42374,CANA VERDE,1398,1833,911,4708,3797,88,478
MG,42382,SERRANÓPOLIS DE MINAS,1742,792,1037,3904,2867,46,287
MG,42390,CANDEIAS,3013,4576,2967,12150,9183,389,1205
MG,42404,SETUBINHA,3501,725,3334,8506,5172,57,889
MG,42412,CAPARAÓ,1266,1604,1071,4321,3250,54,326
MG,42420,TAPARUBA,1149,981,819,3261,2442,35,277
MG,42439,CAPELA NOVA,1600,1130,863,4347,3484,214,540
MG,42447,UNIÃO DE MINAS,1327,771,641,2903,2262,21,143
MG,42455,CAPELINHA,8898,7417,8353,27800,19447,525,2607
MG,42463,URUANA DE MINAS,1059,987,930,3212,2282,19,217
MG,42471,CAPETINGA,1395,2176,1746,5840,4094,127,396
MG,42480,VARGEM GRANDE DO RIO PARDO,1207,1374,1079,4023,2944,38,325
MG,42498,CAPIM BRANCO,1713,3641,1476,7910,6434,203,877
MG,42501,VARJÃO DE MINAS,1532,2192,1405,5633,4228,84,420
MG,42510,CAPINÓPOLIS,4143,3689,2701,11328,8627,127,668
MG,42528,VERDELÂNDIA,3015,929,2260,6752,4492,66,482
MG,42536,CAPITÃO ENÉAS,5233,2457,3485,12396,8911,193,1028
MG,42544,VEREDINHA,2229,893,1429,4940,3511,64,325
MG,42552,CAPITÓLIO,1675,3139,1922,7453,5531,140,577
MG,42560,VERMELHO NOVO,1638,1421,1134,4722,3588,119,410
MG,42579,CAPUTIRA,3138,2133,1780,7809,6029,152,606
MG,42587,TOCOS DO MOJI,1232,1475,658,3875,3217,114,396
MG,42595,CARAÍ,5871,1850,5622,14827,9205,174,1310
MG,42617,CARANAÍBA,961,1015,635,3131,2496,109,411
MG,42633,CARANDAÍ,6402,7191,3449,19984,16535,701,2241
MG,42650,CARANGOLA,7320,8118,7285,25125,17840,355,2047
MG,42676,CARATINGA,14556,23811,17412,61785,44373,1108,4898
MG,42692,CARBONITA,2774,1861,2568,7916,5348,108,605
MG,42714,CAREAÇU,1203,2120,1189,4962,3773,82,368
MG,42730,CARLOS CHAGAS,5086,3882,6217,16579,10362,248,1146
MG,42757,CARMÉSIA,674,597,692,2213,1521,34,216
MG,42773,CARMO DA CACHOEIRA,2953,2921,2486,9629,7143,281,988
MG,42790,CARMO DA MATA,3137,3355,2277,10047,7770,214,1064
MG,42811,CARMO DE MINAS,2640,4023,2230,9980,7750,192,895
MG,42838,CARMO DO CAJURU,4794,7762,3136,17933,14797,498,1743
MG,42854,CARMO DO PARANAÍBA,3686,10525,6026,22459,16433,579,1643
MG,42870,CARMO DO RIO CLARO,3836,6785,3693,15654,11961,314,1026
MG,42897,CARMÓPOLIS DE MINAS,3724,5254,2431,13239,10808,368,1462
MG,42919,CARRANCAS,1087,1098,756,3291,2535,58,292
MG,42935,CARVALHÓPOLIS,830,1443,512,3087,2575,50,252
MG,42951,CARVALHOS,1051,1414,970,3981,3011,114,432
MG,42978,CASA GRANDE,754,980,506,2521,2015,43,238
MG,42994,CASCALHO RICO,878,1215,824,3164,2340,36,211
MG,43010,CÁSSIA,3640,5214,3998,14267,10269,262,1153
MG,43036,CONCEIÇÃO DA BARRA DE MINAS,1098,1249,753,3592,2839,84,408
MG,43052,CATAGUASES,19908,16256,13345,54215,40870,800,3906
MG,43079,CATAS ALTAS DA NORUEGA,1303,955,1123,3775,2652,58,336
MG,43095,CAXAMBU,4751,6550,5137,18180,13043,354,1388
MG,43117,CEDRO DO ABAETÉ,237,462,399,1272,873,36,138
MG,43133,CENTRAL DE MINAS,1595,2151,1702,5917,4215,76,393
MG,43150,CENTRALINA,2923,1983,1585,7038,5453,115,432
MG,43176,CHÁCARA,1089,923,407,2648,2241,35,194
MG,43192,CHALÉ,1793,1549,1196,4961,3765,98,325
MG,43214,CHAPADA DO NORTE,3895,767,4406,9799,5393,91,640
MG,43230,CHIADOR,851,1082,486,2688,2202,46,223
MG,43257,CIPOTÂNEA,1725,1263,2117,5758,3641,190,463
MG,43273,CLARAVAL,865,2487,976,4628,3652,70,230
MG,43290,CLARO DOS POÇÕES,2453,2124,1667,6966,5299,97,625
MG,43311,CLÁUDIO,3546,10366,3784,20610,16826,656,2258
MG,43338,COIMBRA,2310,1971,921,6093,5172,198,693
MG,43354,COLUNA,2463,1331,2391,6966,4575,90,691
MG,43370,COMENDADOR GOMES,691,1060,666,2568,1902,27,124
MG,43397,COMERCINHO,2951,902,2460,6860,4400,77,470
MG,43419,CONCEIÇÃO DA APARECIDA,2378,3161,1720,7947,6227,140,548
MG,43435,CONCEIÇÃO DAS PEDRAS,766,997,560,2638,2078,73,242
MG,43451,CONCEIÇÃO DAS ALAGOAS,6406,6766,4937,19466,14529,243,1114
MG,43478,CONCEIÇÃO DE IPANEMA,1653,973,905,3859,2954,56,272
MG,43494,CONCEIÇÃO DO MATO DENTRO,6322,3189,5150,16342,11192,259,1422
MG,43516,CONCEIÇÃO DO PARÁ,875,2491,1182,5065,3883,103,414
MG,43532,CONCEIÇÃO DO RIO VERDE,3077,3518,2659,10440,7781,276,910
MG,43559,CONCEIÇÃO DOS OUROS,1550,4635,1134,8171,7037,162,690
MG,43575,CONGONHAL,1668,4653,1483,8619,7136,199,616
MG,43591,CONGONHAS,11565,16554,6768,40793,34025,1013,4893
MG,43613,CONGONHAS DO NORTE,1554,623,1396,4147,2751,61,513
MG,43630,CONQUISTA,1469,2212,1056,5308,4252,83,488
MG,43656,CONSELHEIRO LAFAIETE,30180,35020,16132,93012,76880,2302,9378
MG,43672,CONSELHEIRO PENA,4111,6420,5220,17121,11901,246,1124
MG,43699,CONSOLAÇÃO,373,796,532,1867,1335,37,129
MG,43710,CONTAGEM,105418,202384,45718,400188,354470,9457,37211
MG,43737,COQUEIRAL,2087,2931,1935,7777,5842,123,701
MG,43753,CORAÇÃO DE JESUS,9403,3221,6944,21302,14358,201,1533
MG,43770,CORDISBURGO,2248,2253,1962,7175,5213,120,592
MG,43796,CORDISLÂNDIA,882,895,628,2686,2058,47,234
MG,43818,CORINTO,6044,5534,6614,19981,13367,277,1512
MG,43834,COROACI,2418,2580,3375,9329,5954,121,835
MG,43850,COROMANDEL,5264,10220,5822,23580,17758,438,1836
MG,43877,CORONEL FABRICIANO,18177,35471,20636,80944,60308,1324,5336
MG,43893,CORONEL MURTA,3276,1104,2023,6990,4967,93,494
MG,43915,CORONEL PACHECO,952,963,464,2664,2200,43,242
MG,43931,CORONEL XAVIER CHAVES,1056,892,522,2874,2352,68,336
MG,43958,CÓRREGO DANTA,763,1114,903,3007,2104,39,188
MG,43974,CÓRREGO DO BOM JESUS,795,1902,918,3974,3056,58,301
MG,43990,CÓRREGO NOVO,1313,705,845,3131,2286,41,227
MG,44016,COUTO DE MAGALHÃES DE MINAS,1613,567,1282,3844,2562,52,330
MG,44032,CRISTAIS,2163,3284,1834,8269,6435,177,811
MG,44059,CRISTÁLIA,2217,638,1858,5144,3286,66,365
MG,44075,CRISTIANO OTONI,1232,1638,788,4356,3568,157,541
MG,44091,CRISTINA,1662,3643,2042,8295,6253,146,802
MG,44113,CRUCILÂNDIA,1240,1983,1185,5085,3900,150,527
MG,44130,CRUZEIRO DA FORTALEZA,989,1759,1042,4062,3020,51,221
MG,44156,CRUZÍLIA,3663,4583,3018,12632,9614,270,1098
MG,44172,CURVELO,17396,20575,13884,57964,44080,1260,4849
MG,44199,DATAS,2090,739,1377,4773,3396,97,470
MG,44210,DELFIM MOREIRA,1510,3167,1429,6815,5386,170,539
MG,44237,DELFINÓPOLIS,1406,2406,1800,6143,4343,104,427
MG,44253,DESCOBERTO,1586,1508,945,4502,3557,71,392
MG,44270,DESTERRO DE ENTRE RIOS,1357,2394,1153,5910,4757,331,675
MG,44296,DESTERRO DO MELO,1112,1142,592,3255,2663,58,351
MG,44318,DIAMANTINA,13966,8605,10299,36410,26111,620,2920
MG,44334,DIOGO DE VASCONCELOS,1788,648,736,3618,2882,50,396
MG,44350,DIONÍSIO,2087,1755,2572,7110,4538,108,588
MG,44377,DIVINÉSIA,1724,1013,889,4032,3143,53,353
MG,44393,DIVINO,5695,4025,4578,15664,11086,256,1110
MG,44415,DIVINO DAS LARANJEIRAS,1177,1562,1615,4717,3102,56,307
MG,44431,DIVINOLÂNDIA DE MINAS,1761,1622,2236,6316,4080,86,611
MG,44458,DIVINÓPOLIS,41154,77001,27194,163394,136200,4305,13740
MG,44474,DIVISA NOVA,1609,1760,1125,4932,3807,93,345
MG,44490,DOM CAVATI,1092,1932,1338,4772,3434,67,343
MG,44512,DOM JOAQUIM,1448,865,1199,3959,2760,60,387
MG,44539,DOM SILVÉRIO,1756,1120,1106,4571,3465,86,503
MG,44555,DOM VIÇOSO,693,1302,507,2821,2314,66,253
MG,44571,DONA EUSÉBIA,2038,1900,947,5349,4402,69,395
MG,44598,DORES DE CAMPOS,1996,3350,1079,7645,6566,260,960
MG,44610,DORES DE GUANHÃES,1890,1059,1565,5037,3472,72,451
MG,44636,DORES DO INDAIÁ,2154,4926,3384,11464,8080,182,818
MG,44652,DORES DO TURVO,1854,1327,1448,5057,3609,79,349
MG,44679,DORESÓPOLIS,482,582,673,1911,1238,49,125
MG,44695,DOURADOQUARA,681,605,397,1852,1455,31,138
MG,44717,ELÓI MENDES,3689,10394,3949,20070,16121,493,1545
MG,44733,ENGENHEIRO CALDAS,2065,2747,2182,7735,5553,126,615
MG,44750,ENGENHEIRO NAVARRO,2719,1033,1887,6210,4323,65,506
MG,44776,ENTRE RIOS DE MINAS,4108,4017,2506,12196,9690,262,1303
MG,44792,ERVÁLIA,6593,3854,3788,16470,12682,675,1560
MG,44814,ESMERALDAS,14139,17287,10589,47550,36961,1272,4263
MG,44830,ESPERA FELIZ,5949,5453,3889,17033,13144,348,1394
MG,44857,ESPINOSA,9863,5454,5129,22196,17067,300,1450
MG,44873,ESPÍRITO SANTO DO DOURADO,1141,2044,834,4551,3717,100,432
MG,44890,ESTIVA,2093,4013,1664,8885,7221,255,860
MG,44911,ESTRELA DALVA,912,660,804,2580,1776,28,176
MG,44938,ESTRELA DO INDAIÁ,631,1171,875,2958,2083,39,242
MG,44954,ESTRELA DO SUL,2081,1687,1428,5770,4342,97,477
MG,44970,EUGENÓPOLIS,2782,3076,2063,8640,6577,118,601
MG,44997,EWBANK DA CÂMARA,1776,991,912,4008,3096,67,262
MG,45012,EXTREMA,5878,13952,7091,30021,22930,704,2396
MG,45039,FAMA,693,1203,757,2881,2124,47,181
MG,45055,FARIA LEMOS,1207,809,805,3089,2284,27,241
MG,45071,FELÍCIO DOS SANTOS,1317,1191,1818,4889,3071,60,503
MG,45098,SÃO GONÇALO DO RIO PRETO,1105,561,998,2970,1972,51,255
MG,45110,FELISBURGO,2145,978,1899,5485,3586,55,408
MG,45136,FELIXLÂNDIA,3621,3587,3532,11904,8372,257,907
MG,45152,FERNANDES TOURINHO,614,1077,889,2843,1954,25,238
MG,45179,FERROS,3117,1940,2757,8792,6035,145,833
MG,45195,FLORESTAL,1711,2426,1372,6223,4851,120,594
MG,45217,FORMIGA,10499,25314,12332,54569,42237,1395,5029
MG,45233,FORMOSO,2348,1414,1656,5805,4149,50,337
MG,45250,FORTALEZA DE MINAS,631,1360,1023,3422,2399,87,321
MG,45276,FORTUNA DE MINAS,968,949,659,2829,2170,48,205
MG,45292,FRANCISCO BADARÓ,2468,1270,3014,7318,4304,62,504
MG,45314,FRANCISCO DUMONT,1471,989,1740,4558,2818,64,294
MG,45330,FRANCISCO SÁ,7970,3558,5772,19101,13329,209,1592
MG,45357,FREI GASPAR,2048,797,1794,5107,3313,66,402
MG,45373,FREI INOCÊNCIO,2217,2092,2138,7000,4862,77,476
MG,45390,FRONTEIRA,3155,3515,2579,10026,7447,132,645
MG,45411,FRUTAL,9794,17194,11297,41390,30093,629,2476
MG,45438,FUNILÂNDIA,1063,1712,1166,4388,3222,51,396
MG,45454,GALILÉIA,1475,1844,1740,5404,3664,69,276
MG,45470,GONÇALVES,602,1923,972,3938,2966,88,353
MG,45497,GONZAGA,1102,1456,1659,4801,3142,86,498
MG,45519,GOUVEIA,3741,2418,3174,10431,7257,162,936
MG,45535,GOVERNADOR VALADARES,38293,94067,57289,205842,148553,3908,12285
MG,45551,GRÃO MOGOL,4801,1865,4285,12080,7795,131,998
MG,45578,GRUPIARA,435,645,387,1608,1221,30,111
MG,45594,GUANHÃES,6432,7667,7934,25018,17084,507,2478
MG,45616,GUAPÉ,2348,4590,2670,10718,8048,332,778
MG,45632,GUARACIABA,3337,1680,2294,8340,6046,139,890
MG,45659,GUARANÉSIA,5099,4914,3648,15293,11645,351,1281
MG,45675,GUARANI,2532,2098,1776,7151,5375,104,641
MG,45691,GUARARÁ,1150,1128,915,3551,2636,58,300
MG,45713,GUARDA-MOR,1547,2016,1859,5846,3987,92,332
MG,45730,GUAXUPÉ,10366,15289,9018,38582,29564,862,3047
MG,45756,GUIDOVAL,2251,2114,970,5997,5027,121,541
MG,45772,GUIMARÂNIA,1529,2759,1596,6555,4959,119,552
MG,45799,GUIRICEMA,2820,2184,1222,7082,5860,164,692
MG,45810,GURINHATÃ,1522,1578,1658,5054,3396,46,250
MG,45837,HELIODORA,1522,2008,966,5160,4194,149,515
MG,45853,IAPU,2252,3269,2159,8465,6306,148,637
MG,45870,IBERTIOGA,2326,1003,1090,4778,3688,75,284
MG,45896,IBIÁ,4572,6110,5066,17263,12197,319,1196
MG,45918,IBIAÍ,2879,787,2319,6439,4120,41,413
MG,45934,IBIRACI,2109,4003,2219,9031,6812,176,524
MG,45950,IBIRITÉ,32827,48160,20820,115535,94715,2894,10834
MG,45977,IBITIÚRA DE MINAS,443,1836,634,3207,2573,56,238
MG,45993,IBITURUNA,684,889,655,2534,1879,76,230
MG,46019,IGARAPÉ,7712,11868,6161,29132,22971,694,2697
MG,46035,IGARATINGA,1763,3164,1535,7433,5898,226,745
MG,46051,IGUATAMA,1957,2243,1676,6622,4946,129,617
MG,46078,IJACI,1282,2334,802,5193,4391,158,617
MG,46094,ILICÍNEA,3138,3472,2129,9655,7526,202,714
MG,46116,INCONFIDENTES,1593,2985,1277,6387,5110,114,418
MG,46132,INDIANÓPOLIS,1567,1501,1177,4650,3473,72,333
MG,46159,INGAÍ,837,1033,742,2960,2218,66,282
MG,46175,INHAPIM,4753,7653,5766,19799,14033,235,1392
MG,46191,INHAÚMA,1413,2094,1204,5351,4147,120,520
MG,46213,INIMUTABA,2083,1747,1650,6039,4389,106,453
MG,46230,IPANEMA,4023,5267,4540,15086,10546,202,1054
MG,46256,IPATINGA,32082,91851,45513,183517,138004,2714,11357
MG,46272,IPIAÇU,1281,871,1076,3446,2370,32,186
MG,46299,IPUIÚNA,1802,3763,1489,7746,6257,154,538
MG,46310,IRAÍ DE MINAS,1658,2525,950,5641,4691,84,424
MG,46337,ITABIRA,25229,35136,17580,90085,72505,1916,10224
MG,46353,ITABIRINHA,2308,3050,2501,8644,6143,130,655
MG,46370,ITABIRITO,10996,16365,7762,40718,32956,1185,4410
MG,46396,ITACAMBIRA,2049,593,1935,4880,2945,33,270
MG,46418,ITACARAMBI,5433,2444,4440,13602,9162,127,1158
MG,46434,ITAGUARA,2642,4142,1822,10416,8594,455,1355
MG,46450,ITAIPÉ,3126,1818,2940,8838,5898,119,835
MG,46477,ITAJUBÁ,11330,39418,16157,72627,56470,1237,4485
MG,46493,ITAMARANDIBA,8541,6067,7197,24769,17572,616,2348
MG,46515,ITAMARATI DE MINAS,1322,1150,838,3688,2850,51,327
MG,46531,ITAMBACURI,6375,3602,6818,18246,11428,192,1259
MG,46558,ITAMBÉ DO MATO DENTRO,825,640,768,2550,1782,48,269
MG,46574,ITAMOGI,2146,3737,2645,9433,6788,155,750
MG,46590,ITAMONTE,2173,5594,2489,11510,9021,264,990
MG,46612,ITANHANDU,2901,5428,2581,12229,9648,303,1016
MG,46639,ITANHOMI,3091,3015,2976,10017,7041,111,824
MG,46655,ITAOBIM,5010,4485,5484,16535,11051,222,1334
MG,46671,ITAPAGIPE,2697,4319,2608,10272,7664,116,532
MG,46698,ITAPECERICA,5026,6562,3791,17673,13882,400,1894
MG,46710,ITAPEVA,1259,3923,1482,7307,5825,129,514
MG,46736,ITATIAIUÇU,1805,4599,2096,9603,7507,208,895
MG,46752,ITAÚNA,10993,37146,13569,69444,55875,1539,6197
MG,46779,ITAVERAVA,2126,1564,1313,5711,4398,154,554
MG,46795,ITINGA,4933,1585,3799,11199,7400,113,769
MG,46817,ITUETA,1090,2216,1016,4691,3675,81,288
MG,46833,ITUIUTABA,25456,25815,20245,77096,56851,926,4654
MG,46850,ITUMIRIM,1488,2333,1272,5953,4681,140,720
MG,46876,ITURAMA,10313,9675,7615,29438,21823,310,1525
MG,46892,ITUTINGA,1074,1338,816,3738,2922,96,414
MG,46914,JABOTICATUBAS,4092,5306,3153,14255,11102,305,1399
MG,46930,JACINTO,3264,1862,3090,8960,5870,96,648
MG,46957,JACUÍ,919,3020,1844,6505,4661,143,579
MG,46973,JACUTINGA,2291,10264,4066,18091,14025,298,1172
MG,46990,JAGUARAÇU,823,1260,763,3124,2361,60,218
MG,47015,JANAÚBA,17863,14684,13816,51769,37953,774,4632
MG,47031,JANUÁRIA,22111,7287,15942,49478,33536,527,3611
MG,47058,JAPARAÍBA,898,1394,574,3346,2772,82,398
MG,47074,JECEABA,1807,1905,1298,5801,4503,155,636
MG,47090,JEQUERI,4040,1969,3137,10301,7164,196,959
MG,47112,JEQUITAÍ,2440,1148,2413,6634,4221,70,563
MG,47139,JEQUITIBÁ,1470,2104,1406,5648,4242,117,551
MG,47155,JEQUITINHONHA,7581,2462,6498,17852,11354,146,1165
MG,47171,JESUÂNIA,1102,1634,960,4215,3255,84,435
MG,47198,JOAÍMA,4454,1488,3974,10866,6892,119,831
MG,47210,JOANÉSIA,1245,1455,1661,4943,3282,76,506
MG,47236,JOÃO MONLEVADE,15451,23443,13782,59634,45852,1309,5649
MG,47252,JOÃO PINHEIRO,10078,12632,11324,36986,25662,656,2296
MG,47279,JOAQUIM FELÍCIO,1089,859,1092,3357,2265,44,273
MG,47295,JORDÂNIA,2911,1636,2793,7911,5118,50,521
MG,47317,NOVA UNIÃO,1781,1612,1451,5436,3985,115,477
MG,47333,JUIZ DE FORA,132237,145333,83003,398183,315180,7392,30218
MG,47350,JURAMENTO,1937,1005,920,4279,3359,50,367
MG,47376,JURUAIA,1827,3899,1518,8082,6564,187,651
MG,47392,LADAINHA,3900,1893,4828,12129,7301,132,1376
MG,47414,LAGAMAR,1666,2741,1601,6466,4865,74,384
MG,47430,LAGOA DA PRATA,6642,17088,7815,35196,27381,853,2798
MG,47457,LAGOA DOS PATOS,1324,899,1297,3867,2570,28,319
MG,47473,LAGOA DOURADA,2764,3872,1503,9748,8245,351,1258
MG,47490,LAGOA FORMOSA,3590,6109,2628,14009,11381,427,1255
MG,47511,LAGOA SANTA,9088,22301,8952,44914,35962,1173,3400
MG,47538,LAJINHA,4885,5410,4274,16065,11791,306,1190
MG,47554,LAMBARI,3206,7841,3876,16586,12710,301,1362
MG,47570,LAMIM,1473,753,775,3395,2620,80,314
MG,47597,LARANJAL,1823,2135,1176,5609,4433,57,418
MG,47619,LASSANCE,2086,1179,1930,5737,3807,55,487
MG,47635,LAVRAS,17435,31119,14733,72343,57610,1709,7347
MG,47651,LEANDRO FERREIRA,792,1412,704,3207,2503,56,243
MG,47678,LEOPOLDINA,14278,12774,10096,40807,30711,709,2950
MG,47694,LIBERDADE,1604,1228,1042,4366,3324,86,406
MG,47716,LIMA DUARTE,6084,3446,3434,14169,10735,204,1001
MG,47732,LUMINÁRIAS,1427,1400,959,4389,3430,113,490
MG,47759,LUZ,2786,6385,4203,14764,10561,337,1053
MG,47775,MACHACALIS,2261,1280,1808,5790,3982,72,369
MG,47791,MACHADO,5408,14841,6550,29836,23286,602,2435
MG,47813,MADRE DE DEUS DE MINAS,1516,1322,727,4144,3417,103,476
MG,47830,MALACACHETA,5125,3026,5953,15578,9625,199,1275
MG,47856,MANGA,6273,2986,5405,16111,10706,189,1258
MG,47872,MANHUAÇU,15267,23678,13379,57986,44607,1057,4605
MG,47899,MANHUMIRIM,4773,6019,4589,16888,12299,268,1239
MG,47910,MANTENA,4689,8368,5649,20068,14419,226,1136
MG,47937,MARAVILHAS,1739,2566,1180,6137,4957,89,563
MG,47953,MAR DE ESPANHA,2990,3904,1757,9703,7946,168,884
MG,47970,MARIA DA FÉ,2367,6279,2339,12319,9980,257,1077
MG,47996,MARIANA,19882,11883,10032,48015,37983,1010,5208
MG,48011,MARILAC,1419,969,1240,4004,2764,60,316
MG,48038,MARIPÁ DE MINAS,956,1132,622,2984,2362,48,226
MG,48054,MARLIÉRIA,1251,1526,1023,4193,3170,65,328
MG,48070,MARMELÓPOLIS,762,1091,635,2806,2171,47,271
MG,48097,MARTINHO CAMPOS,2326,4689,3141,11354,8213,307,891
MG,48119,MATERLÂNDIA,1602,543,1767,4362,2595,71,379
MG,48135,MATEUS LEME,5499,10341,5848,25032,19184,675,2669
MG,48151,MATIAS BARBOSA,4128,4061,2399,11790,9391,176,1026
MG,48178,MATIPÓ,5295,4496,3673,15072,11399,303,1305
MG,48194,MATO VERDE,4341,2689,2505,10439,7934,151,753
MG,48216,MATOZINHOS,7658,11934,5904,29396,23492,895,3005
MG,48232,MATUTINA,798,1343,938,3436,2498,65,292
MG,48259,MEDEIROS,759,1243,813,3057,2244,57,185
MG,48275,MEDINA,6181,3315,5241,16276,11035,255,1284
MG,48291,MENDES PIMENTEL,1776,1487,1532,5295,3763,93,407
MG,48313,MERCÊS,3538,2032,2084,8587,6503,149,784
MG,48330,MESQUITA,1333,1795,1900,5498,3598,91,379
MG,48356,MINAS NOVAS,8750,2206,9719,22510,12791,255,1580
MG,48372,MINDURI,763,1326,891,3318,2427,48,290
MG,48399,MIRABELA,4509,2147,3397,10971,7574,115,803
MG,48410,MIRADOURO,3008,2403,1546,7822,6276,146,719
MG,48437,MIRAÍ,2871,3940,2836,10588,7752,149,792
MG,48453,MOEDA,1416,2075,1226,5344,4118,107,520
MG,48470,MOEMA,1442,2669,1679,6457,4778,140,527
MG,48496,MONJOLOS,813,519,794,2316,1522,29,161
MG,48518,MONSENHOR PAULO,1828,2719,1401,6696,5295,147,601
MG,48534,MONTALVÂNIA,5201,2305,4331,12880,8549,123,920
MG,48550,MONTE ALEGRE DE MINAS,4500,5042,4457,15454,10997,243,1212
MG,48577,MONTE AZUL,7382,4438,4316,17733,13417,239,1358
MG,48593,MONTE BELO,2908,4100,2601,10949,8348,285,1055
MG,48615,MONTE CARMELO,11117,12586,8709,35996,27287,692,2892
MG,48631,MONTE SANTO DE MINAS,3721,6756,4883,17303,12420,445,1498
MG,48658,MONTES CLAROS,78142,108640,52489,269598,217109,4757,25570
MG,48674,MONTE SIÃO,2155,10372,3942,17863,13921,336,1058
MG,48690,MORADA NOVA DE MINAS,1713,2728,2271,7419,5148,141,566
MG,48712,MORRO DA GARÇA,1137,511,797,2648,1851,29,174
MG,48739,MORRO DO PILAR,1312,668,972,3381,2409,54,375
MG,48755,MUNHOZ,1440,2597,1361,6020,4659,154,468
MG,48771,MURIAÉ,21306,31027,17161,77205,60044,1191,6520
MG,48798,MUTUM,6090,7666,5666,21199,15533,386,1391
MG,48810,MUZAMBINHO,4535,7513,4253,17881,13628,340,1240
MG,48836,NACIP RAYDAN,1075,558,1188,3025,1837,21,183
MG,48852,NANUQUE,8216,9270,10547,30472,19925,489,1950
MG,48879,NATÉRCIA,749,1938,931,4194,3263,131,445
MG,48895,NAZARENO,2272,1901,1327,6316,4989,135,681
MG,48917,NEPOMUCENO,4738,8297,5109,20752,15643,514,2094
MG,48933,NOVA ERA,5057,4601,3893,15144,11251,294,1299
MG,48950,NOVA LIMA,19264,29780,12934,69574,56640,1691,5905
MG,48976,NOVA MÓDICA,1301,921,942,3440,2498,38,238
MG,48992,NOVA PONTE,3508,4062,2952,11421,8469,152,747
MG,49018,NOVA RESENDE,2863,5797,2482,12533,10051,318,1073
MG,49034,NOVA SERRANA,8174,30914,10311,54038,43727,1391,3248
MG,49050,NOVO CRUZEIRO,8607,3183,10378,24580,14202,273,2139
MG,49077,OLARIA,938,497,507,2153,1646,55,156
MG,49093,OLÍMPIO NORONHA,836,807,592,2542,1950,41,266
MG,49115,OLIVEIRA,7888,13844,6905,32861,25956,851,3373
MG,49131,OLIVEIRA FORTES,1068,443,426,2141,1715,38,166
MG,49158,ONÇA DE PITANGUI,692,1467,784,3191,2407,44,204
MG,49174,OURO BRANCO,8795,12198,5774,29924,24150,610,2547
MG,49190,OURO FINO,3647,13102,6060,25065,19005,496,1760
MG,49212,OURO PRETO,26726,14664,12262,60958,48696,1319,5987
MG,49239,OURO VERDE DE MINAS,2185,1503,2301,6462,4161,77,396
MG,49255,PADRE PARAÍSO,4333,3280,5030,13901,8871,163,1095
MG,49271,PAINEIRAS,1383,1254,1089,4182,3093,66,390
MG,49298,PAINS,1780,2848,1421,6770,5349,142,579
MG,49310,PAIVA,673,425,411,1684,1273,36,139
MG,49336,PALMA,2147,1492,1376,5379,4003,64,300
MG,49352,FRONTEIRA DOS VALES,1891,534,1445,4177,2732,39,268
MG,49379,PAPAGAIOS,3673,4289,2144,11350,9206,170,1074
MG,49395,PARACATU,14125,26622,17605,64437,46832,1481,4604
MG,49417,PARÁ DE MINAS,10834,32428,12218,62868,50650,1463,5925
MG,49433,PARAGUAÇU,4230,7309,3659,16930,13271,386,1346
MG,49450,PARAISÓPOLIS,2970,8086,3779,16508,12729,300,1373
MG,49476,PARAOPEBA,4803,8101,4128,19410,15282,386,1992
MG,49492,PASSABÉM,563,531,406,1731,1325,30,201
MG,49514,PASSA QUATRO,3575,5360,2864,13262,10398,300,1163
MG,49530,PASSA TEMPO,2174,2304,1917,7565,5648,233,937
MG,49557,PASSA VINTE,633,791,495,2094,1599,33,142
MG,49573,PASSOS,19919,33806,18572,79914,61342,1768,5849
MG,49590,PATOS DE MINAS,20583,53299,26703,110772,84069,2356,7831
MG,49611,PATROCÍNIO,12725,30375,14655,64192,49537,1482,4955
MG,49638,PATROCÍNIO DO MURIAÉ,1729,1839,1272,5291,4019,65,386
MG,49654,PAULA CÂNDIDO,3330,1696,1833,7690,5857,146,685
MG,49670,PAULISTAS,1766,618,1379,4191,2812,35,393
MG,49697,PAVÃO,2306,1239,1828,5928,4100,75,480
MG,49719,PEÇANHA,4295,2705,5309,13410,8101,149,952
MG,49735,PEDRA AZUL,5718,4453,7094,18847,11753,204,1378
MG,49751,PEDRA DO ANTA,1598,665,971,3595,2624,66,295
MG,49778,PEDRA DO INDAIÁ,759,1563,669,3508,2839,111,406
MG,49794,PEDRA DOURADA,1032,687,670,2708,2038,46,273
MG,49816,PEDRALVA,2256,4198,2123,9647,7524,223,847
MG,49832,PEDRINÓPOLIS,916,1208,767,3154,2387,48,215
MG,49859,PEDRO LEOPOLDO,11414,21303,8893,47315,38422,1176,4529
MG,49875,PEDRO TEIXEIRA,1188,435,353,2116,1763,27,113
MG,49891,PEQUERI,1095,983,810,3183,2373,48,247
MG,49913,PEQUI,939,1472,856,3607,2751,62,278
MG,49930,PERDIGÃO,939,4715,1507,7865,6358,141,563
MG,49956,PERDIZES,2695,5244,3573,12517,8944,186,819
MG,49972,PERDÕES,4059,7300,3551,17099,13548,457,1732
MG,49999,PESCADOR,1234,830,1130,3505,2375,41,270
MG,50016,PIAU,1127,882,492,2785,2293,55,229
MG,50032,PIEDADE DE PONTE NOVA,1583,808,1028,3841,2813,64,358
MG,50059,PIEDADE DO RIO GRANDE,1275,1137,1058,4010,2952,88,452
MG,50075,PIEDADE DOS GERAIS,1268,1720,1122,4692,3570,173,409
MG,50091,PIMENTA,1725,2625,1774,6953,5179,205,624
MG,50113,PIRACEMA,2221,1739,1146,5920,4774,182,632
MG,50130,PIRAJUBA,1338,1463,973,4106,3133,61,271
MG,50156,PIRANGA,4391,2819,4677,13627,8950,312,1428
MG,50172,PIRANGUÇU,952,2411,1022,4775,3753,71,319
MG,50199,PIRANGUINHO,1761,3128,1356,6943,5587,143,555
MG,50210,PIRAPETINGA,3331,3392,1985,9670,7685,159,803
MG,50237,PIRAPORA,9897,15910,10405,40648,30243,694,3742
MG,50253,PIRAÚBA,3152,3424,1980,9524,7544,215,753
MG,50270,PITANGUI,3859,10743,4066,20893,16827,446,1779
MG,50296,PIUMHI,5092,11579,6523,25494,18971,557,1743
MG,50318,PLANURA,2281,3032,2253,8190,5937,147,477
MG,50334,POÇO FUNDO,3294,5677,2472,12826,10354,370,1013
MG,50350,POÇOS DE CALDAS,23578,53695,30245,118580,88335,2417,8645
MG,50377,POCRANE,2171,2428,2358,7511,5153,85,469
MG,50393,POMPÉU,7049,7677,5972,23652,17680,491,2463
MG,50415,PONTE NOVA,17795,11604,9916,43614,33698,789,3510
MG,50431,PORTEIRINHA,12196,7358,8457,31259,22802,436,2812
MG,50458,PORTO FIRME,3479,2197,2387,8916,6529,150,703
MG,50474,POTÉ,3941,3044,4243,12399,8156,112,1059
MG,50490,POUSO ALEGRE,19916,51716,21287,102788,81501,2124,7745
MG,50512,POUSO ALTO,1277,2481,1153,5611,4458,141,559
MG,50539,PRADOS,2430,2183,1175,6939,5764,260,891
MG,50555,PRATA,6408,7194,6307,21399,15092,326,1164
MG,50571,PRATÁPOLIS,1999,2895,1841,7555,5714,145,675
MG,50598,PRATINHA,641,1205,688,2876,2188,79,263
MG,50610,PRESIDENTE BERNARDES,2101,1145,1713,5468,3755,65,444
MG,50636,PRESIDENTE JUSCELINO,1443,772,1630,4211,2581,41,325
MG,50652,PRESIDENTE KUBITSCHEK,1360,351,707,2720,2013,28,274
MG,50679,PRESIDENTE OLEGÁRIO,4090,6013,4907,16520,11613,261,1249
MG,50695,ALTO JEQUITIBÁ,1589,3337,1436,6919,5483,96,461
MG,50717,PRUDENTE DE MORAIS,1931,3412,1029,7586,6557,257,957
MG,50733,QUARTEL GERAL,973,1049,972,3304,2332,45,265
MG,50750,QUELUZITO,750,878,534,2424,1890,55,207
MG,50776,RAPOSOS,4461,4723,1923,12754,10831,337,1310
MG,50792,RAUL SOARES,6034,5272,4672,17944,13272,279,1687
MG,50814,RECREIO,2916,2184,1977,7735,5758,105,553
MG,50830,RESENDE COSTA,2881,3175,1822,9161,7339,267,1016
MG,50857,RESPLENDOR,2569,5887,4064,13273,9209,145,608
MG,50873,RESSAQUINHA,1776,1206,621,4129,3508,85,441
MG,50890,RIACHO DOS MACHADOS,3166,1152,2447,7578,5131,67,746
MG,50911,RIBEIRÃO DAS NEVES,55911,82449,40999,202861,161862,5294,18208
MG,50938,RIBEIRÃO VERMELHO,967,1193,618,3255,2637,51,426
MG,50954,RIO ACIMA,2552,3130,1363,8152,6789,221,886
MG,50970,RIO CASCA,3964,2720,3698,11545,7847,216,947
MG,50997,RIO DOCE,886,664,490,2327,1837,39,248
MG,51012,RIO DO PRADO,2018,536,1362,4273,2911,43,314
MG,51039,RIO ESPERA,1905,1392,1396,5320,3924,129,498
MG,51055,RIO MANSO,1395,1696,889,4577,3688,100,497
MG,51071,RIO NOVO,2369,2397,1798,7276,5478,117,595
MG,51098,RIO PARANAÍBA,2831,3519,2905,10325,7420,241,829
MG,51110,RIO PARDO DE MINAS,7930,4311,6523,21338,14815,226,2348
MG,51136,RIO PIRACICABA,4076,3478,3410,12559,9149,288,1307
MG,51152,RIO POMBA,4899,4583,3291,14193,10902,281,1139
MG,51179,RIO PRETO,2188,1400,1243,5200,3957,56,313
MG,51195,RIO VERMELHO,3483,1784,4618,11126,6508,200,1041
MG,51217,RITÁPOLIS,1499,1347,1097,4538,3441,100,495
MG,51233,ROCHEDO DE MINAS,724,870,556,2358,1802,27,181
MG,51250,RODEIRO,1934,2578,1235,6393,5158,103,543
MG,51276,ROMARIA,1197,954,544,2974,2430,31,248
MG,51292,RUBELITA,3146,746,3182,7575,4393,72,429
MG,51314,RUBIM,2673,1085,2165,6522,4357,66,533
MG,51330,SABARÁ,24351,39086,17763,92192,74429,2463,8529
MG,51357,SABINÓPOLIS,4807,1935,4600,12719,8119,220,1157
MG,51373,SACRAMENTO,4448,8501,4953,19442,14489,275,1265
MG,51390,SALINAS,11614,8308,8558,31685,23127,503,2702
MG,51411,SALTO DA DIVISA,1876,1018,1538,4815,3277,45,338
MG,51438,SANTA BÁRBARA,8460,7270,4663,23148,18485,485,2270
MG,51454,SANTA BÁRBARA DO TUGÚRIO,2109,845,872,4304,3432,74,404
MG,51470,SANTA CRUZ DO ESCALVADO,2081,1005,1230,4830,3600,81,433
MG,51497,SANTA EFIGÊNIA DE MINAS,1267,903,1439,4118,2679,111,398
MG,51519,SANTA FÉ DE MINAS,1349,424,1374,3387,2013,25,215
MG,51535,SANTA JULIANA,2664,3742,1919,9104,7185,147,632
MG,51551,SANTA LUZIA,41289,68452,31093,159401,128308,4186,14381
MG,51578,SANTA MARGARIDA,4685,3906,2605,12443,9838,251,996
MG,51594,SANTA MARIA DE ITABIRA,3350,2017,2173,8783,6610,157,1086
MG,51616,SANTA MARIA DO SALTO,1491,898,1547,4357,2810,48,373
MG,51632,SANTA MARIA DO SUAÇUÍ,3963,2409,5382,12545,7163,91,700
MG,51659,SANTANA DA VARGEM,1849,2312,1009,5907,4898,144,593
MG,51675,SANTANA DE CATAGUASES,1034,1284,432,3064,2632,26,288
MG,51691,SANTANA DE PIRAPAMA,2385,2142,2220,7392,5172,126,519
MG,51713,SANTANA DO DESERTO,1413,893,735,3359,2624,64,254
MG,51730,SANTANA DO GARAMBÉU,1028,440,467,2181,1714,57,189
MG,51756,SANTANA DO JACARÉ,965,1541,952,3951,2999,108,385
MG,51772,SANTANA DO MANHUAÇU,2764,1867,1878,7087,5209,109,469
MG,51799,SANTANA DO RIACHO,1551,1458,1601,5028,3427,90,328
MG,51810,SANTANA DOS MONTES,1257,1115,926,3791,2865,98,395
MG,51837,SANTA RITA DE CALDAS,1518,3526,1512,7172,5660,107,509
MG,51853,SANTA RITA DE JACUTINGA,1573,1435,746,4146,3400,76,316
MG,51870,SANTA RITA DE IBITIPOCA,1417,617,919,3259,2340,64,242
MG,51896,SANTA RITA DO ITUETO,1306,2003,1214,4902,3688,61,318
MG,51918,SANTA RITA DO SAPUCAÍ,4134,16799,5959,29993,24034,802,2299
MG,51934,SANTA ROSA DA SERRA,982,990,1053,3305,2252,70,210
MG,51950,SANTA VITÓRIA,6615,4908,4329,16988,12659,206,930
MG,51977,SANTO ANTÔNIO DO AMPARO,5156,3624,2952,13591,10639,361,1498
MG,51993,SANTO ANTÔNIO DO AVENTUREIRO,1205,1148,773,3584,2811,82,376
MG,52019,SANTO ANTÔNIO DO GRAMA,1603,860,1050,3966,2916,72,381
MG,52035,SANTO ANTÔNIO DO ITAMBÉ,1337,454,1633,3843,2210,51,368
MG,52051,SANTO ANTÔNIO DO JACINTO,3009,2018,3175,9147,5972,103,842
MG,52078,SANTO ANTÔNIO DO MONTE,2749,10425,4536,19720,15184,485,1525
MG,52094,SANTO ANTÔNIO DO RIO ABAIXO,706,450,645,2038,1393,29,208
MG,52116,SANTO HIPÓLITO,1141,460,956,2861,1905,26,278
MG,52132,SANTOS DUMONT,14206,12068,8613,39090,30477,815,3388
MG,52159,SÃO BENTO ABADE,1075,1537,752,3956,3204,99,493
MG,52175,SÃO BRÁS DO SUAÇUÍ,1047,1025,853,3463,2610,74,464
MG,52191,SÃO DOMINGOS DO PRATA,5064,3991,3196,13951,10755,234,1466
MG,52213,SÃO FRANCISCO,16543,6705,14148,40568,26420,427,2745
MG,52230,SÃO FRANCISCO DE PAULA,2123,1681,1378,5859,4481,126,551
MG,52256,SÃO FRANCISCO DE SALES,2042,1280,1068,4705,3637,43,272
MG,52272,SÃO FRANCISCO DO GLÓRIA,1749,1110,1002,4266,3264,44,361
MG,52299,SÃO GERALDO,2594,1939,1346,6660,5314,157,624
MG,52310,SÃO GERALDO DA PIEDADE,1202,1020,1381,3928,2547,58,267
MG,52337,SÃO GONÇALO DO ABAETÉ,1530,1629,1341,4869,3528,54,315
MG,52353,SÃO GONÇALO DO PARÁ,1801,3777,1617,8259,6642,224,840
MG,52370,SÃO GONÇALO DO RIO ABAIXO,3482,3827,1868,10570,8702,255,1138
MG,52396,SÃO GONÇALO DO SAPUCAÍ,4310,8057,4618,18871,14253,425,1461
MG,52418,SÃO GOTARDO,4978,11663,7053,26231,19178,613,1924
MG,52434,SÃO JOÃO BATISTA DO GLÓRIA,1405,2947,1179,6108,4929,117,460
MG,52450,SÃO JOÃO DA MATA,611,1523,744,3127,2383,60,189
MG,52477,SÃO JOÃO DA PONTE,9954,2451,8753,22591,13838,127,1306
MG,52493,SÃO JOÃO DEL REI,17250,29334,13134,67309,54175,1710,5881
MG,52515,SÃO JOÃO DO ORIENTE,2235,2426,1693,7083,5390,108,621
MG,52531,SÃO JOÃO DO PARAÍSO,4319,4955,5439,16994,11555,383,1898
MG,52558,SÃO JOÃO EVANGELISTA,5052,2393,3967,12569,8602,150,1007
MG,52574,SÃO JOÃO NEPOMUCENO,5767,7825,4855,20419,15564,344,1628
MG,52590,SÃO JOSÉ DA SAFIRA,1285,1016,1395,3990,2595,44,250
MG,52612,SÃO JOSÉ DA VARGINHA,883,1438,890,3567,2677,74,282
MG,52639,SÃO JOSÉ DO ALEGRE,692,1834,764,3729,2965,89,350
MG,52655,SÃO JOSÉ DO DIVINO,953,1197,918,3306,2388,31,207
MG,52671,SÃO JOSÉ DO GOIABAL,1803,1025,1345,4718,3373,69,476
MG,52698,SÃO JOSÉ DO JACURI,1919,990,1619,5116,3497,112,476
MG,52710,SÃO JOSÉ DO MANTIMENTO,961,861,752,2807,2055,42,191
MG,52736,SÃO LOURENÇO,5561,16961,8023,33685,25662,651,2489
MG,52752,SÃO MIGUEL DO ANTA,2670,1405,1190,6005,4815,164,576
MG,52779,SÃO PEDRO DA UNIÃO,1050,1625,1089,4281,3192,95,422
MG,52795,SÃO PEDRO DOS FERROS,2505,1417,2103,6730,4627,112,593
MG,52817,SÃO PEDRO DO SUAÇUÍ,1636,1064,1437,4588,3151,54,397
MG,52833,SÃO ROMÃO,2669,992,2756,6895,4139,48,430
MG,52850,SÃO ROQUE DE MINAS,927,2830,1397,5696,4299,167,375
MG,52876,SÃO SEBASTIÃO DA BELA VISTA,1271,2411,1147,5298,4151,66,403
MG,52892,SÃO SEBASTIÃO DO MARANHÃO,2625,1657,3844,8841,4997,99,616
MG,52914,SÃO SEBASTIÃO DO OESTE,2057,2540,1725,6945,5220,100,523
MG,52930,SÃO SEBASTIÃO DO PARAÍSO,10986,20394,13928,50298,36370,976,4014
MG,52957,SÃO SEBASTIÃO DO RIO PRETO,425,479,522,1593,1071,20,147
MG,52973,SÃO SEBASTIÃO DO RIO VERDE,408,956,345,1975,1630,41,225
MG,52990,SÃO TIAGO,2418,3241,1726,8865,7139,317,1163
MG,53015,SÃO TOMÁS DE AQUINO,1461,2161,1674,5908,4234,108,504
MG,53031,SÃO THOMÉ DAS LETRAS,1848,1291,774,4458,3684,122,423
MG,53058,SÃO VICENTE DE MINAS,1525,2112,1431,5739,4308,108,563
MG,53074,SAPUCAÍ-MIRIM,1094,2314,1454,5403,3949,120,421
MG,53090,SARDOÁ,1375,1295,1509,4830,3321,91,560
MG,53112,SENADOR CORTES,920,670,544,2387,1843,49,204
MG,53139,SENADOR FIRMINO,2591,1734,1489,6563,5074,102,647
MG,53155,SENADOR JOSÉ BENTO,472,1064,460,2168,1708,29,143
MG,53171,SENADOR MODESTINO GONÇALVES,1563,829,1767,4541,2774,55,327
MG,53198,SENHORA DE OLIVEIRA,2356,1160,1331,5469,4138,170,452
MG,53210,SENHORA DO PORTO,982,861,1057,3244,2187,40,304
MG,53236,SENHORA DOS REMÉDIOS,3087,2201,1600,7931,6331,144,899
MG,53252,SERICITA,2598,1968,1426,6568,5142,130,446
MG,53279,SERITINGA,514,599,457,1796,1339,49,177
MG,53295,SERRA AZUL DE MINAS,1278,540,1485,3680,2195,41,336
MG,53317,SERRA DA SAUDADE,172,456,253,941,688,8,52
MG,53333,SERRA DOS AIMORÉS,1899,1375,1890,5588,3698,75,349
MG,53350,SERRA DO SALITRE,2242,3559,2191,8678,6487,168,518
MG,53376,SERRANIA,1864,2263,1729,6557,4828,140,561
MG,53392,SERRANOS,626,669,436,1968,1532,47,190
MG,53414,SERRO,6278,2465,6206,16984,10778,242,1793
MG,53430,SETE LAGOAS,34449,79126,30002,163630,133628,4255,15798
MG,53457,SILVEIRÂNIA,1238,631,593,2653,2060,55,136
MG,53473,SILVIANÓPOLIS,915,2334,1118,4907,3789,90,450
MG,53490,SIMÃO PEREIRA,1012,945,565,2744,2179,44,178
MG,53511,SIMONÉSIA,4740,4597,3721,14938,11217,359,1521
MG,53538,SOBRÁLIA,1281,1452,1308,4522,3214,77,404
MG,53554,SOLEDADE DE MINAS,1149,2340,1061,5012,3951,103,359
MG,53570,TABULEIRO,1490,1244,1185,4359,3174,81,359
MG,53597,TAIOBEIRAS,5537,10419,7180,25537,18357,300,2101
MG,53619,TAPIRA,824,2000,1019,4228,3209,85,300
MG,53635,TAPIRAÍ,633,540,373,1685,1312,37,102
MG,53651,TAQUARAÇU DE MINAS,935,1751,1194,4350,3156,88,382
MG,53678,TARUMIRIM,3184,3712,2941,10582,7641,115,630
MG,53694,TEIXEIRAS,3789,2824,2418,10273,7855,181,1061
MG,53716,TEÓFILO OTONI,28194,33970,31811,104000,72189,1687,8338
MG,53732,TIMÓTEO,12599,28465,14856,61178,46322,1026,4232
MG,53759,TIRADENTES,1764,2629,1256,6373,5117,146,578
MG,53775,TIROS,815,2832,1878,6012,4134,120,367
MG,53791,TOCANTINS,3861,5092,2775,13289,10514,363,1198
MG,53813,TOLEDO,1013,2876,1369,5769,4400,122,389
MG,53830,TOMBOS,2658,2064,1905,7144,5239,94,423
MG,53856,TRÊS CORAÇÕES,10716,27186,11859,55980,44121,1368,4851
MG,53872,TRÊS PONTAS,13133,17169,9028,44049,35021,1270,3449
MG,53899,TUMIRITINGA,1731,1558,1697,5409,3712,61,362
MG,53910,TUPACIGUARA,6891,6281,5143,19827,14684,273,1239
MG,53937,TURMALINA,6891,2893,3968,15090,11122,213,1125
MG,53953,TURVOLÂNDIA,1081,1527,987,4094,3107,84,415
MG,53970,UBÁ,19993,28658,14731,70519,55788,1432,5705
MG,53996,UBAÍ,4193,1266,2923,9056,6133,54,620
MG,54011,UBERABA,55842,106569,34517,217723,183206,3872,16923
MG,54038,UBERLÂNDIA,128070,218367,71228,466216,394988,7662,40889
MG,54054,UMBURATIBA,1088,452,868,2601,1733,28,165
MG,54070,UNAÍ,13392,27649,15170,60999,45829,1038,3750
MG,54097,URUCÂNIA,3186,2226,2078,8613,6535,184,939
MG,54119,VARGEM BONITA,573,855,701,2321,1620,52,140
MG,54135,VARGINHA,18711,51221,18823,98593,79770,2311,7527
MG,54151,VÁRZEA DA PALMA,7023,8610,8253,26843,18590,429,2528
MG,54178,VARZELÂNDIA,6777,2285,5535,15765,10230,175,993
MG,54194,VAZANTE,4334,5921,4522,16379,11857,219,1383
MG,54216,WENCESLAU BRAZ,516,1458,668,2880,2212,42,196
MG,54232,VERÍSSIMO,868,919,784,2775,1991,29,175
MG,54259,VESPASIANO,21739,34281,16368,81083,64715,2000,6695
MG,54275,VIÇOSA,22851,15900,12153,57025,44872,1234,4887
MG,54291,VIEIRAS,1484,1082,568,3427,2859,33,260
MG,54313,MATHIAS LOBATO,937,837,1003,2998,1995,28,193
MG,54330,VIRGEM DA LAPA,3540,1802,3857,10130,6273,128,803
MG,54356,VIRGÍNIA,2020,2837,1681,7318,5637,186,594
MG,54372,VIRGINÓPOLIS,2821,2084,2754,8801,6047,192,950
MG,54399,VIRGOLÂNDIA,1775,851,1251,4271,3020,38,356
MG,54410,VISCONDE DO RIO BRANCO,9396,11264,6114,30082,23968,675,2633
MG,54437,VOLTA GRANDE,1662,1098,1516,4578,3062,70,232
MG,54453,ITAÚ DE MINAS,2663,5488,3030,12549,9519,265,1103
MS,55000,NOVA ALVORADA DO SUL,4105,5360,4794,15005,10211,160,586
MS,55018,ALCINÓPOLIS,1059,1194,1066,3505,2439,47,139
MS,55026,LAGUNA CARAPÃ,1342,2129,1078,4720,3642,25,146
MS,55034,JAPORÃ,2559,1184,1582,5597,4015,30,242
MS,55042,NOVO HORIZONTE DO SUL,1253,1312,1097,3886,2789,46,178
MS,55050,PARAÍSO DAS ÁGUAS,567,1731,1273,3734,2461,37,126
MS,55069,FIGUEIRÃO,670,900,655,2342,1687,31,86
MS,90034,ÁGUA CLARA,2501,4269,4334,11614,7280,122,388
MS,90115,AMAMBAI,7354,9916,6625,25175,18550,224,1056
MS,90131,ANASTÁCIO,4920,7024,5316,18187,12871,200,727
MS,90158,ANAURILÂNDIA,1849,2046,2028,6277,4249,45,309
MS,90174,ANTÔNIO JOÃO,2060,2607,1732,6787,5055,71,317
MS,90190,APARECIDA DO TABOADO,3420,8005,5647,18310,12663,235,1003
MS,90212,AQUIDAUANA,9719,12369,10168,33828,23660,351,1221
MS,90298,BANDEIRANTES,1813,2269,1445,5852,4407,60,265
MS,90379,BATAGUASSU,4145,7059,5538,17763,12225,215,806
MS,90395,BATAYPORÃ,2445,3073,2461,8539,6078,95,465
MS,90417,BELA VISTA,4394,6188,4973,16271,11298,154,562
MS,90433,BONITO,4507,7096,4259,16662,12403,170,630
MS,90450,BRASILÂNDIA,1981,3719,3497,9713,6216,93,423
MS,90492,CAMAPUÃ,2943,4462,3256,11207,7951,106,440
MS,90514,CAMPO GRANDE,135939,337170,76960,591533,514573,11417,30047
MS,90530,CARACOL,1191,1770,1404,4537,3133,34,138
MS,90557,CAARAPÓ,4961,9178,5072,20402,15330,217,974
MS,90573,CASSILÂNDIA,2869,7125,5252,16463,11211,239,978
MS,90611,CORGUINHO,1025,1364,1088,3662,2574,44,141
MS,90638,CORUMBÁ,20013,27107,18876,69208,50332,856,2356
MS,90654,COXIM,6376,9704,7904,25200,17296,261,955
MS,90735,DOURADOS,35815,76753,34229,156614,122385,2425,7392
MS,90751,FÁTIMA DO SUL,4458,7087,3715,16260,12545,207,793
MS,90794,GLÓRIA DE DOURADOS,2186,3072,1897,7650,5753,99,396
MS,90816,GUIA LOPES DA LAGUNA,1914,2916,2227,7518,5291,91,370
MS,90859,IGUATEMI,2346,4247,3408,10533,7125,100,432
MS,90875,INOCÊNCIA,1209,2467,2413,6502,4089,65,348
MS,90891,ITAPORÃ,3025,6496,2895,13318,10423,171,731
MS,90930,IVINHEMA,4756,8712,4364,19034,14670,275,927
MS,90972,JARAGUARI,1379,1907,1237,4806,3569,58,225
MS,90999,JARDIM,3973,7847,5564,18206,12642,185,637
MS,91014,JATEÍ,1204,1324,1107,3822,2715,41,146
MS,91030,LADÁRIO,3732,5073,3916,13347,9431,141,485
MS,91073,MARACAJU,6414,13404,6345,27448,21103,299,986
MS,91111,MIRANDA,7117,5626,5573,19167,13594,171,680
MS,91138,NAVIRAÍ,7332,16460,10022,36114,26092,515,1785
MS,91154,NIOAQUE,3332,3597,3091,10463,7372,108,335
MS,91235,NOVA ANDRADINA,8304,14015,9816,33921,24105,430,1356
MS,91251,PARANAÍBA,7376,12781,8400,30741,22341,522,1662
MS,91278,PEDRO GOMES,1807,2018,1870,5982,4112,54,233
MS,91316,PONTA PORÃ,13906,29496,16463,63318,46855,927,2526
MS,91375,PORTO MURTINHO,1957,2727,3326,8310,4984,77,223
MS,91413,RIBAS DO RIO PARDO,3588,5264,4705,14327,9622,204,566
MS,91430,RIO BRILHANTE,7047,10583,6084,25114,19030,292,1108
MS,91456,RIO NEGRO,1063,1487,1142,3924,2782,54,178
MS,91472,RIO VERDE DE MATO GROSSO,3514,5675,4335,14173,9838,113,536
MS,91499,ROCHEDO,922,1785,1061,4037,2976,57,212
MS,91570,SIDROLÂNDIA,9242,12110,7833,30797,22964,360,1252
MS,91596,TERENOS,3956,5007,2922,12638,9716,144,609
MS,91650,TRÊS LAGOAS,16944,34967,21153,77748,56595,1053,3631
MS,91693,ANGÉLICA,2585,3038,2119,8274,6155,98,434
MS,91715,ARAL MOREIRA,2228,2547,1609,6680,5071,48,248
MS,91731,ELDORADO,1830,3771,2753,8886,6133,123,409
MS,91758,DEODÁPOLIS,2750,3983,2653,10220,7567,163,671
MS,91782,CHAPADÃO DO SUL,2917,8869,4673,17306,12633,204,643
MS,91790,MUNDO NOVO,3291,6248,3601,13928,10327,181,607
MS,91804,DOIS IRMÃOS DO BURITI,3330,2029,2179,7980,5801,62,380
MS,91820,JUTI,1864,1612,1418,5178,3760,41,243
MS,91847,PARANHOS,2741,2411,2290,7967,5677,52,473
MS,91863,SANTA RITA DO PARDO,1203,1682,1507,4658,3151,53,213
MS,91880,SONORA,2989,4293,3207,11071,7864,107,475
MS,91901,VICENTINA,2134,1881,1055,5433,4378,59,304
MS,98019,BODOQUENA,1886,2332,2051,6615,4564,56,290
MS,98035,COSTA RICA,4710,8245,6204,20370,14166,228,983
MS,98051,DOURADINA,1346,1876,718,4177,3459,46,191
MS,98078,ITAQUIRAÍ,4327,4183,4497,13791,9294,155,629
MS,98094,SÃO GABRIEL DO OESTE,3691,9997,5168,19648,14480,203,589
MS,98116,SELVÍRIA,2152,1697,1858,6052,4194,63,282
MS,98132,SETE QUEDAS,1728,3149,1731,7047,5316,76,363
MS,98159,TACURU,2954,1443,2283,7099,4816,67,352
MS,98175,TAQUARUSSU,1220,998,813,3197,2384,38,128
MS,98590,CORONEL SAPUCAIA,3351,3532,2890,10359,7469,68,518
MT,89788,COLNIZA,3498,7570,5591,17205,11614,166,380
MT,89796,COLÍDER,2741,13051,6666,23229,16563,241,530
MT,89800,CURVELÂNDIA,985,1755,1060,3925,2865,34,91
MT,89818,NOVA BRASILÂNDIA,1266,1082,829,3301,2472,28,96
MT,89826,NOVA SANTA HELENA,595,1307,600,2580,1980,15,63
MT,89834,PARANATINGA,2829,6686,4947,14824,9877,84,278
MT,89843,SANTO ANTÔNIO DO LESTE,493,973,871,2422,1551,20,65
MT,89850,SINOP,15331,52446,15664,86890,71226,1140,2309
MT,89877,ALTA FLORESTA,7791,18321,11059,38646,27587,404,1071
MT,89893,ARAPUTANGA,2172,5860,3398,11911,8513,104,377
MT,89915,JAURU,1342,3683,2751,8059,5308,70,213
MT,89931,SÃO JOSÉ DOS QUATRO MARCOS,2793,6462,4366,14338,9972,136,581
MT,89958,RIO BRANCO,1084,1639,1126,4032,2906,33,150
MT,89960,RONDOLÂNDIA,824,680,884,2466,1582,28,50
MT,89974,SALTO DO CÉU,705,1404,731,2972,2241,42,90
MT,89990,PONTES E LACERDA,4749,16121,7442,29425,21983,324,789
MT,90018,ACORIZAL,2526,1937,1407,5985,4578,34,81
MT,90026,SÃO JOSÉ DO POVO,876,1065,819,2919,2100,29,130
MT,90042,ALTO BOA VISTA,572,1735,1210,3602,2392,20,65
MT,90050,ALTO ARAGUAIA,2687,5001,3986,12156,8170,93,389
MT,90069,QUERÊNCIA,1954,5965,3899,12073,8174,87,168
MT,90077,ALTO GARÇAS,1730,3183,2106,7320,5214,53,248
MT,90085,CANABRAVA DO NORTE,814,1580,1301,3788,2487,31,62
MT,90093,ALTO PARAGUAI,2412,1714,1903,6239,4336,52,158
MT,90107,SANTA CARMEM,573,1886,847,3396,2549,22,68
MT,90123,NOVA MARINGÁ,726,1780,1496,4085,2589,16,67
MT,90140,NOVA GUARITA,1043,1571,1064,3801,2737,36,87
MT,90166,NOVA MARILÂNDIA,575,1088,877,2632,1755,24,68
MT,90182,PORTO ESTRELA,1456,698,981,3219,2238,25,59
MT,90204,GLÓRIA D OESTE,624,1159,709,2602,1893,25,85
MT,90220,TABAPORÃ,1083,3331,2224,6865,4641,68,159
MT,90239,ARAGUAINHA,296,329,266,946,680,20,35
MT,90247,SÃO JOSÉ DO XINGU,1250,1314,1659,4341,2682,29,89
MT,90255,ARENÁPOLIS,1908,3187,2433,7802,5369,79,195
MT,90263,APIACÁS,1366,2071,1667,5263,3596,33,126
MT,90271,ARIPUANÃ,2325,5148,4630,12404,7774,96,205
MT,90280,CONFRESA,4172,8181,5789,18702,12913,181,379
MT,90301,LAMBARI D OESTE,1356,1535,1590,4660,3070,45,134
MT,90310,BARÃO DE MELGAÇO,2618,1225,1295,5297,4002,30,129
MT,90328,SANTO AFONSO,673,800,852,2409,1557,25,59
MT,90336,BARRA DO BUGRES,7636,8047,6723,23246,16523,192,648
MT,90344,PLANALTO DA SERRA,1025,989,328,2492,2164,28,122
MT,90352,BARRA DO GARÇAS,10350,18236,12779,43117,30338,484,1268
MT,90360,NOVA MONTE VERDE,1141,2644,1773,5715,3942,47,110
MT,90387,NOVA BANDEIRANTES,1381,4318,2999,9004,6005,89,217
MT,90409,SÃO PEDRO DA CIPA,1144,1260,892,3415,2523,26,93
MT,90425,COTRIGUAÇU,2114,3342,2542,8303,5761,91,214
MT,90441,RIBEIRÃOZINHO,650,683,500,1936,1436,30,73
MT,90468,BRASNORTE,2371,5097,3714,11494,7780,96,216
MT,90476,CÁCERES,19254,22961,17724,61628,43904,614,1075
MT,90484,CAMPO NOVO DO PARECIS,4549,10513,6259,22009,15750,222,466
MT,90506,CAMPO VERDE,5577,14839,7595,28912,21317,248,653
MT,90522,CLÁUDIA,1360,3850,2277,7753,5476,66,200
MT,90549,CASTANHEIRA,1520,2366,1701,5789,4088,48,154
MT,90565,JANGADA,2830,1849,1544,6379,4835,41,115
MT,90581,JURUENA,1327,2555,1962,6061,4099,64,153
MT,90590,CHAPADA DOS GUIMARÃES,5091,5438,4352,15362,11010,126,355
MT,90603,LUCAS DO RIO VERDE,7406,22894,10991,42566,31575,371,904
MT,90620,MATUPÁ,2314,5509,3326,11493,8167,101,243
MT,90646,NOVA MUTUM,4595,15291,6281,26931,20650,296,468
MT,90662,RIBEIRÃO CASCALHEIRA,1445,2735,2283,6657,4374,56,138
MT,90670,CUIABÁ,109681,222077,88971,440527,351556,5139,14659
MT,90689,TAPURAH,1182,4259,2299,7923,5624,66,117
MT,90697,DIAMANTINO,3687,6984,4489,15570,11081,147,263
MT,90700,PONTAL DO ARAGUAIA,1350,2116,1352,4996,3644,48,130
MT,90719,DOM AQUINO,1660,2586,1989,6456,4467,39,182
MT,90727,SAPEZAL,2730,6794,4839,14764,9925,112,289
MT,90743,CAMPOS DE JÚLIO,792,2210,1172,4285,3113,32,79
MT,90760,CARLINDA,2350,2685,2109,7402,5293,75,183
MT,90778,GENERAL CARNEIRO,1656,959,1207,3920,2713,16,82
MT,90786,FELIZ NATAL,1475,2536,1942,6100,4158,38,109
MT,90808,NOVO MUNDO,1153,2229,1569,5067,3498,44,72
MT,90824,GAÚCHA DO NORTE,1094,2173,1563,4927,3364,28,69
MT,90832,GUIRATINGA,2365,3162,2482,8411,5929,68,334
MT,90840,UNIÃO DO SUL,670,1036,783,2541,1758,19,33
MT,90867,NOVA LACERDA,1081,1667,1620,4478,2858,36,74
MT,90883,NOVA UBIRATÃ,1267,2824,2114,6369,4255,57,107
MT,90905,BOM JESUS DO ARAGUAIA,1321,1523,1675,4631,2956,27,85
MT,90913,ITIQUIRA,2004,3666,2688,8655,5967,74,223
MT,90921,SERRA NOVA DOURADA,316,549,494,1387,893,9,19
MT,90948,NOVO SANTO ANTÔNIO,496,514,655,1701,1046,10,26
MT,90956,JACIARA,4434,9854,4044,19238,15194,232,674
MT,90964,NOVA NAZARÉ,757,720,851,2390,1539,12,50
MT,90980,SANTA CRUZ DO XINGU,286,674,570,1573,1003,10,33
MT,91006,CONQUISTA D OESTE,541,1307,919,2850,1931,23,60
MT,91022,VALE DE SÃO DOMINGOS,445,1369,676,2590,1914,21,79
MT,91049,SANTA RITA DO TRIVELATO,376,840,758,2036,1278,25,37
MT,91057,LUCIARA,587,745,567,1946,1379,13,34
MT,91081,IPIRANGA DO NORTE,641,2230,1034,3997,2963,26,66
MT,91090,VILA BELA DA SANTÍSSIMA TRINDADE,2813,3677,3266,9990,6724,47,187
MT,91103,ITANHANGÁ,601,2364,1393,4421,3028,19,44
MT,91170,NOBRES,2667,5274,2699,10999,8300,99,260
MT,91197,NORTELÂNDIA,1516,1770,1108,4581,3473,46,141
MT,91219,NOSSA SENHORA DO LIVRAMENTO,5290,2719,2908,11242,8334,68,257
MT,91294,POCONÉ,10374,6051,5921,22902,16981,157,399
MT,91332,PONTE BRANCA,763,451,506,1775,1269,15,40
MT,91359,PORTO DOS GAÚCHOS,813,1843,1298,4079,2781,24,101
MT,91391,POXORÉU,4094,3910,4655,13226,8571,102,465
MT,91510,RONDONÓPOLIS,33847,74166,36407,150889,114482,1524,4945
MT,91537,ROSÁRIO OESTE,4417,4041,3795,12561,8766,93,215
MT,91553,SANTO ANTÔNIO DO LEVERGER,6012,5445,3392,15251,11859,126,276
MT,91618,TESOURO,706,690,1055,2535,1480,28,56
MT,91634,TORIXORÉU,1021,1200,739,3087,2348,27,100
MT,91677,VÁRZEA GRANDE,53552,87193,41657,189785,148128,2086,5297
MT,91774,MIRASSOL D OESTE,4009,8784,5925,19546,13621,192,636
MT,91812,PEDRA PRETA,3602,4979,3616,12734,9118,118,419
MT,91839,SÃO FÉLIX DO ARAGUAIA,1571,2514,2806,7061,4255,49,121
MT,91855,TANGARÁ DA SERRA,10314,34821,18435,65615,47180,700,1345
MT,91898,JUSCIMEIRA,2338,3685,2469,8909,6440,109,308
MT,91910,ÁGUA BOA,2258,8733,5488,16887,11399,155,253
MT,91936,CANARANA,2286,7452,4673,14738,10065,116,211
MT,91952,NOVA XAVANTINA,3015,6544,4980,15067,10087,127,401
MT,91979,SANTA TEREZINHA,1790,1151,1818,4894,3076,24,111
MT,91995,SÃO JOSÉ DO RIO CLARO,1854,5517,3502,11235,7733,94,268
MT,98191,JUARA,3790,11471,7303,23463,16160,234,665
MT,98310,JUÍNA,6438,14479,9474,31463,21989,334,738
MT,98337,DENISE,1641,2144,1545,5560,4015,50,180
MT,98612,ALTO TAQUARI,1197,3139,2317,6888,4571,54,181
MT,98639,ARAGUAIANA,859,1008,853,2838,1985,14,104
MT,98655,CAMPINÁPOLIS,3739,2528,2984,9493,6509,72,170
MT,98671,COCALINHO,1174,1333,1747,4342,2595,19,69
MT,98698,ITAÚBA,871,1724,1450,4137,2687,21,71
MT,98710,MARCELÂNDIA,1585,4181,3061,9054,5993,49,178
MT,98736,NOVA OLÍMPIA,3862,3948,3299,11692,8393,136,447
MT,98752,NOVA CANAÃ DO NORTE,1878,4883,3052,10179,7127,118,248
MT,98779,NOVO SÃO JOAQUIM,1028,2085,1802,5068,3266,20,133
MT,98795,NOVO HORIZONTE DO NORTE,747,1420,861,3145,2284,24,93
MT,98817,PEIXOTO DE AZEVEDO,6283,7067,5679,19712,14033,198,485
MT,98833,PARANAÍTA,1861,3979,2618,8710,6092,79,173
MT,98850,PORTO ALEGRE DO NORTE,1788,2719,2713,7394,4681,54,120
MT,98876,PORTO ESPERIDIÃO,2319,2722,2546,7796,5250,72,137
MT,98892,PRIMAVERA DO LESTE,6846,24938,10442,43796,33354,433,1137
MT,98914,RESERVA DO CABAÇAL,521,735,645,2000,1355,28,71
MT,98930,SORRISO,9939,30599,13303,55195,41892,492,862
MT,98957,TERRA NOVA DO NORTE,2278,3498,2610,8680,6070,86,208
MT,98973,VERA,1238,3014,1826,6290,4464,68,144
MT,98990,VILA RICA,2542,5429,4853,13207,8354,111,272
MT,99015,COMODORO,2855,5947,4613,13814,9201,114,285
MT,99031,FIGUEIRÓPOLIS D OESTE,441,1581,933,3098,2165,37,106
MT,99058,GUARANTÃ DO NORTE,2963,11228,6664,21400,14736,187,358
MT,99074,INDIAVAÍ,505,824,459,1865,1406,18,59
PA,4006,GOIANÉSIA DO PARÁ,8242,4648,8366,22302,13936,172,874
PA,4014,ABAETETUBA,61646,19896,19733,107389,87656,1120,4994
PA,4022,TAILÂNDIA,16910,13392,14260,47124,32864,384,2178
PA,4030,ACARÁ,22544,7548,5280,38344,33064,393,2579
PA,4049,BOM JESUS DO TOCANTINS,4105,3058,1634,9490,7856,76,617
PA,4057,AFUÁ,11169,5684,6098,24068,17970,166,951
PA,4065,SÃO JOÃO DE PIRABAS,7397,3227,4649,16290,11641,131,886
PA,4073,ALENQUER,14397,12988,6294,35781,29487,255,1847
PA,4081,TUCUMÃ,6298,10585,8768,26763,17995,167,945
PA,4090,ALMEIRIM,10213,3882,7048,22067,15019,145,779
PA,4103,MÃE DO RIO,8853,7101,7340,24795,17455,200,1301
PA,4111,ALTAMIRA,19466,33549,21978,79768,57790,861,3914
PA,4120,ELDORADO DOS CARAJÁS,6733,4937,6377,19170,12793,165,958
PA,4138,ANAJÁS,6951,4300,6776,19022,12246,71,924
PA,4146,SANTA LUZIA DO PARÁ,7632,2684,4926,16157,11231,127,788
PA,4154,ANANINDEUA,109713,132590,52964,322390,269426,5188,21935
PA,4162,PALESTINA DO PARÁ,2385,1485,711,4937,4226,40,316
PA,4170,AUGUSTO CORRÊA,17073,5673,6295,31370,25075,257,2072
PA,4189,IPIXUNA DO PARÁ,8214,3962,6030,19294,13264,164,924
PA,4197,AVEIRO,4000,1926,4120,10422,6302,55,321
PA,4200,JACAREACANGA,4370,1419,4016,10273,6257,50,418
PA,4219,BAGRE,6342,1430,5383,13630,8247,53,422
PA,4227,BRASIL NOVO,4132,6726,2052,13790,11738,150,730
PA,4235,BAIÃO,12183,4044,6033,23529,17496,226,1043
PA,4243,SANTA BÁRBARA DO PARÁ,7364,5175,2129,16064,13935,219,1177
PA,4251,BARCARENA,41225,20998,16419,84344,67925,988,4714
PA,4260,ÁGUA AZUL DO NORTE,2743,3065,1183,7464,6281,62,411
PA,4278,BELÉM,351193,427982,121426,991027,869601,17588,72838
PA,4286,TRAIRÃO,2456,3815,3698,10382,6684,78,335
PA,4294,BENEVIDES,16177,13337,7923,40087,32164,471,2179
PA,4308,PAU D ARCO,2046,2033,2696,7053,4357,52,226
PA,4316,BONITO,6275,1816,2017,10939,8922,106,725
PA,4324,ULIANÓPOLIS,6348,4642,5291,17062,11771,122,659
PA,4332,BRAGANÇA,36553,21245,17549,80834,63285,664,4823
PA,4340,AURORA DO PARÁ,8146,3357,5286,17787,12501,103,895
PA,4359,BREVES,25035,12011,22948,62735,39787,357,2384
PA,4367,TERRA SANTA,5303,3753,3682,13196,9514,104,354
PA,4375,BUJARU,10347,3404,4531,19444,14913,173,989
PA,4383,NOVO PROGRESSO,2638,9454,7125,19907,12782,145,545
PA,4391,CACHOEIRA DO ARARI,9055,1908,5461,17243,11782,94,725
PA,4405,VITÓRIA DO XINGU,4540,4272,2283,11825,9542,91,639
PA,4413,CAMETÁ,49947,15959,19108,89094,69986,710,3370
PA,4421,NOVO REPARTIMENTO,12573,11506,14281,40461,26180,302,1799
PA,4430,CAPANEMA,20189,15253,10750,50039,39289,639,3208
PA,4448,BREU BRANCO,11310,7772,11781,32491,20710,209,1419
PA,4456,CAPITÃO POÇO,17366,9979,8265,38222,29957,351,2261
PA,4464,SÃO DOMINGOS DO ARAGUAIA,5976,3701,5198,15778,10580,119,784
PA,4472,CASTANHAL,42925,52067,22406,128193,105787,1575,9220
PA,4480,NOVA ESPERANÇA DO PIRIÁ,5574,3639,4381,14401,10020,129,678
PA,4499,CHAVES,6408,1968,3282,12353,9071,76,619
PA,4502,ABEL FIGUEIREDO,2491,1371,809,5005,4196,35,299
PA,4510,COLARES,4871,1480,3051,10056,7005,98,556
PA,4529,CUMARU DO NORTE,1878,1724,1001,4898,3897,33,262
PA,4537,CONCEIÇÃO DO ARAGUAIA,9945,11724,7504,31529,24025,326,2030
PA,4545,TERRA ALTA,4726,2241,2507,10156,7649,110,572
PA,4553,CURRALINHO,11165,2076,6149,20326,14177,74,862
PA,4561,FLORESTA DO ARAGUAIA,4799,4363,2864,12810,9946,78,706
PA,4570,CURUÇÁ,15550,5033,7902,30320,22418,217,1618
PA,4588,BANNACH,744,1050,473,2393,1920,19,107
PA,4596,FARO,3216,633,1824,5846,4022,28,145
PA,4600,NOVA IPIXUNA,3645,3221,1452,9056,7604,90,648
PA,4618,GURUPÁ,9551,2771,5095,18020,12925,76,527
PA,4626,PLACAS,3478,3809,3564,11564,8000,155,558
PA,4634,IGARAPÉ-AÇU,14992,5649,6559,29471,22912,315,1956
PA,4642,MARITUBA,30049,25234,11908,73273,61365,1040,5042
PA,4650,IGARAPÉ-MIRI,21804,9576,12393,46521,34128,504,2244
PA,4669,TRACUATEUA,13507,3100,4876,22799,17923,135,1181
PA,4677,INHANGAPI,4020,2369,1069,8198,7129,78,662
PA,4685,QUATIPURU,4447,1553,2894,9407,6513,76,437
PA,4693,IRITUIA,12956,4031,6443,24845,18402,206,1209
PA,4707,CANAÃ DOS CARAJÁS,9048,14842,13870,39824,25954,378,1686
PA,4715,ITAITUBA,19715,24784,29039,77083,48044,727,2818
PA,4723,ANAPU,5203,5979,5066,17143,12077,165,730
PA,4731,ITUPIRANGA,12266,6785,11851,32452,20601,190,1360
PA,4740,CURUÁ,5629,1482,1267,8764,7497,46,340
PA,4758,JACUNDÁ,12043,8318,11979,34273,22294,268,1665
PA,4766,CACHOEIRA DO PIRIÁ,6460,1720,4509,13327,8818,62,576
PA,4774,JURUTI,13294,8755,8605,31763,23158,188,921
PA,4782,PIÇARRA,2749,2621,3363,9165,5802,68,364
PA,4790,LIMOEIRO DO AJURU,10679,3381,4603,19523,14920,187,673
PA,4804,BELTERRA,5497,4663,2794,13751,10957,113,684
PA,4812,MAGALHÃES BARATA,3562,1552,2321,7826,5505,59,332
PA,4820,SÃO JOÃO DA PONTA,2776,1094,962,5203,4241,36,335
PA,4839,MARABÁ,48278,61220,42284,162500,120216,1782,8936
PA,4847,SAPUCAIA,1555,1310,807,3917,3110,38,207
PA,4855,MARACANÃ,12021,5165,3890,22420,18530,190,1154
PA,4863,MOJUÍ DOS CAMPOS,5744,7192,4116,18254,14138,173,1029
PA,4871,MARAPANIM,10105,4943,4288,20635,16347,145,1154
PA,4898,MELGAÇO,6115,1970,7149,15894,8745,67,593
PA,4910,MOCAJUBA,12928,3847,5924,23778,17854,184,895
PA,4936,MOJU,26114,8296,13393,50483,37090,347,2333
PA,4952,MONTE ALEGRE,15297,16203,11651,45540,33889,324,2065
PA,4979,MUANÁ,13130,3433,6457,24193,17736,162,1011
PA,4995,NOVA TIMBOTEUA,5548,2064,1566,9954,8388,118,658
PA,5010,ÓBIDOS,16517,6781,9647,34646,24999,303,1398
PA,5037,OEIRAS DO PARÁ,11875,2804,5374,20995,15621,96,846
PA,5053,ORIXIMINÁ,16020,11263,14409,43592,29183,323,1577
PA,5070,OURÉM,7541,2637,4085,15179,11094,122,794
PA,5096,PARAGOMINAS,19464,27031,19986,70740,50754,634,3625
PA,5118,PEIXE-BOI,3890,1851,1921,8174,6253,54,458
PA,5134,PONTA DE PEDRAS,10879,2982,4624,19678,15054,169,1024
PA,5150,PORTEL,13016,5388,13451,33560,20109,202,1503
PA,5177,PORTO DE MOZ,8813,3577,6259,19340,13081,77,614
PA,5193,PRAINHA,9806,5641,6119,22504,16385,155,783
PA,5215,PRIMAVERA,4731,2010,2545,9980,7435,57,637
PA,5231,SALINÓPOLIS,14318,7897,5284,29533,24249,339,1695
PA,5258,SALVATERRA,8757,2955,4609,17490,12881,181,988
PA,5274,SANTA CRUZ DO ARARI,2590,821,2735,6428,3693,30,252
PA,5290,SANTA ISABEL DO PARÁ,17253,14312,9144,44048,34904,573,2766
PA,5312,SANTA MARIA DO PARÁ,8299,6395,2410,18666,16256,248,1314
PA,5339,SANTANA DO ARAGUAIA,5241,7561,8257,22173,13916,155,959
PA,5355,SANTARÉM,70119,90577,44298,218497,174199,2560,10943
PA,5371,SANTARÉM NOVO,3570,830,1158,5853,4695,47,248
PA,5398,SANTO ANTÔNIO DO TAUÁ,11076,5010,5144,22602,17458,219,1153
PA,5410,SÃO CAETANO DE ODIVELAS,6784,2556,4505,14661,10156,146,670
PA,5436,SÃO DOMINGOS DO CAPIM,11473,3872,3336,20233,16897,214,1338
PA,5452,SÃO FÉLIX DO XINGU,8727,13133,12665,36352,23687,255,1572
PA,5479,SÃO FRANCISCO DO PARÁ,6328,3646,2708,13731,11023,119,930
PA,5495,SÃO JOÃO DO ARAGUAIA,4372,2376,3672,11050,7378,78,552
PA,5517,SÃO MIGUEL DO GUAMÁ,16700,8788,9786,37668,27882,376,2018
PA,5533,SÃO SEBASTIÃO DA BOA VISTA,10358,2813,5595,19658,14063,126,766
PA,5550,SENADOR JOSÉ PORFÍRIO,4577,2329,2210,9760,7550,87,557
PA,5576,SOURE,9682,3137,6102,19968,13866,155,892
PA,5592,TOMÉ-AÇU,19586,11569,13361,46988,33627,441,2031
PA,5614,TUCURUÍ,26569,21854,22833,75148,52315,774,3118
PA,5630,VIGIA,16549,7361,10496,36782,26286,382,1994
PA,5657,VISEU,21955,4476,12590,40755,28165,140,1594
PA,5673,REDENÇÃO,12661,24929,18224,58825,40601,586,2425
PA,5690,RIO MARIA,3877,5007,4201,13894,9693,119,690
PA,5711,XINGUARA,8033,13477,10291,33705,23414,360,1544
PA,5738,RONDON DO PARÁ,8530,9123,10477,29612,19135,197,1285
PA,5754,URUARÁ,5993,11999,8618,28555,19937,361,1584
PA,5770,MEDICILÂNDIA,4329,7085,4932,17622,12690,257,1019
PA,5797,SÃO GERALDO DO ARAGUAIA,6276,5519,7571,20543,12972,152,1025
PA,5819,CONCÓRDIA DO PARÁ,9628,5179,5308,21288,15980,187,986
PA,5835,PARAUAPEBAS,40410,64650,41346,156345,114999,1715,8224
PA,5851,CURIONÓPOLIS,5195,5406,4739,16175,11436,139,696
PA,5878,GARRAFÃO DO NORTE,10084,3557,6147,21101,14954,169,1144
PA,5894,RURÓPOLIS,5511,5564,5591,17652,12061,197,789
PA,5916,PACAJÁ,8037,7460,9702,26771,17069,230,1342
PA,5932,BREJO GRANDE DO ARAGUAIA,2700,1602,717,5307,4590,51,237
PA,5959,OURILÂNDIA DO NORTE,5816,7299,8249,22419,14170,140,915
PA,5975,DOM ELISEU,10573,8200,10214,30538,20324,284,1267
PA,5991,SANTA MARIA DAS BARREIRAS,3411,4427,2803,11280,8477,74,565
PB,19003,RIACHÃO DO POÇO,2309,862,516,3932,3416,44,201
PB,19011,ÁGUA BRANCA,5080,573,1071,7025,5954,68,233
PB,19020,SOBRADO,3636,1546,894,6444,5550,86,282
PB,19038,AGUIAR,2827,473,1043,4474,3431,24,107
PB,19046,SÃO JOSÉ DOS RAMOS,2810,873,890,4793,3903,46,174
PB,19054,ALAGOA GRANDE,11443,4100,3855,20646,16791,274,974
PB,19062,CAPIM,3131,1074,1091,5599,4508,77,226
PB,19070,ALAGOA NOVA,8098,2899,2673,14839,12166,218,951
PB,19089,CUITÉ DE MAMANGUAPE,3965,863,1475,6599,5124,69,227
PB,19097,ALAGOINHA,6687,1511,1914,10672,8758,139,421
PB,19100,CURRAL DE CIMA,2927,676,983,4898,3915,79,233
PB,19119,ALHANDRA,8538,4863,2268,16904,14636,173,1062
PB,19127,RIACHÃO DO BACAMARTE,2432,616,632,3957,3325,41,236
PB,19135,SÃO JOÃO DO RIO DO PEIXE,9039,1618,1833,13167,11334,148,529
PB,19143,MATINHAS,2405,624,790,4087,3297,57,211
PB,19151,ARAÇAGI,8256,1597,2615,13088,10473,128,492
PB,19160,LOGRADOURO,1692,833,636,3378,2742,33,184
PB,19178,ARARA,4904,1404,1596,8360,6764,102,354
PB,19186,SERTÃOZINHO,2369,775,613,3960,3347,53,150
PB,19194,ARARUNA,6334,2556,2464,12199,9735,189,656
PB,19208,RIACHÃO,1717,550,626,3021,2395,19,109
PB,19216,AREIA,10765,2853,3039,17760,14721,296,807
PB,19224,SÃO DOMINGOS DO CARIRI,1314,600,755,2793,2038,43,81
PB,19232,AREIAL,2920,1312,881,5538,4657,101,324
PB,19240,CARAÚBAS,2521,560,681,3928,3247,39,127
PB,19259,AROEIRAS,9307,2237,2067,14462,12395,190,661
PB,19267,SANTO ANDRÉ,1504,379,656,2651,1995,21,91
PB,19275,DAMIÃO,2678,471,725,4085,3360,24,187
PB,19283,SOSSÊGO,1996,316,479,2913,2434,23,99
PB,19291,BAÍA DA TRAIÇÃO,4237,790,951,6196,5245,60,158
PB,19305,BARAÚNA,2588,440,742,3981,3239,37,174
PB,19313,BANANEIRAS,10207,2492,3136,16783,13647,243,705
PB,19321,ASSUNÇÃO,2123,467,879,3611,2732,41,101
PB,19330,BARRA DE SANTA ROSA,6565,1304,1709,10006,8297,65,363
PB,19348,ZABELÊ,1285,247,419,2033,1614,15,67
PB,19356,BARRA DE SÃO MIGUEL,2964,843,790,4830,4040,45,188
PB,19364,CACIMBAS,3665,416,1191,5516,4325,54,190
PB,19372,BAYEUX,29039,26588,8699,69580,60881,1070,4184
PB,19380,CAJAZEIRINHAS,2151,408,747,3429,2682,21,102
PB,19399,BELÉM,6815,2904,2192,12716,10524,180,625
PB,19402,SÃO BENTINHO,2095,469,804,3493,2689,32,93
PB,19410,BELÉM DO BREJO DO CRUZ,2964,949,1362,5481,4119,52,154
PB,19429,SÃO DOMINGOS,1649,471,632,2863,2231,21,90
PB,19437,BOA VENTURA,2936,596,1285,4991,3706,37,137
PB,19445,SÃO JOSÉ DE PRINCESA,2166,190,583,3080,2497,18,123
PB,19453,BOM JESUS,1999,189,512,2794,2282,19,75
PB,19461,MARIZÓPOLIS,3377,917,822,5374,4552,52,206
PB,19470,BOM SUCESSO,2953,307,729,4106,3377,29,88
PB,19488,MATO GROSSO,1633,143,724,2575,1851,15,60
PB,19496,BONITO DE SANTA FÉ,4273,1209,1379,7107,5728,40,206
PB,19500,BERNARDINO BATISTA,1797,263,388,2521,2133,16,57
PB,19518,BOQUEIRÃO,7376,3292,2236,13750,11514,153,693
PB,19526,POÇO DE JOSÉ DE MOURA,2496,457,585,3711,3126,29,144
PB,19534,IGARACY,2967,780,1403,5347,3944,47,150
PB,19542,SÃO JOSÉ DO BREJO DO CRUZ,1024,340,388,1826,1438,14,60
PB,19550,BORBOREMA,2476,665,909,4222,3313,43,129
PB,19569,SANTA INÊS,2265,190,716,3299,2583,16,112
PB,19577,BREJO DO CRUZ,4926,1889,2078,9403,7325,86,424
PB,19585,AMPARO,1630,177,421,2277,1856,14,35
PB,19593,BREJO DOS SANTOS,3193,993,937,5398,4461,68,207
PB,19607,CASSERENGUE,3493,664,1007,5383,4376,52,167
PB,19615,CAAPORÃ,8616,3602,1728,15167,13439,210,1011
PB,19623,GADO BRAVO,4562,875,874,6730,5856,68,351
PB,19631,CABACEIRAS,2284,1083,829,4465,3636,72,197
PB,19640,POÇO DANTAS,2327,260,578,3293,2715,22,106
PB,19658,CABEDELO,17190,17852,9215,46733,37518,574,1902
PB,19666,JOCA CLAUDINO,1710,257,476,2511,2035,11,57
PB,19674,CACHOEIRA DOS ÍNDIOS,5011,655,1332,7283,5951,46,239
PB,19682,TENÓRIO,1717,258,506,2587,2081,19,87
PB,19690,CACIMBA DE AREIA,2229,464,621,3429,2808,28,87
PB,19704,COXIXOLA,1107,259,321,1756,1435,17,52
PB,19712,CACIMBA DE DENTRO,7457,2089,2263,12414,10151,104,501
PB,19720,PARARI,1215,302,510,2113,1603,19,67
PB,19739,CAIÇARA,2911,1291,1572,6101,4529,55,272
PB,19747,PEDRO RÉGIS,2254,885,1239,4647,3408,67,202
PB,19755,CAJAZEIRAS,28571,6491,6716,43648,36932,447,1423
PB,19763,ALCANTIL,2052,1212,595,4232,3637,62,311
PB,19771,CALDAS BRANDÃO,2976,886,772,4877,4105,52,191
PB,19780,BARRA DE SANTANA,4060,1377,1113,7037,5924,96,391
PB,19798,CAMALAÚ,3939,297,913,5315,4402,38,128
PB,19801,CATURITÉ,2792,843,516,4438,3922,72,215
PB,19810,CAMPINA GRANDE,98243,126554,35969,285554,249585,4589,20199
PB,19828,RIACHO DE SANTO ANTÔNIO,1187,460,347,2088,1741,19,75
PB,19836,CARRAPATEIRA,1305,136,490,2015,1525,8,76
PB,19844,APARECIDA,4051,1095,1045,6470,5425,94,185
PB,19852,CATINGUEIRA,2311,829,1226,4530,3304,40,124
PB,19860,SÃO FRANCISCO,2286,608,618,3684,3066,27,145
PB,19879,CATOLÉ DO ROCHA,12017,3914,3079,19965,16886,199,756
PB,19887,VIEIRÓPOLIS,3039,549,1053,4802,3749,39,122
PB,19895,CONCEIÇÃO,8410,1921,2305,13175,10870,130,409
PB,19909,AREIA DE BARAÚNAS,1262,182,392,1890,1498,11,43
PB,19917,CONDADO,3317,710,877,5137,4260,46,187
PB,19925,ALGODÃO DE JANDAÍRA,1944,280,491,2796,2305,9,72
PB,19933,CONDE,9809,5332,2046,18325,16279,257,881
PB,19941,BOA VISTA,2960,1477,786,5616,4830,92,301
PB,19950,CONGO,3086,613,782,4675,3893,44,150
PB,19968,MARCAÇÃO,4286,589,885,6020,5135,74,186
PB,19976,COREMAS,6887,1608,2418,11347,8929,80,354
PB,19984,MATURÉIA,3222,605,1004,5095,4091,66,198
PB,19992,CRUZ DO ESPÍRITO SANTO,8871,2859,1585,14345,12760,296,734
PB,20001,SANTA CECÍLIA,3679,981,695,5683,4988,88,240
PB,20010,CUBATI,3384,1216,1093,6075,4982,84,298
PB,20036,CUITÉ,9750,2333,2712,15608,12896,162,651
PB,20052,CUITEGI,3160,933,1066,5488,4422,104,225
PB,20079,CURRAL VELHO,1295,305,552,2240,1688,21,67
PB,20095,DESTERRO,4151,848,1376,6587,5211,55,157
PB,20117,VISTA SERRANA,1475,421,798,2877,2079,32,151
PB,20133,DIAMANTE,3149,602,1348,5294,3946,54,141
PB,20150,DONA INÊS,5288,936,1727,8318,6591,61,306
PB,20176,DUAS ESTRADAS,1875,597,582,3221,2639,45,122
PB,20192,EMAS,1678,415,828,3035,2207,25,89
PB,20214,ESPERANÇA,11949,6337,3859,23712,19853,340,1227
PB,20230,FAGUNDES,5834,1350,1343,9040,7697,105,408
PB,20257,FREI MARTINHO,1435,495,501,2591,2090,27,133
PB,20273,GUARABIRA,18078,13123,6315,40171,33856,684,1971
PB,20290,GURINHÉM,6441,1845,1891,10759,8868,131,451
PB,20311,GURJÃO,1895,362,602,2955,2353,9,87
PB,20338,IBIARA,3266,496,1027,4988,3961,39,160
PB,20354,IMACULADA,5443,743,1668,8182,6514,65,263
PB,20370,INGÁ,7461,3076,2034,13328,11294,140,617
PB,20397,ITABAIANA,9443,4741,2721,18068,15347,222,941
PB,20419,ITAPORANGA,9593,2666,3489,16377,12888,158,471
PB,20435,ITAPOROROCA,6939,2508,2013,12204,10191,203,541
PB,20451,ITATUBA,4710,1542,1102,7788,6686,80,354
PB,20478,JACARAÚ,6741,2413,3064,12872,9808,133,521
PB,20494,JERICÓ,4153,636,1113,6098,4985,53,143
PB,20516,JOÃO PESSOA,188655,228710,67800,518094,450294,7303,25626
PB,20532,JUAREZ TÁVORA,4059,1088,1027,6487,5460,77,236
PB,20559,JUAZEIRINHO,6985,2194,2713,12536,9823,126,518
PB,20575,JUNCO DO SERIDÓ,2927,849,1078,5121,4043,54,213
PB,20591,JURIPIRANGA,5309,1964,1101,8861,7760,97,390
PB,20613,JURU,4817,679,1230,7037,5807,54,257
PB,20630,LAGOA,2812,394,1022,4429,3407,45,156
PB,20656,LAGOA DE DENTRO,3617,975,1371,6240,4869,70,207
PB,20672,LAGOA SECA,8695,6066,2515,19208,16693,418,1514
PB,20699,LASTRO,2430,298,774,3595,2821,16,77
PB,20710,LIVRAMENTO,3359,731,1172,5569,4397,78,229
PB,20737,LUCENA,5393,2785,2305,11143,8838,131,529
PB,20753,MÃE D ÁGUA,2234,462,888,3696,2808,29,83
PB,20770,MALTA,3017,604,800,4592,3792,34,137
PB,20796,MAMANGUAPE,15771,7821,5496,30897,25401,406,1403
PB,20818,MANAÍRA,5481,539,1389,7687,6298,48,230
PB,20834,MARI,9515,3138,1727,15237,13510,235,622
PB,20850,MASSARANDUBA,6137,2248,1623,10785,9162,152,625
PB,20877,MATARACA,3979,1364,1640,7333,5693,81,269
PB,20893,MOGEIRO,5917,2248,1334,10035,8701,94,442
PB,20915,MONTADAS,2541,896,555,4298,3743,65,241
PB,20931,MONTE HOREBE,2429,338,755,3633,2878,22,89
PB,20958,MONTEIRO,14518,4171,4206,23941,19735,240,806
PB,20974,MULUNGU,4977,1497,1295,8152,6857,75,308
PB,20990,NATUBA,3356,1036,830,5699,4869,84,393
PB,21016,NAZAREZINHO,4395,467,957,6064,5107,62,183
PB,21032,NOVA FLORESTA,4443,1298,1248,7477,6229,65,423
PB,21059,NOVA OLINDA,3041,437,1313,4987,3674,40,156
PB,21075,NOVA PALMEIRA,2116,392,408,3106,2698,37,153
PB,21091,OLHO D ÁGUA,3725,842,1846,6649,4803,57,179
PB,21113,OLIVEDOS,2032,677,630,3556,2926,36,181
PB,21130,OURO VELHO,1697,392,426,2598,2172,13,70
PB,21156,PASSAGEM,1334,389,477,2302,1825,27,75
PB,21172,PATOS,30556,18444,10319,63582,53263,901,3362
PB,21199,PAULISTA,5014,1959,2050,9516,7466,69,424
PB,21210,PEDRA BRANCA,2059,575,966,3754,2788,33,121
PB,21237,PEDRA LAVRADA,3505,941,778,5556,4778,53,279
PB,21253,PEDRAS DE FOGO,11563,5380,3787,21951,18164,258,963
PB,21270,PIANCÓ,6632,2165,2829,12257,9428,127,504
PB,21296,PICUÍ,8274,2509,2182,13853,11671,179,709
PB,21318,PILAR,5638,1801,1264,9201,7937,110,388
PB,21334,PILÕES,3884,885,1442,6565,5123,105,249
PB,21350,PILÕEZINHOS,3043,703,866,4865,3999,72,181
PB,21377,PIRPIRITUBA,3961,1434,1298,7171,5873,120,358
PB,21393,PITIMBU,6165,2382,1421,10497,9076,78,451
PB,21415,POCINHOS,6501,3508,1979,12997,11018,225,784
PB,21431,POMBAL,11228,6867,4977,24276,19299,253,951
PB,21458,PRATA,1967,808,635,3583,2948,35,138
PB,21474,PRINCESA ISABEL,9595,1730,2857,14861,12004,135,544
PB,21490,PUXINANÃ,5761,2990,1219,10986,9767,206,810
PB,21512,QUEIMADAS,17660,7618,4285,31875,27590,428,1884
PB,21539,QUIXABA,1054,478,345,1971,1626,21,73
PB,21555,REMÍGIO,7943,2336,2403,13307,10904,149,476
PB,21571,RIACHO DOS CAVALOS,4952,860,1101,7251,6150,83,255
PB,21598,RIO TINTO,9885,3990,2004,16846,14842,215,752
PB,21610,SALGADINHO,1624,388,892,3034,2142,27,103
PB,21636,SALGADO DE SÃO FÉLIX,5114,1842,1557,8977,7420,110,354
PB,21652,SANTA CRUZ,3591,590,960,5298,4338,29,128
PB,21679,SANTA HELENA,3716,408,821,5144,4323,35,164
PB,21695,SANTA LUZIA,5736,2518,2151,11141,8990,194,542
PB,21717,SANTANA DE MANGUEIRA,2831,290,839,4116,3277,22,134
PB,21733,SANTANA DOS GARROTES,3295,897,1578,6021,4443,55,196
PB,21750,SANTA RITA,41667,30877,12549,92940,80391,1534,6313
PB,21776,SANTA TERESINHA,2727,1005,972,4947,3975,71,172
PB,21792,SÃO BENTO,9207,8399,5263,24622,19359,272,1481
PB,21814,SÃO JOÃO DO CARIRI,2395,577,915,4041,3126,32,122
PB,21830,SÃO JOÃO DO TIGRE,2283,443,743,3645,2902,34,142
PB,21857,SÃO JOSÉ DA LAGOA TAPADA,4112,655,1141,6230,5089,68,254
PB,21873,SÃO JOSÉ DE CAIANA,2865,425,1291,4744,3453,38,125
PB,21890,SÃO JOSÉ DE ESPINHARAS,2406,690,723,3990,3267,40,131
PB,21911,SÃO JOSÉ DE PIRANHAS,9378,1629,2712,14273,11561,110,444
PB,21938,SÃO JOSÉ DO BONFIM,1950,736,605,3464,2859,30,143
PB,21954,SÃO JOSÉ DO SABUGI,2275,731,566,3804,3238,51,181
PB,21970,SÃO JOSÉ DOS CORDEIROS,2009,376,627,3148,2521,29,107
PB,21997,SÃO MAMEDE,3190,1320,1554,6387,4833,81,242
PB,22012,SÃO MIGUEL DE TAIPU,3012,1385,736,5505,4769,88,284
PB,22039,SÃO SEBASTIÃO DE LAGOA DE ROÇA,4123,2181,1403,8446,7043,141,598
PB,22055,SÃO SEBASTIÃO DO UMBUZEIRO,2032,332,491,2972,2481,25,92
PB,22071,SAPÉ,19016,8071,4580,33900,29320,580,1653
PB,22098,SÃO VICENTE DO SERIDÓ,5183,1110,1700,8369,6669,92,284
PB,22110,SERRA BRANCA,5352,1948,2088,9884,7796,90,406
PB,22136,SERRA DA RAIZ,1308,537,626,2604,1978,32,101
PB,22152,SERRA GRANDE,1912,286,832,3118,2286,16,72
PB,22179,SERRA REDONDA,3728,1060,815,5922,5107,67,252
PB,22195,SERRARIA,2420,684,792,4161,3369,71,194
PB,22217,SOLÂNEA,10862,4193,3469,19748,16279,295,929
PB,22233,SOLEDADE,5688,2235,1938,10619,8681,152,606
PB,22250,SOUSA,26445,9621,6806,44882,38076,620,1390
PB,22276,SUMÉ,7865,1888,2434,12666,10232,106,373
PB,22292,TACIMA,3939,1062,1205,6499,5294,66,227
PB,22314,TAPEROÁ,6084,1525,2411,10547,8136,135,392
PB,22330,TAVARES,7133,877,2152,10527,8375,81,284
PB,22357,TEIXEIRA,6572,1602,2024,10764,8740,148,418
PB,22373,TRIUNFO,4507,551,1178,6469,5291,55,178
PB,22390,UIRAÚNA,7008,1408,1703,10516,8813,83,314
PB,22411,UMBUZEIRO,3934,951,816,6043,5227,80,262
PB,22438,VÁRZEA,1577,346,416,2413,1997,15,59
PE,23000,QUIXABA,4169,329,1026,5698,4672,30,144
PE,23019,AFOGADOS DA INGAZEIRA,15197,4476,6443,27286,20843,222,948
PE,23027,LAGOA DO CARRO,7198,3078,1405,12526,11121,104,741
PE,23035,AFRÂNIO,8991,2094,4027,16036,12009,146,778
PE,23043,SANTA CRUZ DA BAIXA VERDE,6019,917,1041,8427,7386,60,390
PE,23051,AGRESTINA,11191,2932,2626,18038,15412,202,1087
PE,23060,XEXÉU,5216,1573,1959,9404,7445,99,557
PE,23078,ÁGUA PRETA,11134,2703,8464,23356,14892,224,831
PE,23086,VERTENTE DO LÉRIO,4628,944,1284,7246,5962,92,298
PE,23094,ÁGUAS BELAS,17486,4071,8938,31744,22806,239,1010
PE,23108,SANTA CRUZ,6969,819,2950,11126,8176,66,322
PE,23116,ALAGOINHA,7753,1057,2904,12137,9233,61,362
PE,23124,JUCATI,6003,886,1551,8801,7250,73,288
PE,23132,ALIANÇA,14987,5160,5635,27317,21682,300,1235
PE,23140,DORMENTES,8858,1936,3787,15501,11714,134,786
PE,23159,ALTINHO,9491,2622,2882,16007,13125,161,851
PE,23167,CARNAUBEIRA DA PENHA,7402,371,3054,11095,8041,39,229
PE,23175,AMARAJI,8427,3059,3255,15930,12675,198,991
PE,23183,LAGOA GRANDE,11096,2250,5032,19191,14159,139,674
PE,23191,ANGELIM,4517,1612,2312,8861,6549,83,337
PE,23205,ARAÇOIABA,8887,2858,1957,14701,12744,168,831
PE,23213,ARARIPINA,33843,7083,12072,55406,43334,432,1976
PE,23221,CASINHAS,7251,1375,2013,11178,9165,129,410
PE,23230,ARCOVERDE,25396,9623,8460,45933,37473,454,2000
PE,23248,MANARI,8297,681,3337,12650,9313,67,268
PE,23256,BARRA DE GUABIRABA,4415,2426,1435,8947,7512,68,603
PE,23264,JATOBÁ,6639,1057,1821,9815,7994,60,238
PE,23272,BARREIROS,14345,6368,7428,30099,22671,316,1642
PE,23280,TAMANDARÉ,8304,3560,3513,16379,12866,152,850
PE,23299,BELÉM DE MARIA,4917,1356,2329,9074,6745,89,383
PE,23302,JAQUEIRA,4348,1469,3363,9596,6233,51,365
PE,23310,BELÉM DO SÃO FRANCISCO,9946,1341,2680,14500,11820,108,425
PE,23329,SANTA FILOMENA,6970,773,3303,11361,8058,50,265
PE,23337,BELO JARDIM,27616,12584,15580,60162,44582,790,3592
PE,23353,BETÂNIA,5770,508,3485,10076,6591,45,268
PE,23370,BEZERROS,25082,8900,6703,43648,36945,645,2318
PE,23396,BODOCÓ,16517,1629,2896,21973,19077,173,758
PE,23418,BOM CONSELHO,18763,4353,11163,35614,24451,240,1095
PE,23434,BOM JARDIM,16349,4837,5358,27995,22637,314,1137
PE,23450,BONITO,14054,7438,5521,29030,23509,348,1669
PE,23477,BREJÃO,5569,1401,1335,8762,7427,91,366
PE,23493,BREJINHO,4174,732,1920,7148,5228,72,250
PE,23515,BREJO DA MADRE DE DEUS,15611,6442,7938,31849,23911,369,1489
PE,23531,BUENOS AIRES,6516,1593,1801,10454,8653,89,455
PE,23558,BUÍQUE,22579,2775,11970,38911,26941,263,1324
PE,23574,CABO DE SANTO AGOSTINHO,79320,36402,16019,146431,130412,1968,12722
PE,23590,CABROBÓ,14392,2468,6712,24571,17859,150,849
PE,23612,CACHOEIRINHA,8346,2734,3206,15304,12098,217,801
PE,23639,CAETÉS,12333,1112,5372,19502,14130,129,556
PE,23655,CALÇADO,4428,637,1010,6404,5394,53,276
PE,23671,CALUMBI,4270,424,849,5735,4886,28,164
PE,23698,CAMOCIM DE SÃO FÉLIX,7656,2867,2498,13938,11440,153,764
PE,23710,CAMUTANGA,3725,1684,1366,7168,5802,59,334
PE,23736,CANHOTINHO,8183,3133,3837,16171,12334,154,864
PE,23752,CAPOEIRAS,9205,1157,4951,15863,10912,120,430
PE,23779,CARNAÍBA,9624,1163,3311,14625,11314,90,437
PE,23795,CARPINA,23366,17563,4877,50144,45267,700,3638
PE,23817,CARUARU,90803,77455,30920,217159,186239,3712,14269
PE,23833,CATENDE,13088,3890,6299,24494,18195,225,992
PE,23850,CEDRO,5812,707,2905,9740,6835,59,257
PE,23876,CHÃ DE ALEGRIA,6198,1974,1318,10093,8775,107,496
PE,23892,CHÃ GRANDE,9075,3750,3818,17870,14052,210,1017
PE,23914,CONDADO,9638,3940,5040,19693,14653,193,882
PE,23930,CORRENTES,7755,951,4481,13598,9117,74,337
PE,23957,CORTÊS,5651,1892,1893,10055,8162,104,515
PE,23973,CUMARU,7698,2060,4543,15011,10468,123,587
PE,23990,CUPIRA,9441,4019,4161,18827,14666,201,1005
PE,24015,CUSTÓDIA,17174,2079,6523,26634,20111,180,678
PE,24031,ESCADA,25451,9595,7146,45299,38153,386,2721
PE,24058,EXU,17637,1954,4753,25319,20566,172,803
PE,24074,FEIRA NOVA,8276,4231,3873,17450,13577,179,891
PE,24090,FERREIROS,4955,1925,1834,9261,7427,119,428
PE,24112,FLORES,10591,1266,2652,15205,12553,108,588
PE,24139,FLORESTA,14692,2005,6032,23394,17362,113,552
PE,24155,FREI MIGUELINHO,6818,2150,1431,10934,9503,125,410
PE,24171,GAMELEIRA,7686,2879,2797,14325,11528,144,819
PE,24198,GARANHUNS,49373,18995,15532,88800,73268,1112,3788
PE,24210,GLÓRIA DO GOITÁ,12675,3866,3474,21397,17923,231,1151
PE,24236,GOIANA,29874,14970,8636,57647,49011,659,3508
PE,24252,GRANITO,4001,528,814,5574,4760,34,197
PE,24279,GRAVATÁ,29444,15461,14394,64253,49859,906,4048
PE,24295,IATI,8854,1094,5290,15767,10477,98,431
PE,24317,IBIMIRIM,12337,1367,5796,20062,14266,103,459
PE,24333,IBIRAJUBA,3780,817,1481,6421,4940,76,267
PE,24350,IGARASSU,40695,20826,11456,78982,67526,908,5097
PE,24376,IGUARACY,5368,876,1868,8453,6585,76,265
PE,24392,INAJÁ,9057,682,3265,13328,10063,60,264
PE,24414,INGAZEIRA,2637,377,619,3765,3146,28,104
PE,24430,IPOJUCA,42163,12034,12854,71533,58679,692,3790
PE,24457,IPUBI,12493,2223,6516,22088,15572,181,675
PE,24473,ITACURUBA,2737,291,760,3886,3126,8,90
PE,24490,ITAÍBA,11188,1436,4456,17779,13323,100,599
PE,24511,ILHA DE ITAMARACÁ,9129,3694,3408,16959,13551,154,574
PE,24538,ITAPETIM,7053,1485,2986,12021,9035,111,386
PE,24554,ITAQUITINGA,7064,2443,3474,13673,10199,114,578
PE,24570,JABOATÃO DOS GUARARAPES,175911,153618,86225,452192,365967,5829,30609
PE,24597,JATAÚBA,7908,1652,3899,13951,10052,93,399
PE,24619,JOÃO ALFREDO,12483,3499,6498,23797,17299,222,1095
PE,24635,JOAQUIM NABUCO,6206,1813,4025,12681,8656,144,493
PE,24651,JUPI,7285,1311,1883,11121,9238,123,519
PE,24678,JUREMA,6347,1609,2672,11263,8591,141,494
PE,24694,LAGOA DE ITAENGA,8089,4415,3895,17717,13822,236,1082
PE,24716,LAGOA DO OURO,6763,928,2670,10769,8099,78,330
PE,24732,LAGOA DOS GATOS,6491,1358,3923,12275,8352,97,406
PE,24759,LAJEDO,13750,6678,5032,27461,22429,334,1667
PE,24775,LIMOEIRO,23724,9270,6792,42349,35557,440,2123
PE,24791,MACAPARANA,8934,4263,4805,19205,14400,206,997
PE,24813,MACHADOS,5892,1461,1481,9388,7907,127,427
PE,24830,MARAIAL,4190,1206,4075,9938,5863,81,386
PE,24856,MIRANDIBA,7095,1242,1878,10653,8775,82,356
PE,24872,MORENO,23323,11046,7350,45608,38258,673,3216
PE,24899,NAZARÉ DA MATA,11693,6905,3569,24043,20474,368,1508
PE,24910,OLINDA,127824,98361,29555,275991,246436,3837,16414
PE,24937,OROBÓ,10036,2369,6912,20288,13376,186,785
PE,24953,OROCÓ,6669,1438,3338,11892,8554,68,379
PE,24970,OURICURI,29138,3685,13266,47509,34243,261,1159
PE,24996,PALMARES,21163,7599,8514,39668,31154,422,1970
PE,25011,PALMEIRINA,3768,474,2338,6851,4513,52,219
PE,25038,PANELAS,8582,4924,7102,21473,14371,159,706
PE,25054,PARANATAMA,6520,969,1587,9526,7939,82,368
PE,25070,PARNAMIRIM,11606,1049,4806,17885,13079,53,371
PE,25097,PASSIRA,13838,3916,5248,24299,19051,227,1070
PE,25119,PAUDALHO,19505,11089,8253,41738,33485,556,2335
PE,25135,PAULISTA,92381,75856,25538,208253,182715,2597,11881
PE,25151,PEDRA,10263,2091,5468,18603,13135,167,614
PE,25178,PESQUEIRA,28817,5311,14422,50178,35756,293,1335
PE,25194,PETROLÂNDIA,14529,3335,5188,23965,18777,143,770
PE,25216,PETROLINA,105663,49661,30701,198803,168102,2283,10495
PE,25232,POÇÃO,5977,930,2452,9838,7386,113,366
PE,25259,POMBOS,9747,4273,1708,17144,15436,246,1170
PE,25275,PRIMAVERA,5692,1891,2886,11115,8229,99,547
PE,25291,QUIPAPÁ,8677,1564,6920,17840,10920,121,558
PE,25313,RECIFE,482673,436764,155187,1155649,1000462,16962,64063
PE,25330,RIACHO DAS ALMAS,10272,3806,1881,17260,15379,287,1014
PE,25356,RIBEIRÃO,14120,5563,4789,26353,21564,287,1594
PE,25372,RIO FORMOSO,8410,2945,3853,16287,12434,152,927
PE,25399,SAIRÉ,5667,2326,1238,10108,8870,142,735
PE,25410,SALGADINHO,3471,909,2119,6753,4634,46,208
PE,25437,SALGUEIRO,25020,5694,7086,39247,32161,368,1079
PE,25453,SALOÁ,7509,953,4442,13351,8909,95,352
PE,25470,SANHARÓ,9452,2258,3005,15427,12422,121,591
PE,25496,SANTA CRUZ DO CAPIBARIBE,19765,23044,8301,55630,47329,929,3591
PE,25518,SANTA MARIA DA BOA VISTA,17834,2850,7336,29062,21726,189,853
PE,25534,SANTA MARIA DO CAMBUCÁ,5767,2158,1788,10394,8606,172,509
PE,25550,SANTA TEREZINHA,4733,808,1242,7155,5913,54,318
PE,25577,SÃO BENEDITO DO SUL,4105,843,3184,8555,5371,48,375
PE,25593,SÃO BENTO DO UNA,18139,5727,10531,36172,25641,311,1464
PE,25615,SÃO CAITANO,16917,5028,5165,29065,23900,372,1583
PE,25631,SÃO JOÃO,10263,1668,5147,17753,12606,119,556
PE,25658,SÃO JOAQUIM DO MONTE,8559,3333,3170,16380,13210,206,1112
PE,25674,SÃO JOSÉ DA COROA GRANDE,5951,3643,3627,14110,10483,118,771
PE,25690,SÃO JOSÉ DO BELMONTE,16021,2106,5026,24024,18998,153,718
PE,25712,SÃO JOSÉ DO EGITO,12970,3576,3773,21378,17605,184,875
PE,25739,SÃO LOURENÇO DA MATA,36244,21799,6194,69830,63636,1006,4587
PE,25755,SÃO VICENTE FÉRRER,7430,2357,2961,13547,10586,116,683
PE,25771,SERRA TALHADA,33354,9809,10862,56665,45803,464,2176
PE,25798,SERRITA,9763,948,4559,15638,11079,68,300
PE,25810,SERTÂNIA,15700,2417,7152,26176,19024,168,739
PE,25836,SIRINHAÉM,13461,6245,5407,27170,21763,291,1766
PE,25852,MOREILÂNDIA,6120,533,1946,8899,6953,62,238
PE,25879,SOLIDÃO,3588,400,941,5089,4148,22,138
PE,25895,SURUBIM,22848,11188,6204,43059,36855,756,2063
PE,25917,TABIRA,13138,2083,3752,19547,15795,112,462
PE,25933,TACAIMBÓ,5724,1610,1838,9852,8014,145,535
PE,25950,TACARATU,10527,1274,3169,15454,12285,86,398
PE,25976,ITAMBÉ,12957,4758,3999,23040,19041,246,1080
PE,25992,TAQUARITINGA DO NORTE,8009,6149,4016,19569,15553,268,1127
PE,26018,TEREZINHA,3900,630,1454,6206,4752,47,175
PE,26034,TERRA NOVA,5641,469,1542,7856,6314,28,176
PE,26050,TIMBAÚBA,19783,9717,9123,41238,32115,459,2156
PE,26077,TORITAMA,13038,9830,6051,30309,24258,353,1037
PE,26093,TRACUNHAÉM,5693,2287,1407,10135,8728,176,572
PE,26115,TRINDADE,11966,3316,6370,22530,16160,149,729
PE,26131,TRIUNFO,7109,1286,1659,10621,8962,85,482
PE,26158,TUPANATINGA,9393,1344,6085,17465,11380,103,540
PE,26174,TUPARETAMA,5203,637,1320,7393,6073,50,183
PE,26190,VENTUROSA,8289,1467,3177,13389,10212,109,347
PE,26212,VERDEJANTE,5051,616,1099,7033,5934,53,214
PE,26239,VERTENTES,7795,3442,3683,15802,12119,183,699
PE,26255,VICÊNCIA,10932,4723,4525,21540,17015,227,1133
PE,26271,VITÓRIA DE SANTO ANTÃO,42608,31301,11136,92738,81602,1181,6512
PE,26298,CAMARAGIBE,49546,40652,9723,108991,99268,1521,7549
PE,26310,ABREU E LIMA,36019,24961,14561,81193,66632,909,4743
PE,26336,ITAPISSUMA,10171,3489,2634,17626,14992,216,1116
PE,30015,FERNANDO DE NORONHA,748,783,1097,2740,1643,41,71
PI,10006,BRASILEIRA,4331,705,1476,6741,5265,60,169
PI,10014,AGRICOLÂNDIA,2963,623,908,4707,3799,47,166
PI,10022,ALEGRETE DO PIAUÍ,2687,498,641,3942,3301,17,99
PI,10030,ÁGUA BRANCA,7942,2799,2335,13645,11310,107,462
PI,10049,BAIXA GRANDE DO RIBEIRO,5007,1605,1017,7985,6968,62,294
PI,10057,ALTO LONGÁ,7351,1445,2149,11396,9247,56,395
PI,10065,BOM PRINCÍPIO DO PIAUÍ,3544,825,973,5545,4572,39,164
PI,10073,ALTOS,20732,4338,3975,30387,26412,251,1091
PI,10081,BONFIM DO PIAUÍ,3241,179,1052,4667,3615,43,152
PI,10090,AMARANTE,9036,1419,3259,14225,10966,114,397
PI,10103,BURITI DOS MONTES,4006,472,1095,5800,4705,34,193
PI,10111,ANGICAL DO PIAUÍ,3734,869,1300,6153,4853,42,208
PI,10120,CABECEIRAS DO PIAUÍ,5733,688,1800,8552,6752,60,271
PI,10138,ANÍSIO DE ABREU,4455,605,1080,6365,5285,42,183
PI,10146,CALDEIRÃO GRANDE DO PIAUÍ,3143,507,617,4434,3817,37,130
PI,10154,ANTÔNIO ALMEIDA,1389,586,705,2776,2071,27,69
PI,10162,CANAVIEIRA,1747,304,499,2675,2176,32,93
PI,10170,AROAZES,3330,436,1119,5063,3944,20,158
PI,10189,COIVARAS,2844,759,725,4470,3745,26,116
PI,10197,ARRAIAL,2533,308,765,3738,2973,27,105
PI,10200,COLÔNIA DO GURGUÉIA,2973,585,754,4437,3683,30,95
PI,10219,AVELINO LOPES,5444,1169,1271,8253,6982,91,278
PI,10227,COLÔNIA DO PIAUÍ,3994,453,1263,5847,4584,24,113
PI,10235,BARRAS,20081,5265,7216,34118,26902,330,1226
PI,10243,CORONEL JOSÉ DIAS,3312,209,740,4408,3668,23,124
PI,10251,BARREIRAS DO PIAUÍ,1557,378,511,2533,2022,16,71
PI,10260,FARTURA DO PIAUÍ,2978,166,726,3977,3251,10,97
PI,10278,BARRO DURO,3184,987,1085,5445,4360,42,147
PI,10286,JACOBINA DO PIAUÍ,3386,340,609,4576,3967,32,209
PI,10294,BATALHA,11595,3441,4759,20698,15939,174,729
PI,10308,JARDIM DO MULATO,2460,446,706,3740,3034,33,95
PI,10316,BENEDITINOS,5941,957,1304,8631,7327,67,362
PI,10324,LAGOA ALEGRE,5020,668,1213,7089,5876,28,160
PI,10332,BERTOLÍNIA,2743,634,732,4281,3549,34,138
PI,10340,LAGOA DO BARRO DO PIAUÍ,2920,273,428,3813,3385,60,132
PI,10359,BOCAINA,3143,772,616,4671,4055,26,114
PI,10367,MARCOLÂNDIA,4325,1100,854,6658,5804,54,325
PI,10375,BOM JESUS,9266,3864,2815,16645,13830,149,551
PI,10383,PATOS DO PIAUÍ,3353,502,815,4967,4152,38,259
PI,10391,BURITI DOS LOPES,9979,2191,2358,15095,12737,139,428
PI,10405,PASSAGEM FRANCA DO PIAUÍ,2216,474,623,3403,2780,19,71
PI,10413,CAMPINAS DO PIAUÍ,3405,250,1020,4831,3811,26,130
PI,10421,QUEIMADA NOVA,4673,471,677,6140,5463,42,277
PI,10430,CAMPO MAIOR,19618,6730,5435,33441,28006,317,1341
PI,10448,SANTA CRUZ DOS MILAGRES,2001,305,792,3181,2389,12,71
PI,10456,CANTO DO BURITI,8607,2080,3100,14470,11370,99,584
PI,10464,SANTA ROSA DO PIAUÍ,2269,872,872,4189,3317,32,144
PI,10472,CAPITÃO DE CAMPOS,5947,959,1422,8833,7411,101,404
PI,10480,SANTANA DO PIAUÍ,2618,391,472,3648,3176,31,136
PI,10499,CARACOL,5192,685,1061,7208,6147,64,206
PI,10502,SÃO BRAZ DO PIAUÍ,2720,160,672,3650,2978,27,71
PI,10510,CASTELO DO PIAUÍ,8423,2452,3648,15207,11559,145,539
PI,10529,SÃO JOSÉ DO DIVINO,3124,546,680,4566,3886,43,173
PI,10537,COCAL,11960,2894,2646,18541,15895,212,829
PI,10545,SIGEFREDO PACHECO,5200,830,1446,7720,6274,58,186
PI,10553,CONCEIÇÃO DO CANINDÉ,2776,368,830,4216,3386,53,189
PI,10561,SÃO LOURENÇO DO PIAUÍ,3233,274,810,4461,3651,33,111
PI,10570,CORRENTE,10628,3426,3970,18840,14870,155,661
PI,10588,VÁRZEA BRANCA,2875,266,849,4130,3281,29,111
PI,10596,CRISTALÂNDIA DO PIAUÍ,3196,561,824,4711,3887,17,113
PI,10600,BARRA D ALCÂNTARA,2042,297,549,3054,2505,16,150
PI,10618,CRISTINO CASTRO,4411,908,1163,6781,5618,58,241
PI,10626,BELA VISTA DO PIAUÍ,2607,155,251,3125,2874,19,93
PI,10634,CURIMATÁ,4983,968,1504,7779,6275,80,244
PI,10642,BREJO DO PIAUÍ,2508,235,581,3407,2826,8,75
PI,10650,DEMERVAL LOBÃO,6833,1807,1512,10669,9157,79,438
PI,10669,BOA HORA,3642,630,1243,5708,4465,51,142
PI,10677,DOM EXPEDITO LOPES,3949,795,712,5694,4982,68,170
PI,10685,DOM INOCÊNCIO,4696,439,1104,6482,5378,32,211
PI,10693,ELESBÃO VELOSO,7653,1120,3035,12258,9223,55,395
PI,10707,CAPITÃO GERVÁSIO OLIVEIRA,2667,121,407,3278,2871,10,73
PI,10715,ELISEU MARTINS,1974,584,619,3322,2703,29,116
PI,10723,CAMPO GRANDE DO PIAUÍ,3402,344,596,4569,3973,39,188
PI,10731,ESPERANTINA,15553,5532,5743,28216,22473,319,1069
PI,10740,CAMPO LARGO DO PIAUÍ,2870,589,713,4338,3625,36,130
PI,10758,FLORES DO PIAUÍ,2475,394,693,3711,3018,28,121
PI,10766,CURRAIS,3284,490,934,4841,3907,32,101
PI,10774,FLORIANO,24011,8059,9054,42745,33691,370,1251
PI,10782,GEMINIANO,3879,586,794,5474,4680,38,177
PI,10790,FRANCINÓPOLIS,2558,333,971,3969,2998,13,94
PI,10804,GUARIBAS,2879,59,571,3575,3004,13,53
PI,10812,FRANCISCO AYRES,2493,402,656,3730,3074,32,147
PI,10820,ILHA GRANDE,4885,1067,1338,7653,6315,46,317
PI,10839,FRANCISCO SANTOS,4242,907,1862,7319,5457,65,243
PI,10847,JUREMA,3034,421,740,4335,3595,26,114
PI,10855,FRONTEIRAS,5603,1121,1574,8678,7104,59,321
PI,10863,LAGOA DE SÃO FRANCISCO,3379,414,863,4851,3988,29,166
PI,10871,GILBUÉS,4538,858,1396,7088,5692,38,258
PI,10880,MORRO CABEÇA NO TEMPO,2256,213,535,3129,2594,23,102
PI,10898,GUADALUPE,4730,1094,1730,7879,6149,48,277
PI,10901,NOVO SANTO ANTÔNIO,2511,338,941,3938,2997,27,121
PI,10910,HUGO NAPOLEÃO,2204,509,817,3668,2851,22,116
PI,10928,NOSSA SENHORA DE NAZARÉ,3388,437,855,4793,3938,18,95
PI,10936,INHUMA,7387,1389,2599,11936,9337,94,467
PI,10944,PAQUETÁ,2565,318,380,3369,2989,6,100
PI,10952,IPIRANGA DO PIAUÍ,4837,568,956,6700,5744,52,287
PI,10960,NOVA SANTA RITA,2685,180,477,3447,2970,21,84
PI,10979,ISAÍAS COELHO,4246,278,802,5541,4739,34,181
PI,10987,SÃO JOÃO DO ARRAIAL,3666,1447,860,6244,5384,76,195
PI,10995,ITAINÓPOLIS,6014,947,1261,8700,7439,92,386
PI,11010,ITAUEIRA,4986,1172,1651,8180,6529,91,280
PI,11037,JAICÓS,8220,1221,2185,12289,10104,117,546
PI,11053,JERUMENHA,2628,507,783,4043,3260,21,104
PI,11070,JOAQUIM PIRES,6557,1760,1508,10292,8784,93,374
PI,11088,SÃO JOÃO DA CANABRAVA,2868,383,700,4071,3371,24,96
PI,11096,JOSÉ DE FREITAS,21909,3335,4618,31047,26429,239,946
PI,11118,LANDRI SALES,2604,443,1225,4470,3245,18,180
PI,11134,LUIS CORREIA,14659,3376,4689,23855,19166,205,926
PI,11150,LUZILÂNDIA,10839,2966,3863,18434,14571,152,614
PI,11177,MANOEL EMÍDIO,2687,508,977,4296,3319,24,100
PI,11193,MARCOS PARENTE,1965,730,799,3641,2842,32,115
PI,11215,MATIAS OLÍMPIO,4836,1081,1593,7797,6204,79,208
PI,11231,MIGUEL ALVES,14530,2649,5084,23369,18285,234,872
PI,11258,MIGUEL LEÃO,731,278,270,1327,1057,16,32
PI,11274,MONSENHOR GIL,6058,1303,1491,9152,7661,50,250
PI,11290,MONSENHOR HIPÓLITO,4190,757,860,6081,5221,41,233
PI,11312,MONTE ALEGRE DO PIAUÍ,5063,847,1524,7688,6164,39,215
PI,11339,NAZARÉ DO PIAUÍ,4042,387,902,5527,4625,37,159
PI,11355,NOSSA SENHORA DOS REMÉDIOS,4597,1073,1311,7216,5905,59,176
PI,11371,NOVO ORIENTE DO PIAUÍ,3389,356,896,4870,3974,40,189
PI,11398,OEIRAS,17087,3464,5968,27638,21670,211,908
PI,11410,DOMINGOS MOURÃO,2255,316,722,3420,2698,28,99
PI,11436,PADRE MARCOS,3766,561,855,5472,4617,55,235
PI,11452,PAES LANDIM,1944,717,615,3421,2806,31,114
PI,11479,PALMEIRA DO PIAUÍ,2565,568,755,4082,3327,63,131
PI,11495,PALMEIRAIS,7351,1145,2383,11243,8860,68,296
PI,11517,PARNAGUÁ,4537,610,1223,6568,5345,33,165
PI,11533,PARNAÍBA,49323,29587,17859,102061,84202,1017,4275
PI,11550,PAULISTANA,10068,1585,2378,14862,12484,101,730
PI,11576,PEDRO II,17051,4697,6336,29591,23255,287,1220
PI,11592,PICOS,30013,10143,8222,50621,42399,377,1866
PI,11614,PIMENTEIRAS,5179,1228,1565,8278,6713,60,246
PI,11630,PIO IX,9309,1132,1801,12815,11014,86,487
PI,11657,PIRACURUCA,13153,3782,4857,22793,17936,175,826
PI,11673,PIRIPIRI,26562,8628,12065,49670,37605,506,1909
PI,11690,PORTO,5140,752,1733,7910,6177,67,218
PI,11711,PRATA DO PIAUÍ,1964,244,753,3086,2333,21,104
PI,11738,REDENÇÃO DO GURGUÉIA,3568,945,1258,6041,4783,69,201
PI,11754,REGENERAÇÃO,8554,1126,3415,13638,10223,98,445
PI,11770,RIBEIRO GONÇALVES,2582,903,1179,4877,3698,29,184
PI,11797,RIO GRANDE DO PIAUÍ,3275,449,836,4775,3939,30,185
PI,11819,SANTA CRUZ DO PIAUÍ,3505,655,602,4971,4369,35,174
PI,11835,SANTA FILOMENA,2753,663,817,4385,3568,34,118
PI,11851,SANTA LUZ,2620,771,536,4093,3557,47,119
PI,11878,SANTO ANTÔNIO DE LISBOA,3375,598,544,4744,4200,52,175
PI,11894,SANTO INÁCIO DO PIAUÍ,2034,398,656,3208,2552,26,94
PI,11916,SÃO FÉLIX DO PIAUÍ,1828,520,1048,3496,2448,17,83
PI,11932,SÃO FRANCISCO DO PIAUÍ,2838,1182,1130,5376,4246,59,167
PI,11959,SÃO GONÇALO DO PIAUÍ,2435,823,840,4299,3459,33,168
PI,11975,SÃO JOÃO DA SERRA,3637,794,1275,6000,4725,57,237
PI,11991,SÃO JOÃO DO PIAUÍ,9233,1805,2197,13797,11600,76,486
PI,12009,SÃO JOÃO DA FRONTEIRA,2919,441,945,4466,3521,32,129
PI,12017,SÃO JOSÉ DO PEIXE,1895,280,565,2873,2308,20,113
PI,12025,SÃO JOÃO DA VARJOTA,2605,263,677,3699,3022,22,132
PI,12033,SÃO JOSÉ DO PIAUÍ,3693,612,904,5429,4525,33,187
PI,12041,SEBASTIÃO BARROS,2433,411,869,3842,2973,39,90
PI,12050,SÃO JULIÃO,2871,1098,727,4916,4189,36,184
PI,12068,SEBASTIÃO LEAL,1972,890,443,3533,3090,41,187
PI,12076,SÃO MIGUEL DO TAPUIO,9062,1340,3471,14440,10969,78,489
PI,12084,ALVORADA DO GURGUÉIA,2572,379,535,3612,3077,26,100
PI,12092,SÃO PEDRO DO PIAUÍ,6130,1681,1432,9754,8322,88,423
PI,12106,ASSUNÇÃO DO PIAUÍ,4053,528,1384,6220,4836,44,211
PI,12114,SÃO RAIMUNDO NONATO,15701,2518,3595,22523,18928,164,545
PI,12122,BETÂNIA DO PIAUÍ,3696,275,700,4871,4171,39,161
PI,12130,SIMÕES,7179,1089,1776,10593,8817,89,460
PI,12149,BOQUEIRÃO DO PIAUÍ,3346,413,791,4741,3950,51,140
PI,12157,SIMPLÍCIO MENDES,5844,1048,1365,8657,7292,58,342
PI,12165,CARIDADE DO PIAUÍ,2911,384,852,4322,3470,31,144
PI,12173,SOCORRO DO PIAUÍ,2362,441,955,3876,2921,26,92
PI,12181,CURRAL NOVO DO PIAUÍ,2907,220,672,3965,3293,21,145
PI,12190,TERESINA,273796,162652,89401,556250,466849,6308,24093
PI,12203,JÚLIO BORGES,2832,360,669,3951,3282,24,66
PI,12211,UNIÃO,21387,5457,4725,33045,28320,252,1224
PI,12220,LAGOA DO SÍTIO,2586,345,759,3855,3096,21,144
PI,12238,URUÇUÍ,8495,3572,3323,16118,12795,151,577
PI,12246,MILTON BRANDÃO,3241,936,1213,5683,4470,49,244
PI,12254,VALENÇA DO PIAUÍ,9302,2399,2675,15262,12587,134,752
PI,12262,PAJEÚ DO PIAUÍ,1870,362,810,3151,2341,28,81
PI,12270,VÁRZEA GRANDE,2180,439,655,3443,2788,26,143
PI,12289,PAVUSSU,2462,176,471,3247,2776,34,104
PI,12297,DIRCEU ARCOVERDE,3935,305,1047,5402,4355,22,93
PI,12300,RIACHO FRIO,2586,315,686,3691,3005,13,91
PI,12319,ALAGOINHA DO PIAUÍ,3735,924,751,5670,4919,57,203
PI,12327,ACAUÃ,4196,428,626,5479,4853,46,183
PI,12335,BELÉM DO PIAUÍ,1970,235,349,2667,2318,22,91
PI,12343,CAJAZEIRAS DO PIAUÍ,2026,241,662,3027,2365,16,82
PI,12351,CAMPO ALEGRE DO FIDALGO,3034,233,447,3863,3416,22,127
PI,12360,COCAL DE TELHA,2836,245,680,3938,3258,38,139
PI,12378,FRANCISCO MACEDO,1748,223,344,2439,2095,19,105
PI,12386,JOÃO COSTA,2156,188,427,2845,2418,21,53
PI,12394,JATOBÁ DO PIAUÍ,3677,562,1055,5482,4427,37,151
PI,12408,JOCA MARQUES,2861,399,975,4399,3424,53,111
PI,12416,JUAZEIRO DO PIAUÍ,3179,654,1087,5113,4026,34,159
PI,12424,LAGOA DO PIAUÍ,2571,624,509,3850,3341,26,120
PI,12432,LAGOINHA DO PIAUÍ,1680,279,487,2528,2041,11,71
PI,12440,MADEIRO,3872,564,1349,5968,4619,46,137
PI,12459,MORRO DO CHAPÉU DO PIAUÍ,3108,599,1075,4993,3918,49,162
PI,12467,MASSAPÊ DO PIAUÍ,3833,259,700,5050,4350,33,225
PI,12475,MURICI DOS PORTELAS,3534,658,731,5191,4460,65,203
PI,12483,OLHO D ÁGUA DO PIAUÍ,1467,278,339,2167,1828,15,68
PI,12491,PEDRO LAURENTINO,1629,284,433,2436,2003,14,76
PI,12505,SÃO FRANCISCO DE ASSIS DO PIAUÍ,2846,513,491,4140,3649,29,261
PI,12513,SUSSUAPARA,4164,758,821,5940,5119,37,160
PI,12521,TANQUE DO PIAUÍ,1448,253,354,2212,1858,27,130
PI,12530,TAMBORIL DO PIAUÍ,1655,226,463,2470,2007,17,109
PI,12548,VILA NOVA DO PIAUÍ,1810,346,290,2557,2267,15,96
PI,12556,VERA MENDES,2243,187,432,3030,2598,44,124
PI,12564,WALL FERRAZ,2284,547,426,3400,2974,17,126
PI,12572,CAJUEIRO DA PRAIA,4107,813,1084,6199,5115,38,157
PI,12580,CURRALINHOS,2777,408,711,4013,3302,15,102
PI,12599,PORTO ALEGRE DO PIAUÍ,1114,254,444,1871,1427,10,49
PI,12602,RIBEIRA DO PIAUÍ,2315,187,523,3127,2604,12,90
PI,12610,SÃO GONÇALO DO GURGUÉIA,1224,304,430,2042,1612,18,66
PI,12629,SÃO LUIS DO PIAUÍ,1603,205,263,2133,1870,6,56
PI,12637,FLORESTA DO PIAUÍ,1576,158,611,2458,1847,9,104
PI,12653,SANTO ANTÔNIO DOS MILAGRES,1140,176,315,1684,1369,9,44
PI,12661,SÃO MIGUEL DA BAIXA GRANDE,1263,400,553,2304,1751,17,71
PI,12670,CARAÚBAS DO PIAUÍ,2723,758,817,4554,3737,42,214
PI,12688,CAXINGÓ,3266,569,886,4910,4024,46,143
PI,12696,COCAL DOS ALVES,3579,364,728,4898,4170,60,167
PI,12700,SÃO MIGUEL DO FIDALGO,1678,157,595,2478,1883,8,40
PI,12718,PAU D ARCO DO PIAUÍ,2971,488,875,4477,3602,17,126
PI,12726,NAZÁRIA,6494,1485,1968,10265,8297,57,261
PI,12734,AROEIRAS DO ITAIM,2414,393,396,3322,2926,22,97
PR,74004,GODOY MOREIRA,1240,814,427,2569,2142,23,65
PR,74012,ABATIÁ,1767,2746,885,5743,4858,111,234
PR,74020,IBEMA,1687,1828,1337,5056,3719,75,129
PR,74039,ADRIANÓPOLIS,2251,1456,1160,5079,3919,69,143
PR,74047,LINDOESTE,2157,1460,842,4594,3752,54,81
PR,74055,AGUDOS DO SUL,1770,3692,1104,6869,5765,102,201
PR,74063,OURO VERDE DO OESTE,1288,2331,739,4552,3813,44,150
PR,74071,ALMIRANTE TAMANDARÉ,17171,35436,11465,68011,56546,1441,2498
PR,74080,SANTA TEREZA DO OESTE,2665,4134,1571,8673,7102,89,214
PR,74098,ALTO PARANÁ,2899,4467,2439,10349,7910,143,401
PR,74101,ANAHY,878,1085,541,2641,2100,28,109
PR,74110,ALTO PIQUIRI,2773,2808,1188,7096,5908,88,239
PR,74128,ÂNGULO,578,1378,385,2476,2091,36,99
PR,74136,ALVORADA DO SUL,2019,3323,1091,6730,5639,83,214
PR,74144,BOA ESPERANÇA DO IGUAÇU,1227,584,460,2324,1864,21,32
PR,74152,AMAPORÃ,1538,1474,578,3807,3229,42,175
PR,74160,BOM SUCESSO DO SUL,899,1450,488,2921,2433,29,55
PR,74179,AMPÉRE,5949,4777,2550,13777,11227,127,374
PR,74187,BRASILÂNDIA DO SUL,1155,1085,398,2746,2348,27,81
PR,74195,ANDIRÁ,4168,7969,3183,16353,13170,204,829
PR,74209,CAFEZAL DO SUL,1057,1841,589,3651,3062,53,111
PR,74217,ANTONINA,3150,7761,3029,14599,11570,236,423
PR,74225,CANDÓI,5171,3478,2063,11042,8979,88,242
PR,74233,ANTONIO OLINTO,2237,2672,993,6269,5276,148,219
PR,74241,CRUZEIRO DO IGUAÇU,1537,1142,760,3564,2804,43,82
PR,74250,APUCARANA,15607,54081,16242,91251,75009,1491,3830
PR,74268,DIAMANTE DO SUL,1165,1008,634,2882,2248,17,58
PR,74276,ARAPONGAS,10333,51988,10331,77049,66718,1143,3254
PR,74284,ENTRE RIOS DO OESTE,635,2062,569,3370,2801,23,81
PR,74292,ARAPOTI,3693,10621,3217,18382,15165,335,516
PR,74306,FAROL,967,1176,403,2688,2285,40,102
PR,74314,ARARUNA,2773,5162,2212,10718,8506,161,410
PR,74322,FAZENDA RIO GRANDE,16536,36168,13163,70034,56871,1360,2807
PR,74330,MARILÂNDIA DO SUL,1628,3732,1244,7016,5772,121,291
PR,74349,FLOR DA SERRA DO SUL,2021,1527,529,4209,3680,45,87
PR,74357,ARAUCÁRIA,25283,47434,14954,94403,79449,1976,4756
PR,74365,HONÓRIO SERPA,2054,1243,633,4028,3395,33,65
PR,74373,ASSAÍ,2373,7092,2051,12132,10081,192,424
PR,74381,IGUATU,752,818,388,2028,1640,16,54
PR,74390,ASTORGA,3446,11831,4552,20771,16219,301,641
PR,74403,IRACEMA DO OESTE,796,924,535,2376,1841,27,94
PR,74411,ATALAIA,962,1760,645,3537,2892,43,127
PR,74420,NOVO ITACOLOMI,673,1359,354,2588,2234,43,159
PR,74438,BALSA NOVA,2615,6070,1872,11176,9304,197,422
PR,74446,ITAPERUÇU,9341,6114,2563,18945,16382,333,594
PR,74454,BANDEIRANTES,4626,14638,4164,24467,20303,336,703
PR,74462,IVATÉ,1773,2493,1073,5636,4563,61,236
PR,74470,BARBOSA FERRAZ,2641,3707,1792,8620,6828,140,340
PR,74489,LIDIANÓPOLIS,936,1547,882,3521,2639,29,127
PR,74497,BARRACÃO,2520,3045,1251,7050,5799,91,143
PR,74500,MARIPÁ,728,3401,759,5068,4309,56,124
PR,74519,BARRA DO JACARÉ,825,1075,439,2508,2069,47,122
PR,74527,MATO RICO,1491,801,673,3084,2411,29,90
PR,74535,BELA VISTA DO PARAÍSO,3170,6183,1980,12114,10134,194,587
PR,74543,MAUÁ DA SERRA,2081,3400,1065,6897,5832,120,231
PR,74551,BITURUNA,5242,4087,1591,11488,9897,162,406
PR,74560,MERCEDES,629,3119,673,4545,3872,36,88
PR,74578,BOA ESPERANÇA,757,2192,493,3651,3158,48,161
PR,74586,NOVA LARANJEIRAS,3741,2340,1196,7505,6309,59,169
PR,74594,BOCAIÚVA DO SUL,2543,4202,1933,9119,7186,169,272
PR,74608,NOVA SANTA BÁRBARA,1259,1340,538,3315,2777,57,121
PR,74616,BOM SUCESSO,1714,2210,702,4903,4201,69,208
PR,74624,PATO BRAGADO,724,2672,704,4236,3532,41,95
PR,74632,BORRAZÓPOLIS,1776,2981,1489,6566,5077,76,244
PR,74640,PINHAL DE SÃO BENTO,1296,541,217,2106,1889,13,39
PR,74659,CAFEARA,955,700,302,2086,1784,12,117
PR,74667,PITANGUEIRAS,536,1423,481,2557,2076,32,85
PR,74675,CALIFÓRNIA,1584,3655,911,6563,5652,152,261
PR,74683,QUATRO PONTES,404,2509,537,3558,3021,38,70
PR,74691,CAMBARÁ,4007,9536,3119,17821,14702,228,931
PR,74705,RAMILÂNDIA,1310,1139,900,3473,2573,38,86
PR,74713,CAMBÉ,12795,41798,10229,69268,59039,1182,3264
PR,74721,RANCHO ALEGRE D OESTE,762,1066,607,2515,1908,21,59
PR,74730,CAMBIRA,1390,3169,819,5741,4922,101,262
PR,74748,RIO BONITO DO IGUAÇU,6412,2190,1724,10640,8916,100,214
PR,74756,CAMPINA DA LAGOA,3428,5390,2377,11805,9428,178,432
PR,74764,SANTA LÚCIA,1050,1382,748,3298,2550,41,77
PR,74772,CAMPINA GRANDE DO SUL,7447,16458,5286,30783,25497,530,1062
PR,74780,CAMPO BONITO,1519,1247,625,3496,2871,44,61
PR,74799,CAMPO DO TENENTE,1619,3031,778,5674,4896,109,137
PR,74802,SANTA MARIA DO OESTE,3712,2156,2470,8626,6156,87,201
PR,74810,CAMPO LARGO,17806,49168,14139,86302,72163,1692,3497
PR,74829,SANTA MÔNICA,1055,977,381,2507,2126,14,80
PR,74837,CAMPO MOURÃO,16510,34383,10143,64263,54120,1045,2182
PR,74845,SÃO MANOEL DO PARANÁ,437,1025,253,1835,1582,25,95
PR,74853,CÂNDIDO DE ABREU,4202,4674,1725,11209,9484,195,413
PR,74861,SÃO PEDRO DO IGUAÇU,1533,2398,893,5014,4121,49,141
PR,74870,CAPANEMA,5601,5744,3446,15362,11916,141,430
PR,74888,TUNAS DO PARANÁ,1765,1931,1095,4946,3851,44,111
PR,74896,CAPITÃO LEÔNIDAS MARQUES,3775,4778,2987,12048,9061,154,354
PR,74900,VENTANIA,2699,2685,1004,6801,5797,123,290
PR,74918,CARLÓPOLIS,2595,5949,2066,11235,9169,153,472
PR,74926,ALTO PARAÍSO,869,1208,507,2732,2225,28,120
PR,74934,CASCAVEL,52446,119866,36083,218716,182633,3335,6986
PR,74942,DOUTOR ULYSSES,1823,1532,834,4423,3589,69,165
PR,74950,CASTRO,13169,27181,7964,51377,43413,1238,1825
PR,74969,VIRMOND,1354,1316,484,3313,2829,45,114
PR,74977,CATANDUVAS,2062,2918,1947,7219,5272,105,187
PR,74985,LARANJAL,2343,1087,726,4293,3567,46,91
PR,74993,CENTENÁRIO DO SUL,3658,2884,1490,8479,6989,86,361
PR,75000,ITAIPULÂNDIA,2696,4070,1874,8929,7055,83,206
PR,75019,CERRO AZUL,5283,4167,2216,12472,10256,260,546
PR,75027,NOVA ESPERANÇA DO SUDOESTE,2290,1474,547,4440,3893,55,74
PR,75035,CHOPINZINHO,5633,6945,2600,15874,13274,171,525
PR,75043,PINHAIS,17893,49224,13461,85540,72079,1702,3260
PR,75051,CIANORTE,9029,34002,9083,54854,45771,841,1899
PR,75060,SAUDADE DO IGUAÇU,1972,1605,744,4517,3773,53,143
PR,75078,CIDADE GAÚCHA,2456,4059,2301,9276,6975,85,375
PR,75086,ARIRANHA DO IVAÍ,1016,679,282,2074,1792,20,77
PR,75094,CLEVELÂNDIA,4941,4771,2521,12677,10156,131,313
PR,75108,ARAPUÃ,1331,1150,650,3226,2576,22,73
PR,75116,MANGUEIRINHA,5591,4605,1973,12635,10662,165,301
PR,75124,BELA VISTA DA CAROBA,1481,880,348,2796,2448,27,60
PR,75132,COLOMBO,32853,78718,22440,142387,119947,2992,5384
PR,75140,BOA VENTURA DE SÃO ROQUE,2486,1322,900,4862,3962,53,101
PR,75159,COLORADO,5633,7261,4545,18836,14291,251,1146
PR,75167,BOM JESUS DO SUL,1686,1079,512,3371,2859,34,60
PR,75175,CONGONHINHAS,2730,2281,1160,6417,5257,87,159
PR,75183,CAMPINA DO SIMÃO,1704,929,574,3330,2756,30,93
PR,75191,CONSELHEIRO MAIRINCK,866,1298,444,2805,2361,31,166
PR,75205,CAMPO MAGRO,5182,9319,2767,18291,15524,374,649
PR,75213,CONTENDA,3270,6493,1729,12145,10416,235,418
PR,75221,CARAMBEÍ,3056,9634,1887,15455,13568,310,568
PR,75230,CORBÉLIA,3322,7252,2716,13873,11157,184,399
PR,75248,CORONEL DOMINGOS SOARES,2483,1295,927,4867,3940,60,102
PR,75256,CORNÉLIO PROCÓPIO,7513,19513,5017,34185,29168,534,1608
PR,75264,CRUZMALTINA,733,1293,777,2905,2128,23,79
PR,75272,CORONEL VIVIDA,6499,7127,2494,16868,14374,231,517
PR,75280,CORUMBATAÍ DO SUL,1308,1221,596,3279,2683,53,101
PR,75299,CRUZEIRO DO OESTE,3852,8283,3829,16688,12859,171,553
PR,75302,ESPERANÇA NOVA,422,1010,271,1774,1503,11,60
PR,75310,CRUZEIRO DO SUL,1681,1434,539,3844,3305,31,159
PR,75329,ESPIGÃO ALTO DO IGUAÇU,1209,1886,1200,4411,3211,37,79
PR,75337,CRUZ MACHADO,4364,6305,1618,13091,11473,220,584
PR,75345,FERNANDES PINHEIRO,2056,2104,790,5169,4379,79,140
PR,75353,CURITIBA,241015,786377,231439,1339549,1108110,25629,55089
PR,75361,FOZ DO JORDÃO,1877,1071,878,3946,3068,41,79
PR,75370,CURIÚVA,3171,4394,2143,10371,8228,210,453
PR,75388,GOIOXIM,2867,1145,798,4989,4191,61,118
PR,75396,DIAMANTE DO NORTE,1245,1939,1144,4527,3383,54,145
PR,75400,DIAMANTE D OESTE,1647,1105,924,3827,2903,37,114
PR,75418,DOIS VIZINHOS,10951,12353,5870,30272,24402,437,661
PR,75426,GUAMIRANGA,2166,3051,714,6231,5517,131,169
PR,75434,DOUTOR CAMARGO,1118,2575,950,4972,4022,75,254
PR,75442,IMBAÚ,2841,3323,1038,7686,6648,149,335
PR,75450,ENÉAS MARQUES,2308,1715,1039,5278,4239,63,153
PR,75469,MANFRINÓPOLIS,1458,647,646,2811,2165,24,36
PR,75477,ENGENHEIRO BELTRÃO,2622,5050,2794,10932,8138,161,305
PR,75485,MARQUINHO,1802,1062,611,3595,2984,33,87
PR,75493,FAXINAL,2448,6431,2871,12192,9321,161,281
PR,75507,PEROBAL,1182,2862,860,5165,4305,56,205
PR,75515,FÊNIX,1250,1544,968,3975,3007,55,158
PR,75523,PONTAL DO PARANÁ,4057,8638,3132,16644,13512,270,547
PR,75531,FLORAÍ,1206,2256,738,4410,3672,48,162
PR,75540,PORTO BARREIRO,1412,979,431,2904,2473,38,44
PR,75558,FLORESTA,1307,3163,1039,5783,4744,58,216
PR,75566,PRADO FERREIRA,1110,1291,441,3027,2586,33,152
PR,75574,FLORESTÓPOLIS,3554,3760,1248,8964,7716,91,311
PR,75582,QUARTO CENTENÁRIO,1140,1627,923,3834,2911,53,91
PR,75590,FLÓRIDA,756,996,270,2133,1863,26,85
PR,75604,RESERVA DO IGUAÇU,2531,1445,930,5097,4167,68,123
PR,75612,FORMOSA DO OESTE,1431,3139,1361,6308,4947,98,279
PR,75620,RIO BRANCO DO IVAÍ,1125,1167,1044,3478,2434,38,104
PR,75639,FOZ DO IGUAÇU,42061,99545,29748,179035,149287,2841,4840
PR,75647,SERRANÓPOLIS DO IGUAÇU,948,2427,765,4314,3549,51,123
PR,75655,FRANCISCO BELTRÃO,21869,28034,12831,65153,52322,827,1592
PR,75663,TAMARANA,2499,3403,1815,8102,6287,141,244
PR,75671,GENERAL CARNEIRO,3604,3007,1484,8426,6942,114,217
PR,75698,GOIOERÊ,4990,10777,5453,22080,16627,285,575
PR,75710,GUAÍRA,4847,12156,3074,20847,17773,292,478
PR,75736,GUAIRAÇÁ,1470,2267,770,4802,4032,58,237
PR,75744,ROSÁRIO DO IVAÍ,1380,2014,1317,4948,3631,74,163
PR,75752,GUAPIRAMA,1055,1621,569,3467,2898,63,159
PR,75760,NOVA TEBAS,2829,1597,774,5407,4633,75,132
PR,75779,GUAPOREMA,505,860,470,1917,1447,15,67
PR,75787,SULINA,1160,1063,320,2667,2347,23,101
PR,75795,GUARACI,1084,2310,562,4193,3631,43,194
PR,75809,LUIZIANA,2129,2159,1022,5526,4504,65,151
PR,75817,GUARANIAÇU,3245,5261,2288,11143,8855,121,228
PR,75833,GUARAPUAVA,42173,56654,20713,125757,105044,2069,4148
PR,75850,GUARAQUEÇABA,2245,2380,1626,6465,4839,77,137
PR,75876,GUARATUBA,4476,13921,4559,23920,19361,362,602
PR,75892,IBAITI,4979,10688,3941,20818,16877,333,877
PR,75914,IBIPORÃ,7070,21838,5933,37380,31447,769,1770
PR,75930,ICARAÍMA,1692,3531,1743,7268,5525,95,207
PR,75957,IGUARAÇU,838,1858,766,3652,2886,36,154
PR,75973,IMBITUVA,6511,11576,2932,22318,19386,476,823
PR,75990,INÁCIO MARTINS,3686,2682,1153,7905,6752,113,271
PR,76015,INAJÁ,1027,837,331,2271,1940,17,59
PR,76031,IPIRANGA,2713,6044,1303,10715,9412,246,409
PR,76058,IPORÃ,2771,6173,2021,11532,9511,151,416
PR,76074,IRATI,12333,23159,6162,44301,38139,825,1822
PR,76090,IRETAMA,3048,2774,1231,7516,6285,137,326
PR,76112,ITAGUAJÉ,1205,1291,917,3600,2683,47,140
PR,76139,ITAMBARACÁ,1218,2468,1001,4926,3925,70,169
PR,76155,ITAMBÉ,1267,2458,974,4980,4006,61,220
PR,76171,ITAPEJARA D OESTE,3782,3223,1671,9037,7366,113,248
PR,76198,ITAÚNA DO SUL,1250,760,906,3076,2170,30,130
PR,76210,IVAÍ,3207,5237,1111,9984,8873,170,259
PR,76236,IVAIPORÃ,6656,11074,5702,24630,18928,300,898
PR,76252,IVATUBA,617,1116,599,2436,1837,19,85
PR,76279,JABOTI,982,2067,593,3909,3316,55,212
PR,76295,JACAREZINHO,9519,13102,4401,28521,24120,445,1054
PR,76317,JAGUAPITÃ,2194,5490,1708,9941,8233,131,418
PR,76333,JAGUARIAÍVA,5092,14567,3804,24567,20763,414,690
PR,76350,JANDAIA DO SUL,3041,9550,2078,15531,13453,205,657
PR,76376,JANIÓPOLIS,1738,1965,1011,4983,3972,80,189
PR,76392,JAPIRA,1113,1679,685,3679,2994,49,153
PR,76414,JAPURÁ,1401,4115,989,6935,5946,131,299
PR,76430,JARDIM ALEGRE,2867,3741,2258,9264,7006,104,294
PR,76457,JARDIM OLINDA,670,323,136,1173,1037,12,32
PR,76473,JATAIZINHO,2446,4829,1267,9103,7836,157,404
PR,76490,JOAQUIM TÁVORA,2076,4570,1453,8640,7187,95,446
PR,76511,JUNDIAÍ DO SUL,1021,960,457,2543,2086,31,74
PR,76538,JUSSARA,1501,2535,806,5148,4342,91,215
PR,76554,KALORÉ,995,1838,443,3523,3080,59,188
PR,76570,LAPA,8862,18887,4934,34762,29828,748,1331
PR,76597,LARANJEIRAS DO SUL,10413,8374,3719,23397,19678,281,610
PR,76619,LEÓPOLIS,1171,1441,399,3172,2773,44,117
PR,76635,LOANDA,3756,7792,1889,14137,12248,204,496
PR,76651,LOBATO,1095,1668,550,3554,3004,30,211
PR,76678,LONDRINA,56111,230473,62905,372169,309264,6678,16002
PR,76694,LUPIONÓPOLIS,1621,1353,614,3855,3241,35,232
PR,76716,MALLET,2659,5435,1443,10241,8798,183,521
PR,76732,MAMBORÊ,2713,5836,1525,10545,9020,160,311
PR,76759,MANDAGUAÇU,4043,8585,4162,17783,13621,266,727
PR,76775,MANDAGUARI,5537,15126,4352,26657,22305,446,1196
PR,76791,MANDIRITUBA,5156,8514,3060,17726,14666,336,660
PR,76813,MANOEL RIBAS,2803,5362,1421,10008,8587,119,303
PR,76830,MARECHAL CÂNDIDO RONDON,6664,23281,7616,38839,31223,408,870
PR,76856,MARIA HELENA,1574,2045,678,4519,3841,62,160
PR,76872,MARIALVA,5542,15615,6054,28717,22663,477,1029
PR,76899,MARILUZ,2741,3164,1816,8120,6304,116,283
PR,76910,MARINGÁ,50271,157818,53762,276257,222495,4541,9865
PR,76937,MARIÓPOLIS,1779,2341,615,4956,4341,81,140
PR,76953,MARMELEIRO,4623,4351,1505,10942,9437,164,299
PR,76970,MARUMBI,1260,1640,427,3548,3121,49,172
PR,76996,MATELÂNDIA,1955,7803,2979,13131,10152,142,252
PR,77011,MEDIANEIRA,7803,18930,7738,35809,28071,430,908
PR,77038,MIRADOR,821,650,583,2122,1539,22,46
PR,77054,MIRASELVA,603,804,202,1699,1497,25,65
PR,77070,MOREIRA SALES,2654,4544,2067,9670,7603,110,295
PR,77097,MORRETES,3210,6441,2155,12442,10287,256,380
PR,77119,MUNHOZ DE MELO,974,1599,451,3202,2751,31,147
PR,77135,NOSSA SENHORA DAS GRAÇAS,1248,1030,432,2908,2476,37,161
PR,77151,NOVA ALIANÇA DO IVAÍ,487,570,212,1331,1119,17,45
PR,77178,NOVA AMÉRICA DA COLINA,1039,1264,398,2867,2469,40,126
PR,77194,NOVA CANTU,2565,1831,1069,5705,4636,75,165
PR,77216,NOVA ESPERANÇA,4455,10236,5430,21078,15648,309,648
PR,77232,NOVA FÁTIMA,1579,2738,1749,6373,4624,116,191
PR,77259,NOVA LONDRINA,2699,4017,3163,10329,7166,92,358
PR,77275,ORTIGUEIRA,7725,5510,3694,17608,13914,239,440
PR,77291,OURIZONA,1082,1090,576,2911,2335,38,125
PR,77313,PAIÇANDU,7320,12934,5527,27551,22024,528,1242
PR,77330,PALMAS,12589,10803,5946,30398,24452,436,624
PR,77356,PALMEIRA,5546,14898,3464,25216,21752,490,818
PR,77372,PALMITAL,4712,3385,1922,10398,8476,124,255
PR,77399,PALOTINA,4204,14145,4585,23782,19197,240,608
PR,77410,PARAÍSO DO NORTE,2725,4320,1851,9322,7471,83,343
PR,77437,PARANACITY,2788,2917,1329,7492,6163,75,383
PR,77453,PARANAGUÁ,19052,59529,15799,98889,83090,1807,2702
PR,77470,PARANAPOEMA,909,730,269,1998,1729,25,65
PR,77496,PARANAVAÍ,12793,34585,9657,60144,50487,901,2208
PR,77518,PATO BRANCO,16395,30191,12157,61334,49177,941,1650
PR,77534,PAULA FREITAS,1285,2196,573,4266,3693,76,136
PR,77550,PAULO FRONTIN,1659,2784,626,5403,4777,112,222
PR,77577,PEABIRU,2801,4597,2567,10470,7903,146,359
PR,77593,PÉROLA D OESTE,1851,2250,979,5265,4286,63,122
PR,77615,PIÊN,1659,6212,905,9238,8333,143,319
PR,77631,PINHALÃO,1575,2479,773,5100,4327,83,190
PR,77658,PINHÃO,10627,6972,3971,22587,18616,322,695
PR,77674,PIRAÍ DO SUL,4827,9417,2965,18347,15382,476,662
PR,77690,PIRAQUARA,16251,31538,11534,62686,51152,1262,2101
PR,77712,PITANGA,10180,8811,6394,26441,20047,320,736
PR,77739,PLANALTINA DO PARANÁ,1372,1204,428,3155,2727,30,121
PR,77755,PLANALTO,4230,3636,2398,10604,8206,95,245
PR,77771,PONTA GROSSA,49049,137776,36026,237228,201202,5323,9054
PR,77798,PORECATU,3090,4267,1721,9686,7965,177,431
PR,77810,PORTO AMAZONAS,785,1939,546,3517,2971,86,161
PR,77836,PORTO RICO,702,1071,309,2153,1844,16,55
PR,77852,PORTO VITÓRIA,893,1425,436,2919,2483,50,115
PR,77879,PRESIDENTE CASTELO BRANCO,1343,1556,875,4013,3138,46,193
PR,77895,PRIMEIRO DE MAIO,1986,4495,1742,8650,6908,122,305
PR,77917,PRUDENTÓPOLIS,7999,21933,5651,37577,31926,621,1373
PR,77933,QUATIGUÁ,1361,3583,952,6241,5289,74,271
PR,77950,QUATRO BARRAS,2824,9011,2320,15005,12685,240,610
PR,77976,QUERÊNCIA DO NORTE,3526,2754,978,7572,6594,62,252
PR,77992,QUINTA DO SOL,1431,1681,1126,4416,3290,63,115
PR,78018,QUITANDINHA,3015,7565,1503,12809,11306,209,517
PR,78034,RANCHO ALEGRE,809,1572,424,2984,2560,45,134
PR,78050,REALEZA,4252,6135,3015,13895,10880,134,359
PR,78077,REBOUÇAS,4239,4943,1440,11258,9818,233,403
PR,78093,RENASCENÇA,2216,1894,598,4936,4338,66,162
PR,78115,RESERVA,6896,8161,3724,19711,15987,306,624
PR,78131,RIBEIRÃO CLARO,2641,4418,1753,9454,7701,121,521
PR,78158,RIBEIRÃO DO PINHAL,3963,3769,2041,10263,8222,139,351
PR,78174,RIO AZUL,3033,5650,1026,10419,9393,209,501
PR,78190,RIO BOM,775,1387,467,2845,2378,49,167
PR,78212,RIO BRANCO DO SUL,9451,10317,3999,24986,20987,480,739
PR,78239,RIO NEGRO,3757,14557,3085,22680,19595,469,812
PR,78255,ROLÂNDIA,8017,28551,7092,46541,39449,844,2037
PR,78271,RONCADOR,3772,2902,1109,8140,7031,72,285
PR,78298,RONDON,1737,3779,1469,7314,5845,87,242
PR,78310,SABÁUDIA,887,3603,581,5364,4783,68,225
PR,78336,SALGADO FILHO,1493,1343,444,3425,2981,62,83
PR,78352,SALTO DO ITARARÉ,1369,1671,706,4012,3306,80,186
PR,78379,SALTO DO LONTRA,5482,3112,1452,10407,8955,108,253
PR,78395,SANTA AMÉLIA,997,1357,405,2901,2496,43,99
PR,78417,SANTA CECÍLIA DO PAVÃO,902,1380,506,2946,2440,40,118
PR,78433,SANTA CRUZ DE MONTE CASTELO,2311,2789,796,6185,5389,74,215
PR,78450,SANTA FÉ,2037,4732,1306,8516,7210,95,346
PR,78476,SANTA INÊS,631,641,359,1693,1334,18,44
PR,78492,SANTA ISABEL DO IVAÍ,1616,3633,1027,6670,5643,91,303
PR,78514,SANTA IZABEL DO OESTE,3335,3344,1769,8741,6972,80,213
PR,78530,SANTA MARIANA,3002,4018,1875,9445,7570,125,425
PR,78557,SANTANA DO ITARARÉ,1438,1841,675,4237,3562,79,204
PR,78573,SANTO ANTÔNIO DO SUDOESTE,6045,5256,1817,13630,11813,161,351
PR,78590,SANTO ANTÔNIO DA PLATINA,7285,16873,5012,31020,26008,579,1271
PR,78611,SANTO ANTONIO DO CAIUÁ,932,776,516,2354,1838,15,115
PR,78638,SANTO ANTÔNIO DO PARAÍSO,660,947,310,2026,1716,21,88
PR,78654,SANTO INÁCIO,1651,1809,550,4241,3691,40,191
PR,78670,SÃO CARLOS DO IVAÍ,1284,2546,1084,5169,4085,43,212
PR,78697,SÃO JERÔNIMO DA SERRA,3389,2596,1709,8127,6418,109,324
PR,78719,SÃO JOÃO,3120,3935,1230,8723,7493,110,328
PR,78735,SÃO JOÃO DO CAIUÁ,1850,1540,1163,4771,3608,57,161
PR,78751,SÃO JOÃO DO IVAÍ,3258,3599,1392,8799,7407,122,428
PR,78778,SÃO JOÃO DO TRIUNFO,5174,3714,1411,10809,9398,258,252
PR,78794,SÃO JORGE DO IVAÍ,1160,2409,939,4725,3786,58,159
PR,78816,SÃO JORGE D OESTE,2975,3283,913,7466,6553,97,198
PR,78832,SÃO JOSÉ DA BOA VISTA,931,2580,686,4446,3760,70,179
PR,78859,SÃO JOSÉ DOS PINHAIS,35813,111865,29655,188625,158970,3723,7569
PR,78875,SÃO MATEUS DO SUL,10658,14918,4446,31915,27469,802,1091
PR,78891,SÃO MIGUEL DO IGUAÇU,5832,10243,5250,21961,16711,173,463
PR,78913,SÃO PEDRO DO IVAÍ,1960,3630,931,6874,5943,86,267
PR,78930,SÃO PEDRO DO PARANÁ,577,1228,295,2179,1884,19,60
PR,78956,SÃO SEBASTIÃO DA AMOREIRA,2483,2707,1025,6549,5524,88,246
PR,78972,SÃO TOMÉ,1041,2426,645,4356,3711,57,187
PR,78999,SAPOPEMA,1901,1906,887,5014,4127,96,224
PR,79014,SENGÉS,3444,6812,2505,13545,11040,231,553
PR,79030,SERTANEJA,1303,2404,635,4574,3939,64,168
PR,79057,SERTANÓPOLIS,2210,7786,2062,12658,10596,183,417
PR,79073,SIQUEIRA CAMPOS,4439,7000,2563,15081,12518,213,866
PR,79090,TAMBOARA,1098,1902,654,3920,3266,49,217
PR,79111,TAPEJARA,2642,5866,2590,11743,9153,131,514
PR,79138,TEIXEIRA SOARES,2475,3431,1203,7485,6282,103,273
PR,79154,TELÊMACO BORBA,11740,26848,5660,46758,41098,838,1672
PR,79170,TERRA BOA,2433,7304,1983,12406,10423,226,460
PR,79197,TERRA RICA,2839,5989,2055,11629,9574,168,578
PR,79219,TERRA ROXA,2784,7616,1746,12676,10930,141,389
PR,79235,TIBAGI,5041,5755,2294,13787,11493,268,429
PR,79251,TIJUCAS DO SUL,3534,5129,1790,11159,9369,230,476
PR,79278,TOLEDO,21097,55323,15061,96070,81009,1299,3290
PR,79294,TOMAZINA,1745,3090,1053,6216,5163,78,250
PR,79316,TUNEIRAS DO OESTE,1790,3301,1498,6930,5432,82,259
PR,79332,UBIRATÃ,4473,9343,3948,18605,14657,258,583
PR,79359,UMUARAMA,14381,46489,12026,76348,64322,1021,2431
PR,79375,UNIÃO DA VITÓRIA,9105,20508,5835,37550,31715,776,1326
PR,79391,UNIFLOR,757,893,381,2106,1725,29,46
PR,79413,URAÍ,2306,4180,1268,8282,7014,104,424
PR,79430,WENCESLAU BRAZ,2959,7898,2586,14203,11617,237,523
PR,79456,VERÊ,3030,2378,1058,6682,5624,80,136
PR,79472,VITORINO,1406,2660,1218,5474,4256,53,137
PR,79499,XAMBRÊ,1587,2461,714,5003,4289,46,195
PR,79510,ALTÔNIA,3301,8130,2216,14466,12250,178,641
PR,79537,ASSIS CHATEAUBRIAND,6424,13142,5593,26374,20781,352,863
PR,79553,QUEDAS DO IGUAÇU,6250,10306,6164,23365,17201,214,431
PR,79570,CÉU AZUL,1497,5178,1804,8859,7055,98,282
PR,79596,GRANDES RIOS,1167,2393,1434,5189,3755,55,140
PR,79618,INDIANÓPOLIS,903,1963,541,3624,3083,62,155
PR,79634,MATINHOS,6124,13045,6044,26386,20342,388,785
PR,79650,NOVA AURORA,2494,4863,1880,9650,7770,125,288
PR,79677,NOVA OLÍMPIA,1270,2366,979,4827,3848,45,167
PR,79693,PÉROLA,2259,4694,1566,9019,7453,145,355
PR,79715,SANTA HELENA,6053,9295,4371,20431,16060,176,536
PR,79731,TAPIRA,1463,2017,1011,4706,3695,49,166
PR,79758,MARILENA,2268,1877,1630,6029,4399,55,199
PR,79774,FRANCISCO ALVES,1473,2920,871,5529,4658,66,199
PR,79790,NOVA SANTA ROSA,725,4743,1003,6616,5613,52,93
PR,79812,BOA VISTA DA APARECIDA,2348,2453,1749,6858,5109,90,218
PR,79839,BRAGANEY,1535,1831,1059,4667,3608,71,171
PR,79855,CAFELÂNDIA,2793,6528,2117,11960,9843,151,371
PR,79871,TRÊS BARRAS DO PARANÁ,2958,3889,1889,9123,7234,123,264
PR,79898,VERA CRUZ DO OESTE,1792,3299,1589,6963,5374,70,213
PR,79910,PRANCHITA,1607,2162,517,4498,3981,76,136
PR,79936,TUPÃSSI,1269,3559,494,5546,5052,57,167
PR,79952,NOVA PRATA DO IGUAÇU,3678,3014,1137,8075,6938,75,171
PR,79979,JESUÍTAS,1951,3464,1383,7246,5863,108,340
PR,79995,SÃO JORGE DO PATROCÍNIO,1485,2555,700,4998,4298,49,209
PR,84514,CANTAGALO,4127,2681,1640,8749,7109,92,209
PR,84530,TURVO,5298,3651,1672,11056,9384,161,274
PR,84557,ALTAMIRA DO PARANÁ,1288,1174,701,3293,2592,38,92
PR,84573,FIGUEIRA,2275,2581,1205,6412,5207,117,234
PR,84590,LUNARDELLI,1384,1773,665,4002,3337,50,130
PR,84611,SARANDI,17398,28697,9908,60108,50200,1164,2941
PR,84638,JURANDA,1579,3072,1271,6186,4915,81,183
PR,84654,DOURADINA,1875,3394,905,6433,5528,81,178
PR,84670,SANTA TEREZINHA DE ITAIPU,3378,10067,2755,16800,14045,199,401
PR,84697,MISSAL,2351,4714,1603,8941,7338,78,195
PR,84719,SÃO JOSÉ DAS PALMEIRAS,1248,1273,345,3010,2665,50,94
RJ,58009,QUISSAMÃ,4752,6250,5010,17719,12709,368,1339
RJ,58017,ANGRA DOS REIS,21829,63148,36126,130471,94345,1942,7426
RJ,58025,QUATIS,2806,4426,2234,10315,8081,190,659
RJ,58033,ARARUAMA,13961,47767,26674,96073,69399,1552,6119
RJ,58041,BELFORD ROXO,69174,153078,79007,331030,252023,5868,23903
RJ,58050,BARRA DO PIRAÍ,16806,30218,17773,71197,53424,1350,5050
RJ,58068,CARDOSO MOREIRA,2511,4894,3182,11442,8260,183,672
RJ,58076,BARRA MANSA,31110,62358,28950,135213,106263,2544,10251
RJ,58084,VARRE-SAI,1764,3490,2106,8137,6031,131,646
RJ,58092,BOM JARDIM,4304,9457,5551,22109,16558,492,2305
RJ,58106,GUAPIMIRIM,8525,17709,11332,40716,29384,699,2451
RJ,58114,BOM JESUS DO ITABAPOANA,6634,12540,8443,29689,21246,379,1693
RJ,58122,QUEIMADOS,17884,38830,8634,72959,64325,1456,6155
RJ,58130,CABO FRIO,23520,74772,42299,151859,109560,2471,8797
RJ,58149,JAPERI,16143,32013,18914,73653,54739,1400,5183
RJ,58157,CACHOEIRAS DE MACACU,9565,20042,11548,45283,33735,861,3267
RJ,58165,COMENDADOR LEVY GASPARIAN,2692,2609,1529,7627,6098,161,636
RJ,58173,CAMBUCI,3299,4917,3029,12167,9138,155,767
RJ,58181,APERIBÉ,1794,4925,1477,8960,7483,128,636
RJ,58190,CAMPOS DOS GOYTACAZES,79838,147437,93685,361418,267733,7577,32881
RJ,58203,RIO DAS OSTRAS,14202,41487,13971,75927,61956,1281,4986
RJ,58211,CANTAGALO,3332,6886,4283,16176,11893,295,1380
RJ,58220,AREAL,2090,4434,2070,9609,7539,203,812
RJ,58238,CARMO,4536,5185,3461,14408,10947,205,1021
RJ,58246,PINHEIRAL,5410,6759,3895,17403,13508,256,1083
RJ,58254,CASIMIRO DE ABREU,5101,15731,8760,31984,23224,421,1971
RJ,58262,IGUABA GRANDE,3300,12008,6207,22832,16625,280,1037
RJ,58270,CONCEIÇÃO DE MACABU,4246,6552,4768,17409,12641,343,1500
RJ,58289,SÃO FRANCISCO DE ITABAPOANA,6269,15425,12397,37033,24636,699,2243
RJ,58297,CORDEIRO,3478,7339,4254,16663,12409,278,1314
RJ,58300,CARAPEBUS,2635,5059,3192,11927,8735,211,830
RJ,58319,DUAS BARRAS,2528,3871,2235,9695,7460,196,865
RJ,58327,PORTO REAL,3931,7836,3914,17071,13157,259,1131
RJ,58335,DUQUE DE CAXIAS,136240,300227,139006,634613,495607,11319,47821
RJ,58343,SÃO JOSÉ DE UBÁ,1492,3664,1544,7232,5688,101,431
RJ,58351,ENGENHEIRO PAULO DE FRONTIN,2713,4670,2255,10651,8396,196,817
RJ,58360,TANGUÁ,5901,10803,5639,24392,18753,445,1604
RJ,58378,ITABORAÍ,38886,75544,41911,171832,129921,3307,12184
RJ,58386,MACUCO,1815,2881,1618,6966,5348,101,551
RJ,58394,ITAGUAÍ,15406,46148,21998,90916,68918,1601,5763
RJ,58408,ARMAÇÃO DOS BÚZIOS,4869,13938,7277,27884,20607,444,1356
RJ,58416,ITAOCARA,3047,10021,4605,19290,14685,294,1323
RJ,58424,SEROPÉDICA,10695,27258,12483,55023,42540,930,3657
RJ,58432,ITAPERUNA,13120,36707,20336,75711,55375,1241,4307
RJ,58440,ITATIAIA,5194,11721,6281,24987,18706,416,1375
RJ,58459,LAJE DO MURIAÉ,2840,2486,1301,7271,5970,108,536
RJ,58467,MESQUITA,26728,67824,30056,135061,105005,2087,8366
RJ,58475,MACAÉ,36212,67223,43993,160709,116716,3171,10110
RJ,58491,MAGÉ,37416,83510,45010,181346,136336,3174,12236
RJ,58513,MANGARATIBA,5796,18723,8972,36056,27084,502,2063
RJ,58530,MARICÁ,28593,47243,25024,107890,82866,1491,5539
RJ,58556,MENDES,3677,6396,3919,15457,11538,256,1209
RJ,58572,MIGUEL PEREIRA,4677,10264,6137,22992,16855,407,1507
RJ,58599,MIRACEMA,6033,7970,6466,22316,15850,370,1477
RJ,58610,NATIVIDADE,2941,5233,3079,12365,9286,188,924
RJ,58637,NILÓPOLIS,26814,68352,28238,133193,104955,2059,7730
RJ,58653,NITERÓI,105606,175730,72100,384917,312817,6877,24604
RJ,58670,NOVA FRIBURGO,26805,71859,37796,151981,114185,3331,12190
RJ,58696,NOVA IGUAÇU,110820,291877,132505,588320,455815,10887,42231
RJ,58718,PARACAMBI,7108,16288,7750,33953,26203,573,2234
RJ,58734,PARAÍBA DO SUL,7328,14535,8953,34116,25163,619,2681
RJ,58750,PARATY,5787,13359,8285,29675,21390,528,1716
RJ,58777,PETRÓPOLIS,40665,116947,62803,243734,180931,5188,18131
RJ,58793,PIRAÍ,5777,9342,5371,22452,17081,355,1607
RJ,58815,PORCIÚNCULA,3945,4690,4204,13993,9789,210,944
RJ,58831,RESENDE,16429,47443,22448,93586,71138,1878,5388
RJ,58858,RIO BONITO,8303,22743,10139,45298,35159,797,3316
RJ,58874,RIO CLARO,4138,5920,4097,15476,11379,222,1099
RJ,58890,RIO DAS FLORES,2881,2699,2157,8507,6350,117,653
RJ,58912,SANTA MARIA MADALENA,1894,3272,2477,8641,6164,143,855
RJ,58939,SANTO ANTÔNIO DE PÁDUA,6298,15663,8856,33340,24484,467,2056
RJ,58955,SÃO FIDÉLIS,4892,14256,9174,30591,21417,517,1752
RJ,58971,SÃO GONÇALO,149075,307577,158048,678364,520316,12431,51233
RJ,58998,SÃO JOÃO DA BARRA,8219,14866,6097,32860,26763,602,3076
RJ,59013,SÃO JOÃO DE MERITI,70499,176534,90284,367702,277418,5949,24436
RJ,59030,SÃO PEDRO DA ALDEIA,8363,34748,16633,63953,47320,1003,3206
RJ,59056,SÃO SEBASTIÃO DO ALTO,1855,2911,1226,6732,5506,119,621
RJ,59072,SAPUCAIA,3946,6877,4175,16499,12324,254,1247
RJ,59099,SAQUAREMA,9857,31251,18679,64851,46172,970,4094
RJ,59110,SILVA JARDIM,3376,8495,5445,18750,13305,269,1165
RJ,59137,SUMIDOURO,2595,6653,3230,13785,10555,341,966
RJ,59153,TERESÓPOLIS,17579,66081,34013,129517,95504,2510,9334
RJ,59170,TRAJANO DE MORAES,2588,3002,1440,8132,6692,158,944
RJ,59196,TRÊS RIOS,18369,23461,14738,62277,47539,1206,4503
RJ,59218,VALENÇA,15920,20623,15991,58265,42274,1201,4530
RJ,59234,VASSOURAS,6904,11972,8585,30187,21602,571,2155
RJ,59250,VOLTA REDONDA,56080,100256,48972,224160,175188,3707,15145
RJ,59277,ARRAIAL DO CABO,4751,14047,9294,29903,20609,436,1375
RJ,59293,ITALVA,1951,5559,2896,11144,8248,140,598
RJ,59315,PATY DO ALFERES,4660,10064,6124,22810,16686,452,1510
RJ,59331,SÃO JOSÉ DO VALE DO RIO PRETO,1656,9305,3989,16159,12170,253,956
RJ,60011,RIO DE JANEIRO,1105393,2179896,1188317,4891904,3703587,85506,332792
RN,16004,TENENTE LAURENTINO CRUZ,2682,905,707,4636,3929,50,292
RN,16012,ACARI,4000,2282,1837,8869,7032,109,641
RN,16020,SERRA DO MEL,4668,2433,1901,9641,7740,135,504
RN,16039,ASSÚ,24008,7100,8368,41778,33410,477,1825
RN,16047,CAIÇARA DO NORTE,2343,1011,1056,4675,3619,50,215
RN,16055,AFONSO BEZERRA,4917,1363,2532,9278,6746,93,373
RN,16063,SÃO MIGUEL DO GOSTOSO,4137,1545,1367,7508,6141,67,392
RN,16071,ÁGUA NOVA,1865,190,399,2549,2150,28,67
RN,16080,ITAJÁ,3653,1034,1307,6292,4985,55,243
RN,16098,ALEXANDRIA,6767,1145,2410,10785,8375,80,383
RN,16101,BODÓ,1842,365,571,2958,2387,24,156
RN,16110,ALMINO AFONSO,2883,587,1221,4880,3659,55,134
RN,16128,TRIUNFO POTIGUAR,2025,707,732,3658,2926,42,152
RN,16136,ALTO DO RODRIGUES,6587,1554,1914,10610,8696,85,470
RN,16144,FERNANDO PEDROZA,1523,584,508,2807,2299,36,156
RN,16152,ANGICOS,4434,2328,1697,9037,7340,112,466
RN,16160,MAJOR SALES,1946,301,414,2800,2386,28,111
RN,16179,ANTÔNIO MARTINS,3569,598,896,5325,4429,75,187
RN,16187,VENHA-VER,2217,181,808,3372,2564,30,136
RN,16195,APODI,16465,4994,3688,26867,23179,376,1344
RN,16209,SERRINHA DOS PINTOS,2427,480,571,3722,3151,51,193
RN,16217,AREIA BRANCA,9365,5315,4204,20406,16202,208,1314
RN,16225,TIBAU,2382,1108,1037,4806,3769,56,223
RN,16233,ARÊS,5814,2369,1295,10299,9004,141,680
RN,16241,SANTA MARIA,2376,816,743,4154,3411,45,174
RN,16250,CAMPO GRANDE,4427,1464,1712,8031,6319,100,328
RN,16268,RIO DO FOGO,3991,2538,1464,8549,7085,88,468
RN,16276,BAÍA FORMOSA,3279,1554,1359,6668,5309,101,375
RN,16284,PORTO DO MANGUE,2811,571,908,4487,3579,30,167
RN,16292,BARCELONA,2028,1093,1041,4407,3366,38,207
RN,16306,JUNDIÁ,1831,864,775,3732,2957,57,205
RN,16314,BENTO FERNANDES,2940,553,739,4418,3679,34,152
RN,16330,BOM JESUS,3855,1755,1671,7714,6043,65,368
RN,16357,BREJINHO,4675,2391,1677,9491,7814,136,612
RN,16373,CAIÇARA DO RIO DO VENTO,1890,577,671,3331,2660,31,162
RN,16390,CAICÓ,20999,11374,7417,42705,35288,569,2346
RN,16411,CAMPO REDONDO,4819,810,1362,7451,6089,89,371
RN,16438,CANGUARETAMA,13388,3874,4236,22796,18560,218,1080
RN,16454,CARAÚBAS,10842,2664,3814,18208,14394,204,684
RN,16470,CARNAÚBA DOS DANTAS,2061,2071,764,5685,4921,119,670
RN,16497,CARNAUBAIS,5059,1298,1606,8457,6851,78,416
RN,16519,CEARÁ-MIRIM,29424,9970,8992,51505,42513,625,2494
RN,16535,CERRO CORÁ,4835,1328,1715,8447,6732,69,500
RN,16551,CORONEL EZEQUIEL,2602,598,949,4463,3514,51,263
RN,16578,CORONEL JOÃO PESSOA,2409,363,791,3753,2962,24,166
RN,16594,CRUZETA,3462,1286,1390,6606,5216,90,378
RN,16616,CURRAIS NOVOS,13427,8524,5818,29990,24172,432,1789
RN,16632,DOUTOR SEVERIANO,3665,491,853,5260,4407,39,212
RN,16659,ENCANTO,2999,410,771,4357,3586,33,144
RN,16675,EQUADOR,2189,1030,877,4460,3583,70,294
RN,16691,ESPÍRITO SANTO,3418,1838,1126,6886,5760,113,391
RN,16713,EXTREMOZ,9516,6869,2670,20517,17847,245,1217
RN,16730,FELIPE GUERRA,4279,888,849,6308,5459,77,215
RN,16756,FLORÂNIA,4238,1414,1378,7543,6165,84,429
RN,16772,FRANCISCO DANTAS,1630,381,512,2631,2119,11,97
RN,16799,GALINHOS,970,548,675,2352,1677,21,138
RN,16810,GOIANINHA,9493,5192,2889,19145,16256,294,1277
RN,16837,GOVERNADOR DIX-SEPT ROSADO,6671,1706,2206,11346,9140,159,604
RN,16853,GROSSOS,4160,1833,1211,7966,6755,150,612
RN,16870,GUAMARÉ,6397,3681,2924,13716,10792,134,580
RN,16896,IELMO MARINHO,5734,1851,2085,10196,8111,128,398
RN,16918,IPANGUAÇU,7522,1450,2426,11903,9477,98,407
RN,16934,IPUEIRA,1089,353,221,1781,1560,40,78
RN,16950,ITAÚ,2731,691,800,4462,3662,39,201
RN,16977,JAÇANÃ,3216,990,889,5499,4610,64,340
RN,16993,JANDAÍRA,2952,1030,913,5178,4265,51,232
RN,17019,JANDUÍS,2594,455,874,4120,3246,54,143
RN,17035,BOA SAÚDE,3532,1482,1341,6930,5589,94,481
RN,17051,JAPI,3356,616,901,5096,4195,29,194
RN,17078,JARDIM DE ANGICOS,1532,356,491,2506,2015,17,110
RN,17094,JARDIM DE PIRANHAS,6572,1265,1967,10294,8327,94,396
RN,17116,JARDIM DO SERIDÓ,4553,2648,1412,9703,8291,168,922
RN,17132,JOÃO CÂMARA,12980,4793,3757,22911,19154,242,1139
RN,17159,JOÃO DIAS,1559,305,693,2669,1976,13,99
RN,17175,JOSÉ DA PENHA,3335,407,847,4791,3944,38,164
RN,17191,JUCURUTU,8305,2410,2580,14030,11450,135,600
RN,17213,MESSIAS TARGINO,2383,752,699,4018,3319,51,133
RN,17230,LAGOA D ANTA,2979,741,850,4832,3982,46,216
RN,17256,LAGOA DE PEDRAS,3789,1109,1212,6515,5303,60,345
RN,17272,LAGOA DE VELHOS,1619,658,767,3186,2419,30,112
RN,17299,LAGOA NOVA,6324,2057,2249,11432,9183,160,642
RN,17310,LAGOA SALGADA,4461,1867,1691,8598,6907,123,456
RN,17337,LAJES,4559,1469,1750,8213,6463,77,358
RN,17353,LAJES PINTADAS,2853,621,851,4623,3772,53,245
RN,17370,LUCRÉCIA,2135,327,715,3257,2542,17,63
RN,17396,LUÍS GOMES,4725,539,1282,6868,5586,50,272
RN,17418,MACAÍBA,23473,13716,9222,49788,40566,690,2687
RN,17434,MACAU,12415,3254,5302,22054,16752,211,872
RN,17450,MARCELINO VIEIRA,4459,440,1015,6163,5148,43,206
RN,17477,MARTINS,3487,1304,1153,6358,5205,65,349
RN,17493,MAXARANGUAPE,4151,2109,1338,8028,6690,81,349
RN,17515,FRUTUOSO GOMES,2328,368,1070,3911,2841,41,104
RN,17531,MONTANHAS,5364,1204,1125,8154,7029,86,375
RN,17558,MONTE ALEGRE,7127,4814,3245,16252,13007,245,821
RN,17574,MONTE DAS GAMELEIRAS,1361,524,368,2412,2044,23,136
RN,17590,MOSSORÓ,77547,53391,29200,174288,145088,2482,11668
RN,17612,NATAL,195938,220770,100815,557715,456900,7538,32654
RN,17639,NÍSIA FLORESTA,8243,5985,4353,19998,15645,282,1135
RN,17655,NOVA CRUZ,12368,6151,3870,24219,20349,316,1514
RN,17671,OLHO D ÁGUA DO BORGES,2519,540,779,4011,3232,36,137
RN,17698,OURO BRANCO,2463,744,492,3923,3431,38,186
RN,17710,PARANÁ,2356,213,544,3245,2701,21,111
RN,17736,PARAÚ,2185,714,974,4117,3143,49,195
RN,17752,PARAZINHO,2405,1071,784,4547,3763,63,224
RN,17779,PARELHAS,6062,5904,2819,16446,13627,277,1384
RN,17795,PARNAMIRIM,37327,55904,17544,119294,101750,1753,6766
RN,17817,PASSA E FICA,4383,2127,1415,8625,7210,114,586
RN,17833,PASSAGEM,1313,1107,304,2978,2674,41,213
RN,17850,PATU,5267,1670,1391,8735,7344,110,297
RN,17876,PAU DOS FERROS,11447,3497,3593,19401,15808,164,700
RN,17892,PEDRA GRANDE,2056,516,858,3640,2782,37,173
RN,17914,PEDRA PRETA,1439,560,574,2713,2139,20,120
RN,17930,PEDRO AVELINO,2882,926,2825,6924,4099,47,244
RN,17957,PEDRO VELHO,6191,1849,1757,10441,8684,104,540
RN,17973,PENDÊNCIAS,6150,1548,2073,10239,8166,84,384
RN,17990,PILÕES,2115,236,1012,3457,2445,22,72
RN,18015,POÇO BRANCO,6548,1334,1547,9938,8391,112,397
RN,18031,PORTALEGRE,3201,1203,917,5726,4809,62,343
RN,18058,SERRA CAIADA,4367,1214,1263,7211,5948,74,293
RN,18074,PUREZA,3932,1246,1563,7228,5665,116,371
RN,18090,RAFAEL FERNANDES,2873,506,739,4320,3581,43,159
RN,18112,RIACHO DA CRUZ,1644,389,466,2636,2170,19,118
RN,18139,RIACHO DE SANTANA,2262,279,695,3404,2709,36,132
RN,18155,RIACHUELO,3298,1263,713,5535,4822,47,214
RN,18171,RODOLFO FERNANDES,2421,546,620,3775,3155,36,152
RN,18198,RUY BARBOSA,1630,868,1072,3743,2671,24,149
RN,18210,SÃO FRANCISCO DO OESTE,2235,732,568,3799,3231,57,207
RN,18236,SANTA CRUZ,12500,5889,3703,23714,20011,300,1322
RN,18252,SANTANA DO SERIDÓ,1109,736,334,2425,2091,38,208
RN,18279,SANTANA DO MATOS,6416,1493,2299,10923,8624,130,585
RN,18295,SANTO ANTÔNIO,9498,3420,2180,16289,14109,204,987
RN,18317,SÃO BENTO DO NORTE,1776,544,745,3220,2475,29,126
RN,18333,SÃO BENTO DO TRAIRÍ,2191,606,726,3809,3083,47,239
RN,18350,SÃO FERNANDO,1889,646,549,3308,2759,30,194
RN,18376,SÃO GONÇALO DO AMARANTE,28141,22383,10100,65046,54946,799,3623
RN,18392,SÃO JOÃO DO SABUGI,2862,1013,623,4770,4147,51,221
RN,18414,SÃO JOSÉ DE MIPIBU,13420,8094,6184,29998,23814,438,1862
RN,18430,SÃO JOSÉ DO CAMPESTRE,5077,1821,2066,9668,7602,149,555
RN,18457,SÃO JOSÉ DO SERIDÓ,2196,830,590,3949,3359,54,279
RN,18473,SÃO MIGUEL,10032,1713,3680,16595,12915,260,910
RN,18490,SÃO PAULO DO POTENGI,5364,4140,2005,12452,10447,151,792
RN,18511,SÃO PEDRO,3311,1148,892,5701,4809,67,283
RN,18538,SÃO RAFAEL,3679,1182,1449,6721,5272,72,339
RN,18554,SÃO TOMÉ,3805,2484,2449,9278,6829,101,439
RN,18570,SÃO VICENTE,2410,1140,803,4832,4029,50,429
RN,18597,SENADOR ELÓI DE SOUZA,2828,899,933,4915,3982,54,201
RN,18619,SENADOR GEORGINO AVELINO,1760,902,557,3450,2893,41,190
RN,18635,SERRA DE SÃO BENTO,2758,737,1009,4850,3841,74,272
RN,18651,SERRA NEGRA DO NORTE,3181,1319,1078,5986,4908,81,327
RN,18678,SERRINHA,3408,1214,1149,6169,5020,84,314
RN,18694,SEVERIANO MELO,4056,752,1159,6259,5100,73,219
RN,18716,SÍTIO NOVO,2602,550,1006,4416,3410,62,196
RN,18732,TABOLEIRO GRANDE,1524,452,362,2445,2083,13,94
RN,18759,TAIPU,5938,1568,1604,9712,8108,137,465
RN,18775,TANGARÁ,5198,2658,2580,11307,8727,170,701
RN,18791,TENENTE ANANIAS,4411,1051,1488,7339,5851,48,341
RN,18813,TIBAU DO SUL,5293,2682,1756,10392,8636,148,513
RN,18830,TIMBAÚBA DOS BATISTAS,1150,648,463,2424,1961,35,128
RN,18856,TOUROS,11582,5357,4671,23387,18716,293,1484
RN,18872,UMARIZAL,4978,1201,1595,8272,6677,90,408
RN,18899,UPANEMA,5204,3047,1592,10530,8938,170,517
RN,18910,VÁRZEA,2338,1140,555,4278,3723,39,206
RN,18937,RAFAEL GODEIRO,2047,521,992,3688,2696,46,82
RN,18953,VERA CRUZ,4792,2382,1729,9707,7978,181,623
RN,18970,VIÇOSA,1043,200,345,1697,1352,16,93
RN,18996,VILA FLOR,1538,468,469,2653,2184,32,146
RN,30031,BARAÚNA,9527,4458,3841,19207,15366,267,1114
RO,19,GUAJARÁ-MIRIM,5844,12838,8550,28474,19924,276,966
RO,35,PORTO VELHO,74847,166145,74950,334743,259793,4451,14350
RO,51,JI-PARANÁ,14174,48520,19248,85899,66651,931,3026
RO,78,ARIQUEMES,8862,37325,17867,66849,48982,754,2041
RO,94,CACOAL,10091,35962,11945,60870,48925,848,2024
RO,116,PIMENTA BUENO,4284,15045,5547,26257,20710,345,1036
RO,132,VILHENA,8396,36531,12319,60413,48094,834,2333
RO,159,JARU,5627,19879,12846,40109,27263,430,1327
RO,175,OURO PRETO DO OESTE,4696,13779,9772,29451,19679,263,941
RO,191,PRESIDENTE MÉDICI,2978,7768,3203,14804,11601,216,639
RO,213,COSTA MARQUES,2329,3320,2862,8836,5974,63,262
RO,230,COLORADO DO OESTE,2441,6932,3641,13725,10084,169,542
RO,256,ESPIGÃO DO OESTE,4593,12536,4949,23285,18336,316,891
RO,272,CEREJEIRAS,1745,7656,2298,12232,9934,121,412
RO,299,ROLIM DE MOURA,6779,21429,7861,38236,30375,539,1628
RO,310,ALTA FLORESTA D OESTE,3763,8524,5691,18773,13082,169,626
RO,337,ALVORADA DO OESTE,2817,4729,4009,12142,8133,124,463
RO,353,SANTA LUZIA D OESTE,1632,3053,1331,6447,5116,90,341
RO,370,NOVA BRASILÂNDIA D OESTE,2790,6723,3866,14055,10189,158,518
RO,396,MACHADINHO D OESTE,4633,9513,8074,23103,15029,227,656
RO,418,SÃO MIGUEL DO GUAPORÉ,3616,7386,4689,16489,11800,190,608
RO,434,NOVA MAMORÉ,2795,8634,4959,17005,12046,128,489
RO,450,CABIXI,1110,2142,1108,4611,3503,56,195
RO,477,CANDEIAS DO JAMARI,4507,7104,5269,17669,12400,169,620
RO,493,ITAPUÃ DO OESTE,1534,2556,2119,6512,4393,68,235
RO,515,NOVO HORIZONTE DO OESTE,1995,3152,1050,6614,5564,80,337
RO,531,CASTANHEIRAS,875,1250,814,3065,2251,29,97
RO,558,VALE DO PARAÍSO,1407,2615,2106,6417,4311,57,232
RO,566,URUPÁ,2051,3985,2844,9294,6450,99,315
RO,574,MIRANTE DA SERRA,2158,3543,2680,8775,6095,95,299
RO,582,SERINGUEIRAS,2252,3832,2641,9140,6499,96,319
RO,590,THEOBROMA,1759,3441,2776,8313,5537,71,266
RO,604,MINISTRO ANDREAZZA,1518,2840,1082,5732,4650,57,235
RO,612,GOVERNADOR JORGE TEIXEIRA,1462,3098,2548,7414,4866,74,232
RO,620,CACAULÂNDIA,694,1967,1071,3938,2867,30,176
RO,639,ALTO PARAÍSO,2257,5701,3500,11951,8451,114,379
RO,647,RIO CRESPO,539,1446,948,3043,2095,25,85
RO,655,CORUMBIARA,1613,2585,1118,5612,4494,55,241
RO,663,MONTE NEGRO,1811,4750,2955,9907,6952,79,312
RO,671,CAMPO NOVO DE RONDÔNIA,1789,3595,2248,7989,5741,68,289
RO,680,CUJUBIM,1775,4975,3537,10709,7172,87,335
RO,698,VALE DO ANARI,1309,2732,1929,6223,4294,49,204
RO,701,PARECIS,912,1301,710,3078,2368,33,122
RO,710,SÃO FELIPE D OESTE,964,2282,833,4372,3539,76,217
RO,728,PRIMAVERA DE RONDÔNIA,529,1423,668,2776,2108,24,132
RO,736,ALTO ALEGRE DOS PARECIS,2244,3790,1532,8097,6565,105,426
RO,744,NOVA UNIÃO,1697,2106,1613,5645,4032,46,183
RO,752,TEIXEIRÓPOLIS,996,1810,1178,4163,2985,49,130
RO,779,BURITIS,3417,11682,7057,23064,16007,199,709
RO,787,PIMENTEIRAS DO OESTE,428,847,407,1750,1343,19,49
RO,795,SÃO FRANCISCO DO GUAPORÉ,2505,5134,3017,11090,8073,113,321
RO,809,CHUPINGUAIA,1504,3057,1578,6474,4896,92,243
RR,3000,CAROEBE,1296,3120,936,5633,4697,57,224
RR,3018,BOA VISTA,36021,132361,40380,218476,178096,2865,6849
RR,3026,IRACEMA,1450,2234,1098,5025,3927,24,219
RR,3034,CARACARAÍ,3248,5631,3120,12488,9368,88,401
RR,3042,AMAJARI,1844,2648,1030,5715,4685,39,154
RR,3050,ALTO ALEGRE,2877,4354,1896,9536,7640,68,341
RR,3069,CANTÁ,3556,4991,1957,10994,9037,109,381
RR,3077,BONFIM,2797,3778,1472,8378,6906,59,272
RR,3085,RORAINÓPOLIS,4455,8597,3744,17519,13775,131,592
RR,3093,MUCAJAÍ,2641,5715,2326,11220,8894,83,455
RR,3107,UIRAMUTÃ,3643,887,644,5411,4767,17,220
RR,3115,NORMANDIA,3594,1833,754,6395,5641,35,179
RR,3123,PACARAIMA,3028,2841,1440,7569,6129,44,216
RR,3131,SÃO JOÃO DA BALIZA,1217,2048,888,4346,3458,45,148
RR,3158,SÃO LUIZ,1205,2230,1240,4871,3631,36,160
RS,84735,ÁUREA,1008,1484,252,2957,2705,103,110
RS,84743,TRÊS ARROIOS,669,1337,301,2441,2140,49,85
RS,84751,NOVA ROMA DO SUL,485,1924,335,2967,2632,54,169
RS,84760,PROGRESSO,1784,2029,568,4705,4137,114,210
RS,84778,PIRAPÓ,862,709,487,2204,1717,48,98
RS,84786,JABOTICABA,1165,1128,537,3055,2518,70,155
RS,84794,SÃO JORGE,407,1550,303,2421,2118,56,105
RS,84808,ALTO ALEGRE,586,772,206,1691,1485,53,74
RS,84816,NOVA HARTZ,3617,7460,1735,13863,12128,283,768
RS,84824,DOIS LAJEADOS,480,1737,426,2823,2397,64,116
RS,84832,SÃO DOMINGOS DO SUL,729,1276,395,2601,2206,84,117
RS,84840,TUNAS,1652,880,472,3182,2710,80,98
RS,84859,SÃO JOÃO DA URTIGA,1411,1787,466,4013,3547,160,189
RS,84867,GUABIJU,222,897,183,1384,1201,37,45
RS,84875,QUINZE DE NOVEMBRO,761,1999,438,3331,2893,23,110
RS,84883,DOUTOR MAURÍCIO CARDOSO,1235,2005,469,3961,3492,53,199
RS,84891,CAPELA DE SANTANA,2237,3196,976,7085,6109,185,491
RS,84905,JAQUIRANA,991,1256,726,3265,2539,101,191
RS,84913,VANINI,439,1041,262,1899,1637,65,92
RS,84921,BOQUEIRÃO DO LEÃO,2022,2210,738,5368,4630,139,259
RS,84930,FAGUNDES VARELA,296,1559,284,2258,1974,39,80
RS,84948,ÁGUA SANTA,730,1659,373,2950,2577,64,124
RS,84956,SILVEIRA MARTINS,627,1087,339,2221,1882,60,108
RS,84964,IBIRAPUITÃ,1204,1374,606,3417,2811,76,157
RS,84972,IBARAMA,1353,1398,397,3409,3012,92,169
RS,84980,PANTANO GRANDE,3076,2822,1410,7880,6470,204,368
RS,84999,IPÊ,777,3446,762,5294,4532,91,218
RS,85006,TRINDADE DO SUL,1980,1703,650,4626,3976,96,197
RS,85014,AGUDO,3949,6043,1010,11908,10898,360,546
RS,85022,ERNESTINA,853,1284,388,2676,2288,55,96
RS,85030,AJURICABA,1635,3116,874,5883,5009,87,171
RS,85049,DEZESSEIS DE NOVEMBRO,932,899,518,2537,2019,59,129
RS,85057,ALECRIM,1909,2355,594,5181,4587,94,229
RS,85065,BROCHIER,967,2008,351,3703,3352,91,286
RS,85073,ALEGRETE,18469,21771,16287,59973,43686,1233,2213
RS,85081,EREBANGO,765,1149,452,2523,2071,39,118
RS,85090,ALPESTRE,2519,2435,648,6097,5449,194,301
RS,85103,ENTRE-IJUÍS,2402,3125,976,6958,5982,135,320
RS,85111,ALVORADA,35734,57782,22844,128949,106105,4154,8435
RS,85120,NOVA ESPERANÇA DO SUL,1122,1922,575,4056,3481,130,307
RS,85138,ANTA GORDA,612,3203,629,4826,4197,145,237
RS,85146,PAVERAMA,1703,2780,845,5770,4925,109,333
RS,85154,ANTÔNIO PRADO,1250,7131,929,9981,9052,192,479
RS,85162,TERRA DE AREIA,1562,3790,1350,7285,5935,189,394
RS,85170,ARATIBA,2090,2831,754,6047,5293,109,263
RS,85189,HARMONIA,721,2363,282,3624,3342,86,172
RS,85197,ARROIO DO MEIO,3421,9339,1575,15568,13993,406,827
RS,85200,CAMPOS BORGES,1078,1262,532,3119,2587,129,118
RS,85219,ARROIO DOS RATOS,3353,3883,1774,10007,8233,356,641
RS,85227,CERRO GRANDE,1072,581,397,2225,1828,58,117
RS,85235,ARROIO DO TIGRE,3256,4640,1913,10514,8601,280,425
RS,85243,IPIRANGA DO SUL,340,1209,229,1883,1654,24,81
RS,85251,ARROIO GRANDE,5903,4816,2366,14328,11962,424,819
RS,85260,LAGOÃO,2343,1202,564,4467,3903,131,227
RS,85278,ARVOREZINHA,1987,4539,1418,8696,7278,332,420
RS,85286,ESTAÇÃO,1130,2684,606,4836,4230,118,298
RS,85294,AUGUSTO PESTANA,1467,3061,595,5490,4895,109,258
RS,85308,ARROIO DO SAL,1318,3619,1365,6821,5456,171,348
RS,85316,BAGÉ,27319,35630,21882,91971,70089,2439,4701
RS,85324,SÃO JOSÉ DO HORTÊNCIO,511,2348,219,3313,3094,58,177
RS,85332,BARÃO DE COTEGIPE,1528,2645,465,5077,4612,152,287
RS,85340,PINHAL,758,891,303,2113,1810,57,104
RS,85359,BARRACÃO,1468,1656,773,4289,3516,136,256
RS,85367,TRÊS CACHOEIRAS,1354,4784,754,7337,6583,141,304
RS,85375,BARRA DO RIBEIRO,2789,4285,1794,9776,7982,263,645
RS,85383,SÃO VENDELINO,397,1347,228,2136,1908,43,121
RS,85391,BARROS CASSAL,2887,2991,1477,7974,6497,223,396
RS,85405,PROTÁSIO ALVES,227,1315,187,1850,1663,66,55
RS,85413,BENTO GONÇALVES,12741,56142,15174,89315,74141,1588,3670
RS,85421,POUSO NOVO,486,721,218,1527,1309,29,73
RS,85430,BOA VISTA DO BURICÁ,1441,2959,555,5331,4776,105,271
RS,85448,EUGÊNIO DE CASTRO,679,1057,451,2355,1904,50,118
RS,85456,BOM JESUS,2538,3269,1776,8338,6562,337,418
RS,85464,CRISTAL,1976,2494,1270,6178,4908,137,301
RS,85472,BOM RETIRO DO SUL,2073,5191,1369,9452,8083,233,586
RS,85480,SÃO MIGUEL DAS MISSÕES,2328,2058,945,5631,4686,143,157
RS,85499,BOSSOROCA,1894,1626,881,4811,3930,169,241
RS,85502,GLORINHA,1128,3577,1168,6283,5115,127,283
RS,85510,BRAGA,1190,871,570,2841,2271,75,135
RS,85529,SEGREDO,2097,2242,681,5415,4734,171,224
RS,85537,BUTIÁ,4631,5995,2287,14165,11878,518,734
RS,85545,ALEGRIA,1215,1308,405,3168,2763,85,155
RS,85553,CAÇAPAVA DO SUL,8960,8113,3580,23356,19776,990,1713
RS,85561,SALDANHA MARINHO,693,1354,377,2612,2235,68,120
RS,85570,CACEQUI,3290,2850,1479,8285,6806,179,487
RS,85588,SÃO JOSÉ DO HERVAL,706,710,497,2073,1576,52,108
RS,85596,CACHOEIRA DO SUL,15395,30445,18307,68744,50437,1964,2633
RS,85600,VISTA ALEGRE,1089,911,278,2427,2149,45,104
RS,85618,CACHOEIRINHA,22310,51143,21612,102560,80948,2458,5037
RS,85626,IVORÁ,582,805,292,1860,1568,72,109
RS,85634,CACIQUE DOBLE,1206,1847,545,3868,3323,118,152
RS,85642,VILA MARIA,820,1968,381,3400,3019,78,153
RS,85650,CAIBATÉ,1624,1426,602,3922,3320,99,171
RS,85669,TAQUARUÇU DO SUL,966,1042,345,2563,2218,69,141
RS,85677,CAIÇARA,1401,1859,533,4030,3497,82,155
RS,85685,IMBÉ,3952,8420,4812,18193,13381,302,707
RS,85693,CAMAQUÃ,12485,23621,11378,51183,39805,1486,2213
RS,85707,SEDE NOVA,796,1015,261,2223,1962,48,103
RS,85715,CAMBARÁ DO SUL,1026,2580,834,4882,4048,145,297
RS,85723,TUPANDI,524,2700,438,3906,3468,73,171
RS,85731,CAMPINA DAS MISSÕES,1785,2341,641,5076,4435,89,220
RS,85740,RIOZINHO,1034,1883,529,3797,3268,92,259
RS,85758,CAMPINAS DO SUL,873,2741,562,4513,3951,100,237
RS,85766,RELVADO,347,1123,417,2014,1597,39,88
RS,85774,CAMPO BOM,9932,29746,9180,52236,43056,1052,2326
RS,85782,IMIGRANTE,542,1420,463,2663,2200,72,166
RS,85790,CAMPO NOVO,1629,1496,769,4156,3387,66,196
RS,85804,CIDREIRA,2554,4028,2017,9239,7222,200,440
RS,85812,CANDELÁRIA,6168,10474,2236,20946,18710,821,1247
RS,85820,MONTAURI,268,896,198,1487,1289,49,76
RS,85839,CÂNDIDO GODÓI,1369,3228,478,5386,4908,105,206
RS,85847,VISTA GAÚCHA,886,974,463,2517,2054,39,155
RS,85855,CANELA,5044,16873,6758,31247,24489,962,1610
RS,85863,VISTA ALEGRE DO PRATA,206,994,214,1505,1291,34,57
RS,85871,CANGUÇU,12786,18428,9324,44654,35330,1560,2556
RS,85880,CASEIROS,783,1287,409,2699,2290,83,137
RS,85898,CANOAS,63161,119862,49413,252320,202907,6450,13434
RS,85901,ITACURUBI,984,882,553,2564,2011,68,77
RS,85910,CARAZINHO,11532,22876,9646,47233,37587,1133,2046
RS,85928,ENTRE RIOS DO SUL,910,1014,562,2668,2106,71,111
RS,85936,CARLOS BARBOSA,3458,13837,1950,20690,18740,435,1010
RS,85944,CERRO GRANDE DO SUL,2296,2880,974,6725,5751,236,339
RS,85952,CASCA,1481,4279,1291,7616,6325,206,359
RS,85960,CAMARGO,561,1295,325,2359,2034,51,127
RS,85979,CATUÍPE,2313,3425,875,7150,6275,173,364
RS,85987,PARAÍSO DO SUL,1601,2650,547,5173,4626,119,256
RS,85995,CAXIAS DO SUL,62109,187051,46050,323123,277073,7801,20112
RS,86010,CERRO LARGO,3454,4149,1183,9507,8324,200,521
RS,86029,FAXINALZINHO,725,991,424,2283,1859,41,102
RS,86037,CHAPADA,2173,3828,880,7505,6625,214,410
RS,86045,AMARAL FERRADOR,1630,1687,821,4546,3725,156,252
RS,86053,CHIAPETTA,1102,1450,687,3426,2739,77,110
RS,86061,VILA FLORES,456,2193,344,3185,2841,56,136
RS,86070,CIRÍACO,1084,1733,482,3622,3140,130,193
RS,86088,CERRO BRANCO,1101,1698,597,3677,3080,101,180
RS,86096,COLORADO,659,1759,455,3046,2591,60,113
RS,86100,ANDRÉ DA ROCHA,236,709,231,1249,1018,29,44
RS,86118,CONDOR,1627,2672,859,5549,4690,111,280
RS,86126,POÇO DAS ANTAS,396,1143,308,1971,1663,34,90
RS,86134,CONSTANTINA,2820,3364,1226,7955,6729,200,345
RS,86142,TRÊS PALMEIRAS,1637,1308,474,3690,3216,98,173
RS,86150,CORONEL BICACO,2163,1935,1380,5889,4509,127,284
RS,86169,NOVA ALVORADA,591,1506,321,2649,2328,82,149
RS,86177,CRISSIUMAL,3470,4501,1718,10649,8931,247,713
RS,86185,MORRO REDONDO,1434,2426,816,5193,4377,196,321
RS,86193,CRUZ ALTA,13134,20626,11704,48244,36540,966,1814
RS,86207,SANTA MARIA DO HERVAL,1248,2884,354,4988,4634,111,391
RS,86215,CRUZEIRO DO SUL,2147,4993,1019,8901,7882,227,515
RS,86223,BARÃO,963,2974,445,4746,4301,102,262
RS,86231,DAVID CANABARRO,1249,1808,532,3924,3392,143,192
RS,86240,ELDORADO DO SUL,6858,9705,2500,20972,18472,605,1304
RS,86258,DOIS IRMÃOS,5483,13371,3214,23703,20489,479,1156
RS,86274,DOM FELICIANO,3853,3758,1636,10272,8636,451,574
RS,86282,ALTO FELIZ,403,1592,334,2559,2225,57,173
RS,86290,DOM PEDRITO,9557,10132,8261,30061,21800,622,1489
RS,86304,AMETISTA DO SUL,1956,2141,700,5257,4557,163,297
RS,86312,DONA FRANCISCA,948,1363,529,3066,2537,75,151
RS,86320,ARAMBARÉ,874,1437,806,3348,2542,82,149
RS,86339,ENCANTADO,3140,9897,3441,17576,14135,351,747
RS,86347,BARÃO DO TRIUNFO,1245,2118,385,4199,3814,222,229
RS,86355,ENCRUZILHADA DO SUL,7041,6116,2881,17997,15116,758,1201
RS,86363,BARRA DO GUARITA,998,804,349,2277,1928,16,110
RS,86371,ERECHIM,16527,42360,14565,78712,64147,1736,3524
RS,86380,BARRA DO RIO AZUL,704,684,213,1758,1545,51,106
RS,86398,HERVAL,2379,1252,1117,5157,4040,158,251
RS,86401,BARRA FUNDA,785,1263,379,2602,2223,52,123
RS,86410,ERVAL GRANDE,1674,1530,580,4113,3533,143,186
RS,86428,BOA VISTA DAS MISSÕES,753,683,326,1885,1559,45,78
RS,86436,ERVAL SECO,2261,1940,787,5394,4607,127,279
RS,86444,BOM PROGRESSO,800,804,380,2073,1693,30,59
RS,86452,ESMERALDA,784,1106,590,2637,2047,61,96
RS,86460,CAMPESTRE DA SERRA,295,1774,328,2577,2249,49,131
RS,86479,ESPUMOSO,3851,5698,1809,12182,10373,293,531
RS,86487,CANDIOTA,3524,2005,1213,7301,6088,176,383
RS,86495,ESTÂNCIA VELHA,5921,20689,6019,35193,29174,775,1789
RS,86509,CAPITÃO,620,1322,299,2456,2157,76,139
RS,86517,ESTEIO,18829,30443,14807,68779,53972,1473,3227
RS,86525,CARLOS GOMES,590,542,173,1392,1219,37,50
RS,86533,ESTRELA,4327,14841,5004,25767,20763,452,1143
RS,86541,CENTENÁRIO,1066,1091,254,2527,2273,59,57
RS,86550,FARROUPILHA,8491,34114,8781,55568,46787,1275,2907
RS,86568,CHARRUA,813,941,337,2300,1963,61,148
RS,86576,FAXINAL DO SOTURNO,1579,2695,893,5571,4678,140,264
RS,86584,COLINAS,392,1370,309,2239,1930,44,124
RS,86592,FELIZ,2103,6167,1121,10206,9085,227,588
RS,86606,COQUEIROS DO SUL,535,1290,327,2268,1941,46,70
RS,86614,FLORES DA CUNHA,2268,16466,2668,22851,20183,420,1029
RS,86622,CORONEL BARROS,667,1298,321,2411,2090,44,81
RS,86630,FONTOURA XAVIER,3354,2404,1773,8163,6390,251,381
RS,86649,COXILHA,847,1159,336,2463,2127,49,72
RS,86657,FORMIGUEIRO,1906,2216,960,5563,4603,165,316
RS,86665,DERRUBADAS,960,1076,514,2696,2182,37,109
RS,86673,FREDERICO WESTPHALEN,6713,11651,5041,25083,20042,547,1131
RS,86681,DOIS IRMÃOS DAS MISSÕES,809,673,271,1875,1604,35,87
RS,86690,GARIBALDI,3837,15945,2299,23661,21362,470,1110
RS,86703,ENGENHO VELHO,478,413,230,1196,966,27,48
RS,86711,GAURAMA,1129,3015,600,5076,4476,125,207
RS,86720,GARRUCHOS,1157,700,647,2647,2000,55,88
RS,86738,GENERAL CÂMARA,2027,2445,902,5839,4937,171,294
RS,86746,GENTIL,307,891,250,1535,1285,38,49
RS,86754,SÃO VICENTE DO SUL,2500,2477,1951,7371,5420,177,266
RS,86762,GRAMADO DOS LOUREIROS,954,609,358,2056,1698,39,96
RS,86770,GETÚLIO VARGAS,2639,7244,2579,13327,10748,269,596
RS,86789,GRAMADO XAVIER,1271,965,431,2854,2423,76,111
RS,86797,GIRUÁ,3868,6066,1718,12395,10677,233,510
RS,86800,HULHA NEGRA,2154,1399,719,4606,3887,114,220
RS,86819,GRAMADO,3997,18844,6368,31331,24963,756,1366
RS,86827,INHACORÁ,769,701,405,2006,1601,42,89
RS,86835,GRAVATAÍ,38323,95935,39656,189385,149729,5282,10189
RS,86843,ITAPUCA,537,804,362,1843,1481,53,87
RS,86851,GUAÍBA,20423,31968,15292,74077,58785,2121,4273
RS,86860,LAJEADO DO BUGRE,839,510,286,1788,1502,64,89
RS,86878,GUAPORÉ,2957,11449,1913,17599,15686,438,842
RS,86886,LAGOA DOS TRÊS CANTOS,300,918,215,1541,1326,32,76
RS,86894,GUARANI DAS MISSÕES,2145,2633,555,5756,5201,128,295
RS,86908,LINDOLFO COLLOR,1422,2036,470,4367,3897,97,342
RS,86916,HORIZONTINA,3446,7891,1849,14012,12163,230,596
RS,86924,LINHA NOVA,283,819,177,1395,1218,34,82
RS,86932,CHARQUEADAS,8026,10125,5058,25200,20142,646,1345
RS,86940,MANOEL VIANA,2117,1845,985,5286,4301,114,225
RS,86959,HUMAITÁ,1227,2002,476,3993,3517,77,211
RS,86967,MAQUINÉ,1847,2300,910,5541,4631,140,344
RS,86975,IBIAÇÁ,930,2094,466,3826,3360,159,177
RS,86983,MARATÁ,402,1390,237,2179,1942,43,107
RS,86991,IBIRAIARAS,1213,2964,715,5350,4635,163,295
RS,87009,MARIANA PIMENTEL,896,1663,596,3408,2812,84,169
RS,87017,IBIRUBÁ,3685,8953,1975,15597,13622,362,622
RS,87025,MATO CASTELHANO,560,1481,406,2563,2157,41,75
RS,87033,IGREJINHA,5444,15185,4457,26882,22425,609,1187
RS,87041,MATO LEITÃO,968,2032,444,3727,3283,90,193
RS,87050,IJUÍ,18425,29987,12527,64534,52007,1173,2422
RS,87068,MINAS DO LEÃO,1735,2678,1043,6040,4997,207,377
RS,87076,ILÓPOLIS,521,2097,550,3468,2918,111,189
RS,87084,MONTE BELO DO SUL,318,2087,393,2946,2553,50,98
RS,87092,INDEPENDÊNCIA,1636,2689,761,5435,4674,122,227
RS,87106,MORMAÇO,772,1165,476,2588,2112,58,117
RS,87114,IRAÍ,2146,2177,1393,6135,4742,136,283
RS,87122,MORRINHOS DO SUL,688,1689,373,2910,2537,51,109
RS,87130,ITAQUI,7372,11048,7834,27714,19880,528,932
RS,87149,MORRO REUTER,755,3382,537,5080,4543,111,295
RS,87157,ITATIBA DO SUL,1670,995,422,3285,2863,63,135
RS,87165,MULITERNO,731,741,421,2094,1673,99,102
RS,87173,IVOTI,2863,9333,969,14337,13368,291,881
RS,87181,NICOLAU VERGUEIRO,467,955,367,1895,1528,41,65
RS,87190,JACUTINGA,785,1558,385,2957,2572,87,142
RS,87203,NOVA BOA VISTA,538,987,196,1902,1706,70,111
RS,87211,JAGUARÃO,6699,7930,3730,20064,16334,549,1156
RS,87220,NOVA PÁDUA,134,1770,323,2308,1985,31,50
RS,87238,JAGUARI,2465,4138,1073,8378,7305,264,438
RS,87246,NOVA SANTA RITA,4644,8171,2990,16998,14008,397,796
RS,87254,JÚLIO DE CASTILHOS,5786,5575,2157,14481,12324,351,612
RS,87262,NOVO BARREIRO,1518,1238,444,3443,2999,110,133
RS,87270,LAGOA VERMELHA,5367,9759,2871,19637,16766,586,1054
RS,87289,NOVO MACHADO,915,1600,386,3103,2717,66,136
RS,87297,LAJEADO,12932,32683,10551,60166,49615,1314,2686
RS,87300,NOVO TIRADENTES,743,606,265,1750,1485,49,87
RS,87319,LAVRAS DO SUL,2130,1736,881,5271,4390,163,361
RS,87327,PARECI NOVO,441,2049,377,3043,2666,67,109
RS,87335,LIBERATO SALZANO,2003,1276,765,4409,3644,179,186
RS,87343,PASSO DO SOBRADO,1655,2231,551,4799,4248,150,212
RS,87351,MACHADINHO,1429,2180,547,4488,3941,114,218
RS,87360,PICADA CAFÉ,726,2703,590,4357,3767,79,259
RS,87378,MARAU,5855,17922,5193,30958,25765,668,1320
RS,87386,PINHAL GRANDE,1373,1311,605,3514,2909,74,151
RS,87394,MARCELINO RAMOS,1273,1840,483,3826,3343,61,169
RS,87408,PINHEIRINHO DO VALE,1334,1326,343,3236,2893,56,177
RS,87416,MARIANO MORO,751,756,323,2015,1692,86,99
RS,87424,PONTÃO,1296,1297,353,3082,2729,46,90
RS,87432,MATA,1434,1570,747,4063,3316,143,169
RS,87440,PONTE PRETA,457,946,187,1684,1497,24,70
RS,87459,MAXIMILIANO DE ALMEIDA,895,2104,639,3962,3323,138,186
RS,87467,PORTO MAUÁ,531,1125,383,2169,1786,26,104
RS,87475,MIRAGUAÍ,1761,1292,598,3893,3295,63,179
RS,87483,PORTO VERA CRUZ,576,718,265,1630,1365,15,56
RS,87491,MONTENEGRO,10918,22518,10048,47183,37135,1242,2457
RS,87505,PRESIDENTE LUCENA,406,1567,202,2367,2165,45,147
RS,87513,MOSTARDAS,2483,3631,1376,8314,6938,236,588
RS,87521,QUEVEDOS,851,747,398,2172,1774,95,81
RS,87530,MUÇUM,600,2590,532,3998,3466,104,172
RS,87548,RIO DOS ÍNDIOS,1349,782,556,2882,2326,83,112
RS,87556,NÃO-ME-TOQUE,3087,7007,1466,12394,10928,270,564
RS,87564,SAGRADA FAMÍLIA,842,766,423,2193,1770,66,96
RS,87572,NONOAI,3414,3479,1619,9033,7414,172,349
RS,87580,SALVADOR DAS MISSÕES,746,1271,300,2443,2143,45,81
RS,87599,NOVA ARAÇÁ,513,2605,524,3878,3354,88,148
RS,87602,SANTA CLARA DO SUL,930,3159,555,5021,4466,120,257
RS,87610,NOVA BASSANO,774,4980,702,6842,6140,130,256
RS,87629,SANTA TEREZA,289,1004,256,1662,1406,35,78
RS,87637,NOVA BRÉSCIA,397,1766,313,2640,2327,50,114
RS,87645,SANTO ANTÔNIO DO PALMA,676,810,264,1889,1625,49,90
RS,87653,NOVA PALMA,1651,2460,683,5143,4460,129,220
RS,87661,SANTO ANTÔNIO DO PLANALTO,406,1145,257,1934,1677,42,84
RS,87670,NOVA PETRÓPOLIS,2172,10608,1653,15538,13885,304,801
RS,87688,SANTO EXPEDITO DO SUL,649,1030,307,2171,1864,99,86
RS,87696,NOVA PRATA,2597,11842,1662,17257,15595,366,790
RS,87700,SÃO JOÃO DO POLÊSINE,605,1316,463,2524,2061,50,90
RS,87718,NOVO HAMBURGO,32641,100374,34898,180341,145443,4152,8276
RS,87726,SÃO JOSÉ DOS AUSENTES,715,1392,604,2904,2300,59,134
RS,87734,OSÓRIO,9789,16099,7598,36320,28722,847,1987
RS,87742,SÃO JOSÉ DO INHACORÁ,624,1178,208,2136,1928,39,87
RS,87750,PAIM FILHO,1392,1534,619,3749,3130,61,143
RS,87769,SÃO JOSÉ DAS MISSÕES,973,620,373,2099,1726,60,73
RS,87777,PALMEIRA DAS MISSÕES,8010,9490,3099,22254,19155,578,1077
RS,87785,SÃO MARTINHO DA SERRA,710,1442,579,2951,2372,101,119
RS,87793,PALMITINHO,2525,1917,698,5630,4932,149,341
RS,87807,SÃO PEDRO DA SERRA,538,1901,249,2931,2682,55,188
RS,87815,PANAMBI,6701,17514,4072,30084,26012,642,1155
RS,87823,SÃO PEDRO DO BUTIÁ,727,1181,259,2311,2052,39,105
RS,87831,PARAÍ,1018,3754,912,6199,5287,177,338
RS,87840,SÃO VALENTIM DO SUL,297,1380,311,2113,1802,38,87
RS,87858,PASSO FUNDO,38940,70103,27985,146317,118332,3574,5715
RS,87866,SÃO VALÉRIO DO SUL,922,626,423,2102,1679,34,97
RS,87874,PEDRO OSÓRIO,2904,1811,1519,6775,5256,170,371
RS,87882,SENTINELA DO SUL,1358,1595,636,3977,3341,150,238
RS,87890,PEJUÇARA,821,1526,440,2968,2528,56,125
RS,87904,SÉRIO,706,834,237,1967,1730,71,119
RS,87912,PELOTAS,81705,97524,37143,239012,201869,7393,15247
RS,87920,SERTÃO SANTANA,1191,2642,803,5023,4220,150,237
RS,87939,PINHEIRO MACHADO,4086,2882,2112,10220,8108,357,783
RS,87947,SINIMBU,2590,2924,475,6437,5962,156,292
RS,87955,PIRATINI,6022,4426,2331,14233,11902,603,851
RS,87963,TIRADENTES DO SUL,1823,1674,714,4528,3814,83,234
RS,87971,PLANALTO,2418,3260,1283,7585,6302,191,433
RS,87980,TRAVESSEIRO,641,938,191,1892,1701,41,81
RS,87998,PORTÃO,5801,11685,4330,23745,19415,580,1349
RS,88005,TRÊS FORQUILHAS,785,1205,411,2607,2196,69,137
RS,88013,PORTO ALEGRE,331419,436643,250485,1100882,850397,28231,54104
RS,88021,TUPANCI DO SUL,329,650,302,1408,1106,60,67
RS,88030,PORTO LUCENA,1385,1719,552,3913,3361,73,184
RS,88048,UNIÃO DA SERRA,227,950,197,1465,1268,35,56
RS,88056,PORTO XAVIER,2788,3062,1076,7416,6340,137,353
RS,88064,VALE DO SOL,3046,3425,981,8149,7168,276,421
RS,88072,PUTINGA,551,2159,932,3930,2998,121,167
RS,88080,VALE REAL,976,2653,558,4568,4010,110,271
RS,88099,QUARAÍ,5429,7015,3240,16752,13512,307,761
RS,88102,VILA NOVA DO SUL,1232,1235,735,3518,2783,111,205
RS,88110,REDENTORA,2899,1670,1259,6222,4963,110,284
RS,88129,VITÓRIA DAS MISSÕES,1332,1269,542,3294,2752,43,108
RS,88137,RESTINGA SÊCA,3457,5828,1585,11774,10189,368,536
RS,88145,XANGRI-LÁ,2015,5827,1643,10100,8457,218,397
RS,88153,RIO GRANDE,57742,50082,36485,156662,120177,3466,8887
RS,88161,BOA VISTA DO SUL,396,1612,296,2448,2152,53,91
RS,88170,RIO PARDO,11054,10198,7059,30450,23391,740,1399
RS,88188,DILERMANDO DE AGUIAR,865,1168,583,2797,2214,64,117
RS,88196,ROCA SALES,1530,4430,600,7115,6515,180,375
RS,88200,CAPIVARI DO SUL,964,1651,610,3482,2872,73,184
RS,88218,RODEIO BONITO,1777,1950,691,4779,4088,109,252
RS,88226,NOVA CANDELÁRIA,616,1365,145,2343,2198,53,164
RS,88234,ROLANTE,3440,8657,1793,15123,13330,363,870
RS,88242,FLORIANO PEIXOTO,699,735,271,1814,1543,51,58
RS,88250,RONDA ALTA,3002,2795,878,7074,6196,148,251
RS,88269,CHUVISCA,1080,2172,499,4048,3549,149,148
RS,88277,RONDINHA,1644,2109,622,4656,4034,139,142
RS,88285,ESPERANÇA DO SUL,1196,1000,362,2728,2366,33,137
RS,88293,ROQUE GONZALES,2042,2219,573,5196,4623,129,233
RS,88307,DOUTOR RICARDO,388,1126,316,1963,1647,47,86
RS,88315,ROSÁRIO DO SUL,9686,11583,8977,32357,23380,749,1362
RS,88323,HERVEIRAS,1258,710,374,2447,2073,31,74
RS,88331,SALVADOR DO SUL,960,3303,418,5175,4757,142,352
RS,88340,CARAÁ,1602,2713,1202,6086,4884,202,367
RS,88358,SANANDUVA,2862,7328,1947,13014,11067,344,533
RS,88366,FAZENDA VILANOVA,861,1525,472,3191,2719,91,242
RS,88374,SANTA BÁRBARA DO SUL,1908,3425,1145,6977,5832,190,309
RS,88382,ITAARA,1066,1999,603,3912,3309,92,152
RS,88390,SANTA CRUZ DO SUL,25729,51725,17554,102610,85056,2836,4766
RS,88404,ESTRELA VELHA,949,1259,463,2918,2455,81,166
RS,88412,SANTA MARIA,57445,91619,44000,206540,162540,5184,8292
RS,88420,BENJAMIN CONSTANT DO SUL,971,518,338,1939,1601,39,73
RS,88439,SANTANA DA BOA VISTA,2097,2157,1202,6201,4999,345,400
RS,88447,MAÇAMBARÁ,1279,1322,928,3711,2783,66,116
RS,88455,SANT ANA DO LIVRAMENTO,23224,25240,20920,73651,52731,1584,2683
RS,88463,DOM PEDRO DE ALCÂNTARA,573,1326,326,2387,2061,50,112
RS,88471,SANTA ROSA,13430,30248,10590,57027,46437,982,1777
RS,88480,UNISTALDA,816,1023,534,2535,2001,67,95
RS,88498,SANTA VITÓRIA DO PALMAR,8032,7615,7220,24783,17563,712,1204
RS,88501,TURUÇU,747,1789,494,3298,2804,97,171
RS,88510,SANTIAGO,10394,17660,9679,40174,30495,942,1499
RS,88528,CRISTAL DO SUL,1149,758,350,2414,2064,59,98
RS,88536,SANTO ÂNGELO,17692,26347,14242,61716,47474,1178,2257
RS,88544,MUITOS CAPÕES,426,1326,499,2436,1937,83,102
RS,88552,SANTO ANTÔNIO DA PATRULHA,8363,14926,7285,33500,26215,946,1980
RS,88560,NOVA RAMADA,649,996,263,2025,1762,32,85
RS,88579,SANTO ANTÔNIO DAS MISSÕES,3609,2537,1907,8608,6701,215,340
RS,88587,JARI,1268,896,469,2886,2417,142,111
RS,88595,SANTO AUGUSTO,3792,4472,1941,10967,9026,230,532
RS,88609,UBIRETAMA,462,1092,187,1854,1667,46,67
RS,88617,SANTO CRISTO,4124,6038,1993,12884,10891,262,467
RS,88625,BARRA DO QUARAÍ,963,994,706,2782,2076,30,89
RS,88633,SÃO BORJA,16441,16398,13363,48491,35128,795,1494
RS,88641,CERRITO,2186,1752,943,5416,4473,234,301
RS,88650,SÃO FRANCISCO DE ASSIS,5544,5127,2230,14073,11843,515,657
RS,88668,VALE VERDE,973,1203,538,2990,2452,106,170
RS,88676,SÃO FRANCISCO DE PAULA,4766,6091,2121,14414,12293,540,896
RS,88684,NOVO CABRAIS,1046,1707,505,3483,2978,100,125
RS,88692,SÃO GABRIEL,13220,18188,12631,46809,34178,1043,1727
RS,88706,SETE DE SETEMBRO,655,738,201,1725,1524,46,85
RS,88714,SÃO JERÔNIMO,4740,5942,1713,13727,12014,493,839
RS,88722,TABAÍ,1122,1719,559,3671,3112,101,170
RS,88730,SÃO JOSÉ DO NORTE,6976,7503,2895,19503,16608,640,1489
RS,88749,VILA LÂNGARO,445,1261,262,2128,1866,57,103
RS,88757,SÃO JOSÉ DO OURO,1277,3100,763,5652,4889,239,273
RS,88765,SENADOR SALGADO FILHO,640,1495,317,2597,2280,51,94
RS,88773,SÃO LEOPOLDO,43166,76586,34930,166336,131406,3754,7900
RS,88781,VESPASIANO CORRÊA,198,1518,333,2174,1841,56,69
RS,88790,SÃO LOURENÇO DO SUL,10676,15254,7627,35961,28334,813,1591
RS,88803,MONTE ALEGRE DOS CAMPOS,783,1496,770,3275,2505,90,136
RS,88811,SÃO LUIZ GONZAGA,8728,9521,7163,27171,20008,601,1158
RS,88820,MARQUES DE SOUZA,902,1801,494,3410,2916,61,152
RS,88838,SÃO MARCOS,1960,10338,1429,15102,13673,323,1052
RS,88846,CHUÍ,1523,1168,907,3936,3029,139,199
RS,88854,SÃO MARTINHO,1099,2695,646,4763,4117,100,223
RS,88862,ARARICÁ,1218,2670,761,4986,4225,99,238
RS,88870,SÃO NICOLAU,1688,1186,535,3742,3207,95,238
RS,88889,PASSA SETE,1439,1470,464,3674,3210,115,186
RS,88897,SÃO PAULO DAS MISSÕES,1875,2293,752,5208,4456,87,201
RS,88900,TOROPI,730,1271,379,2576,2197,81,115
RS,88919,SÃO PEDRO DO SUL,3684,5867,1757,12356,10599,428,620
RS,88927,BALNEÁRIO PINHAL,1910,3613,1931,8063,6132,172,437
RS,88935,SÃO SEBASTIÃO DO CAÍ,3662,8758,1658,15337,13679,378,881
RS,88943,MAMPITUBA,1007,1055,385,2665,2280,68,150
RS,88951,SÃO SEPÉ,6531,6060,2358,16270,13912,465,856
RS,88978,SÃO VALENTIM,907,1466,461,3048,2587,91,123
RS,88986,ACEGUÁ,1025,1739,679,3653,2974,109,101
RS,88994,SAPIRANGA,14808,31672,10681,61181,50500,1194,2826
RS,89001,ALMIRANTE TAMANDARÉ DO SUL,573,923,254,1881,1627,37,94
RS,89010,SAPUCAIA DO SUL,30034,44203,22926,105081,82155,2645,5273
RS,89028,ARROIO DO PADRE,399,1876,250,2641,2391,39,77
RS,89036,SARANDI,4163,8181,2076,15453,13377,394,639
RS,89044,BOA VISTA DO CADEADO,447,1073,341,1982,1641,44,77
RS,89052,SEBERI,2973,3773,1010,8379,7369,226,397
RS,89060,BOA VISTA DO INCRA,633,1012,338,2072,1734,38,51
RS,89079,SELBACH,966,2465,653,4324,3671,83,157
RS,89087,BOZANO,622,1264,333,2307,1974,23,65
RS,89095,SERAFINA CORRÊA,2121,7339,1549,11921,10372,324,588
RS,89109,CANUDOS DO VALE,766,646,234,1765,1531,35,84
RS,89117,SERTÃO,1328,2548,497,4721,4224,118,230
RS,89125,CAPÃO BONITO DO SUL,694,787,348,1951,1603,39,83
RS,89133,SEVERIANO DE ALMEIDA,1117,1570,483,3412,2929,68,174
RS,89141,CAPÃO DO CIPÓ,1094,943,523,2703,2180,58,85
RS,89150,CAPÃO DA CANOA,7242,19183,8607,37365,28758,792,1541
RS,89168,COQUEIRO BAIXO,204,826,227,1325,1098,23,45
RS,89176,SOBRADINHO,3106,5372,2440,11673,9233,253,502
RS,89184,CORONEL PILAR,225,942,200,1442,1242,26,49
RS,89192,SOLEDADE,7203,8802,2661,20285,17624,484,1135
RS,89206,CRUZALTENSE,524,1121,232,1979,1747,38,64
RS,89214,TAPEJARA,2818,9981,2081,16050,13969,378,792
RS,89222,FORQUETINHA,560,1312,272,2286,2014,56,86
RS,89230,TAPERA,2588,3608,1033,7723,6690,144,350
RS,89247,SANTA CECÍLIA DO SUL,419,982,220,1747,1527,58,68
RS,89249,ITATI,793,1223,468,2662,2194,54,124
RS,89257,TAPES,3551,4502,1447,10436,8989,281,655
RS,89265,JACUIZINHO,958,611,293,1974,1681,37,75
RS,89273,TAQUARA,7853,22327,8555,41608,33053,932,1941
RS,89281,LAGOA BONITA DO SUL,942,860,322,2247,1925,50,73
RS,89290,TAQUARI,5392,9523,2512,18851,16339,475,949
RS,89303,MATO QUEIMADO,569,655,243,1571,1328,23,81
RS,89311,TENENTE PORTELA,3716,3660,1288,9287,7999,153,470
RS,89320,NOVO XINGU,640,598,245,1555,1310,27,45
RS,89338,TORRES,5997,14136,6817,29262,22445,692,1620
RS,89346,PAULO BENTO,483,1068,195,1891,1696,37,108
RS,89354,TRAMANDAÍ,7784,15303,9832,35206,25374,752,1535
RS,89362,PINHAL DA SERRA,701,934,581,2371,1790,74,81
RS,89370,TRÊS COROAS,3489,10171,1947,16969,15022,480,882
RS,89389,QUATRO IRMÃOS,466,726,242,1518,1276,28,56
RS,89397,TRÊS DE MAIO,4500,9625,1704,16929,15225,382,718
RS,89400,ROLADOR,871,796,343,2156,1813,58,88
RS,89419,TRÊS PASSOS,5713,8297,2030,17403,15373,352,1011
RS,89435,TRIUNFO,5263,10016,4016,21205,17189,645,1265
RS,89443,SANTA MARGARIDA DO SUL,802,1064,520,2530,2010,54,90
RS,89451,TUCUNDUVA,1142,2570,695,4691,3996,73,211
RS,89460,SÃO JOSÉ DO SUL,340,1108,168,1805,1637,60,129
RS,89478,TUPANCIRETÃ,5552,6314,3028,15941,12913,389,658
RS,89486,SÃO PEDRO DAS MISSÕES,639,549,232,1516,1284,31,65
RS,89494,TUPARENDI,1589,4005,1044,7058,6014,149,271
RS,89508,TIO HUGO,679,1188,288,2323,2035,65,103
RS,89516,URUGUAIANA,18684,40426,25230,88634,63404,1574,2720
RS,89524,WESTFALIA,523,1520,323,2548,2225,60,122
RS,89532,VACARIA,8247,25243,10160,46843,36683,1312,1881
RS,89540,PINTO BANDEIRA,277,1548,342,2311,1969,45,99
RS,89559,VENÂNCIO AIRES,13231,26905,7061,51082,44021,1393,2492
RS,89567,PEDRAS ALTAS,912,478,430,1933,1503,31,82
RS,89575,VERA CRUZ,5683,8796,1087,16987,15900,467,954
RS,89591,VERANÓPOLIS,2091,12103,1579,17027,15448,464,790
RS,89613,VIADUTOS,1193,2156,481,4150,3669,111,209
RS,89630,VIAMÃO,46975,64617,22367,148594,126227,4991,9644
RS,89656,VICENTE DUTRA,1381,1540,514,3726,3212,102,189
RS,89672,PALMARES DO SUL,2692,4337,2505,10326,7821,251,541
RS,89699,VICTOR GRAEFF,583,1360,332,2433,2101,59,99
RS,89710,TAVARES,1395,1701,913,4428,3515,141,278
RS,89737,CAPÃO DO LEÃO,5953,6517,2097,16262,14165,593,1102
RS,89753,SALTO DO JACUÍ,3026,2939,1199,7759,6560,209,386
RS,89770,COTIPORÃ,493,2252,405,3404,2999,97,157
RS,98213,TEUTÔNIA,5657,12878,3224,23706,20482,515,1432
RS,98230,BOM PRINCÍPIO,1355,6741,1215,9887,8672,184,392
RS,98256,PAROBÉ,9058,20047,6552,38824,32272,784,2383
RS,98272,FORTALEZA DOS VALOS,1163,1744,417,3542,3125,88,130
RS,98299,JÓIA,2809,2060,832,6051,5219,132,218
SC,80004,MONTE CARLO,2522,2639,1652,7325,5673,169,343
SC,80012,ABELARDO LUZ,4121,5023,3351,13074,9723,204,375
SC,80020,IPORÃ DO OESTE,1841,3692,1080,7033,5953,120,300
SC,80039,AGROLÂNDIA,1151,5056,1221,7827,6606,92,307
SC,80047,LINDÓIA DO SUL,1026,1753,652,3673,3021,55,187
SC,80055,AGRONÔMICA,430,2928,574,4157,3583,53,172
SC,80063,APIÚNA,1118,5028,1500,8077,6577,122,309
SC,80071,ÁGUA DOCE,1158,2921,1125,5444,4319,86,154
SC,80080,DOUTOR PEDRINHO,317,1998,504,2959,2455,31,109
SC,80098,ÁGUAS DE CHAPECÓ,2061,1559,891,4770,3879,65,194
SC,80101,JOSÉ BOITEUX,986,2080,832,4090,3258,51,141
SC,80110,ÁGUAS MORNAS,906,3608,604,5691,5087,139,434
SC,80128,VITOR MEIRELES,985,2181,958,4338,3380,80,134
SC,80136,ALFREDO WAGNER,1479,4600,615,7143,6528,138,311
SC,80144,UNIÃO DO OESTE,792,1183,409,2512,2103,43,85
SC,80152,ANCHIETA,1801,2027,611,4691,4080,83,169
SC,80160,URUPEMA,624,1062,445,2282,1837,52,99
SC,80179,ANGELINA,1466,2473,520,4843,4323,110,274
SC,80187,IRACEMINHA,857,1970,592,3631,3039,74,138
SC,80195,ANITA GARIBALDI,2473,2584,1975,7549,5574,194,323
SC,80209,TIMBÓ GRANDE,1958,1846,1344,5597,4253,150,299
SC,80217,ANITÁPOLIS,620,1617,446,2933,2487,67,183
SC,80225,ABDON BATISTA,687,1151,368,2322,1954,39,77
SC,80233,ANTÔNIO CARLOS,833,5611,760,7606,6846,105,297
SC,80241,SANTA ROSA DO SUL,1212,4171,1322,7120,5798,117,298
SC,80250,ARAQUARI,3277,10771,4603,19756,15153,319,786
SC,80268,CELSO RAMOS,855,1041,414,2453,2039,54,89
SC,80276,ARARANGUÁ,8171,28744,10323,49845,39522,806,1801
SC,80284,SERRA ALTA,806,1353,430,2760,2330,57,114
SC,80292,ARMAZÉM,875,4299,917,6345,5428,61,193
SC,80306,COCAL DO SUL,1594,8892,2483,13763,11280,199,595
SC,80314,ARROIO TRINTA,546,1837,520,3090,2570,35,152
SC,80322,NOVA ITABERABA,1619,1539,593,3941,3348,73,117
SC,80330,ASCURRA,506,4257,1135,6273,5138,115,260
SC,80349,SANTA TEREZINHA,1445,3643,1110,6519,5409,109,212
SC,80357,ATALANTA,379,1934,416,2871,2455,33,109
SC,80365,MIRIM DOCE,456,1387,394,2354,1960,30,87
SC,80373,AURORA,693,3374,544,4836,4292,68,157
SC,80381,CERRO NEGRO,1465,832,618,3097,2479,60,122
SC,80390,BALNEÁRIO CAMBORIÚ,11902,54202,12151,82672,70521,1488,2929
SC,80403,PASSO DE TORRES,1217,3151,1261,6019,4758,128,262
SC,80411,BARRA VELHA,2909,13122,5759,23003,17244,398,815
SC,80420,BRAÇO DO TROMBUDO,303,2166,228,2846,2618,37,112
SC,80438,BENEDITO NOVO,736,5685,1338,8223,6885,119,345
SC,80446,SUL BRASIL,949,985,309,2368,2059,49,76
SC,80454,BIGUAÇU,9277,28061,7379,48445,41066,994,2734
SC,80462,VARGEM,944,906,696,2668,1972,49,73
SC,80470,BLUMENAU,31090,162622,33870,244336,210466,4086,12668
SC,80489,ARABUTÃ,967,1943,600,3754,3154,47,197
SC,80497,BOM RETIRO,1518,3216,835,5999,5164,119,311
SC,80500,ÁGUAS FRIAS,891,1031,287,2342,2055,42,91
SC,80519,BOTUVERÁ,449,3087,301,4101,3800,78,186
SC,80527,GUATAMBÚ,2317,1959,776,5308,4532,71,185
SC,80535,BRAÇO DO NORTE,2413,16337,3893,23680,19787,286,751
SC,80543,PLANALTO ALEGRE,1198,985,466,2793,2327,38,106
SC,80551,BRUSQUE,9095,59820,7696,81357,73661,1324,3422
SC,80560,RIQUEZA,1309,1715,756,3999,3243,51,168
SC,80578,CAÇADOR,12277,24760,11533,52235,40702,1239,2426
SC,80586,LAJEADO GRANDE,377,757,118,1302,1184,15,35
SC,80594,CAIBI,1163,2607,867,4891,4024,64,190
SC,80608,RIO RUFINO,605,1060,509,2331,1822,44,113
SC,80616,CAMBORIÚ,8233,29889,6441,47655,41214,933,2159
SC,80624,PASSOS MAIA,1382,1185,475,3176,2701,39,95
SC,80632,CAMPO ALEGRE,1048,6146,1656,9388,7732,160,378
SC,80640,SÃO JOÃO DO OESTE,857,3193,776,5147,4371,95,226
SC,80659,CAMPO BELO DO SUL,1989,2435,1138,5951,4813,121,268
SC,80667,CALMON,1307,747,999,3175,2176,49,73
SC,80675,CAMPO ERÊ,2871,2420,975,6610,5635,115,229
SC,80683,BALNEÁRIO BARRA DO SUL,1488,5164,2443,9529,7086,106,328
SC,80691,CAMPOS NOVOS,5899,13034,5598,25962,20364,496,935
SC,80705,PARAÍSO,1245,1500,788,3718,2930,63,122
SC,80713,CANELINHA,1133,5434,1762,8829,7067,142,358
SC,80721,SANTA HELENA,759,935,387,2238,1851,47,110
SC,80730,CANOINHAS,7699,23636,8575,42096,33521,916,1270
SC,80748,BELMONTE,792,1049,484,2430,1946,28,77
SC,80756,CAPINZAL,3825,8851,2898,16785,13887,307,904
SC,80764,NOVO HORIZONTE,807,995,264,2183,1919,28,89
SC,80772,CATANDUVAS,1992,3945,1236,7530,6294,96,261
SC,80780,SÃO MIGUEL DA BOA VISTA,663,610,309,1654,1345,20,52
SC,80799,CAXAMBU DO SUL,1810,1645,720,4335,3615,59,101
SC,80802,ARVOREDO,786,1044,344,2278,1934,33,71
SC,80810,CHAPECÓ,40310,73156,25686,146979,121293,2564,5263
SC,80829,IPUAÇU,2621,1265,912,5054,4142,61,195
SC,80837,CONCÓRDIA,10815,33063,10310,57371,47061,938,2245
SC,80845,OURO VERDE,562,925,451,2037,1586,34,65
SC,80853,CORONEL FREITAS,2483,3824,1268,8089,6821,168,346
SC,80861,IRATI,757,749,344,1943,1599,30,63
SC,80870,CORUPÁ,1454,7716,934,10886,9952,181,601
SC,80888,FORMOSA DO SUL,991,862,347,2299,1952,38,61
SC,80896,CRICIÚMA,19694,89133,28622,145629,117007,2542,5638
SC,80900,MACIEIRA,546,767,383,1803,1420,35,72
SC,80918,CUNHA PORÃ,1177,5790,762,8187,7425,132,326
SC,80926,PONTE ALTA DO NORTE,767,1117,633,2677,2044,37,123
SC,80934,CURITIBANOS,6912,14273,7422,30665,23243,698,1360
SC,80942,SÃO CRISTÓVÃO DO SUL,881,1526,871,3494,2623,68,148
SC,80950,DESCANSO,2077,3389,1115,6954,5839,113,260
SC,80969,VARGEM BONITA,1083,2003,826,4115,3289,57,146
SC,80977,DIONÍSIO CERQUEIRA,3745,4399,3225,11821,8596,140,312
SC,80985,BOMBINHAS,1974,8189,2984,13964,10980,226,591
SC,80993,DONA EMMA,639,1718,531,3117,2586,61,168
SC,81000,SANGÃO,955,5487,1497,8325,6828,103,283
SC,81019,ERVAL VELHO,777,2316,603,3862,3259,48,118
SC,81027,CAPIVARI DE BAIXO,3300,9604,3123,17084,13961,255,802
SC,81035,FAXINAL DOS GUEDES,3366,3212,1454,8534,7080,132,370
SC,81043,CORDILHEIRA ALTA,1120,1980,567,3865,3298,60,138
SC,81051,FLORIANÓPOLIS,92063,169952,58314,345512,287198,6786,18397
SC,81060,FORQUILHINHA,2743,12367,3025,19127,16102,273,719
SC,81078,FRAIBURGO,6329,13838,6078,28113,22035,538,1330
SC,81086,MORRO GRANDE,316,2018,494,2969,2475,44,97
SC,81094,GALVÃO,990,1161,271,2597,2326,59,116
SC,81108,CORONEL MARTINS,802,790,176,1860,1684,33,59
SC,81116,GOVERNADOR CELSO RAMOS,1568,9103,1905,13439,11534,201,662
SC,81124,SÃO JOÃO DO ITAPERIÚ,357,2309,708,3544,2836,41,129
SC,81132,GAROPABA,3973,9143,3499,17884,14385,379,890
SC,81140,JARDINÓPOLIS,526,727,210,1566,1356,42,61
SC,81159,GARUVA,1834,6449,1321,10272,8951,186,482
SC,81167,ERMO,322,1338,154,1920,1766,30,76
SC,81175,GASPAR,6259,29511,7847,46241,38394,813,1811
SC,81183,SÃO PEDRO DE ALCÂNTARA,528,2561,478,3818,3340,56,195
SC,81191,GRÃO-PARÁ,709,3723,840,5631,4791,87,272
SC,81205,SANTIAGO DO SUL,620,560,130,1384,1254,9,65
SC,81213,GRAVATAL,1128,5801,1459,8748,7289,99,261
SC,81221,BELA VISTA DO TOLDO,1324,2508,803,4917,4114,126,156
SC,81230,GUABIRUBA,1610,11000,974,14486,13512,275,627
SC,81248,CAPÃO ALTO,680,1427,628,2904,2276,60,109
SC,81256,GUARACIABA,2728,4207,1467,8860,7393,122,336
SC,81264,PAINEL,746,1033,547,2431,1884,44,61
SC,81272,GUARAMIRIM,4341,18653,5400,29927,24527,429,1104
SC,81280,BOCAINA DO SUL,881,1484,516,3044,2528,43,120
SC,81299,GUARUJÁ DO SUL,1100,1960,778,4052,3274,62,152
SC,81302,ALTO BELA VISTA,445,1063,346,1955,1609,21,80
SC,81310,HERVAL D OESTE,3276,9201,3153,16500,13347,266,604
SC,81329,FREI ROGÉRIO,644,1041,446,2270,1824,36,103
SC,81337,IBICARÉ,534,1823,525,3015,2490,23,110
SC,81345,TREVISO,502,2680,701,4075,3374,49,143
SC,81353,IBIRAMA,1835,8815,3284,14787,11503,182,671
SC,81361,IOMERÊ,450,1742,442,2760,2318,42,84
SC,81370,IÇARA,5363,25561,7185,40152,32967,606,1437
SC,81388,BOM JESUS,899,953,449,2394,1945,30,63
SC,81396,ILHOTA,1301,6950,1998,10872,8874,186,437
SC,81400,IBIAM,476,916,199,1670,1471,23,56
SC,81418,IMARUÍ,2386,4288,1390,8788,7398,160,564
SC,81426,ENTRE RIOS,1564,562,613,2865,2252,40,86
SC,81434,IMBITUBA,7633,17413,8810,36319,27509,607,1856
SC,81442,PAIAL,694,692,390,1843,1453,24,43
SC,81450,IMBUIA,891,2923,551,4733,4182,119,249
SC,81469,BOM JESUS DO OESTE,551,941,293,1908,1615,37,86
SC,81477,INDAIAL,4635,29606,8368,45176,36808,603,1964
SC,81485,SÃO BERNARDINO,1043,788,396,2353,1957,43,83
SC,81493,IPIRA,1094,1767,612,3680,3068,53,154
SC,81507,SANTA TEREZINHA DO PROGRESSO,1066,717,465,2381,1916,55,78
SC,81515,IPUMIRIM,1955,2673,876,5832,4956,76,252
SC,81523,SALTINHO,1497,890,680,3261,2581,77,117
SC,81531,IRANI,2139,3387,1282,7307,6025,178,321
SC,81540,JUPIÁ,739,874,131,1850,1719,27,79
SC,81558,IRINEÓPOLIS,2149,3861,1463,7924,6461,127,324
SC,81566,PALMEIRA,590,1437,596,2798,2202,51,124
SC,81574,ITÁ,1939,2437,1206,5915,4709,73,260
SC,81582,BANDEIRANTE,1000,1117,558,2782,2224,29,78
SC,81590,ITAIÓPOLIS,2749,9357,3302,16589,13287,391,790
SC,81604,FLOR DO SERTÃO,652,604,337,1681,1344,27,61
SC,81612,ITAJAÍ,20584,89866,14076,133893,119817,2588,6779
SC,81620,CUNHATAÍ,530,874,198,1715,1517,38,75
SC,81639,ITAPEMA,5244,25591,8638,41564,32926,652,1439
SC,81647,PRINCESA,744,1221,466,2553,2087,42,80
SC,81655,ITAPIRANGA,2624,6907,2021,12241,10220,177,512
SC,81663,ITAPOÁ,2225,7459,2522,13102,10580,277,619
SC,81671,ITUPORANGA,2340,12231,2839,18303,15464,229,664
SC,81680,TIGRINHOS,690,782,355,1929,1574,39,63
SC,81698,JABORÁ,745,2198,557,3685,3128,51,134
SC,81701,CHAPADÃO DO LAGEADO,612,1375,296,2398,2102,24,91
SC,81710,JACINTO MACHADO,1336,5613,1657,9112,7455,186,320
SC,81728,BALNEÁRIO ARROIO DO SILVA,1979,5177,2779,10456,7677,136,385
SC,81736,JAGUARUNA,2115,8771,2787,14417,11630,241,503
SC,81744,BALNEÁRIO GAIVOTA,1590,4422,2171,8620,6449,103,334
SC,81752,JARAGUÁ DO SUL,15558,77241,10310,109593,99283,1801,4683
SC,81760,BARRA BONITA,615,776,391,1898,1507,28,88
SC,81779,JOAÇABA,3570,13168,4232,22076,17844,320,786
SC,81787,BRUNÓPOLIS,938,1165,561,2809,2248,57,88
SC,81795,JOINVILLE,53088,262556,54995,397159,342164,6683,19837
SC,81809,LUZERNA,630,3367,691,4903,4212,61,154
SC,81817,LACERDÓPOLIS,322,1240,319,2013,1694,34,98
SC,81825,ZORTÉA,727,1368,369,2672,2303,47,161
SC,81833,LAGES,23459,66171,25454,123520,98066,2804,5632
SC,81850,LAGUNA,7011,18029,7590,34796,27206,555,1611
SC,81876,LAURENTINO,744,3812,781,5622,4841,81,204
SC,81892,LAURO MÜLLER,1760,7493,2191,12288,10097,186,658
SC,81914,LEBON RÉGIS,3516,2656,2204,9040,6836,220,444
SC,81930,LEOBERTO LEAL,661,1690,454,3002,2548,67,130
SC,81957,LONTRAS,1067,5331,1540,8401,6861,139,324
SC,81973,LUIZ ALVES,924,6275,1229,8817,7588,107,282
SC,81990,MAFRA,6104,25692,4023,38752,34729,1017,1916
SC,82015,MAJOR GERCINO,563,1733,582,3053,2471,47,128
SC,82031,MAJOR VIEIRA,1537,2812,1037,5749,4712,106,257
SC,82058,MARAVILHA,4154,10625,3541,19362,15821,313,729
SC,82066,MAREMA,650,982,148,1854,1706,19,55
SC,82074,MASSARANDUBA,1321,8665,1953,12511,10558,154,418
SC,82090,MATOS COSTA,880,751,665,2405,1740,31,78
SC,82112,MELEIRO,686,4077,916,5912,4996,77,156
SC,82139,MODELO,1007,1617,509,3331,2822,57,141
SC,82155,MONDAÍ,2205,3534,1412,7604,6192,85,368
SC,82171,MONTE CASTELO,1810,3140,1511,6901,5390,164,276
SC,82198,MORRO DA FUMAÇA,1410,9012,2041,13087,11046,187,437
SC,82210,NAVEGANTES,7774,28223,10745,49657,38912,873,2042
SC,82236,NOVA ERECHIM,1201,1841,539,3813,3274,65,167
SC,82252,NOVA TRENTO,1069,7232,1383,10322,8939,189,449
SC,82279,NOVA VENEZA,1482,7975,1841,11874,10033,152,424
SC,82295,ORLEANS,1972,12589,3367,18912,15545,300,684
SC,82317,OURO,1154,3340,976,5867,4891,98,299
SC,82333,PALHOÇA,22914,71369,19192,123008,103816,2600,6933
SC,82350,PALMA SOLA,2273,1813,1360,5730,4370,94,190
SC,82376,PALMITOS,2901,6582,1741,11872,10131,190,458
SC,82392,PAPANDUVA,4042,6961,1388,13337,11949,306,640
SC,82414,PAULO LOPES,1221,3535,789,5968,5179,129,294
SC,82430,PEDRAS GRANDES,374,2685,676,3916,3240,60,121
SC,82457,PENHA,2280,11931,2276,17557,15281,319,751
SC,82473,PERITIBA,568,1623,449,2808,2359,52,116
SC,82490,PETROLÂNDIA,762,3466,678,5189,4511,82,201
SC,82511,BALNEÁRIO PIÇARRAS,2029,8993,1912,13720,11808,248,538
SC,82538,PINHALZINHO,4312,6942,1654,13785,12131,250,627
SC,82554,PINHEIRO PRETO,668,1429,356,2629,2273,49,127
SC,82570,PIRATUBA,1061,2740,624,4675,4051,73,177
SC,82597,POMERODE,2448,16620,3968,24309,20341,302,971
SC,82619,PONTE ALTA,1153,1779,923,4065,3142,76,134
SC,82635,PONTE SERRADA,2978,2976,1112,7599,6487,155,378
SC,82651,PORTO BELO,1794,8176,3038,13703,10665,214,481
SC,82678,PORTO UNIÃO,4641,13798,6062,25965,19903,531,933
SC,82694,POUSO REDONDO,1556,7168,2120,11381,9261,164,373
SC,82716,PRAIA GRANDE,1648,2890,1105,6098,4993,149,306
SC,82732,PRESIDENTE CASTELLO BRANCO,260,1049,205,1579,1374,16,49
SC,82759,PRESIDENTE GETÚLIO,1614,8350,2235,12915,10680,159,557
SC,82775,PRESIDENTE NEREU,339,1252,463,2177,1714,36,87
SC,82791,QUILOMBO,3204,3337,905,7863,6958,148,269
SC,82813,RANCHO QUEIMADO,475,1775,382,2805,2423,57,116
SC,82830,RIO DAS ANTAS,957,2930,1217,5385,4168,97,184
SC,82856,RIO DO CAMPO,906,3207,769,5115,4346,65,168
SC,82872,RIO DO OESTE,1129,3568,834,5843,5009,97,215
SC,82899,RIO DOS CEDROS,848,5681,1389,8382,6993,107,357
SC,82910,RIO DO SUL,6311,30687,9529,49225,39696,787,1911
SC,82937,RIO FORTUNA,380,3283,462,4323,3861,48,150
SC,82953,RIO NEGRINHO,3950,19056,6726,31504,24778,490,1282
SC,82970,RODEIO,891,6390,1488,9237,7749,137,331
SC,82996,ROMELÂNDIA,1386,1611,383,3649,3266,83,186
SC,83011,SALETE,966,3634,1045,6006,4961,90,271
SC,83038,SALTO VELOSO,765,1874,638,3560,2922,66,217
SC,83054,SANTA CECÍLIA,3233,5461,3508,13082,9574,367,513
SC,83070,SANTA ROSA DE LIMA,391,1156,290,1949,1659,30,82
SC,83097,SANTO AMARO DA IMPERATRIZ,3345,10643,2137,17619,15482,363,1131
SC,83119,SÃO BENTO DO SUL,7048,40247,10250,61046,50796,1016,2485
SC,83135,SÃO BONIFÁCIO,332,1833,326,2654,2328,50,113
SC,83151,SÃO CARLOS,2443,4026,1321,8232,6911,114,328
SC,83178,SÃO DOMINGOS,2474,3339,756,6930,6174,112,249
SC,83194,SÃO FRANCISCO DO SUL,5555,20054,8995,36817,27822,584,1629
SC,83216,SÃO JOÃO BATISTA,2090,14229,3905,21333,17428,293,816
SC,83232,SÃO JOÃO DO SUL,1051,3767,1020,6269,5249,156,275
SC,83259,SÃO JOAQUIM,4571,9052,4155,19236,15081,465,993
SC,83275,SÃO JOSÉ,34859,95393,24834,167380,142546,3424,8870
SC,83291,SÃO JOSÉ DO CEDRO,2464,6222,2164,11410,9246,174,386
SC,83313,SÃO JOSÉ DO CERRITO,2903,2441,1298,7031,5733,150,239
SC,83330,SÃO LOURENÇO DO OESTE,4800,8899,3583,18396,14813,344,770
SC,83356,SÃO LUDGERO,940,6161,1262,8774,7512,127,284
SC,83372,SÃO MARTINHO,332,2355,406,3220,2814,36,91
SC,83399,SÃO MIGUEL DO OESTE,7091,15470,6284,30354,24070,416,1093
SC,83410,SAUDADES,2276,3832,829,7350,6521,116,297
SC,83437,SCHROEDER,1777,8937,2022,13410,11388,173,501
SC,83453,SEARA,4122,6454,2666,14225,11559,254,729
SC,83470,SIDERÓPOLIS,1536,6691,2153,10960,8807,176,404
SC,83496,SOMBRIO,3544,12546,4574,21841,17267,332,845
SC,83518,TAIÓ,1752,9199,2331,13940,11609,190,468
SC,83534,TANGARÁ,1301,3851,891,6410,5519,112,255
SC,83550,TIJUCAS,3770,16227,5676,27495,21819,483,1339
SC,83577,TIMBÓ,2615,22582,5251,32165,26914,409,1308
SC,83593,TRÊS BARRAS,3096,7237,3320,14514,11194,321,540
SC,83615,TREZE DE MAIO,543,4503,865,6184,5319,94,179
SC,83631,TREZE TÍLIAS,895,3657,948,5757,4809,71,186
SC,83658,TROMBUDO CENTRAL,681,3431,516,4876,4360,59,189
SC,83674,TUBARÃO,9784,49205,14921,78052,63131,1176,2966
SC,83682,TUNÁPOLIS,737,2398,495,3879,3384,82,167
SC,83690,TURVO,986,6763,822,9002,8180,130,301
SC,83712,URUBICI,1366,4473,2044,8279,6235,112,284
SC,83739,URUSSANGA,1707,11206,3633,17338,13705,181,611
SC,83755,VARGEÃO,1046,1190,284,2681,2397,36,125
SC,83771,VIDAL RAMOS,1089,3371,405,5154,4749,69,220
SC,83798,VIDEIRA,6117,21129,7847,37334,29487,664,1577
SC,83810,WITMARSUM,568,1924,554,3287,2733,56,185
SC,83836,XANXERÊ,10315,15782,6609,34504,27895,517,1281
SC,83852,XAVANTINA,1215,1666,519,3530,3011,49,81
SC,83879,XAXIM,5823,10995,3777,21717,17940,324,798
SC,83895,BOM JARDIM DA SERRA,1060,1549,798,3607,2809,55,145
SC,83909,BALNEÁRIO RINCÃO,1956,5842,2700,10991,8291,137,356
SC,83917,MARACAJÁ,1113,3728,943,6140,5197,106,250
SC,83925,PESCARIA BRAVA,1646,4051,636,6773,6137,107,333
SC,83933,TIMBÉ DO SUL,746,2730,846,4577,3731,80,175
SC,83950,CORREIA PINTO,3433,5419,2103,11691,9588,270,466
SC,83976,OTACÍLIO COSTA,2480,7238,2499,12940,10441,189,534
SE,31003,SANTANA DO SÃO FRANCISCO,3026,912,1107,5473,4366,59,369
SE,31011,AMPARO DE SÃO FRANCISCO,1282,447,685,2579,1894,23,142
SE,31038,AQUIDABÃ,8619,2193,3639,15641,12002,151,1039
SE,31054,ARACAJU,155892,139603,74818,407184,332366,6303,30568
SE,31070,ARAUÁ,5115,1256,1989,9077,7088,96,621
SE,31097,AREIA BRANCA,6638,2678,2443,13162,10719,207,1196
SE,31119,BARRA DOS COQUEIROS,8149,5914,5269,21104,15835,289,1483
SE,31135,BREJO GRANDE,3536,797,1608,6358,4750,67,350
SE,31151,BOQUIM,10488,3847,4591,20706,16115,260,1520
SE,31194,CAMPO DO BRITO,7539,2211,2974,13988,11014,181,1083
SE,31216,CANHOBA,2565,500,903,4231,3328,31,232
SE,31232,CANINDÉ DE SÃO FRANCISCO,12679,2788,5773,22779,17006,176,1363
SE,31259,CAPELA,11271,4454,5936,24305,18369,413,2231
SE,31275,CARIRA,9381,2225,3495,16403,12908,150,1152
SE,31291,CARMÓPOLIS,5601,3028,3217,13199,9982,176,1177
SE,31313,CEDRO DE SÃO JOÃO,2530,985,1075,4908,3833,39,279
SE,31330,CRISTINÁPOLIS,7394,1488,3305,12962,9657,118,657
SE,31356,NOSSA SENHORA APARECIDA,3689,1502,1203,6985,5782,128,463
SE,31372,CUMBE,1908,840,769,3854,3085,47,290
SE,31399,DIVINA PASTORA,2125,510,798,3682,2884,35,214
SE,31410,ESTÂNCIA,24515,8590,10080,47372,37292,637,3550
SE,31437,FEIRA NOVA,3222,792,1120,5500,4380,46,320
SE,31453,FREI PAULO,5505,3475,2131,12055,9924,148,796
SE,31470,GENERAL MAYNARD,1402,490,486,2612,2126,31,203
SE,31496,GARARU,5632,839,1696,8769,7073,93,509
SE,31518,GRACCHO CARDOSO,3465,683,1107,5582,4475,58,269
SE,31534,ILHA DAS FLORES,3539,990,2015,7056,5041,78,434
SE,31550,INDIAROBA,6795,1240,2957,11885,8928,101,792
SE,31577,ITABAIANA,31846,16608,11702,66807,55105,939,5712
SE,31593,ITABAIANINHA,14754,6270,5086,28549,23463,382,2057
SE,31615,ITABI,2332,800,947,4397,3450,49,269
SE,31631,ITAPORANGA D AJUDA,13186,4872,5366,25958,20592,323,2211
SE,31658,JAPARATUBA,7201,2508,3129,13911,10782,147,926
SE,31674,JAPOATÃ,6036,1315,2282,10385,8103,118,634
SE,31690,LAGARTO,38486,13887,12964,72288,59324,857,6094
SE,31712,LARANJEIRAS,10434,4663,4051,21345,17294,321,1876
SE,31739,MACAMBIRA,3124,1239,1122,6054,4932,77,492
SE,31755,MALHADA DOS BOIS,2165,509,869,3792,2923,31,218
SE,31771,MALHADOR,5417,1530,1573,9428,7855,112,796
SE,31798,MARUIM,6999,1860,2271,12223,9952,151,942
SE,31810,MOITA BONITA,4091,1906,1765,8967,7202,158,1047
SE,31836,MONTE ALEGRE DE SERGIPE,6231,1643,2310,10981,8671,141,656
SE,31852,MURIBECA,3511,1088,1575,6708,5133,77,457
SE,31879,NEÓPOLIS,7060,2159,3612,13990,10378,140,1019
SE,31895,NOSSA SENHORA DA GLÓRIA,16250,3622,4380,26027,21647,266,1509
SE,31917,NOSSA SENHORA DAS DORES,9763,4384,3726,19943,16217,398,1672
SE,31933,NOSSA SENHORA DE LOURDES,3478,704,1016,5539,4523,29,312
SE,31950,NOSSA SENHORA DO SOCORRO,42414,32091,17558,103235,85677,1692,9480
SE,31976,PACATUBA,5945,1247,3151,11144,7993,113,688
SE,31992,PEDRA MOLE,1442,792,579,3069,2490,32,224
SE,32018,PEDRINHAS,3733,1089,1842,7240,5398,61,515
SE,32034,PINHÃO,2691,792,1195,5164,3969,65,421
SE,32050,PIRAMBU,3827,1466,1891,7779,5888,92,503
SE,32077,POÇO REDONDO,11124,2853,4261,19785,15524,194,1353
SE,32093,POÇO VERDE,10479,2233,3997,18189,14192,233,1247
SE,32115,PORTO DA FOLHA,12453,2902,5035,22209,17174,324,1495
SE,32131,PROPRIÁ,9340,4715,3975,19494,15519,227,1237
SE,32158,RIACHÃO DO DANTAS,9942,1984,3212,16344,13132,179,1027
SE,32174,RIACHUELO,4394,1219,1593,7801,6208,57,538
SE,32190,RIBEIRÓPOLIS,6578,3192,2636,13663,11027,183,1074
SE,32212,ROSÁRIO DO CATETE,4512,1283,1774,8298,6524,85,644
SE,32239,SALGADO,9100,2222,2585,15244,12659,181,1156
SE,32255,SANTA LUZIA DO ITANHY,5859,1143,2497,10420,7923,130,791
SE,32298,SANTA ROSA DE LIMA,2001,628,870,3837,2967,57,281
SE,32310,SANTO AMARO DAS BROTAS,5254,814,1955,8669,6714,74,572
SE,32336,SÃO CRISTÓVÃO,25032,14108,9358,54272,44914,866,4908
SE,32352,SÃO DOMINGOS,3451,1905,1785,7916,6131,97,678
SE,32379,SÃO FRANCISCO,1988,477,796,3495,2699,23,211
SE,32395,SÃO MIGUEL DO ALEIXO,2101,520,932,3824,2892,40,231
SE,32417,SIMÃO DIAS,19094,4971,6308,33887,27579,375,3139
SE,32433,SIRIRI,3508,1079,1206,6348,5142,87,468
SE,32450,TELHA,1720,726,591,3240,2649,32,171
SE,32476,TOBIAS BARRETO,21192,6832,7316,38244,30928,384,2520
SE,32492,TOMAR DO GERU,4859,1540,2488,9710,7222,110,713
SE,32514,UMBAÚBA,9162,3193,4116,17968,13852,237,1260
SP,61000,EUCLIDES DA CUNHA PAULISTA,2860,1660,2550,7626,5076,102,454
SP,61018,ADAMANTINA,3156,15088,7252,27703,20451,679,1528
SP,61026,BOREBI,495,1046,473,2206,1733,47,145
SP,61034,ADOLFO,661,2041,1156,4193,3037,62,273
SP,61042,TARUMÃ,2247,5665,2385,11184,8799,214,673
SP,61050,AGUAÍ,4335,10765,4691,22325,17634,610,1924
SP,61069,MOTUCA,981,1426,1025,3751,2726,56,263
SP,61077,ÁGUAS DA PRATA,997,3172,1676,6382,4706,138,399
SP,61085,IARAS,1383,1263,1422,4424,3002,81,275
SP,61093,ÁGUAS DE LINDÓIA,1712,8221,3352,14438,11086,273,880
SP,61107,GUATAPARÁ,1417,2197,1386,5497,4111,136,361
SP,61115,ÁGUAS DE SÃO PEDRO,560,2062,970,3784,2814,48,144
SP,61123,DIRCE REIS,465,618,423,1661,1238,38,117
SP,61131,AGUDOS,4571,15379,7152,29946,22794,777,2067
SP,61140,ESPÍRITO SANTO DO TURVO,796,1354,998,3439,2441,70,221
SP,61158,ALFREDO MARCONDES,853,1880,836,3866,3030,80,217
SP,61166,ROSANA,4417,4592,5683,15734,10051,236,806
SP,61174,ALTAIR,808,1269,871,3207,2336,62,197
SP,61182,EMBAÚBA,456,1195,521,2337,1816,48,117
SP,61190,ALTINÓPOLIS,2905,5115,1845,11232,9387,406,961
SP,61204,ILHA SOLTEIRA,4182,8755,6697,21368,14671,379,1355
SP,61212,ALTO ALEGRE,576,1932,923,3729,2806,88,210
SP,61220,ALUMÍNIO,3054,6530,3049,14127,11078,304,1190
SP,61239,ÁLVARES FLORENCE,637,2008,1067,4065,2998,75,278
SP,61247,PEDRINHAS PAULISTA,512,1475,685,2864,2179,37,155
SP,61255,ÁLVARES MACHADO,3640,8536,4292,18073,13781,414,1191
SP,61263,ARAÇARIGUAMA,3192,7212,4002,15827,11825,351,1070
SP,61271,ÁLVARO DE CARVALHO,703,1208,916,3145,2229,67,251
SP,61280,BERTIOGA,8884,18527,12088,42856,30768,752,2605
SP,61298,ALVINLÂNDIA,686,1118,734,2759,2025,51,170
SP,61301,SUZANÁPOLIS,834,1133,736,3002,2266,57,242
SP,61310,AMERICANA,27044,98605,34804,175261,140457,3442,11366
SP,61328,SANTO ANTÔNIO DO ARACANGUÁ,1594,3165,1266,6411,5145,64,322
SP,61336,AMÉRICO BRASILIENSE,7524,10503,6311,27488,21177,558,2592
SP,61344,CANITAR,859,1536,458,3279,2821,121,305
SP,61352,AMÉRICO DE CAMPOS,833,2630,945,4815,3870,95,312
SP,61360,BARRA DO CHAPÉU,1532,1383,1331,4770,3439,129,395
SP,61379,AMPARO,7048,29332,13071,54351,41280,1181,3719
SP,61387,EMILIANÓPOLIS,766,1090,657,2698,2041,56,129
SP,61395,ANALÂNDIA,556,2050,1412,4320,2908,83,219
SP,61409,NOVAIS,729,1749,786,3594,2808,48,282
SP,61417,ANDRADINA,8274,20882,11675,44350,32675,969,2550
SP,61425,NOVA CANAÃ PAULISTA,526,750,640,2110,1470,45,149
SP,61433,ANGATUBA,4055,7903,4109,17871,13762,423,1381
SP,61441,SALTINHO,539,4454,1084,6497,5413,124,296
SP,61450,ANHEMBI,884,2504,1885,5664,3779,93,298
SP,61468,UBARANA,1072,1857,1201,4485,3284,70,285
SP,61476,ANHUMAS,724,1687,728,3374,2646,45,190
SP,61484,CAJATI,3712,11259,6702,23517,16815,496,1348
SP,61492,APARECIDA,4553,16138,6128,29063,22935,694,1550
SP,61506,CAMPINA DO MONTE ALEGRE,982,2264,1035,4724,3689,91,352
SP,61514,APARECIDA D OESTE,1090,1547,1077,4021,2944,54,253
SP,61522,ASPÁSIA,455,818,454,1861,1407,22,112
SP,61530,APIAÍ,5069,7214,5992,20362,14370,466,1621
SP,61549,VARGEM,872,3589,1717,6869,5152,147,544
SP,61557,ARAÇATUBA,20424,80353,33806,144311,110505,2520,7208
SP,61565,POTIM,2169,6404,2712,12279,9567,285,709
SP,61573,ARAÇOIABA DA SERRA,3881,13130,3057,22606,19549,623,1915
SP,61581,ALAMBARI,747,2432,1105,4654,3549,95,275
SP,61590,ARAMINA,1164,1834,1207,4595,3388,70,320
SP,61603,ITAOCA,910,888,1025,3099,2074,66,210
SP,61611,ARANDU,1206,2679,1358,5872,4514,175,454
SP,61620,TUIUTI,703,2971,1250,5401,4151,91,386
SP,61638,ARARAQUARA,40311,70340,39811,166760,126949,3554,12744
SP,61646,ARAPEÍ,624,950,712,2544,1832,40,218
SP,61654,ARARAS,13466,54587,19744,97341,77597,2564,6980
SP,61662,ESTIVA GERBI,1395,4662,1738,8628,6890,180,653
SP,61670,AREALVA,1063,3277,1500,6369,4869,148,381
SP,61689,ENGENHEIRO COELHO,2810,7049,3267,14163,10896,238,799
SP,61697,AREIAS,1128,963,503,2932,2429,72,266
SP,61700,RIBEIRÃO GRANDE,1898,2545,1550,6734,5184,236,505
SP,61719,AREIÓPOLIS,1861,3791,1914,8485,6571,223,696
SP,61727,HORTOLÂNDIA,35843,68606,30342,149073,118731,2908,11374
SP,61735,ARIRANHA,1207,3668,1682,7253,5571,141,555
SP,61743,HOLAMBRA,1695,5866,2001,10547,8546,255,730
SP,61751,ARTUR NOGUEIRA,6342,18341,6624,34844,28220,814,2723
SP,61760,ELISIÁRIO,444,1593,381,2679,2298,45,216
SP,61778,ARUJÁ,13943,31746,14049,66575,52526,1464,5373
SP,61786,BOM SUCESSO DE ITARARÉ,1095,1090,817,3225,2408,52,171
SP,61794,ASSIS,12785,35336,18240,71594,53354,1428,3805
SP,61808,PONTALINDA,889,1210,915,3310,2395,56,240
SP,61816,ATIBAIA,15439,56292,25151,107040,81889,2495,7663
SP,61824,PARISI,411,1295,542,2433,1891,37,148
SP,61832,AURIFLAMA,2255,5561,1781,10449,8668,206,646
SP,61840,TAQUARIVAÍ,980,2255,1195,4874,3679,118,326
SP,61859,AVAÍ,1120,1571,1142,4184,3042,73,278
SP,61867,MARAPOAMA,274,1587,579,2653,2074,38,175
SP,61875,AVANHANDAVA,1855,3257,2000,7867,5867,186,569
SP,61883,SÃO JOÃO DE IRACEMA,534,572,277,1523,1246,22,118
SP,61891,AVARÉ,9550,32653,16512,65039,48527,1616,4708
SP,61905,SÃO LOURENÇO DA SERRA,2828,4808,2926,11935,9009,336,1037
SP,61913,BADY BASSITT,1762,6953,2797,12484,9687,209,763
SP,61921,ZACARIAS,457,1132,647,2451,1804,31,184
SP,61930,BALBINOS,227,719,426,1485,1059,33,80
SP,61948,ITAPIRAPUÃ PAULISTA,999,1128,826,3278,2452,101,224
SP,61956,BÁLSAMO,955,4204,1428,7189,5761,163,439
SP,61964,MESÓPOLIS,447,713,457,1763,1306,42,104
SP,61972,BANANAL,2428,3078,2351,8883,6532,178,848
SP,61980,NOVA CAMPINA,1960,2877,1795,7107,5312,99,376
SP,61999,BARBOSA,1149,2178,1568,5358,3790,89,374
SP,62006,ILHA COMPRIDA,1998,4586,3771,11220,7449,186,679
SP,62014,BARÃO DE ANTONINA,736,1018,696,2725,2029,74,201
SP,62022,LOURDES,428,904,502,1966,1464,28,104
SP,62030,BARIRI,2855,13538,6663,25310,18647,665,1589
SP,62049,TORRE DE PEDRA,359,1230,790,2595,1805,38,178
SP,62057,BARRA BONITA,4666,15951,6976,30287,23311,654,2040
SP,62065,ARCO-ÍRIS,421,987,553,2116,1563,30,125
SP,62073,BARRA DO TURVO,1802,1846,2960,7059,4099,88,363
SP,62081,BREJO ALEGRE,883,899,633,2658,2025,56,187
SP,62090,BARRETOS,14354,40754,24812,86762,61950,1853,4989
SP,62103,CANAS,698,1927,830,3870,3040,104,311
SP,62111,BARRINHA,6025,9469,5403,23041,17638,512,1632
SP,62120,PRACINHA,325,578,206,1228,1022,31,88
SP,62138,BARUERI,64279,109197,51895,252194,200299,5493,21330
SP,62146,PRATÂNIA,989,1903,1203,4505,3302,124,286
SP,62154,BASTOS,1970,9951,4308,17586,13278,432,925
SP,62162,QUADRA,503,1506,842,3109,2267,69,189
SP,62170,BATATAIS,8366,20371,10726,43533,32807,1047,3023
SP,62189,SANTA CRUZ DA ESPERANÇA,375,941,603,2123,1520,25,179
SP,62197,BAURU,49704,133954,60553,269104,208551,6810,18083
SP,62200,SANTA SALETE,307,980,392,1798,1406,26,93
SP,62219,BEBEDOURO,7831,30396,15337,58078,42741,1244,3270
SP,62227,VITÓRIA BRASIL,405,753,315,1600,1285,36,91
SP,62235,BENTO DE ABREU,426,1035,563,2186,1623,36,126
SP,62243,IPIGUÁ,632,2174,1092,4200,3108,81,221
SP,62251,BERNARDINO DE CAMPOS,1386,4140,2128,8412,6284,184,574
SP,62260,TAQUARAL,465,1032,571,2291,1720,53,170
SP,62278,BILAC,852,3764,1118,6166,5048,90,342
SP,62286,FERNÃO,256,777,395,1547,1152,24,95
SP,62294,BIRIGUI,10302,50564,17281,85321,68040,1703,5471
SP,62308,GAVIÃO PEIXOTO,1353,1381,946,4051,3105,95,276
SP,62316,BIRITIBA MIRIM,3818,11348,5323,23302,17979,796,2017
SP,62324,JUMIRIM,345,1242,583,2352,1769,41,141
SP,62332,BOA ESPERANÇA DO SUL,3013,3573,2466,10163,7697,237,874
SP,62340,NANTES,668,924,584,2330,1746,41,113
SP,62359,BOCAINA,1134,4892,2006,8960,6954,235,693
SP,62367,NOVA CASTILHO,206,641,226,1155,929,18,64
SP,62375,BOFETE,1338,3568,2392,8010,5618,163,549
SP,62383,OUROESTE,1812,3122,1186,6775,5589,99,556
SP,62391,BOITUVA,6524,21746,9372,41653,32281,849,3162
SP,62405,PAULISTÂNIA,281,917,491,1837,1346,39,109
SP,62413,BOM JESUS DOS PERDÕES,2769,8597,3637,16602,12965,351,1248
SP,62421,RIBEIRÃO DOS ÍNDIOS,590,676,319,1800,1481,42,173
SP,62430,BORÁ,234,525,280,1122,842,21,62
SP,62448,TRABIJU,436,681,348,1618,1270,39,114
SP,62456,BORACÉIA,721,1860,798,3703,2905,91,233
SP,62472,BORBOREMA,1420,5904,2720,11031,8311,202,785
SP,62499,BOTUCATU,18725,52219,14338,96143,81805,2372,8489
SP,62510,BRAGANÇA PAULISTA,16995,67605,28485,125176,96691,3121,8970
SP,62553,BRAÚNA,677,2402,873,4220,3347,69,199
SP,62570,BRODOWSKI,2279,9157,3353,16171,12818,334,1048
SP,62596,BROTAS,2373,9364,5097,18314,13217,404,1076
SP,62618,BURI,2884,7390,3779,15330,11551,388,889
SP,62634,BURITAMA,2393,6252,3710,13388,9678,255,778
SP,62650,BURITIZAL,545,2047,802,3665,2863,52,219
SP,62677,CABRÁLIA PAULISTA,932,1376,591,3213,2622,86,228
SP,62693,CABREÚVA,5680,17136,7120,33369,26249,825,2608
SP,62715,CAÇAPAVA,9171,39663,15661,71300,55639,1775,5030
SP,62731,CACHOEIRA PAULISTA,4652,12126,6389,25347,18958,567,1613
SP,62758,CACONDE,3160,5956,4264,14625,10361,324,921
SP,62774,CAFELÂNDIA,2029,6467,3770,13379,9609,380,733
SP,62790,CAIABU,1105,1305,490,3219,2729,80,239
SP,62812,CAIEIRAS,16144,29988,13051,66640,53589,1542,5915
SP,62839,CAIUÁ,1320,1197,1155,3952,2797,42,238
SP,62855,CAJAMAR,15248,26934,13051,61970,48919,1463,5274
SP,62871,CAJOBI,1537,3847,2077,8077,6000,146,470
SP,62898,CAJURU,4320,7421,5498,19164,13666,410,1515
SP,62910,CAMPINAS,181841,401284,190196,849870,659674,17173,59376
SP,62936,CAMPO LIMPO PAULISTA,11705,28924,12900,59841,46941,1325,4987
SP,62952,CAMPOS DO JORDÃO,5455,18414,11254,39295,28041,1163,3009
SP,62979,CAMPOS NOVOS PAULISTA,789,1714,973,3762,2789,68,218
SP,62995,CANANÉIA,1944,4107,1613,8509,6896,212,633
SP,63010,CÂNDIDO MOTA,3708,12990,6085,24934,18849,570,1581
SP,63037,CÂNDIDO RODRIGUES,430,1227,637,2526,1889,66,166
SP,63053,CAPÃO BONITO,6044,17480,9322,36404,27082,1064,2494
SP,63070,CAPELA DO ALTO,1976,7699,2638,13689,11051,414,962
SP,63096,CAPIVARI,5228,20783,8154,37520,29366,802,2553
SP,63118,CARAGUATATUBA,17363,42855,23025,91720,68695,2104,6373
SP,63134,CARAPICUÍBA,80671,115383,62507,290947,228440,7050,25336
SP,63150,CARDOSO,2379,3859,3365,10455,7090,188,664
SP,63177,CASA BRANCA,2670,10147,6045,20738,14693,519,1357
SP,63193,CÁSSIA DOS COQUEIROS,602,1106,861,2899,2038,52,278
SP,63215,CASTILHO,4821,5005,3701,14649,10948,257,865
SP,63231,CATANDUVA,13376,49732,14522,85774,71252,1745,6399
SP,63258,CATIGUÁ,928,3140,1060,5767,4707,122,517
SP,63274,CEDRAL,991,3890,1452,6953,5501,158,462
SP,63290,CERQUEIRA CÉSAR,2572,7135,4117,15239,11122,426,989
SP,63312,CERQUILHO,4010,20269,7172,34573,27401,728,2394
SP,63339,CESÁRIO LANGE,1466,6939,2772,12713,9941,385,1151
SP,63355,CHARQUEADA,1865,7063,2744,12716,9972,253,791
SP,63371,CHAVANTES,1738,4551,974,8096,7122,196,637
SP,63398,CLEMENTINA,987,2859,1201,5486,4285,74,365
SP,63410,COLINA,3022,6144,4149,14810,10661,338,1157
SP,63436,COLÔMBIA,1480,2160,1885,6016,4131,85,406
SP,63452,CONCHAL,2627,12002,4142,20439,16297,475,1193
SP,63479,CONCHAS,1836,6887,4045,13777,9732,272,737
SP,63495,CORDEIRÓPOLIS,2904,10191,4027,18696,14669,378,1196
SP,63517,COROADOS,569,2369,898,4148,3250,77,235
SP,63533,CORONEL MACEDO,1344,1362,569,3678,3109,116,287
SP,63550,CORUMBATAÍ,414,1814,685,3199,2514,77,209
SP,63576,COSMÓPOLIS,9109,21333,11257,45868,34611,855,3314
SP,63592,COSMORAMA,1250,3250,1434,6382,4948,119,329
SP,63614,COTIA,43296,72473,33840,168069,134229,4296,14164
SP,63630,CRAVINHOS,3539,13546,6575,26201,19626,597,1944
SP,63657,CRISTAIS PAULISTA,1377,3576,1678,7232,5554,140,461
SP,63673,CRUZÁLIA,488,1081,421,2116,1695,40,86
SP,63690,CRUZEIRO,9254,30111,14013,59568,45555,1367,4823
SP,63711,CUBATÃO,25584,39026,22813,96216,73403,1831,6962
SP,63738,CUNHA,3725,7824,2622,16021,13399,494,1356
SP,63754,DESCALVADO,3129,13415,4409,23831,19422,753,2125
SP,63770,DIADEMA,108740,117805,68256,332905,264649,7187,30917
SP,63797,DIVINOLÂNDIA,1519,5084,1443,9292,7849,245,1001
SP,63819,DOBRADA,1868,2260,1299,6127,4828,141,559
SP,63835,DOIS CÓRREGOS,2654,9845,5149,19346,14197,544,1154
SP,63851,DOLCINÓPOLIS,831,677,578,2265,1687,25,154
SP,63878,DOURADO,1164,3406,1879,7376,5497,228,699
SP,63894,DRACENA,4710,19141,8763,35172,26409,712,1846
SP,63916,DUARTINA,1922,4879,2624,10317,7693,236,656
SP,63932,DUMONT,1088,3714,1434,6853,5419,143,474
SP,63959,ECHAPORÃ,1079,2431,1368,5283,3915,73,332
SP,63975,ELDORADO,3256,3890,3880,11900,8020,227,647
SP,63991,ELIAS FAUSTO,1950,6815,3164,13263,10099,305,1029
SP,64017,EMBU DAS ARTES,57509,68422,31206,181813,150607,4874,19802
SP,64033,EMBU-GUAÇU,12537,21334,13123,52966,39843,1319,4653
SP,64050,ESTRELA D OESTE,1095,3624,1737,7093,5356,155,482
SP,64076,ESTRELA DO NORTE,757,875,732,2598,1866,44,190
SP,64092,FARTURA,2741,5772,3466,13177,9711,346,852
SP,64114,FERNANDÓPOLIS,9414,24660,14123,52344,38221,1032,3115
SP,64130,FERNANDO PRESTES,671,2538,1309,4920,3611,97,305
SP,64157,FERRAZ DE VASCONCELOS,36186,48212,27578,126877,99299,2994,11907
SP,64173,FLORA RICA,483,603,537,1727,1190,22,82
SP,64190,FLOREAL,521,1230,467,2440,1973,49,173
SP,64211,FLÓRIDA PAULISTA,1626,3880,1966,8185,6219,180,533
SP,64238,FLORÍNEA,714,1048,716,2734,2018,54,202
SP,64254,FRANCA,41285,126487,50379,238481,188102,5575,14755
SP,64270,FRANCISCO MORATO,40445,39062,27065,121394,94329,3076,11746
SP,64297,FRANCO DA ROCHA,27499,38078,21628,99278,77650,2456,9617
SP,64319,GABRIEL MONTEIRO,314,1558,362,2436,2074,34,168
SP,64335,GÁLIA,1321,2157,1535,5482,3947,102,367
SP,64351,GARÇA,4647,18233,9249,35238,25989,944,2165
SP,64378,GASTÃO VIDIGAL,994,1005,485,2731,2246,58,189
SP,64394,GENERAL SALGADO,1581,4170,1552,7928,6376,162,463
SP,64416,GETULINA,1414,3456,2774,8339,5565,168,527
SP,64432,GLICÉRIO,956,1749,1064,4058,2994,56,233
SP,64459,GUAIÇARA,1471,4101,2356,8675,6319,202,545
SP,64475,GUAIMBÊ,1131,1843,1225,4657,3432,102,356
SP,64491,GUAÍRA,4898,13565,9342,30087,20745,644,1638
SP,64513,GUAPIAÇU,2774,7041,3189,14486,11297,362,1120
SP,64530,GUAPIARA,4528,4914,4333,15218,10885,345,1098
SP,64556,GUARÁ,3833,5779,2133,13117,10984,283,1089
SP,64572,GUARAÇAÍ,1200,3233,1801,6787,4986,125,428
SP,64599,GUARACI,2195,3183,2423,8417,5994,139,477
SP,64610,GUARANI D OESTE,459,582,212,1379,1167,21,105
SP,64637,GUARANTÃ,947,2472,1504,5320,3816,135,262
SP,64653,GUARARAPES,3443,12499,3414,21263,17849,492,1415
SP,64670,GUARAREMA,3891,12788,5093,24069,18976,577,1720
SP,64696,GUARATINGUETÁ,13689,50772,20463,92430,71967,2288,5218
SP,64718,GUAREÍ,1294,4601,1889,8872,6983,372,716
SP,64734,GUARIBA,6142,12825,7082,28765,21683,684,2032
SP,64750,GUARUJÁ,50938,104510,49458,226727,177269,4964,16857
SP,64777,GUARULHOS,203594,397523,103379,814491,711112,19508,90487
SP,64793,GUZOLÂNDIA,1073,1280,633,3347,2714,85,276
SP,64815,HERCULÂNDIA,1484,2976,1925,7112,5187,132,595
SP,64831,IACANGA,1183,4307,1814,7993,6179,204,485
SP,64858,IACRI,845,2579,1350,5232,3882,100,358
SP,64874,IBATÉ,5182,11452,5799,25001,19202,673,1895
SP,64890,IBIRÁ,1258,4842,2010,8819,6809,178,531
SP,64912,IBIRAREMA,820,2629,1048,4988,3940,159,332
SP,64939,IBITINGA,6888,22062,10296,43147,32851,1075,2826
SP,64955,IBIÚNA,8646,28966,14605,59169,44564,1732,5220
SP,64971,ICÉM,1506,2576,1825,6378,4553,92,379
SP,64998,IEPÊ,1389,3097,1410,6377,4967,92,389
SP,65013,IGARAÇU DO TIETÊ,3418,8735,4165,18710,14545,655,1737
SP,65030,IGARAPAVA,5004,8041,6876,21627,14751,453,1253
SP,65056,IGARATÁ,1344,4225,1894,8225,6331,143,619
SP,65072,IGUAPE,4452,9249,7588,23111,15523,433,1389
SP,65099,ILHABELA,5042,10815,6331,24312,17981,538,1586
SP,65110,INDAIATUBA,26816,88374,31803,161899,130096,3614,11292
SP,65137,INDIANA,715,2153,521,3717,3196,86,242
SP,65153,INDIAPORÃ,870,1194,380,2680,2300,45,191
SP,65170,INÚBIA PAULISTA,390,1823,404,2882,2478,56,209
SP,65196,IPAUSSU,1773,5575,2395,10735,8340,287,705
SP,65218,IPERÓ,4683,8473,4497,19859,15362,466,1740
SP,65234,IPEÚNA,744,2952,1155,5249,4094,78,320
SP,65250,IPORANGA,1195,813,1186,3495,2309,57,244
SP,65277,IPUÃ,3043,4408,2453,10779,8326,214,661
SP,65293,IRACEMÁPOLIS,2732,10139,3197,17432,14235,327,1037
SP,65315,IRAPUÃ,889,2891,1455,5725,4270,119,371
SP,65331,IRAPURU,1109,2364,1397,5278,3881,119,289
SP,65358,ITABERÁ,3802,6066,3022,14137,11115,381,866
SP,65374,ITAÍ,4583,6556,3993,16981,12988,505,1344
SP,65390,ITAJOBI,1372,7102,2681,12211,9530,279,777
SP,65412,ITAJU,523,1502,833,3103,2270,56,189
SP,65439,ITANHAÉM,14314,31784,23376,75728,52352,1505,4749
SP,65455,ITAPECERICA DA SERRA,35079,41677,25167,115963,90796,3041,10999
SP,65471,ITAPETININGA,15586,57906,24944,109033,84089,2786,7811
SP,65498,ITAPEVA,11919,34188,17094,69421,52327,1892,4328
SP,65510,ITAPEVI,43108,57076,32036,149949,117913,4188,13541
SP,65536,ITAPIRA,7478,30289,12597,55969,43372,1445,4160
SP,65552,ITÁPOLIS,4029,15842,8683,30968,22285,691,1723
SP,65579,ITAPORANGA,2300,5204,3037,11577,8540,300,736
SP,65595,ITAPUÍ,1491,4711,2137,9241,7104,255,647
SP,65617,ITAPURA,1578,782,1191,3852,2661,48,253
SP,65633,ITAQUAQUECETUBA,64242,90182,48401,232254,183853,6368,23061
SP,65650,ITARARÉ,5886,17141,10528,36620,26092,944,2121
SP,65676,ITARIRI,1705,3992,3151,9608,6457,170,590
SP,65692,ITATIBA,11253,44476,16922,79766,62844,1765,5350
SP,65714,ITATINGA,2481,6814,2253,13082,10829,352,1182
SP,65730,ITIRAPINA,1865,4739,2042,9537,7495,225,666
SP,65757,ITIRAPUÃ,1431,1845,1298,5028,3730,122,332
SP,65773,ITOBI,1425,2783,1492,6346,4854,205,441
SP,65790,ITU,18904,64175,28374,122698,94324,2414,8831
SP,65811,ITUPEVA,6544,21693,8343,40415,32072,842,2993
SP,65838,ITUVERAVA,5344,13229,9092,29926,20834,610,1651
SP,65854,JABORANDI,1280,2132,1173,5094,3921,117,392
SP,65870,JABOTICABAL,7937,26606,15045,53518,38473,1180,2750
SP,65897,JACAREÍ,25569,88982,35348,164815,129467,3498,11418
SP,65919,JACI,965,2694,1314,5484,4170,130,381
SP,65935,JACUPIRANGA,2051,6358,4225,13519,9294,235,650
SP,65951,JAGUARIÚNA,6098,21336,8694,39496,30802,869,2499
SP,65978,JALES,5694,19587,9454,37983,28529,811,2437
SP,65994,JAMBEIRO,707,2732,1070,4899,3829,106,284
SP,66010,JANDIRA,20346,32976,16511,78699,62188,2039,6827
SP,66036,JARDINÓPOLIS,3943,14129,7710,28312,20602,690,1840
SP,66052,JARINU,3659,11346,5447,22648,17201,516,1680
SP,66079,JAÚ,12272,57771,22178,100991,78813,2612,6158
SP,66095,JERIQUARA,862,1114,491,2742,2251,45,230
SP,66117,JOANÓPOLIS,1231,5122,2175,9454,7279,240,686
SP,66133,JOÃO RAMALHO,877,1403,526,3144,2618,75,263
SP,66150,JOSÉ BONIFÁCIO,4393,13648,6461,26563,20102,625,1436
SP,66176,JÚLIO MESQUITA,1087,1373,923,3812,2889,106,323
SP,66192,JUNDIAÍ,48827,173143,56638,308466,251828,5991,23867
SP,66214,JUNQUEIRÓPOLIS,2297,7384,2237,13214,10977,379,917
SP,66230,JUQUIÁ,2622,6815,6116,16786,10670,269,964
SP,66257,JUQUITIBA,5427,8993,5910,22838,16928,553,1955
SP,66273,LAGOINHA,949,2444,1018,5040,4022,174,455
SP,66290,LARANJAL PAULISTA,2482,11916,5011,21157,16146,471,1277
SP,66311,LAVÍNIA,993,1728,1095,4177,3082,98,263
SP,66338,LAVRINHAS,1379,2698,1404,6200,4796,170,549
SP,66354,LEME,11306,38007,16255,73260,57005,1897,5795
SP,66370,LENÇÓIS PAULISTA,5874,29023,9864,49041,39177,1097,3183
SP,66397,LIMEIRA,27257,127375,45005,216740,171735,4030,13073
SP,66419,LINDÓIA,726,3300,1226,5679,4453,89,338
SP,66435,LINS,6317,31675,14810,56923,42113,1090,3031
SP,66451,LORENA,8929,33879,15123,63560,48437,1653,3976
SP,66478,LOUVEIRA,5961,18600,5548,32967,27419,659,2199
SP,66494,LUCÉLIA,2091,6931,2381,12583,10202,279,901
SP,66516,LUCIANÓPOLIS,492,914,494,2074,1580,41,133
SP,66532,LUÍS ANTÔNIO,2101,3940,2669,9585,6916,171,704
SP,66559,LUIZIÂNIA,870,1772,1040,4004,2964,58,264
SP,66575,LUPÉRCIO,792,1470,986,3593,2607,107,238
SP,66591,LUTÉCIA,677,1001,657,2543,1886,40,168
SP,66613,MACATUBA,1959,7084,2848,13092,10244,312,889
SP,66630,MACAUBAL,896,3119,1317,5980,4663,167,481
SP,66656,MACEDÔNIA,606,1437,495,2817,2322,56,223
SP,66672,MAGDA,580,1282,418,2555,2137,59,216
SP,66699,MAIRINQUE,7040,17565,8611,37402,28791,974,3212
SP,66710,MAIRIPORÃ,10743,30283,14009,61261,47252,1383,4843
SP,66737,MANDURI,1205,3680,1666,7295,5629,190,554
SP,66753,MARABÁ PAULISTA,1057,974,1041,3300,2259,51,177
SP,66770,MARACAÍ,2118,5548,2469,10833,8364,181,517
SP,66796,MARIÁPOLIS,779,1275,779,3167,2388,62,272
SP,66818,MARÍLIA,23536,94124,40716,171761,131045,3579,9806
SP,66834,MARINÓPOLIS,496,772,408,1859,1451,35,148
SP,66850,MARTINÓPOLIS,3596,8734,2797,16729,13932,385,1217
SP,66877,MATÃO,12776,30373,14267,63963,49696,1431,5116
SP,66893,MAUÁ,78638,128689,61664,306710,245046,6877,30842
SP,66915,MENDONÇA,953,2121,1035,4480,3445,95,276
SP,66931,MERIDIANO,734,1576,510,3131,2621,75,236
SP,66958,MIGUELÓPOLIS,4069,5545,2884,13768,10884,236,1034
SP,66974,MINEIROS DO TIETÊ,1148,5035,2139,9215,7076,288,605
SP,66990,MIRACATU,3274,6585,6070,17292,11222,317,1046
SP,67016,MIRA ESTRELA,569,1110,692,2592,1900,28,193
SP,67032,MIRANDÓPOLIS,2699,10035,5962,20170,14208,346,1128
SP,67059,MIRANTE DO PARANAPANEMA,4574,3947,2866,12426,9560,216,823
SP,67075,MIRASSOL,6403,22447,9866,42463,32597,1021,2726
SP,67091,MIRASSOLÂNDIA,620,1847,779,3562,2783,79,237
SP,67113,MOCOCA,7963,24341,15112,53387,38275,1587,4384
SP,67130,MOGI DAS CRUZES,60367,149953,65699,309935,244236,8242,25674
SP,67156,MOGI GUAÇU,14361,64012,24666,113415,88749,2536,7840
SP,67172,MOGI MIRIM,8423,37986,15599,68056,52457,1669,4379
SP,67199,MOMBUCA,508,1788,734,3294,2560,50,214
SP,67210,MONÇÕES,439,900,351,1939,1588,59,190
SP,67237,MONGAGUÁ,8719,18364,13636,44455,30819,854,2882
SP,67253,MONTE ALEGRE DO SUL,824,3389,1325,6170,4845,123,509
SP,67270,MONTE ALTO,4604,19985,9547,37117,27570,901,2080
SP,67296,MONTE APRAZÍVEL,2964,8523,4175,17164,12989,370,1132
SP,67318,MONTE AZUL PAULISTA,2263,7408,2176,13372,11196,448,1077
SP,67334,MONTE CASTELO,953,1439,727,3436,2709,57,260
SP,67350,MONTEIRO LOBATO,844,1661,871,3718,2847,85,257
SP,67377,MONTE MOR,9225,17676,10102,41389,31287,1001,3385
SP,67393,MORRO AGUDO,4089,9198,5367,20744,15377,468,1622
SP,67415,MORUNGABA,1355,6096,1884,10158,8274,194,629
SP,67431,MURUTINGA DO SUL,691,1652,960,3587,2627,67,217
SP,67458,NARANDIBA,1264,1601,988,4225,3237,86,286
SP,67474,NATIVIDADE DA SERRA,951,2786,2073,6377,4304,107,460
SP,67490,NAZARÉ PAULISTA,2088,6753,3693,14075,10382,320,1221
SP,67512,NEVES PAULISTA,1359,3699,1808,7577,5769,211,500
SP,67539,NHANDEARA,1153,4335,1178,7253,6075,166,421
SP,67555,NIPOÃ,913,1557,1082,3897,2815,90,255
SP,67571,NOVA ALIANÇA,881,2598,1148,5098,3950,113,358
SP,67598,NOVA EUROPA,2264,2740,1974,7702,5728,158,566
SP,67610,NOVA GRANADA,3403,6394,4478,15556,11078,250,1031
SP,67636,NOVA GUATAPORANGA,597,744,458,1997,1539,27,171
SP,67652,NOVA INDEPENDÊNCIA,786,1285,426,2759,2333,67,195
SP,67679,NOVA LUZITÂNIA,757,1200,358,2549,2191,30,204
SP,67695,NOVA ODESSA,8377,23989,9029,45567,36538,906,3266
SP,67717,NOVO HORIZONTE,4435,15451,7437,29318,21881,593,1402
SP,67733,NUPORANGA,917,3045,1355,5818,4463,103,398
SP,67750,OCAUÇU,879,1374,449,3068,2619,92,274
SP,67776,ÓLEO,382,1351,672,2665,1993,57,203
SP,67792,OLÍMPIA,6422,20672,11014,41104,30090,854,2142
SP,67814,ONDA VERDE,792,1721,1000,3830,2830,68,249
SP,67830,ORIENTE,923,2601,573,4599,4026,110,392
SP,67857,ORINDIÚVA,1260,1902,1125,4701,3576,69,345
SP,67873,ORLÂNDIA,5161,15111,7662,30866,23204,716,2216
SP,67890,OSASCO,143603,245969,120269,569606,449337,12695,47070
SP,67911,OSCAR BRESSANE,386,1443,754,2745,1991,29,133
SP,67938,OSVALDO CRUZ,2944,13016,6678,24609,17931,544,1427
SP,67954,OURINHOS,13350,39357,19719,78973,59254,1814,4733
SP,67970,OURO VERDE,1907,2244,1463,6226,4763,115,497
SP,67997,PACAEMBU,1359,4286,2659,8999,6340,194,501
SP,68012,PALESTINA,1940,4109,2394,9231,6837,223,565
SP,68039,PALMARES PAULISTA,1779,3332,1424,7419,5995,168,716
SP,68055,PALMEIRA D OESTE,1698,3406,2228,8009,5781,156,521
SP,68071,PALMITAL,3018,8520,4452,17266,12814,364,912
SP,68098,PANORAMA,2186,4670,2715,10522,7807,247,704
SP,68110,PARAGUAÇU PAULISTA,6277,14579,8832,32513,23681,764,2061
SP,68136,PARAIBUNA,3183,6189,3785,14442,10657,235,1050
SP,68152,PARAÍSO,765,2507,465,4350,3885,111,502
SP,68179,PARANAPANEMA,3381,5898,3261,13872,10611,305,1027
SP,68195,PARANAPUÃ,698,1506,638,3140,2502,60,238
SP,68217,PARAPUÃ,1462,4079,2215,8516,6301,194,566
SP,68233,PARDINHO,1005,2681,961,5135,4174,89,399
SP,68250,PARIQUERA-AÇU,2407,7104,4047,15021,10974,370,1093
SP,68276,PATROCÍNIO PAULISTA,1940,5293,2615,10781,8166,246,687
SP,68292,PAULICÉIA,1182,2614,1641,5929,4288,108,384
SP,68314,PAULÍNIA,14863,37123,14985,73154,58169,1403,4780
SP,68330,PAULO DE FARIA,1645,2439,1943,6541,4598,93,421
SP,68357,PEDERNEIRAS,4896,17622,7597,33003,25406,763,2125
SP,68373,PEDRA BELA,969,2405,1228,5078,3850,144,332
SP,68390,PEDRANÓPOLIS,527,900,260,1876,1616,46,143
SP,68411,PEDREGULHO,3605,4262,1882,10854,8972,279,826
SP,68438,PEDREIRA,4055,19185,7903,34363,26460,681,2539
SP,68454,PEDRO DE TOLEDO,1584,3060,2990,8225,5235,128,463
SP,68470,PENÁPOLIS,7460,22610,12414,46081,33667,934,2663
SP,68497,PEREIRA BARRETO,3915,8684,6216,20483,14267,468,1200
SP,68519,PEREIRAS,1057,3174,1867,6746,4879,175,473
SP,68535,PERUÍBE,10296,23235,17572,55810,38238,1141,3566
SP,68551,PIACATU,930,2466,808,4606,3798,87,315
SP,68578,PIEDADE,7451,20074,10184,42273,32089,1317,3247
SP,68594,PILAR DO SUL,3437,11439,4651,21654,17003,580,1547
SP,68616,PINDAMONHANGABA,16054,60525,25773,113125,87352,2896,7877
SP,68632,PINDORAMA,1858,5915,2666,11536,8870,301,796
SP,68659,ESPÍRITO SANTO DO PINHAL,4926,16536,9167,33899,24732,866,2404
SP,68675,PINHALZINHO,1364,5461,2617,10626,8009,269,915
SP,68691,PIQUEROBI,851,1154,472,2743,2271,64,202
SP,68713,PIQUETE,1412,5482,1361,9137,7776,212,670
SP,68730,PIRACAIA,2878,11625,5424,22060,16636,526,1607
SP,68756,PIRACICABA,43260,158008,62953,289257,226304,6411,18625
SP,68772,PIRAJU,3880,11080,6472,23556,17084,499,1625
SP,68799,PIRAJUÍ,2306,7875,4569,16100,11531,391,959
SP,68810,PIRANGI,1129,4320,1880,8035,6155,188,518
SP,68837,PIRAPORA DO BOM JESUS,3302,4938,2569,12016,9447,247,960
SP,68853,PIRAPOZINHO,4133,9312,5512,20522,15010,377,1188
SP,68870,PIRASSUNUNGA,7167,32142,13465,57558,44093,1295,3489
SP,68896,PIRATININGA,1452,5001,1296,8529,7233,229,551
SP,68918,PITANGUEIRAS,5335,11391,7153,26519,19366,613,2027
SP,68934,PLANALTO,1127,1693,1031,4178,3147,52,275
SP,68950,PLATINA,564,1299,677,2775,2098,55,180
SP,68977,POÁ,22471,40969,20379,93570,73191,2166,7585
SP,68993,POLONI,772,2275,1166,4548,3382,81,254
SP,69019,POMPÉIA,2135,9331,3629,16318,12689,265,958
SP,69035,PONGAÍ,461,1723,781,3178,2397,48,165
SP,69051,PONTAL,5791,12077,6517,27648,21131,703,2560
SP,69078,PONTES GESTAL,577,1133,592,2490,1898,44,144
SP,69094,POPULINA,1135,1301,918,3689,2771,63,272
SP,69116,PORANGABA,1109,3143,1699,6567,4868,152,464
SP,69132,PORTO FELIZ,5652,22178,8879,40546,31667,1048,2789
SP,69159,PORTO FERREIRA,5502,22295,9459,41365,31906,1022,3087
SP,69175,POTIRENDABA,2098,6553,2818,12654,9836,349,836
SP,69191,PRADÓPOLIS,2710,6276,2935,13254,10319,319,1014
SP,69213,PRAIA GRANDE,39211,102534,54520,213870,159350,4405,13200
SP,69230,PRESIDENTE ALVES,649,1733,881,3573,2692,71,239
SP,69256,PRESIDENTE BERNARDES,2281,5072,3342,11434,8092,235,504
SP,69272,PRESIDENTE EPITÁCIO,5915,13437,9829,31756,21927,652,1923
SP,69299,PRESIDENTE PRUDENTE,25387,90190,45661,172899,127238,3297,8364
SP,69310,PRESIDENTE VENCESLAU,4254,15173,7579,29083,21504,545,1532
SP,69337,PROMISSÃO,5333,12565,8158,28256,20098,570,1630
SP,69353,QUATÁ,1869,5221,1527,9547,8020,204,726
SP,69370,QUEIROZ,659,1314,1147,3360,2213,55,185
SP,69396,QUELUZ,1904,2652,1198,6520,5322,134,632
SP,69418,QUINTANA,1051,2473,1199,5236,4037,116,397
SP,69434,RAFARD,1022,4378,1433,7493,6060,164,496
SP,69450,RANCHARIA,4961,11199,6654,24781,18127,494,1473
SP,69477,REDENÇÃO DA SERRA,665,1958,1036,4056,3020,103,294
SP,69493,REGENTE FEIJÓ,2814,7553,2192,13810,11618,308,943
SP,69515,REGINÓPOLIS,595,2621,1000,4543,3543,62,265
SP,69531,REGISTRO,8333,21153,13069,46171,33102,969,2647
SP,69558,RESTINGA,1760,2599,1685,6522,4837,94,384
SP,69574,RIBEIRA,981,988,784,2999,2215,59,187
SP,69590,RIBEIRÃO BONITO,1778,3712,2574,9099,6525,235,800
SP,69612,RIBEIRÃO BRANCO,4489,5242,3923,15197,11274,372,1171
SP,69639,RIBEIRÃO CORRENTE,960,1749,987,4025,3038,84,245
SP,69655,RIBEIRÃO DO SUL,1139,1583,454,3531,3077,75,280
SP,69671,RIBEIRÃO PIRES,20501,41053,19506,90595,71089,1951,7584
SP,69698,RIBEIRÃO PRETO,82528,215117,105473,443577,338104,8804,31655
SP,69710,RIVERSUL,1291,1741,1233,4707,3474,143,299
SP,69736,RIFAINA,857,1672,889,3701,2812,65,218
SP,69752,RINCÃO,2192,2957,1876,7825,5949,181,619
SP,69779,RINÓPOLIS,1079,4076,1891,7694,5803,145,503
SP,69795,RIO CLARO,21484,81089,32004,148144,116140,2914,10653
SP,69817,RIO DAS PEDRAS,4132,12839,5054,24373,19319,563,1785
SP,69833,RIO GRANDE DA SERRA,9376,13583,7629,34865,27236,917,3360
SP,69850,RIOLÂNDIA,2102,2503,2046,7197,5151,101,445
SP,69876,ROSEIRA,1409,4461,1862,8440,6578,213,495
SP,69892,RUBIÁCEA,468,1048,318,2052,1734,42,176
SP,69914,RUBINÉIA,569,1370,858,3046,2188,43,206
SP,69930,SABINO,857,2066,1413,4776,3363,74,366
SP,69957,SAGRES,542,865,473,2088,1615,46,162
SP,69973,SALES,630,2679,1353,5062,3709,81,319
SP,69990,SALES OLIVEIRA,1487,4182,1587,8092,6505,193,643
SP,70017,SALESÓPOLIS,2566,7429,3596,15193,11597,388,1214
SP,70033,SALMOURÃO,934,1786,964,4103,3139,108,311
SP,70050,SALTO,15501,46789,18144,88705,70561,1781,6490
SP,70076,SALTO DE PIRAPORA,5774,14417,3989,28095,24106,959,2956
SP,70092,SALTO GRANDE,1315,2936,848,5839,4991,163,577
SP,70114,SANDOVALINA,1323,983,1088,3617,2529,35,188
SP,70130,SANTA ADÉLIA,1703,5649,3310,11768,8458,253,853
SP,70157,SANTA ALBERTINA,859,2454,1176,4921,3745,83,349
SP,70173,SANTA BÁRBARA D OESTE,22479,76429,27703,140081,112378,2943,10527
SP,70190,ÁGUAS DE SANTA BÁRBARA,850,2448,1420,5141,3721,101,322
SP,70211,SANTA BRANCA,1929,6230,3243,12535,9292,283,850
SP,70238,SANTA CLARA D OESTE,464,988,614,2205,1591,28,111
SP,70254,SANTA CRUZ DA CONCEIÇÃO,532,2202,811,3854,3043,70,239
SP,70270,SANTA CRUZ DAS PALMEIRAS,4002,11123,3559,20894,17335,465,1745
SP,70297,SANTA CRUZ DO RIO PARDO,4309,19301,8560,34882,26322,779,1933
SP,70319,SANTA ERNESTINA,1257,2232,1093,5091,3998,87,422
SP,70335,SANTA FÉ DO SUL,3560,13054,7031,25528,18497,514,1369
SP,70351,SANTA GERTRUDES,2778,9755,3189,17197,14008,297,1178
SP,70378,SANTA ISABEL,7046,20358,9323,41409,32086,990,3692
SP,70394,SANTA LÚCIA,1967,2824,1891,7655,5764,209,764
SP,70416,SANTA MARIA DA SERRA,721,2074,918,4134,3216,112,309
SP,70432,SANTA MERCEDES,653,1029,799,2701,1902,41,179
SP,70459,SANTANA DA PONTE PENSA,336,733,419,1640,1221,33,119
SP,70475,SANTANA DE PARNAÍBA,20077,40706,15154,84635,69481,1906,6792
SP,70491,SANTA RITA D OESTE,511,1127,595,2446,1851,38,175
SP,70513,SANTA RITA DO PASSA QUATRO,2484,11659,3328,19130,15802,402,1257
SP,70530,SANTA ROSA DE VITERBO,3554,8540,5384,19626,14242,442,1706
SP,70556,SANTO ANASTÁCIO,3286,7122,2602,14485,11883,331,1144
SP,70572,SANTO ANDRÉ,131021,264039,122679,573075,450396,10678,44658
SP,70599,SANTO ANTÔNIO DA ALEGRIA,1382,2294,771,5060,4289,123,490
SP,70610,SANTO ANTÔNIO DE POSSE,2397,8882,4001,16742,12741,402,1060
SP,70637,SANTO ANTÔNIO DO JARDIM,849,2879,1169,5402,4233,142,363
SP,70653,SANTO ANTÔNIO DO PINHAL,942,3093,1489,6208,4719,196,488
SP,70670,SANTO EXPEDITO,698,1125,686,2752,2066,48,195
SP,70696,SANTÓPOLIS DO AGUAPEÍ,662,1616,763,3389,2626,72,276
SP,70718,SANTOS,67785,168843,80644,343898,263254,6471,20155
SP,70734,SÃO BENTO DO SAPUCAÍ,1370,4667,2389,9374,6985,237,711
SP,70750,SÃO BERNARDO DO CAMPO,175284,258269,125230,620985,495755,11596,50606
SP,70777,SÃO CAETANO DO SUL,25514,77010,23105,136080,112975,2427,8024
SP,70793,SÃO CARLOS,40433,83202,41553,184846,143293,4319,15339
SP,70815,SÃO FRANCISCO,604,1087,676,2588,1912,49,172
SP,70831,SÃO JOÃO DA BOA VISTA,10015,36546,15873,68935,53062,1663,4838
SP,70858,SÃO JOÃO DAS DUAS PONTES,680,873,636,2394,1758,38,167
SP,70874,SÃO JOÃO DO PAU D ALHO,579,860,411,2027,1616,40,137
SP,70890,SÃO JOAQUIM DA BARRA,7321,16374,9275,36266,26991,868,2428
SP,70912,SÃO JOSÉ DA BELA VISTA,1734,2571,2168,7086,4918,159,454
SP,70939,SÃO JOSÉ DO BARREIRO,1027,1273,928,3630,2702,88,314
SP,70955,SÃO JOSÉ DO RIO PARDO,6545,20490,10555,41588,31033,1123,2875
SP,70971,SÃO JOSÉ DO RIO PRETO,49211,177175,76034,328755,252721,6800,19535
SP,70998,SÃO JOSÉ DOS CAMPOS,87356,279797,100402,508935,408533,10660,30720
SP,71013,SÃO LUÍS DO PARAITINGA,2033,4486,1709,9451,7742,293,930
SP,71030,SÃO MANUEL,4839,15328,7156,30728,23572,777,2628
SP,71056,SÃO MIGUEL ARCANJO,4560,11888,6231,25179,18948,516,1984
SP,71072,SÃO PAULO,2424125,3694834,1924653,9055207,7130554,212813,798782
SP,71099,SÃO PEDRO,3133,14483,5931,25509,19578,491,1471
SP,71110,SÃO PEDRO DO TURVO,1297,2574,1306,5623,4317,113,333
SP,71137,SÃO ROQUE,10351,28284,14356,59664,45308,1789,4884
SP,71153,SÃO SEBASTIÃO,14986,24898,15546,60755,45209,1256,4069
SP,71170,SÃO SEBASTIÃO DA GRAMA,1695,3915,1469,8096,6627,227,790
SP,71196,SÃO SIMÃO,2034,5734,3316,12226,8910,242,900
SP,71218,SÃO VICENTE,57415,113848,60072,254058,193986,5632,17091
SP,71234,SARAPUÍ,1498,3125,1663,7043,5380,156,601
SP,71250,SARUTAIÁ,925,1140,875,3227,2352,46,241
SP,71277,SEBASTIANÓPOLIS DO SUL,415,1600,690,2965,2275,76,184
SP,71293,SERRA AZUL,1861,2719,1982,7214,5232,145,507
SP,71315,SERRANA,7259,14648,8120,32808,24688,674,2107
SP,71331,SERRA NEGRA,2712,12094,6085,22586,16501,425,1270
SP,71358,SERTÃOZINHO,17181,41928,21732,89450,67718,2040,6569
SP,71374,SETE BARRAS,2072,4123,3549,10588,7039,210,634
SP,71390,SEVERÍNIA,2354,6065,2897,12498,9601,315,867
SP,71412,SILVEIRAS,1167,2255,1250,5201,3951,153,376
SP,71439,SOCORRO,3039,17090,7312,29752,22440,480,1831
SP,71455,SOROCABA,91927,257866,57403,458916,401513,10454,41266
SP,71471,SUD MENNUCCI,1739,2579,1537,6362,4825,133,374
SP,71498,SUMARÉ,40727,88674,40153,186837,146684,3757,13526
SP,71510,SUZANO,47201,98160,45303,215986,170683,5703,19619
SP,71536,TABAPUÃ,1371,4821,2039,9227,7188,240,756
SP,71552,TABATINGA,2428,4951,2856,11403,8547,292,876
SP,71579,TABOÃO DA SERRA,64301,77834,43839,208762,164923,4897,17891
SP,71595,TACIBA,1543,1949,670,4463,3793,64,237
SP,71617,TAGUAÍ,1878,4314,2044,9019,6975,223,560
SP,71633,TAIAÇU,1223,1884,1285,4855,3570,123,340
SP,71650,TAIÚVA,639,2441,1207,4669,3462,105,277
SP,71676,TAMBAÚ,3148,7596,2436,15002,12566,425,1397
SP,71692,TANABI,3143,10629,5050,20230,15180,350,1058
SP,71714,TAPIRAÍ,1245,2570,1952,6436,4484,180,489
SP,71730,TAPIRATIBA,2454,4350,2607,10499,7892,268,820
SP,71757,TAQUARITINGA,7212,18278,11057,40170,29113,1088,2535
SP,71773,TAQUARITUBA,4108,7829,2391,16300,13909,597,1375
SP,71790,TARABAI,1704,1928,1431,5570,4139,77,430
SP,71811,TATUÍ,11048,45426,20295,85314,65019,2086,6459
SP,71838,TAUBATÉ,30037,128269,50781,228940,178159,5435,14418
SP,71854,TEJUPÁ,1204,1323,1050,3909,2859,64,268
SP,71870,TEODORO SAMPAIO,5234,5936,5083,17577,12494,283,1041
SP,71897,TERRA ROXA,1206,3060,693,5663,4970,137,567
SP,71919,TIETÊ,3825,16856,6636,29839,23203,523,1999
SP,71935,TIMBURI,500,1040,629,2415,1786,36,210
SP,71951,TORRINHA,1024,4030,1725,7366,5641,176,411
SP,71978,TREMEMBÉ,3932,14843,6031,27005,20974,605,1594
SP,71994,TRÊS FRONTEIRAS,981,2309,1339,5065,3726,102,334
SP,72010,TUPÃ,6625,26574,13785,50722,36937,879,2859
SP,72036,TUPI PAULISTA,2039,5779,2865,11535,8670,223,629
SP,72052,TURIÚBA,295,852,452,1728,1276,18,111
SP,72079,TURMALINA,475,725,592,1967,1375,25,150
SP,72095,UBATUBA,11741,32462,18780,68647,49867,1496,4168
SP,72117,UBIRAJARA,946,1837,1062,4152,3090,81,226
SP,72133,UCHOA,1469,3927,1768,7980,6212,187,629
SP,72150,UNIÃO PAULISTA,368,705,511,1696,1185,23,89
SP,72176,URÂNIA,1262,3218,1519,6590,5071,122,469
SP,72192,URU,223,767,372,1447,1075,29,56
SP,72214,URUPÊS,1572,5667,2874,11018,8144,218,687
SP,72230,VALENTIM GENTIL,1616,4771,2356,9570,7214,190,637
SP,72257,VALINHOS,14322,48664,18953,89639,70686,1790,5910
SP,72273,VALPARAÍSO,3071,7449,4445,16098,11653,324,809
SP,72311,VARGEM GRANDE DO SUL,4103,16342,7479,31203,23724,1077,2202
SP,72338,VÁRZEA PAULISTA,15480,39776,10203,74336,64133,1711,7166
SP,72354,VERA CRUZ,1426,4082,846,7086,6240,163,569
SP,72370,VINHEDO,8704,34113,10609,58237,47628,1235,3576
SP,72397,VIRADOURO,2120,7182,1580,12031,10451,314,835
SP,72419,VISTA ALEGRE DO ALTO,1100,2656,1196,5469,4273,142,375
SP,72435,VOTORANTIM,16250,46025,10698,81991,71293,2051,6967
SP,72451,VOTUPORANGA,10502,36114,17198,69605,52407,1401,4390
SP,72737,VARGEM GRANDE PAULISTA,8774,17252,7962,38043,30081,971,3084
TO,73008,ABREULÂNDIA,856,542,628,2079,1451,7,46
TO,73016,PIRAQUÊ,930,543,566,2124,1558,16,69
TO,73024,RIACHINHO,1650,726,719,3229,2510,10,124
TO,73032,DARCINÓPOLIS,1814,991,863,3883,3020,22,193
TO,73040,PALMEIRAS DO TOCANTINS,1744,981,835,3739,2904,29,150
TO,73059,MAURILÂNDIA DO TOCANTINS,1523,453,541,2637,2096,21,99
TO,73067,CACHOEIRINHA,827,365,535,1806,1271,15,64
TO,73075,ANGICO,920,744,564,2345,1781,17,100
TO,73083,PALMEIRANTE,1763,669,737,3292,2555,19,104
TO,73091,CAMPOS LINDOS,2797,1168,1067,5289,4222,47,210
TO,73105,SÃO FÉLIX DO TOCANTINS,641,199,497,1379,882,8,34
TO,73113,LAGOA DO TOCANTINS,1250,547,844,2771,1927,9,121
TO,73121,BOM JESUS DO TOCANTINS,1258,877,740,3031,2291,22,134
TO,73130,SANTA MARIA DO TOCANTINS,903,613,634,2233,1599,13,70
TO,73148,NOVO ALEGRE,740,449,579,1860,1281,9,83
TO,73156,SANDOLÂNDIA,1045,1069,825,3041,2216,20,82
TO,73164,TAIPAS DO TOCANTINS,812,275,568,1733,1165,5,73
TO,73172,NOVO JARDIM,860,407,592,1987,1395,13,115
TO,73180,SÃO MIGUEL DO TOCANTINS,3786,1690,1036,6778,5742,58,208
TO,73199,FORTALEZA DO TABOCÃO,952,846,788,2719,1931,23,110
TO,73202,ITAPIRATINS,1312,673,595,2728,2133,26,122
TO,73210,CENTENÁRIO,841,354,383,1649,1266,9,62
TO,73229,RECURSOLÂNDIA,1331,485,469,2377,1908,14,78
TO,73237,TUPIRATINS,825,337,545,1789,1244,19,63
TO,73245,BRASILÂNDIA DO TOCANTINS,631,529,400,1676,1276,9,107
TO,73253,JUARINA,815,504,538,1943,1405,11,75
TO,73261,PAU D ARCO,1320,1037,870,3360,2490,21,112
TO,73270,MATEIROS,851,394,412,1708,1296,10,41
TO,73288,SÃO BENTO DO TOCANTINS,2020,792,1070,4014,2944,11,121
TO,73296,ESPERANTINA,3125,1070,1306,5706,4400,28,177
TO,73300,CARIRI DO TOCANTINS,1011,1127,853,3172,2319,24,157
TO,73318,ARAGUANÃ,1367,1107,819,3441,2622,16,132
TO,73326,CARMOLÂNDIA,901,527,425,1964,1539,11,100
TO,73334,ARAGOMINAS,1875,984,985,4028,3043,32,152
TO,73342,MURICILÂNDIA,1077,530,483,2165,1682,17,58
TO,73350,SANTA FÉ DO ARAGUAIA,1866,1380,1056,4500,3444,23,175
TO,73369,JAÚ DO TOCANTINS,1056,788,616,2561,1945,13,88
TO,73377,SUCUPIRA,544,550,361,1525,1164,11,59
TO,73385,LAGOA DA CONFUSÃO,3140,2479,2247,8100,5853,30,204
TO,73393,SÃO SALVADOR DO TOCANTINS,1052,353,776,2258,1482,10,67
TO,73407,LAJEADO,1047,1053,1063,3288,2225,19,106
TO,73415,RIO DOS BOIS,945,544,616,2193,1577,16,72
TO,73423,CARRASCO BONITO,1407,520,727,2754,2027,16,84
TO,73431,RIO DA CONCEIÇÃO,760,331,592,1791,1199,13,95
TO,73440,PALMAS,45892,84782,44230,185370,141140,1899,8567
TO,73458,TUPIRAMA,665,505,525,1788,1263,15,78
TO,73466,OLIVEIRA DE FÁTIMA,606,404,511,1594,1083,12,61
TO,73474,CHAPADA DE AREIA,619,634,625,1927,1302,7,42
TO,73482,CHAPADA DA NATIVIDADE,1331,430,780,2628,1848,13,74
TO,73504,TALISMÃ,872,710,749,2396,1647,11,54
TO,73512,AGUIARNÓPOLIS,1723,887,686,3462,2776,26,140
TO,73520,LUZINÓPOLIS,958,517,510,2104,1594,23,96
TO,73539,SANTA TEREZINHA DO TOCANTINS,893,478,390,1855,1465,9,85
TO,73547,SANTA RITA DO TOCANTINS,598,561,571,1782,1211,8,44
TO,73555,CRIXÁS DO TOCANTINS,542,380,430,1405,975,8,45
TO,73563,MONTE SANTO DO TOCANTINS,750,835,637,2305,1668,8,75
TO,73571,PUGMIL,572,641,600,1916,1316,7,96
TO,73580,BANDEIRANTES DO TOCANTINS,846,860,541,2359,1818,3,109
TO,73598,IPUEIRAS,751,279,427,1504,1077,2,45
TO,73601,LAVANDEIRA,646,393,497,1623,1126,12,75
TO,73610,BARRA DO OURO,1755,648,851,3407,2556,19,134
TO,92002,BERNARDO SAYÃO,1068,1100,788,3150,2362,16,178
TO,92045,BURITI DO TOCANTINS,3017,1539,1105,5923,4818,37,225
TO,92070,ALMAS,2214,1022,1304,4781,3477,39,202
TO,92088,CASEARA,1706,915,720,3462,2742,11,110
TO,92134,ALVORADA,1989,2516,1960,6754,4794,50,239
TO,92142,COMBINADO,1182,1285,833,3504,2671,21,183
TO,92185,DIVINÓPOLIS DO TOCANTINS,2283,1380,1413,5309,3896,29,204
TO,92193,ANANÁS,3195,1823,1461,6879,5418,43,357
TO,92240,GOIANORTE,1680,1146,857,3840,2983,20,137
TO,92304,MARIANÓPOLIS DO TOCANTINS,1340,776,816,3053,2237,12,109
TO,92371,ARAGUACEMA,2120,1053,1274,4594,3320,18,129
TO,92398,ARAGUAÇU,1436,3001,1680,6383,4703,23,243
TO,92401,NOVA ROSALÂNDIA,849,1022,759,2726,1967,10,86
TO,92410,ARAGUAÍNA,31320,46436,25685,110112,84427,934,5737
TO,92436,ARAGUATINS,8819,5882,5131,20828,15697,168,828
TO,92452,ARAPOEMA,1811,1385,1162,4566,3404,37,171
TO,92479,ARRAIAS,3642,1323,2464,7742,5278,44,269
TO,92487,PEQUIZEIRO,1631,1073,839,3714,2875,16,155
TO,92509,PORTO ALEGRE DO TOCANTINS,995,401,661,2188,1527,28,103
TO,92525,PRAIA NORTE,2738,996,1134,5081,3947,34,179
TO,92533,AURORA DO TOCANTINS,1173,740,880,2970,2090,24,153
TO,92541,SAMPAIO,1525,593,779,3025,2246,19,109
TO,92576,AXIXÁ DO TOCANTINS,4033,2147,1492,8110,6618,62,376
TO,92584,SANTA ROSA DO TOCANTINS,1850,725,985,3683,2698,13,110
TO,92592,BABAÇULÂNDIA,3312,1276,1077,5951,4874,42,244
TO,92606,SANTA TEREZA DO TOCANTINS,843,869,613,2428,1815,15,88
TO,92681,SÃO VALÉRIO,1660,642,920,3354,2434,20,112
TO,92738,BREJINHO DE NAZARÉ,1542,1135,901,3830,2929,22,230
TO,93114,COLINAS DO TOCANTINS,6805,9249,5822,23051,17229,157,1018
TO,93130,CONCEIÇÃO DO TOCANTINS,1372,455,1242,3180,1938,18,93
TO,93211,COUTO MAGALHÃES,1886,1027,761,3813,3052,18,121
TO,93238,CRISTALÂNDIA,1903,1681,1521,5320,3799,38,177
TO,93416,DIANÓPOLIS,5206,3012,3556,12611,9055,85,752
TO,93459,DOIS IRMÃOS DO TOCANTINS,2168,1066,1302,4730,3428,19,175
TO,93475,DUERÉ,1206,945,834,3149,2315,17,147
TO,93556,FILADÉLFIA,2646,1470,1494,5848,4354,46,192
TO,93653,FORMOSO DO ARAGUAIA,4217,5013,3660,13414,9754,88,436
TO,93858,GURUPI,14655,24613,14799,57146,42347,529,2550
TO,94056,ITACAJÁ,2422,1447,1317,5420,4103,26,208
TO,94099,ITAGUATINS,2276,912,866,4233,3367,21,158
TO,94170,ITAPORÃ DO TOCANTINS,797,663,448,1987,1539,16,63
TO,94617,MIRACEMA DO TOCANTINS,5913,3769,3823,14359,10536,95,759
TO,94633,MIRANORTE,3333,3352,2505,9677,7172,67,420
TO,94692,MONTE DO CARMO,1959,1134,1232,4528,3296,28,175
TO,94811,NATIVIDADE,2346,1780,1882,6301,4419,43,250
TO,94838,NAZARÉ,1934,730,819,3667,2848,39,145
TO,94994,NOVO ACORDO,1373,992,1312,3830,2518,15,138
TO,95192,PARAÍSO DO TOCANTINS,6609,16149,8589,33088,24499,234,1507
TO,95214,PARANÃ,4008,949,2504,7738,5234,32,245
TO,95257,PEDRO AFONSO,3270,3226,2587,9545,6958,60,402
TO,95273,PEIXE,3158,1633,1906,6979,5073,24,258
TO,95290,COLMÉIA,1780,2607,1485,6218,4733,25,321
TO,95338,GOIATINS,3960,1459,1698,7494,5796,64,313
TO,95370,PINDORAMA DO TOCANTINS,1290,1016,849,3322,2473,23,144
TO,95478,PIUM,1585,1779,1777,5327,3550,32,154
TO,95516,PONTE ALTA DO BOM JESUS,1582,635,954,3340,2386,19,150
TO,95532,PONTE ALTA DO TOCANTINS,1852,1502,1403,5027,3624,22,248
TO,95591,PORTO NACIONAL,15105,13764,9095,40259,31164,284,2011
TO,95699,LIZARDA,1324,329,1149,2902,1753,13,87
TO,96032,SÃO SEBASTIÃO DO TOCANTINS,1662,571,589,2931,2342,15,94
TO,96130,SÍTIO NOVO DO TOCANTINS,4045,1556,1223,7139,5916,57,258
TO,96156,TAGUATINGA,4471,2451,2946,10420,7474,44,508
TO,96199,TOCANTÍNIA,2683,867,1012,4732,3720,26,144
TO,96210,TOCANTINÓPOLIS,7512,3592,2670,14488,11818,101,613
TO,96270,GUARAÍ,4965,6544,4192,16561,12369,98,762
TO,96296,PRESIDENTE KENNEDY,919,849,726,2651,1925,12,145
TO,96431,XAMBIOÁ,2888,2939,2044,8258,6214,58,329
TO,96490,PALMEIRÓPOLIS,1658,2089,1323,5353,4030,24,259
TO,96598,SILVANÓPOLIS,1793,1192,1033,4206,3173,25,163
TO,96636,NOVA OLINDA,3277,2443,1446,7575,6129,35,374
TO,96652,WANDERLÂNDIA,2735,1944,1512,6510,4998,33,286
TO,96679,FIGUEIRÓPOLIS,1418,1433,1122,4170,3048,29,168
TO,96792,RIO SONO,1616,959,1056,3768,2712,15,122
TO,96830,FÁTIMA,946,1092,742,2949,2207,16,153
TO,96857,AUGUSTINÓPOLIS,5598,3171,2542,11977,9435,130,536
TO,96954,ALIANÇA DO TOCANTINS,1449,1215,1192,4094,2902,33,205
TO,96970,APARECIDA DO RIO NEGRO,1291,1171,870,3547,2677,24,191
TO,96997,BARROLÂNDIA,1545,1501,1053,4336,3283,35,202