SG_UF,CD_MUNICIPIO,NM_MUNICIPIO,"('QT_VOTOS', 13, 'PARTIDO DOS TRABALHADORES')","('QT_VOTOS', 45, 'PARTIDO DA SOCIAL DEMOCRACIA BRASILEIRA')",QT_ABST,QT_APTOS,QT_BRANCOS,QT_COMPARECIMENTOS,QT_NULOS
AC,1007,BUJARI,2862,2386,985,3721,24,2736,88
AC,1015,CAPIXABA,2276,2000,1462,3682,12,2220,70
AC,1023,PORTO ACRE,4906,4562,3263,8216,45,4953,174
AC,1031,SANTA ROSA,616,198,615,1059,4,444,33
AC,1040,MARECHAL THAUMATURGO,1532,2584,2615,4782,15,2167,94
AC,1058,BRASILEIA,9158,6820,3887,12234,95,8347,263
AC,1066,PORTO WALTER,1496,1814,2385,4134,5,1749,89
AC,1074,CRUZEIRO DO SUL,19458,24330,17534,40270,179,22736,663
AC,1082,RODRIGUES ALVES,1984,2980,3129,5731,10,2602,110
AC,1090,MANCIO LIMA,3710,5118,2728,7337,35,4609,160
AC,1104,JORDAO,1182,842,1562,2655,6,1093,75
AC,1112,EPITACIOLANDIA,5510,3038,2062,6546,42,4484,168
AC,1120,ACRELANDIA,4404,4160,1959,6422,51,4463,130
AC,1139,FEIJO,10530,3130,5771,12932,43,7161,288
AC,1392,RIO BRANCO,162868,86440,45710,175346,1532,129636,3450
AC,1457,SENA MADUREIRA,11838,9274,7886,18961,98,11075,421
AC,1473,TARAUACA,9342,6506,8200,16628,116,8428,388
AC,1490,XAPURI,6384,5072,3196,9219,45,6023,250
AC,1511,PLACIDO DE CASTRO,6502,5890,3692,10127,59,6435,180
AC,1538,SENADOR GUIOMARD,10160,6222,4282,12827,74,8545,280
AC,1554,MANUEL URBANO,1614,2334,1720,3799,17,2079,88
AC,1570,ASSIS BRASIL,2394,1906,907,3158,16,2251,85
AL,27006,PARIPUEIRA,3234,5058,970,5451,118,4481,217
AL,27014,AGUA BRANCA,7120,7484,4291,12076,109,7785,374
AL,27022,PARICONHA,3428,4522,1852,6119,89,4267,203
AL,27030,ANADIA,5228,8222,4729,11991,158,7262,379
AL,27049,ESTRELA DE ALAGOAS,2290,8448,2847,8564,69,5717,279
AL,27057,ARAPIRACA,49000,97600,23950,100480,968,76530,2262
AL,27065,JEQUIA DA PRAIA,1488,4528,3266,6407,35,3141,98
AL,27073,ATALAIA,5878,24044,7820,23591,208,15771,602
AL,27081,CAMPESTRE,1988,2294,1371,3665,57,2294,96
AL,27090,BARRA DE SANTO ANTONIO,3004,5138,1098,5418,73,4320,176
AL,27111,BARRA DE SAO MIGUEL,1830,3234,427,3087,33,2660,95
AL,27138,BATALHA,5786,5206,3415,9212,62,5797,239
AL,27154,BELEM,1464,3644,1124,3896,64,2772,154
AL,27170,BELO MONTE,1772,1964,2124,4108,25,1984,91
AL,27197,BOCA DA MATA,8366,12702,4466,15780,295,11314,485
AL,27219,BRANQUINHA,2938,4378,2120,6080,89,3960,213
AL,27235,CACIMBINHAS,1782,6090,2068,6203,35,4135,164
AL,27251,CAJUEIRO,4012,10854,3113,11021,131,7908,344
AL,27278,CAMPO ALEGRE,9600,10528,6636,17608,277,10972,631
AL,27294,CAMPO GRANDE,2782,4808,894,4889,43,3995,157
AL,27316,CANAPI,4742,7786,4096,10691,58,6595,273
AL,27332,CAPELA,3286,11562,3167,11062,123,7895,348
AL,27359,CARNEIROS,2278,3406,779,3796,33,3017,142
AL,27375,CHA PRETA,1938,4724,519,4127,73,3608,204
AL,27391,COITE DO NOIA,2912,6148,2055,6927,82,4872,260
AL,27413,COLONIA LEOPOLDINA,5680,7914,4073,11425,184,7352,371
AL,27430,COQUEIRO SECO,1892,2630,405,2803,52,2398,85
AL,27456,CORURIPE,12302,25328,9621,29641,389,20020,816
AL,27472,DELMIRO GOUVEIA,27040,11114,8912,29089,293,20177,807
AL,27499,DOIS RIACHOS,2232,6984,2067,6938,45,4871,218
AL,27510,FEIRA GRANDE,5900,9616,3806,12131,145,8325,422
AL,27537,FELIZ DESERTO,854,2436,467,2225,40,1758,73
AL,27553,FLEXEIRAS,1660,7176,867,5595,68,4728,242
AL,27570,GIRAU DO PONCIANO,5992,15674,6693,18166,145,11473,495
AL,27596,IBATEGUARA,2840,6652,3168,8273,93,5105,266
AL,27618,IGACI,4820,13424,6519,16258,169,9739,448
AL,27634,IGREJA NOVA,6112,9208,5483,13664,155,8181,366
AL,27650,INHAPI,7462,5382,3209,10053,66,6844,356
AL,27677,JACARE DOS HOMENS,3194,2166,1107,3917,21,2810,109
AL,27693,JACUIPE,2874,2592,1376,4273,41,2897,123
AL,27715,JAPARATINGA,1530,3358,1550,4137,63,2587,80
AL,27731,JARAMATAIA,1572,3076,1077,3534,35,2457,98
AL,27758,JOAQUIM GOMES,4650,8932,4894,12189,110,7295,394
AL,27774,JUNDIA,1308,2496,498,2532,35,2034,97
AL,27790,JUNQUEIRO,7644,10896,5139,15025,189,9886,427
AL,27812,LAGOA DA CANOA,5482,7990,3449,10658,121,7209,352
AL,27839,LIMOEIRO DE ANADIA,5370,11522,4855,13942,143,9087,498
AL,27855,MACEIO,386220,254894,76526,416017,6373,339491,12561
AL,27871,MAJOR ISIDORO,3732,9978,4468,11709,78,7241,308
AL,27898,MARAGOGI,5604,9240,3348,11280,194,7932,316
AL,27910,MARAVILHA,1224,7698,2744,7416,38,4672,173
AL,27936,MARECHAL DEODORO,9242,17888,5456,19917,297,14461,599
AL,27952,MARIBONDO,3768,8626,3346,10053,174,6707,336
AL,27979,MAR VERMELHO,1096,2730,351,2391,39,2040,88
AL,27995,MATA GRANDE,5920,12136,4927,14585,155,9658,475
AL,28010,MATRIZ DE CAMARAGIBE,6154,10508,4637,13530,204,8893,358
AL,28037,MESSIAS,3388,7316,2569,8287,123,5718,243
AL,28053,MINADOR DO NEGRAO,1158,3738,1113,3743,37,2630,145
AL,28070,MONTEIROPOLIS,2330,3434,1291,4352,48,3061,131
AL,28096,MURICI,6792,12570,2227,12703,195,10476,600
AL,28118,NOVO LINO,2714,5874,864,5475,88,4611,229
AL,28134,OLHO D AGUA DAS FLORES,4636,10226,3413,11211,99,7798,268
AL,28150,OLHO D AGUA DO CASADO,3888,2656,1455,4916,43,3461,146
AL,28177,OLHO D AGUA GRANDE,1304,2792,1164,3345,26,2181,107
AL,28193,OLIVENCA,1654,7434,2142,6893,37,4751,170
AL,28215,OURO BRANCO,1276,6998,1980,6332,45,4352,170
AL,28231,PALESTINA,1964,2284,283,2534,28,2251,99
AL,28258,PALMEIRA DOS INDIOS,20178,33464,11781,40149,470,28368,1077
AL,28274,PAO DE ACUCAR,8560,9982,4961,14681,111,9720,338
AL,28290,PASSO DE CAMARAGIBE,2832,7334,2789,8243,138,5454,233
AL,28312,PAULO JACINTO,1890,4636,557,4061,58,3504,183
AL,28339,PENEDO,21804,18146,8813,29820,284,21007,748
AL,28355,PIACABUCU,5396,6224,4282,10501,94,6219,315
AL,28371,PILAR,7924,19178,6056,20339,258,14283,474
AL,28398,PINDOBA,518,2124,151,1569,18,1418,79
AL,28410,PIRANHAS,6372,8410,3957,11768,74,7811,346
AL,28436,POCO DAS TRINCHEIRAS,2404,7530,2760,7935,37,5175,171
AL,28452,PORTO CALVO,6180,13636,5607,16068,180,10461,373
AL,28479,PORTO DE PEDRAS,1510,4538,1920,5122,58,3202,120
AL,28495,PORTO REAL DO COLEGIO,4450,10048,3868,11618,147,7750,354
AL,28517,QUEBRANGULO,3612,6954,1221,6897,98,5676,295
AL,28533,RIO LARGO,25290,28520,8967,37469,607,28502,990
AL,28550,ROTEIRO,1302,3448,1630,4155,37,2525,113
AL,28576,SANTA LUZIA DO NORTE,2416,3738,1235,4490,52,3255,126
AL,28592,SANTANA DO IPANEMA,10242,23680,6964,24798,220,17834,653
AL,28614,SANTANA DO MUNDAU,1960,6710,1008,5715,78,4707,294
AL,28630,SAO BRAS,2598,3202,648,3742,67,3094,127
AL,28657,SAO JOSE DA LAJE,4728,11832,1203,10108,150,8905,475
AL,28673,SAO JOSE DA TAPERA,5482,13738,5049,15301,159,10252,483
AL,28690,SAO LUIS DO QUITUNDE,9606,12074,6027,17702,320,11675,515
AL,28711,SAO MIGUEL DOS CAMPOS,20076,19166,3184,24311,436,21127,1070
AL,28738,SAO MIGUEL DOS MILAGRES,1570,3494,826,3550,58,2724,134
AL,28754,SAO SEBASTIAO,5836,17066,6465,18664,206,12199,542
AL,28770,SATUBA,4896,5134,1668,7059,166,5391,210
AL,28797,TANQUE D ARCA,1318,3898,1768,4579,53,2811,150
AL,28819,TAQUARANA,2550,10494,2871,9848,107,6977,348
AL,28835,TRAIPU,5196,11776,6613,15603,115,8990,389
AL,28851,UNIAO DOS PALMARES,17566,22406,10468,32051,451,21583,1146
AL,28878,VICOSA,9604,11846,5036,16605,255,11569,589
AL,28894,CRAIBAS,5706,9932,4356,12666,108,8310,383
AL,28916,SENADOR RUI PALMEIRA,2504,3604,2159,5391,41,3232,137
AL,28932,SENADOR TEOTONIO VILELA,9322,15884,8614,22108,303,13494,588
AM,2003,APUI,4030,3562,3457,7425,54,3968,118
AM,2011,NOVO AYRAO,3376,2638,2587,5685,17,3098,74
AM,2020,GUAJARA,2612,4196,4575,8156,22,3581,155
AM,2038,ANORI,2478,4102,3011,6418,30,3407,87
AM,2046,CAREIRO DA VARZEA,5652,5850,5104,11072,42,5968,175
AM,2054,ATALAIA DO NORTE,1562,1820,1685,3468,12,1783,80
AM,2070,AUTAZES,5450,7374,6335,12994,69,6659,178
AM,2097,BARCELOS,2598,3810,2339,5626,13,3287,70
AM,2119,BARREIRINHA,8014,6674,3983,11628,54,7645,247
AM,2135,BENJAMIN CONSTANT,11944,5130,4392,13460,81,9068,450
AM,2151,BOCA DO ACRE,6394,7776,6635,14045,57,7410,268
AM,2178,BORBA,6384,6440,6276,12972,57,6696,227
AM,2194,CANUTAMA,1492,2764,2184,4397,18,2213,67
AM,2216,CARAUARI,7120,5472,6213,12753,52,6540,192
AM,2232,CAREIRO,7954,5142,7284,14114,66,6830,216
AM,2259,COARI,22796,7012,12952,28427,115,15475,456
AM,2275,CODAJAS,4996,5680,4757,10315,43,5558,177
AM,2291,EIRUNEPE,6614,5592,6876,13353,100,6477,274
AM,2313,ENVIRA,2330,3356,4834,7826,36,2992,113
AM,2330,FONTE BOA,3716,4960,4756,9316,46,4560,176
AM,2356,HUMAITA,12310,8768,4963,15929,130,10966,297
AM,2372,SANTA ISABEL DO RIO NEGRO,1392,2706,2317,4433,21,2116,46
AM,2399,IPIXUNA,2204,2878,4181,6899,20,2718,157
AM,2410,ITACOATIARA,43340,16160,15919,46382,180,30463,533
AM,2437,ITAPIRANGA,2918,2432,1509,4261,22,2752,55
AM,2453,JAPURA,660,1224,1235,2213,7,978,29
AM,2470,JURUA,400,2804,2252,3898,4,1646,40
AM,2496,JUTAI,1786,5234,3026,6711,29,3685,146
AM,2518,LABREA,11576,3620,7411,15418,61,8007,348
AM,2534,MANACAPURU,26334,18028,18574,41539,228,22965,556
AM,2550,MANAUS,1022660,297874,161206,844789,9135,683583,14181
AM,2577,MANICORE,6744,13414,6807,17236,66,10429,284
AM,2593,MARAA,1640,1668,3973,5705,9,1732,69
AM,2615,MAUES,20812,4468,9938,22939,71,13001,290
AM,2631,NHAMUNDA,4080,7180,3787,9603,38,5816,148
AM,2658,NOVA OLINDA DO NORTE,4222,6434,5339,10862,40,5523,155
AM,2674,NOVO ARIPUANA,2786,5016,4261,8369,66,4108,141
AM,2690,PARINTINS,34330,25304,13595,44346,264,30751,670
AM,2712,PAUINI,2052,3640,4215,7214,22,2999,131
AM,2739,SANTO ANTONIO DO ICA,1990,6634,3011,7544,32,4533,189
AM,2755,SAO PAULO DE OLIVENCA,5036,7080,1785,8207,64,6422,300
AM,2771,SILVES,5218,968,1432,4617,29,3185,63
AM,2798,TAPAUA,1032,5984,3282,6933,24,3651,119
AM,2810,TEFE,20376,8428,13761,28721,97,14960,461
AM,2836,SAO GABRIEL DA CACHOEIRA,12636,5460,7290,16670,89,9380,243
AM,2852,URUCARA,6910,2672,2786,7716,39,4930,100
AM,2879,URUCURITUBA,6438,2340,3040,7561,39,4521,93
AM,2895,ALVARAES,4572,1588,2559,5758,24,3199,95
AM,2917,AMATURA,1104,2780,1245,3295,15,2050,93
AM,2933,ANAMA,1800,2668,2425,4731,11,2306,61
AM,2950,BERURI,1298,4064,1736,4553,12,2817,124
AM,2976,BOA VISTA DE RAMOS,5056,1618,2787,6248,20,3461,104
AM,2992,CAAPIRANGA,2358,1878,2686,4888,15,2202,69
AM,98353,IRANDUBA,12816,7036,3428,13704,82,10276,268
AM,98370,ITAMARATI,840,1744,2290,3654,9,1364,63
AM,98396,MANAQUIRI,4364,3476,3808,7888,34,4080,126
AM,98418,PRESIDENTE FIGUEIREDO,11892,3360,5174,13082,85,7908,197
AM,98434,RIO PRETO DA EVA,5584,3682,3421,8212,45,4791,113
AM,98450,SAO SEBASTIAO DO UATUMA,1670,2748,1483,3757,18,2274,47
AM,98477,TABATINGA,8706,12026,4433,15392,116,10959,477
AM,98493,UARINI,1174,2104,2529,4251,12,1722,71
AM,98515,TONANTINS,1440,3810,2040,4780,22,2740,93
AP,6009,PRACUUBA,1114,830,161,1180,11,1019,36
AP,6017,AMAPA,4468,1924,844,4189,20,3345,129
AP,6025,PORTO GRANDE,5826,2324,530,4826,35,4296,186
AP,6033,CALCOENE,3626,2168,1104,4191,48,3087,142
AP,6041,ITAUBAL,2138,790,269,1806,4,1537,69
AP,6050,MACAPA,218436,61866,28318,174593,1315,146275,4809
AP,6068,CUTIAS,1858,1166,693,2286,9,1593,72
AP,6076,MAZAGAO,8372,3502,1756,7997,42,6241,262
AP,6084,AMAPARI,2082,874,306,1854,10,1548,60
AP,6092,OIAPOQUE,6812,3218,2737,8121,76,5384,293
AP,6106,SERRA DO NAVIO,2288,746,217,1803,14,1586,55
AP,6114,FERREIRA GOMES,2630,1244,600,2652,26,2052,89
AP,6122,VITORIA DO JARI,5250,2358,1561,5599,40,4038,194
AP,6130,LARANJAL DO JARI,17330,8506,4473,18051,137,13578,523
AP,6157,SANTANA,58716,16924,7358,46528,253,39170,1097
AP,6173,TARTARUGALZINHO,2754,3006,1354,4425,27,3071,164
BA,30007,LUIS EDUARDO MAGALHAES,13118,7578,4025,14842,152,10817,317
BA,30058,EUNAPOLIS,34736,24862,15595,47303,403,31708,1506
BA,30660,IUIU,4890,3274,2678,7008,38,4330,210
BA,30678,JABORANDI,3548,5266,2253,6990,73,4737,257
BA,30694,JUSSARI,3058,2608,2411,5467,55,3056,168
BA,30716,AMERICA DOURADA,7028,6838,3757,11138,87,7381,361
BA,30732,ARATACA,3136,4180,4026,7969,49,3943,236
BA,30759,BARRO ALTO,5318,6328,2517,8675,84,6158,251
BA,30775,BARROCAS,7990,5120,2883,9940,91,7057,411
BA,30791,BURITIRAMA,8910,6782,3153,11610,61,8457,550
BA,30813,CAPELA DO ALTO ALEGRE,4776,6374,3169,9186,96,6017,346
BA,30830,CAPIM GROSSO,11658,11804,6426,18974,189,12548,628
BA,30856,CANUDOS,6904,6550,2723,9837,67,7114,320
BA,30872,DIAS D AVILA,37240,6928,8302,31528,347,23226,795
BA,30899,FATIMA,7278,8642,2837,11370,100,8533,473
BA,30910,FILADELFIA,6774,7374,3273,10902,136,7629,419
BA,30937,GAVIAO,2438,2518,1022,3734,44,2712,190
BA,30953,GUAJERU,2342,5064,2339,6329,58,3990,229
BA,30970,HELIOPOLIS,5912,6518,2540,9146,87,6606,304
BA,30996,JOAO DOURADO,7170,9514,2454,11302,96,8848,410
BA,33014,ABAIRA,2292,6588,1936,6732,82,4796,274
BA,33030,ABARE,6522,7224,2584,9982,74,7398,451
BA,33057,ACAJUTIBA,8532,4512,3072,10140,106,7068,440
BA,33065,ADUSTINA,4632,8286,2495,9442,70,6947,418
BA,33073,AGUA FRIA,7240,5140,4553,11529,134,6976,652
BA,33090,ERICO CARDOSO,2914,6186,3092,7989,38,4897,309
BA,33111,AIQUARA,3094,1530,2217,4803,61,2586,213
BA,33138,ALAGOINHAS,85176,32910,20544,83302,1059,62758,2656
BA,33154,ALCOBACA,9540,4778,5130,12948,122,7818,537
BA,33170,ALMADINA,4436,1820,2520,5808,36,3288,124
BA,33197,AMARGOSA,17462,10520,8710,23817,246,15107,870
BA,33219,AMELIA RODRIGUES,17046,5960,5359,17735,308,12376,565
BA,33235,ANAGE,9486,15382,9073,22376,161,13303,708
BA,33251,ANDARAI,5994,3862,3312,8710,60,5398,410
BA,33260,ANDORINHA,10504,3044,2591,9789,85,7198,339
BA,33278,ANGICAL,7036,7722,2948,10683,53,7735,303
BA,33294,ANGUERA,6806,3448,1845,7441,116,5596,353
BA,33316,ANTAS,6190,6056,1928,8475,87,6547,337
BA,33332,ANTONIO CARDOSO,9456,3288,1934,8984,117,7050,561
BA,33359,ANTONIO GONCALVES,5158,4848,2568,7917,52,5349,294
BA,33375,APORA,4892,7612,4000,10864,127,6864,485
BA,33383,ARACAS,6158,2790,2417,7242,56,4825,295
BA,33391,ARACATU,3778,8350,3517,9930,56,6413,293
BA,33405,APUAREMA,2544,3798,2505,5968,41,3463,251
BA,33413,ARACI,17486,19252,10668,30632,294,19964,1301
BA,33430,ARAMARI,6140,3064,2532,7578,95,5046,349
BA,33456,ARATUIPE,3306,3750,2246,6156,77,3910,305
BA,33472,AURELINO LEAL,5426,4708,4620,10061,57,5441,317
BA,33499,BAIANOPOLIS,4724,6868,2783,8970,76,6187,315
BA,33510,BAIXA GRANDE,8074,8724,5379,14747,205,9368,764
BA,33529,BANZAE,5336,6520,3268,9587,75,6319,316
BA,33537,BARRA,15942,16894,8472,26214,180,17742,1144
BA,33553,BARRA DA ESTIVA,6566,11562,3622,13287,127,9665,474
BA,33570,BARRA DO CHOCA,10696,12452,6361,19003,204,12642,864
BA,33596,BARRA DO MENDES,8874,4814,4772,12046,82,7274,348
BA,33618,BARRA DO ROCHA,3408,1692,3322,6079,41,2757,166
BA,33634,BARREIRAS,75072,21502,18074,68311,557,50237,1393
BA,33650,GOVERNADOR LOMANTO JUNIOR,3678,2776,2251,5698,41,3447,179
BA,33677,BELMONTE,7252,6964,6954,14716,119,7762,535
BA,33693,BELO CAMPO,6228,7866,3684,11237,86,7553,420
BA,33715,BIRITINGA,6888,6036,3258,10471,110,7213,641
BA,33731,BOA NOVA,3956,7958,4368,10866,93,6498,448
BA,33758,BOA VISTA DO TUPIM,9286,6414,4154,12681,121,8527,556
BA,33774,BOM JESUS DA LAPA,22204,18630,13032,34846,355,21814,1042
BA,33782,BOM JESUS DA SERRA,2468,4966,2181,6159,37,3978,224
BA,33790,BONINAL,4388,7328,2473,8759,79,6286,349
BA,33804,BONITO,4024,5688,2622,7750,44,5128,228
BA,33812,BOQUIRA,10900,8352,5442,15627,102,10185,457
BA,33839,BOTUPORA,5142,3654,2848,7647,85,4799,316
BA,33855,BREJOES,6188,5204,3140,9355,90,6215,429
BA,33871,BREJOLANDIA,4332,4644,2336,7137,82,4801,231
BA,33898,BROTAS DE MACAUBAS,5916,6084,2963,9331,55,6368,313
BA,33910,BRUMADO,36404,21972,10810,41620,370,30810,1252
BA,33936,BUERAREMA,10090,7900,5899,15605,135,9706,576
BA,33952,CAATIBA,2964,3696,2807,6402,28,3595,237
BA,33960,CABACEIRAS DO PARAGUACU,4512,7844,2923,9637,93,6714,443
BA,33979,CACHOEIRA,20888,7140,6883,21968,314,15085,757
BA,33995,CACULE,9034,9876,4253,14327,140,10074,479
BA,34010,CAEM,7362,3798,3963,10040,85,6077,412
BA,34029,CAETANOS,1686,6246,2463,6715,29,4252,257
BA,34037,CAETITE,22366,18466,10192,32193,289,22001,1296
BA,34053,CAFARNAUM,4290,8704,3227,10155,98,6928,333
BA,34070,CAIRU,4062,4452,2151,6660,62,4509,190
BA,34096,CALDEIRAO GRANDE,4628,3378,2504,6867,68,4363,292
BA,34118,CAMACAN,14622,8598,9446,21920,232,12474,632
BA,34134,CAMACARI,143940,25556,25734,115818,1724,90084,3612
BA,34150,CAMAMU,7884,11376,8425,18901,165,10476,681
BA,34177,CAMPO ALEGRE DE LOURDES,13720,8578,5830,17833,137,12003,717
BA,34193,CAMPO FORMOSO,25642,27270,15083,43343,368,28260,1436
BA,34215,CANAPOLIS,3886,5138,2344,7218,36,4874,326
BA,34231,CANARANA,9158,10324,4506,14829,137,10323,445
BA,34258,CANAVIEIRAS,15710,9680,10604,24268,194,13664,775
BA,34274,CANDEAL,6386,3684,2385,7872,63,5487,389
BA,34290,CANDEIAS,70582,7318,10603,51418,661,40815,1204
BA,34312,CANDIBA,6884,5768,2753,9575,145,6822,351
BA,34339,CANDIDO SALES,9320,11522,7129,18249,189,11120,510
BA,34355,CANSANCAO,12860,13942,6944,21451,226,14507,880
BA,34363,CARAIBAS,3418,4808,5061,9456,57,4395,225
BA,34371,CARAVELAS,10296,5068,5485,13866,118,8381,581
BA,34398,CARDEAL DA SILVA,4390,1644,2031,5266,38,3235,180
BA,34410,CARINHANHA,13236,7306,5336,16285,102,10949,576
BA,34436,CASA NOVA,29980,20210,11783,38869,420,27086,1571
BA,34452,CASTRO ALVES,12804,11578,7473,20553,199,13080,690
BA,34479,CATOLANDIA,2062,1314,555,2352,28,1797,81
BA,34495,CATU,41674,10464,7788,35737,565,27949,1315
BA,34509,CATURAMA,3398,4516,2385,6621,58,4236,221
BA,34517,CENTRAL,11422,5518,2267,11232,108,8965,387
BA,34533,CHORROCHO,4730,4770,2283,7416,63,5133,320
BA,34550,CICERO DANTAS,14966,15478,6941,23418,286,16477,969
BA,34576,CIPO,6580,6946,3847,11144,84,7297,450
BA,34592,COARACI,11276,9344,6998,18035,154,11037,573
BA,34614,COCOS,4486,8180,4443,11320,110,6877,434
BA,34630,CONCEICAO DA FEIRA,13474,3252,2871,11950,235,9079,481
BA,34657,CONCEICAO DO ALMEIDA,11720,4912,3209,12201,136,8992,540
BA,34673,CONCEICAO DO COITE,30412,24600,11019,40358,476,29339,1357
BA,34690,CONCEICAO DO JACUIPE,18212,7816,5158,19118,236,13960,710
BA,34711,CONDE,8444,5558,3839,11477,126,7638,511
BA,34738,CONDEUBA,7176,10442,4885,14405,120,9520,591
BA,34754,CONTENDAS DO SINCORA,1504,2582,1561,3731,21,2170,106
BA,34770,CORACAO DE MARIA,14006,8450,5052,17284,230,12232,774
BA,34797,CORDEIROS,2018,5224,2279,6223,59,3944,264
BA,34819,CORIBE,7706,4934,3419,10213,119,6794,355
BA,34835,CORONEL JOAO SA,5196,7536,3318,10124,56,6806,384
BA,34851,CORRENTINA,12602,12610,6883,20519,182,13636,848
BA,34878,COTEGIPE,5462,4936,3091,8728,57,5637,381
BA,34894,CRAVOLANDIA,2196,3180,891,3851,53,2960,219
BA,34916,CRISOPOLIS,7610,8168,4527,13056,118,8529,522
BA,34932,CRISTOPOLIS,4444,8106,2940,9634,50,6694,369
BA,34959,CRUZ DAS ALMAS,40026,11642,8565,35894,543,27329,952
BA,34975,CURACA,15344,8724,5829,18880,216,13051,801
BA,34991,DARIO MEIRA,3760,4620,2715,7375,70,4660,400
BA,35017,DOM BASILIO,2718,8814,2108,8180,58,6072,248
BA,35033,DOM MACEDO COSTA,2918,1630,681,3133,33,2452,145
BA,35050,ELISIO MEDRADO,4856,3578,2202,6782,98,4580,265
BA,35076,ENCRUZILHADA,6382,9172,6365,14811,92,8446,577
BA,35092,ENTRE RIOS,18022,11378,8656,24638,316,15982,966
BA,35114,ESPLANADA,14066,10398,6530,19756,238,13226,756
BA,35130,EUCLIDES DA CUNHA,23520,25414,11988,38219,313,26231,1451
BA,35149,FEIRA DA MATA,2230,2884,1301,3997,24,2696,115
BA,35157,FEIRA DE SANTANA,314180,123466,61038,295307,4327,234269,11119
BA,35173,FIRMINO ALVES,1912,2210,1558,3785,33,2227,133
BA,35190,FLORESTA AZUL,3632,5868,2004,7126,72,5122,300
BA,35211,FORMOSA DO RIO PRETO,6908,6954,5497,12878,47,7381,403
BA,35238,GANDU,10200,11818,8347,20222,216,11875,650
BA,35254,GENTIO DO OURO,5172,5158,2168,7699,78,5531,288
BA,35270,GLORIA,9880,3950,1811,9166,102,7355,338
BA,35297,GONGOGI,2582,2812,3327,6253,41,2926,188
BA,35319,GOVERNADOR MANGABEIRA,11300,6720,4618,14295,190,9677,477
BA,35335,GUANAMBI,35892,27736,11577,45349,441,33772,1517
BA,35351,GUARATINGA,10678,4846,6759,15223,123,8464,579
BA,35378,IACU,11004,11022,7778,19588,165,11810,632
BA,35394,IBIASSUCE,3338,6424,2231,7459,57,5228,290
BA,35416,IBICARAI,10696,12488,8726,21103,166,12377,619
BA,35432,IBICOARA,4700,4876,2470,7743,125,5273,360
BA,35459,IBICUI,5690,5726,4382,10599,110,6217,399
BA,35475,IBIPEBA,11982,3922,4144,12536,122,8392,318
BA,35491,SANTA RITA DE CASSIA,10892,11608,4979,17014,191,12035,594
BA,35513,IBIPITANGA,2820,8480,4927,10942,75,6015,290
BA,35530,IBIQUERA,2904,1114,1394,3581,18,2187,160
BA,35556,IBIRAPITANGA,8256,5910,8093,15791,120,7698,495
BA,35572,IBIRAPUA,3042,3122,2259,5571,51,3312,179
BA,35599,IBIRATAIA,8588,6804,6536,14992,147,8456,613
BA,35610,IBITIARA,5748,7458,3702,10773,84,7071,384
BA,35637,IBITITA,12754,4644,4311,13387,93,9076,284
BA,35653,IBOTIRAMA,12810,7896,6443,17575,219,11132,560
BA,35670,ICHU,5172,2388,1389,5402,56,4013,177
BA,35696,IGAPORA,6052,8266,3455,11085,87,7630,384
BA,35700,IGRAPIUNA,3340,3532,3400,7212,87,3812,289
BA,35718,IGUAI,9598,8482,7408,17240,133,9832,659
BA,35734,ILHEUS,109262,37506,31843,109397,1397,77554,2773
BA,35750,INHAMBUPE,16604,8704,8577,22419,246,13842,942
BA,35777,IPECAETA,6228,9294,5097,13581,136,8484,587
BA,35793,IPIAU,20798,12514,11181,29065,308,17884,920
BA,35815,IPIRA,31438,17612,16626,43266,402,26640,1713
BA,35831,IPUPIARA,5048,4128,2192,7016,50,4824,186
BA,35858,IRAJUBA,3018,3124,1716,5009,33,3293,189
BA,35874,IRAMAIA,4600,4834,3856,8927,62,5071,292
BA,35890,IRAQUARA,7584,9398,3906,12960,120,9054,443
BA,35912,IRARA,12848,11608,5801,19113,221,13312,863
BA,35939,IRECE,31952,16216,10658,36247,403,25589,1102
BA,35947,ITABELA,10518,7708,6540,16570,166,10030,751
BA,35955,ITABERABA,34534,17280,13196,40940,512,27744,1325
BA,35971,ITABUNA,96290,88110,37087,134326,1479,97239,3560
BA,35998,ITACARE,4998,4346,4400,9496,106,5096,318
BA,36013,ITAETE,4176,6004,3274,8917,91,5643,462
BA,36030,ITAGI,9586,2554,2819,9383,63,6564,431
BA,36056,ITAGIBA,8776,3430,5124,11796,105,6672,464
BA,36072,ITAGIMIRIM,2786,3580,1841,5296,51,3455,221
BA,36080,ITAGUACU DA BAHIA,7300,2832,3120,8510,57,5390,267
BA,36099,ITAJU DO COLONIA,3556,2380,2800,5990,47,3190,175
BA,36110,ITAJUIPE,10576,9284,6510,17329,216,10819,673
BA,36137,ITAMARAJU,34008,17754,17778,45371,396,27593,1316
BA,36153,ITAMARI,4536,3364,1954,6142,56,4188,182
BA,36170,ITAMBE,7296,11516,6262,16347,123,10085,556
BA,36196,ITANAGRA,3076,1462,1917,4429,40,2512,203
BA,36218,ITANHEM,11754,5814,7115,16618,126,9503,593
BA,36234,ITAPARICA,12814,1988,3417,11215,97,7798,300
BA,36250,ITAPE,5502,3776,2227,7247,67,5020,314
BA,36277,ITAPEBI,3174,4574,3041,7197,47,4156,235
BA,36293,ITAPETINGA,36502,17234,12749,41429,541,28680,1271
BA,36315,ITAPICURU,9176,11640,7014,18427,163,11413,842
BA,36331,ITAPITANGA,4264,3008,2975,6908,76,3933,221
BA,36358,ITAQUARA,3218,4272,1760,5798,49,4038,244
BA,36374,ITARANTIM,8992,4408,5401,12616,91,7215,424
BA,36382,ITATIM,2346,9816,3051,9573,96,6522,345
BA,36390,ITIRUCU,6776,6264,3092,10030,87,6938,331
BA,36412,ITIUBA,16734,14172,7135,23945,316,16810,1041
BA,36439,ITORORO,10604,5966,3350,12361,163,9011,563
BA,36455,ITUACU,3884,14216,3212,12876,101,9664,513
BA,36471,ITUBERA,8628,8850,5945,15480,223,9535,573
BA,36498,JACARACI,5450,6484,4874,11238,73,6364,324
BA,36510,JACOBINA,47072,21056,18063,54449,428,36386,1894
BA,36536,JAGUAQUARA,21050,13864,8163,27251,356,19088,1275
BA,36552,JAGUARARI,19460,9028,6055,21215,226,15160,690
BA,36579,JAGUARIPE,6700,4128,3740,9731,132,5991,445
BA,36595,JANDAIRA,3060,3068,2983,6349,51,3366,251
BA,36617,JEQUIE,91288,26534,31792,94899,1200,63107,2996
BA,36633,JEREMOABO,11094,19300,7118,23341,162,16223,864
BA,36650,JIQUIRICA,4360,6918,2869,9103,88,6234,507
BA,36676,JITAUNA,4786,6478,5902,12035,83,6133,418
BA,36692,JUAZEIRO,103496,43982,25641,104104,1156,78463,3568
BA,36706,JUCURUCU,4332,3578,5069,9375,41,4306,310
BA,36714,JUSSARA,9330,3412,3887,10780,83,6893,439
BA,36730,JUSSIAPE,2960,5602,2593,7140,61,4547,205
BA,36757,LAFAIETE COUTINHO,2924,1548,1613,4064,51,2451,164
BA,36765,LAGOA REAL,3666,6514,2122,7569,38,5447,319
BA,36773,LAJE,10848,8504,4590,15213,137,10623,810
BA,36790,LAJEDAO,2354,2010,844,3160,26,2316,108
BA,36811,LAJEDINHO,1870,1770,509,2514,28,2005,157
BA,36820,LAJEDO DO TABOCAL,3298,3468,2010,5719,53,3709,273
BA,36838,LAMARAO,2768,3826,2564,6202,76,3638,265
BA,36854,LAURO DE FREITAS,88106,13640,14896,68695,935,53799,1991
BA,36870,LENCOIS,3450,2426,1737,4899,33,3162,191
BA,36897,LICINIO DE ALMEIDA,6244,5812,2692,9080,80,6388,280
BA,36919,LIVRAMENTO DE NOSSA SENHORA,16500,19576,7810,26915,248,19105,819
BA,36935,MACAJUBA,3012,6082,2383,7457,52,5074,475
BA,36951,MACARANI,6088,6330,4382,11157,82,6775,484
BA,36978,MACAUBAS,17758,18088,8508,27595,201,19087,963
BA,36994,MACURURE,2966,4074,1950,5708,27,3758,211
BA,37010,MAIQUINIQUE,4082,2706,2106,5753,45,3647,208
BA,37036,MAIRI,7580,9252,5343,14540,172,9197,609
BA,37052,MALHADA,7746,4060,3358,9608,61,6250,286
BA,37079,MALHADA DE PEDRAS,3630,4354,1983,6251,51,4268,225
BA,37095,MANOEL VITORINO,4064,7540,5175,11353,65,6178,311
BA,37117,MARACAS,7390,10768,6499,16209,167,9710,464
BA,37133,MARAGOGIPE,19216,17428,9817,29683,358,19866,1186
BA,37150,MARAU,4330,5750,4749,10249,99,5500,361
BA,37176,MARCIONILIO SOUZA,5596,2936,3080,7731,78,4651,307
BA,37192,MASCOTE,5448,5024,5150,10741,60,5591,295
BA,37214,MATA DE SAO JOAO,25918,5986,6779,23953,392,17174,830
BA,37222,MATINA,3134,6104,1946,6986,61,5040,360
BA,37230,MEDEIROS NETO,13308,6390,6286,17004,142,10718,727
BA,37257,MIGUEL CALMON,15656,9466,5323,19046,167,13723,995
BA,37273,MILAGRES,5828,4502,2929,8543,99,5614,350
BA,37290,MIRANGABA,4080,7442,3426,9630,78,6204,365
BA,37303,MIRANTE,1226,6096,1784,5683,15,3899,223
BA,37311,MONTE SANTO,18328,23012,10304,33172,447,22868,1751
BA,37338,MORPARA,4976,3296,2268,6709,41,4441,264
BA,37354,MORRO DO CHAPEU,14464,13588,7768,22884,214,15116,876
BA,37370,MORTUGABA,4104,6136,4495,10000,52,5505,333
BA,37397,MUCUGE,2346,6498,1447,6292,74,4845,349
BA,37419,MUCURI,13174,8216,7495,18862,153,11367,519
BA,37427,MULUNGU DO MORRO,2336,6308,2623,7239,42,4616,252
BA,37435,MUNDO NOVO,9272,8416,3456,13361,147,9905,914
BA,37451,MUNIZ FERREIRA,5540,3064,1480,6124,89,4644,253
BA,37460,MUQUEM DO SAO FRANCISCO,3200,3212,1935,5307,24,3372,142
BA,37478,MURITIBA,15234,7684,4838,17292,276,12454,719
BA,37494,MUTUIPE,10976,8702,4397,15059,156,10662,667
BA,37516,NAZARE,17320,8518,6640,20846,395,14206,892
BA,37532,NILO PECANHA,3554,4642,2769,7295,117,4526,311
BA,37559,NOVA CANAA,7054,4620,4097,10495,100,6398,461
BA,37567,NOVA FATIMA,3994,3698,1223,5419,95,4196,255
BA,37575,NOVA ITARANA,1762,3698,2025,4992,40,2967,197
BA,37583,NOVA REDENCAO,4832,2198,2198,6089,55,3891,321
BA,37591,NOVA SOURE,12800,9188,6397,18389,216,11992,782
BA,37613,NOVA VICOSA,13996,8134,7772,19716,192,11944,687
BA,37621,NOVO TRIUNFO,3074,5342,1739,6272,33,4533,292
BA,37630,OLINDINA,11508,10082,6356,17920,145,11564,624
BA,37656,OLIVEIRA DOS BREJINHOS,11424,8704,5152,16050,156,10898,678
BA,37672,OURICANGAS,4686,2892,1869,6190,108,4321,424
BA,37680,OUROLANDIA,5330,7976,3615,10716,40,7101,408
BA,37699,PALMAS DE MONTE ALTO,11432,7142,4543,14602,111,10059,661
BA,37710,PALMEIRAS,3616,3760,1795,5710,40,3915,187
BA,37737,PARAMIRIM,7866,9972,5041,14504,144,9463,400
BA,37753,PARATINGA,19360,6686,6570,20307,120,13737,594
BA,37770,PARIPIRANGA,6962,18462,5408,19007,167,13599,720
BA,37796,PAU BRASIL,3806,4584,4513,9047,72,4534,267
BA,37818,PAULO AFONSO,68502,18080,10914,56297,600,45383,1492
BA,37834,PEDRAO,4430,2228,1743,5325,58,3582,195
BA,37850,PEDRO ALEXANDRE,2350,6710,2403,7402,64,4999,405
BA,37877,PIATA,3456,14256,4653,14164,101,9511,554
BA,37893,PILAO ARCADO,19754,5294,8501,21900,145,13399,730
BA,37915,PINDAI,4052,10534,3393,11246,99,7853,461
BA,37931,PINDOBACU,6996,10900,4495,14036,104,9541,489
BA,37940,PIRAI DO NORTE,1330,4986,2496,5922,49,3426,219
BA,37958,PIRIPA,3858,3898,3161,7432,42,4271,351
BA,37974,PIRITIBA,8628,7638,3660,12443,78,8783,572
BA,37990,PLANALTINO,2006,4644,2518,6176,68,3658,265
BA,38016,PLANALTO,6214,13946,4927,15813,157,10886,649
BA,38032,POCOES,16268,19634,10056,29341,254,19285,1080
BA,38059,POJUCA,23532,6114,4549,20638,419,16089,847
BA,38067,PONTO NOVO,7250,4272,2750,8927,65,6177,351
BA,38075,PORTO SEGURO,43436,17730,15137,47504,447,32367,1337
BA,38091,POTIRAGUA,4394,2904,3551,7486,60,3935,226
BA,38113,PRADO,9312,7794,6366,15618,166,9252,533
BA,38130,PRESIDENTE DUTRA,9386,4082,3004,10100,71,7096,291
BA,38156,PRESIDENTE JANIO QUADROS,5624,4686,4335,9887,50,5552,347
BA,38164,PRESIDENTE TANCREDO NEVES,2750,11308,3898,11660,122,7762,611
BA,38172,QUEIMADAS,11986,10636,6468,18623,188,12155,656
BA,38199,QUIJINGUE,11786,13976,5163,18963,153,13800,766
BA,38210,REMANSO,20212,9706,10612,26680,196,16068,913
BA,38237,RETIROLANDIA,9474,3998,2649,9903,144,7254,374
BA,38253,RIACHAO DAS NEVES,9856,8510,6982,16905,112,9923,628
BA,38270,RIACHAO DO JACUIPE,19898,13646,7146,25053,288,17907,847
BA,38296,RIACHO DE SANTANA,12206,14190,6726,20874,225,14148,725
BA,38318,RIBEIRA DO AMPARO,6088,5442,1647,7876,75,6229,389
BA,38334,RIBEIRA DO POMBAL,20410,19348,8999,30129,300,21130,951
BA,38342,RIBEIRAO DO LARGO,4044,3106,3181,7099,39,3918,304
BA,38350,RIO DE CONTAS,4902,9504,1847,9535,102,7688,383
BA,38377,RIO DO ANTONIO,5468,6746,3239,9826,87,6587,393
BA,38393,RIO DO PIRES,2162,8520,2038,7652,53,5614,220
BA,38415,RIO REAL,12910,14112,7059,21459,179,14400,710
BA,38431,RODELAS,5440,914,788,4109,26,3321,118
BA,38458,RUY BARBOSA,14448,8786,7530,20148,174,12618,827
BA,38474,SALINAS DA MARGARIDA,7048,1480,2634,7207,97,4573,212
BA,38490,SALVADOR,2056012,244050,291211,1508170,20915,1216959,46013
BA,38512,SANTA BARBARA,13534,6224,3152,13893,157,10741,705
BA,38539,SANTA BRIGIDA,3652,8224,1932,8376,81,6444,425
BA,38555,SANTA CRUZ CABRALIA,8352,5034,3535,10633,105,7098,300
BA,38571,SANTA CRUZ DA VITORIA,2668,1496,1835,4106,45,2271,144
BA,38598,SANTA INES,5940,3868,3199,8580,98,5381,379
BA,38610,SANTALUZ,19326,11686,8387,24890,226,16503,771
BA,38636,SANTA MARIA DA VITORIA,14656,17534,8427,25677,229,17250,926
BA,38652,SANTANA,11762,12342,5024,17795,131,12771,588
BA,38679,SANTANOPOLIS,5056,4708,2960,8335,122,5375,371
BA,38695,SANTA TERESINHA,3080,5010,2626,7082,89,4456,322
BA,38717,SANTO AMARO,46694,9366,11322,41118,577,29796,1189
BA,38733,SANTO ANTONIO DE JESUS,46892,24932,11684,50290,658,38606,2036
BA,38750,SANTO ESTEVAO,17992,17000,8871,28125,344,19254,1414
BA,38776,SAO DESIDERIO,10192,6586,5333,14420,122,9087,576
BA,38792,SAO FELIX,9394,3916,2512,9606,99,7094,340
BA,38806,SAO DOMINGOS,6250,3388,1374,6493,56,5119,244
BA,38814,SAO FELIPE,9470,10484,6070,16889,223,10819,619
BA,38822,SAO FELIX DO CORIBE,5454,5442,3110,8849,65,5739,226
BA,38830,SAO FRANCISCO DO CONDE,29706,2098,3504,20035,191,16531,438
BA,38857,SAO GONCALO DOS CAMPOS,20158,7752,3569,18545,316,14976,705
BA,38865,SAO JOSE DO JACUIPE,3740,4860,2937,7677,122,4740,318
BA,38873,SAO MIGUEL DAS MATAS,5860,3264,2257,7201,61,4944,321
BA,38890,SAO SEBASTIAO DO PASSE,34856,5298,6879,28069,295,21190,818
BA,38911,SAPEACU,11096,6060,4168,13343,139,9175,458
BA,38938,SATIRO DIAS,7854,4694,4320,11140,89,6820,457
BA,38946,SAUBARA,7874,1896,2382,7567,103,5185,197
BA,38954,SAUDE,7326,4348,1800,8134,90,6334,407
BA,38970,SEABRA,17732,15886,7541,25447,183,17906,914
BA,38997,SEBASTIAO LARANJEIRAS,4136,4026,2031,6351,63,4320,176
BA,39012,SENHOR DO BONFIM,33908,27806,12245,45047,495,32802,1450
BA,39039,SENTO SE,8516,20382,7404,22634,163,15230,618
BA,39047,SERRA DO RAMALHO,12210,10320,7655,19766,171,12111,675
BA,39055,SERRA DOURADA,5422,10102,3658,11928,113,8270,395
BA,39071,SERRA PRETA,9490,8390,4152,14015,180,9863,743
BA,39098,SERRINHA,45438,18570,13096,47680,435,34584,2145
BA,39110,SERROLANDIA,4820,5752,2711,8443,76,5732,370
BA,39136,SIMOES FILHO,73880,13484,11970,58506,893,46536,1961
BA,39144,SITIO DO MATO,3758,4650,2418,6879,65,4461,192
BA,39152,SOUTO SOARES,3576,9348,4140,10918,72,6778,244
BA,39179,TABOCAS DO BREJO VELHO,4912,5860,2710,8460,79,5750,285
BA,39195,TANHACU,6352,13242,3999,14466,89,10467,581
BA,39217,TANQUINHO,6264,1948,1019,5391,60,4372,206
BA,39233,TAPEROA,6146,6498,4635,11642,133,7007,552
BA,39250,TAPIRAMUTA,4802,5872,2593,8436,85,5843,421
BA,39276,TEODORO SAMPAIO,6662,1494,2471,6875,77,4404,249
BA,39292,TEOFILANDIA,11846,8696,5082,16269,171,11187,745
BA,39314,TEOLANDIA,2662,7254,3617,9050,80,5433,395
BA,39330,TERRA NOVA,10902,1610,2704,9347,101,6643,286
BA,39357,TREMEDAL,4360,9292,10032,17426,83,7394,485
BA,39373,TUCANO,18890,20098,10483,31294,278,20811,1039
BA,39390,UAUA,12148,12410,6462,19564,203,13102,620
BA,39411,UBAIRA,6772,9242,4942,14087,146,9145,992
BA,39438,UBAITABA,8098,7336,5362,13696,138,8334,479
BA,39454,UBATA,11374,6604,8139,17913,186,9774,599
BA,39470,UIBAI,10174,3644,2988,10231,60,7243,274
BA,39489,UMBURANAS,2526,7504,2952,8264,33,5312,264
BA,39497,UNA,11800,6290,8268,18054,155,9786,586
BA,39519,URANDI,6476,8502,4059,12116,152,8057,416
BA,39535,URUCUCA,11114,6892,7323,17090,138,9767,626
BA,39551,UTINGA,9504,4078,3700,11188,116,7488,581
BA,39578,VALENCA,35228,22282,12761,44823,954,32062,2353
BA,39594,VALENTE,14198,7716,3519,15273,227,11754,570
BA,39616,VARZEA DO POCO,3898,3894,2367,6565,78,4198,224
BA,39624,VARZEDO,4600,3944,1881,6506,77,4625,276
BA,39632,VERA CRUZ,22420,4416,6303,20435,276,14132,438
BA,39640,VEREDA,3248,2824,2702,5990,29,3288,223
BA,39659,VITORIA DA CONQUISTA,124218,101952,44006,163941,1791,119935,5059
BA,39675,WAGNER,4330,3312,2112,6224,48,4112,243
BA,39691,WENCESLAU GUIMARAES,5450,6608,4751,11410,97,6659,533
BA,39713,XIQUE XIQUE,27732,10104,11850,32063,206,20213,1089
BA,39730,LAPAO,14700,9006,4457,17007,137,12550,560
BA,39748,MADRE DE DEUS,15498,1694,2208,11081,116,8873,161
BA,39756,MAETINGA,2512,2910,3023,6006,31,2983,241
BA,39772,MANSIDAO,5076,5114,2099,7463,31,5364,238
BA,39799,NORDESTINA,5574,3098,2148,6895,75,4747,336
BA,39810,PE DE SERRA,5792,7370,3514,10564,92,7050,377
BA,39837,PINTADAS,6116,4016,2697,8084,51,5387,270
BA,39845,QUIXABEIRA,4654,3488,2646,7007,82,4361,208
BA,39853,RAFAEL JAMBEIRO,9092,8416,6095,15797,160,9702,788
BA,39870,SANTA LUZIA,3942,4500,4136,8742,55,4606,330
BA,39896,SAO GABRIEL,12190,6136,3585,13311,117,9726,446
BA,39900,SITIO DO QUINTO,2736,7288,2209,7547,55,5338,271
BA,39918,TANQUE NOVO,6654,5916,2747,9574,114,6827,428
BA,39926,SAO JOSE DA VITORIA,3872,1932,2499,5633,37,3134,195
BA,39934,TEIXEIRA DE FREITAS,64992,21358,21813,67491,615,45678,1888
BA,39942,NOVO HORIZONTE,1618,7036,1833,6429,35,4596,234
BA,39950,VARZEA NOVA,6480,4374,1879,7767,70,5888,391
BA,39969,NOVA IBIA,2616,3314,2485,5702,61,3217,191
BA,39977,VARZEA DA ROCA,5562,5102,3292,9323,198,6031,501
BA,39985,SOBRADINHO,14142,7450,4570,16002,156,11432,480
BA,39993,WANDERLEY,4314,6444,3313,9035,48,5722,295
CE,13005,JIJOCA DE JERICOACOARA,5420,5310,2046,7688,81,5642,196
CE,13013,ABAIARA,3096,4920,980,5277,110,4297,179
CE,13021,MADALENA,9232,3242,2774,9377,105,6603,261
CE,13030,ACARAU,21908,15752,10817,30917,396,20100,874
CE,13048,PIRES FERREIRA,5922,4608,1304,6834,82,5530,183
CE,13056,ACOPIARA,24526,23772,7808,33701,562,25893,1182
CE,13064,GRACA,6750,6218,3531,10568,125,7037,428
CE,13072,AIUABA,6184,6748,3478,10433,121,6955,368
CE,13080,TURURU,8614,4514,1793,8753,157,6960,239
CE,13099,ALCANTARAS,6688,2254,2025,6936,113,4911,327
CE,13102,QUITERIANOPOLIS,10486,8264,3642,13670,180,10028,473
CE,13110,ALTANEIRA,2780,3488,709,4041,40,3332,158
CE,13129,BARREIRA,9680,8032,3032,12507,227,9475,392
CE,13137,ALTO SANTO,9000,4534,1955,9260,275,7305,263
CE,13145,ACARAPE,9466,2772,1726,8304,180,6578,279
CE,13153,ANTONINA DO NORTE,3072,3506,1297,4814,67,3517,161
CE,13161,CHOROZINHO,14022,4222,1861,11645,238,9784,424
CE,13170,APUIARES,8130,4004,2680,9186,134,6506,305
CE,13188,HORIZONTE,25016,6430,3999,20621,374,16622,525
CE,13196,AQUIRAZ,42592,10430,8682,36894,577,28212,1124
CE,13200,ERERE,1772,4422,1585,4877,57,3292,138
CE,13218,ARACATI,45110,12990,8327,38852,632,30525,843
CE,13226,EUZEBIO,29606,5102,4452,22629,311,18177,512
CE,13234,ARACOIABA,15234,9930,5721,19209,296,13488,610
CE,13242,GUAIUBA,14954,5032,3255,13845,152,10590,445
CE,13250,ARARIPE,6432,11662,3794,13540,165,9746,534
CE,13269,POTIRETAMA,3460,2312,963,4044,78,3081,117
CE,13277,ARATUBA,7956,3764,2763,9156,157,6393,376
CE,13285,PINDORETAMA,11558,4440,1270,9722,115,8452,338
CE,13293,ARNEIROZ,3964,3480,1306,5272,65,3966,179
CE,13307,OCARA,13212,8404,4567,16058,212,11491,471
CE,13315,ASSARE,11144,8014,4753,15074,235,10321,507
CE,13323,TEJUSSUOCA,9972,3172,1533,8604,163,7071,336
CE,13331,AURORA,14102,12364,3817,17749,223,13932,476
CE,13340,IPAPORANGA,4516,7100,1752,7895,75,6143,260
CE,13358,BAIXIO,4664,1778,899,4298,43,3399,135
CE,13366,TARRAFAS,2196,5490,1466,5480,35,4014,136
CE,13374,BARBALHA,31336,13428,7365,30965,346,23600,872
CE,13382,BANABUIU,7820,6310,3191,10766,159,7575,351
CE,13390,BARRO,14682,5082,3439,14058,224,10619,513
CE,13404,BARROQUINHA,5760,9380,2891,10984,160,8093,363
CE,13412,BATURITE,22150,8620,6146,22517,353,16371,633
CE,13420,ARARENDA,6090,4924,2711,8522,68,5811,236
CE,13439,BEBERIBE,29586,10028,7904,29150,565,21246,874
CE,13447,SENADOR CATUNDA,5458,3084,2503,7058,77,4555,207
CE,13455,BELA CRUZ,14906,7372,5686,17571,256,11885,490
CE,13463,CHORO,7866,3154,2554,8416,102,5862,250
CE,13471,BOA VIAGEM,29014,16690,11406,36386,684,24980,1444
CE,13480,ITAITINGA,19564,4732,3027,15895,252,12868,468
CE,13498,BREJO SANTO,31844,6102,6619,26845,278,20226,975
CE,13501,FORTIM,9210,3080,2365,8920,142,6555,268
CE,13510,CAMOCIM,30348,16706,7407,32678,621,25271,1123
CE,13536,CAMPOS SALES,8478,14296,4136,16406,258,12270,625
CE,13552,CANINDE,39666,14530,14644,43729,664,29085,1323
CE,13579,CAPISTRANO,10282,5386,3555,11956,208,8401,359
CE,13595,CARIDADE,9350,5346,1789,9781,244,7992,400
CE,13617,CARIRE,10338,8592,4406,14578,236,10172,471
CE,13633,CARIRIACU,7750,16236,5813,18541,182,12728,553
CE,13650,CARIUS,10084,7598,4348,13914,276,9566,449
CE,13676,CARNAUBAL,7394,5976,3605,10917,171,7312,456
CE,13692,CASCAVEL,36036,18224,9402,38457,839,29055,1086
CE,13714,CATARINA,3702,5406,2224,7068,62,4844,228
CE,13730,CAUCAIA,151364,30876,22818,119013,1765,96195,3310
CE,13757,CEDRO,12760,13670,3286,17353,233,14067,619
CE,13773,CHAVAL,8274,4000,1680,8275,145,6595,313
CE,13811,COREAU,12022,7680,4284,15093,243,10809,715
CE,13838,CRATEUS,45656,19188,15655,50857,826,35202,1954
CE,13854,CRATO,65732,33568,16963,69631,872,52668,2146
CE,13870,FARIAS BRITO,9464,11214,2605,13699,223,11094,532
CE,13897,FORTALEZA,1797466,237692,194434,1262204,19263,1067770,30928
CE,13919,FRECHEIRINHA,6258,5498,1492,7956,181,6464,405
CE,13935,GENERAL SAMPAIO,3762,2474,1173,4515,60,3342,164
CE,13951,GRANJA,18708,21166,7546,28866,393,21320,990
CE,13978,GRANGEIRO,1790,3712,799,3715,41,2916,124
CE,13994,GROAIRAS,6598,2272,1219,6130,184,4911,292
CE,14010,GUARACIABA DO NORTE,16352,15250,7262,24244,316,16982,865
CE,14036,GUARAMIRANGA,4374,1108,1291,4283,74,2992,177
CE,14052,HIDROLANDIA,11644,4986,2766,11688,189,8922,418
CE,14060,IBARETAMA,7090,4916,2025,8446,125,6421,293
CE,14079,IBIAPINA,9504,10100,4681,15223,228,10542,512
CE,14095,ICO,24686,31350,14143,43792,497,29649,1134
CE,14117,IGUATU,56176,25998,15933,59529,844,43596,1665
CE,14133,INDEPENDENCIA,15700,9608,4581,18362,367,13781,760
CE,14150,IPAUMIRIM,7838,4402,2479,8998,112,6519,287
CE,14176,IPU,20580,13658,9262,27804,416,18542,1007
CE,14192,IPUEIRAS,17556,15722,9756,27879,468,18123,1016
CE,14214,IRACEMA,6072,6846,3328,10209,122,6881,300
CE,14230,IRAUCUBA,12704,5008,3948,13405,160,9457,441
CE,14257,ITAICABA,5392,2082,1346,5322,76,3976,163
CE,14273,ITAPAGE,27092,12468,7097,28542,632,21445,1033
CE,14290,ITAPIPOCA,61144,18290,17347,60219,996,42872,2159
CE,14311,ITAPIUNA,11906,5194,2208,11275,141,9067,376
CE,14338,ITATIRA,7704,6718,2413,10183,158,7770,401
CE,14354,JAGUARETAMA,11186,6526,3244,12851,283,9607,468
CE,14370,JAGUARIBARA,6522,2826,1598,6642,153,5044,217
CE,14397,JAGUARIBE,19222,13134,7492,24985,490,17493,825
CE,14419,JAGUARUANA,22948,6772,5829,21923,572,16094,662
CE,14435,JARDIM,12870,12432,5027,18541,204,13514,659
CE,14451,JATI,3084,4730,1021,5215,68,4194,219
CE,14478,JUAZEIRO DO NORTE,108864,75072,35930,132978,1499,97048,3581
CE,14494,JUCAS,8440,13256,3486,15272,326,11786,612
CE,14516,LAVRAS DA MANGABEIRA,15902,12832,7888,23337,297,15449,785
CE,14532,LIMOEIRO DO NORTE,41450,11104,7773,35963,880,28190,1033
CE,14559,MARANGUAPE,70302,13514,11206,55458,766,44252,1578
CE,14575,MARCO,13470,7064,3481,14472,253,10991,471
CE,14591,MARTINOPOLE,4574,4164,1209,5794,74,4585,142
CE,14613,MASSAPE,19204,9888,5607,21258,425,15651,680
CE,14630,MAURITI,19288,17848,6917,26787,282,19870,1020
CE,14656,MERUOCA,9114,2532,1475,8092,343,6617,451
CE,14672,MILAGRES,12968,14870,5220,19852,234,14632,479
CE,14680,MIRAIMA,6390,4654,2917,8763,97,5846,227
CE,14699,MISSAO VELHA,15874,15568,5701,22450,248,16749,780
CE,14710,MOMBACA,16722,23160,6485,27858,383,21373,1049
CE,14737,MONSENHOR TABOSA,9334,6232,2546,10889,176,8343,384
CE,14753,MORADA NOVA,49820,16552,13568,49123,755,35555,1614
CE,14770,MORAUJO,2916,4468,1186,5166,105,3980,183
CE,14796,MORRINHOS,10552,4180,4230,12093,169,7863,328
CE,14818,MUCAMBO,5656,7792,2071,9257,155,7186,307
CE,14834,MULUNGU,5136,3528,1732,6494,156,4762,274
CE,14850,NOVA OLINDA,5578,7268,1415,8225,106,6810,281
CE,14877,NOVA RUSSAS,17196,10124,8579,23300,317,14721,744
CE,14893,NOVO ORIENTE,11110,14026,4027,17441,251,13414,595
CE,14915,OROS,12396,10352,3797,16055,293,12258,591
CE,14931,PACAJUS,29956,10598,6347,28065,619,21718,822
CE,14958,PACATUBA,33920,7034,5630,27201,356,21571,738
CE,14974,PACOTI,7918,3358,2568,8680,183,6112,291
CE,14990,PACUJA,3376,2668,1052,4378,116,3326,188
CE,15016,PALHANO,5034,4272,1179,6165,138,4986,195
CE,15032,PALMACIA,8128,2062,1663,7195,114,5532,323
CE,15059,PARACURU,14360,10694,5242,18754,392,13512,593
CE,15075,PARAMBU,16524,10922,8925,23722,330,14797,744
CE,15091,PARAMOTI,6948,4080,1850,7776,132,5926,280
CE,15113,PEDRA BRANCA,19346,14150,9738,27900,436,18162,978
CE,15130,PENAFORTE,3406,4422,874,5098,110,4224,200
CE,15156,PENTECOSTE,23270,9390,4799,22271,325,17472,817
CE,15172,PEREIRO,7368,8138,3054,11335,120,8281,408
CE,15199,PIQUET CARNEIRO,6524,7884,1861,9523,133,7662,325
CE,15210,PORANGA,5088,6580,1761,7961,79,6200,287
CE,15237,PORTEIRAS,10406,6036,1960,10789,79,8829,529
CE,15253,POTENGI,3866,4658,1193,5774,108,4581,211
CE,15270,QUIXADA,38356,23728,12430,44935,503,32505,960
CE,15296,QUIXERAMOBIM,38404,18000,11100,41156,567,30056,1287
CE,15318,QUIXERE,11856,5724,2376,11764,204,9388,394
CE,15334,REDENCAO,19352,6224,4338,18245,384,13907,735
CE,15350,RERIUTABA,10764,6356,4740,14072,308,9332,464
CE,15377,RUSSAS,41940,12524,8222,37325,725,29103,1146
CE,15393,SABOEIRO,7902,7808,2593,11103,148,8510,507
CE,15415,SANTANA DO ACARAU,18616,8496,6852,21184,260,14332,516
CE,15431,SANTANA DO CARIRI,7008,8156,3310,11405,100,8095,413
CE,15440,SALITRE,2102,9016,2246,8177,89,5931,283
CE,15458,SANTA QUITERIA,27176,9104,9319,29133,754,19814,920
CE,15474,SAO BENEDITO,18970,20396,9192,30004,352,20812,777
CE,15490,SAO GONCALO DO AMARANTE,22754,13148,6772,25904,405,19132,776
CE,15512,SAO JOAO DO JAGUARIBE,8298,1758,1361,6720,138,5359,193
CE,15539,SAO LUIS DO CURU,9016,4274,2079,9205,196,7126,285
CE,15555,SENADOR POMPEU,17178,8412,3682,17450,313,13768,660
CE,15571,SENADOR SA,2242,3570,1125,4244,74,3119,139
CE,15598,SOBRAL,124550,17480,19068,96116,2515,77048,3518
CE,15610,SOLONOPOLE,9364,7540,3677,12644,164,8967,351
CE,15636,TABULEIRO DO NORTE,22498,7690,5230,21382,425,16152,633
CE,15652,TAMBORIL,15650,9378,6905,20374,277,13469,678
CE,15679,TAUA,31782,16340,7742,34311,812,26569,1696
CE,15695,TIANGUA,28946,21148,8680,35804,826,27124,1251
CE,15717,TRAIRI,22976,15622,8480,28947,385,20467,783
CE,15733,UBAJARA,13838,11778,5321,19329,462,14008,738
CE,15750,UMARI,4686,2818,1185,5200,56,4015,207
CE,15776,URUBURETAMA,14400,5604,2304,13096,283,10792,507
CE,15792,URUOCA,5688,5614,2424,8458,103,6034,280
CE,15814,VARZEA ALEGRE,21636,13616,7678,26624,462,18946,858
CE,15830,VICOSA DO CEARA,17586,29106,7825,32607,391,24782,1045
CE,15857,MARACANAU,144296,17010,17770,102015,1241,84245,2351
CE,15873,AMONTADA,17684,11460,7426,23123,407,15697,718
CE,15881,CROATA,5028,10300,3374,11539,133,8165,368
CE,15890,CRUZ,9668,10198,4917,15394,175,10477,369
CE,15911,FORQUILHA,14972,2742,3242,13034,371,9792,564
CE,15920,IBICUITINGA,8058,4066,1604,7993,121,6389,206
CE,15938,ICAPUI,12932,4728,2354,11505,96,9151,225
CE,15954,ITAREMA,11520,11036,7205,19186,202,11981,501
CE,15970,MILHA,7870,5678,1749,8955,120,7206,312
CE,15989,DEP IRAPUAN PINHEIRO,6074,3270,1554,6555,86,5001,243
CE,15997,PARAIPABA,14892,9548,2852,15880,298,13028,510
CE,98531,QUIXELO,8774,9426,1979,11535,135,9556,321
CE,98558,UMIRIM,9482,5862,3502,11700,187,8198,339
CE,98574,VARJOTA,9458,4580,2571,10288,312,7717,386
DF,97012,BRASILIA,1555416,942970,207722,1518437,18826,1310715,42696
ES,56006,SAO DOMINGOS,5486,3862,1713,6597,81,4884,129
ES,56014,AFONSO CLAUDIO,14022,16750,5931,22155,264,16224,574
ES,56022,AGUA DOCE DO NORTE,6590,6408,4459,11444,167,6985,319
ES,56030,ALEGRE,15076,16854,6423,23441,335,17018,718
ES,56049,IRUPI,3172,6310,1970,6946,65,4976,170
ES,56057,ALFREDO CHAVES,7638,7810,2342,10485,183,8143,236
ES,56065,ALTO RIO NOVO,3076,4314,2333,6245,66,3912,151
ES,56073,ANCHIETA,13534,8870,4114,15883,243,11769,324
ES,56081,VILA PAVAO,5472,3642,1464,6222,66,4758,135
ES,56090,APIACA,3674,4056,1749,5842,69,4093,159
ES,56103,MARECHAL FLORIANO,8026,7894,2617,10961,166,8344,218
ES,56111,ARACRUZ,46540,24208,10226,47186,589,36960,997
ES,56120,MARATAIZES,13224,14644,5883,20551,336,14668,398
ES,56138,ATILIO VIVACQUA,6404,4696,1328,7148,93,5820,177
ES,56146,BREJETUBA,4530,4412,2851,7565,66,4714,177
ES,56154,BAIXO GUANDU,17352,13872,5898,22459,352,16561,597
ES,56162,SAO ROQUE DO CANAA,5848,5492,1300,7234,116,5934,148
ES,56170,BARRA DE SAO FRANCISCO,18784,18290,8366,27864,274,19498,687
ES,56189,SOORETAMA,10266,7122,3118,12228,166,9110,250
ES,56197,BOA ESPERANCA,8302,5828,3153,10523,101,7370,204
ES,56200,PONTO BELO,4408,2724,2394,6184,60,3790,164
ES,56219,BOM JESUS DO NORTE,5296,5052,2095,7608,86,5513,253
ES,56227,VILA VALERIO,9840,3742,2106,9154,91,7048,166
ES,56235,CACHOEIRO DE ITAPEMIRIM,110780,55600,20547,108449,2335,87902,2377
ES,56251,CARIACICA,186452,111616,29652,185347,2960,155695,3701
ES,56278,CASTELO,22398,14366,4705,24012,365,19307,560
ES,56294,COLATINA,63522,51500,15295,75292,1000,59997,1486
ES,56308,GOVERNADOR LINDENBERG,6778,3726,1796,7239,78,5443,113
ES,56316,CONCEICAO DA BARRA,12578,9160,6064,17706,239,11642,534
ES,56332,CONCEICAO DO CASTELO,5232,6916,2169,8648,143,6479,262
ES,56359,DIVINO DE SAO LOURENCO,1654,2958,1356,3762,32,2406,68
ES,56375,DOMINGOS MARTINS,14104,18922,4052,21372,351,17320,456
ES,56391,DORES DO RIO PRETO,2734,3724,1308,4761,73,3453,151
ES,56413,ECOPORANGA,11706,10708,6210,18132,180,11922,535
ES,56430,FUNDAO,10108,5104,1273,9276,171,8003,226
ES,56456,GUACUI,13806,12090,4679,18406,328,13727,451
ES,56472,GUARAPARI,47798,42864,15622,63478,1018,47856,1507
ES,56499,IBIRACU,9314,3940,2108,9115,168,7007,212
ES,56502,IBITIRAMA,3022,4744,2370,6529,102,4159,174
ES,56510,ICONHA,8072,6314,1306,8784,113,7478,172
ES,56537,ITAGUACU,8574,7876,2712,11469,206,8757,326
ES,56553,ITAPEMIRIM,15384,12958,5732,20768,386,15036,479
ES,56570,ITARANA,7684,5340,1686,8632,160,6946,274
ES,56596,IUNA,9878,16716,5688,19676,233,13988,458
ES,56618,JERONIMO MONTEIRO,4920,5780,1410,7094,116,5684,218
ES,56626,JOAO NEIVA,12670,6006,2210,11978,176,9768,254
ES,56634,LINHARES,60860,52792,17551,77423,1289,59872,1757
ES,56650,MANTENOPOLIS,4566,8206,4008,10783,125,6775,264
ES,56677,MIMOSO DO SUL,12678,13428,5855,19758,312,13903,538
ES,56693,MONTANHA,9698,6186,4856,13280,172,8424,310
ES,56715,MUCURICI,3440,2336,1924,4944,40,3020,92
ES,56731,MUNIZ FREIRE,9320,8804,3703,13183,139,9480,279
ES,56758,MUQUI,9114,7510,2525,11370,198,8845,335
ES,56774,NOVA VENECIA,26680,15444,7638,29877,452,22239,725
ES,56790,PANCAS,10916,8352,5149,15290,173,10141,334
ES,56812,PINHEIROS,12998,7380,5675,16315,144,10640,307
ES,56839,PIUMA,6898,7440,2755,10262,139,7507,199
ES,56855,PRESIDENTE KENNEDY,3652,5058,1890,6480,106,4590,129
ES,56871,RIO NOVO DO SUL,6866,6544,1893,8970,179,7077,193
ES,56898,SANTA LEOPOLDINA,6200,7012,1469,8459,167,6990,217
ES,56910,SANTA TERESA,10840,14672,3691,17000,202,13309,351
ES,56936,SAO GABRIEL DA PALHA,17662,10372,4386,19017,207,14631,407
ES,56952,SAO JOSE DO CALCADO,5788,5804,2466,8796,150,6330,384
ES,56979,SAO MATEUS,54284,24568,16940,58208,628,41268,1214
ES,56995,SERRA,212280,84870,38369,194762,3368,156393,4450
ES,57010,VIANA,38970,22952,8602,40962,650,32360,749
ES,57037,VILA VELHA,229018,137650,41049,233231,4084,192182,4764
ES,57053,VITORIA,214104,137140,40189,223572,3634,183383,4127
ES,57070,MARILANDIA,7718,4852,1595,8216,117,6621,219
ES,57096,IBATIBA,5826,13522,3465,13531,120,10066,272
ES,57118,RIO BANANAL,10956,7238,3334,12842,165,9508,246
ES,57134,JAGUARE,13570,6200,3027,13355,212,10328,231
ES,57150,PEDRO CANARIO,13356,7456,7506,18582,205,11076,465
ES,57916,LARANJA DA TERRA,5140,7912,1604,8442,121,6838,191
ES,57932,SANTA MARIA DO JETIBA,16786,13546,2282,18247,315,15965,484
ES,57959,VARGEM ALTA,9012,8414,2518,11655,194,9137,230
ES,57975,VENDA NOVA DO IMIGRANTE,8104,9276,1945,11060,174,9115,251
ES,57991,AGUIA BRANCA,5316,4272,1694,6703,71,5009,144
GO,92010,ABADIANIA,6114,6060,1577,7974,115,6397,195
GO,92029,BONFINOPOLIS,3942,2788,985,4512,45,3527,117
GO,92037,AGUA LIMPA,1442,1124,408,1751,27,1343,33
GO,92053,ALEXANIA,9012,12410,3603,14932,212,11329,406
GO,92061,CAMPOS VERDES,3092,3782,2399,5979,32,3580,111
GO,92096,ALOANDIA,1374,1436,353,1819,24,1466,37
GO,92100,CEZARINA,4584,3480,964,5214,72,4250,146
GO,92118,ALTO PARAISO,2958,2266,1312,4053,27,2741,102
GO,92126,COLINAS DO SUL,1282,1934,1458,3140,18,1682,56
GO,92150,ALVORADA DO NORTE,3124,3924,1880,5563,34,3683,125
GO,92169,MORRO AGUDO DE GOIAS,1434,1572,465,2060,31,1595,61
GO,92177,AMORINOPOLIS,2666,2436,681,3340,36,2659,72
GO,92207,EDEALINA,2620,2264,653,3227,42,2574,90
GO,92215,ANAPOLIS,146672,146844,34471,188467,2338,153996,4900
GO,92223,FAINA,3884,3236,2032,5794,53,3762,149
GO,92231,ANHANGUERA,666,466,169,772,10,603,27
GO,92258,ANICUNS,12344,8038,3269,14042,171,10773,411
GO,92266,GOUVELANDIA,2570,2184,924,3405,41,2481,63
GO,92274,APARECIDA DE GOIANIA,175674,100810,36938,181114,1909,144176,4025
GO,92282,ITAGUARI,2874,2464,877,3682,60,2805,76
GO,92290,APORE,1432,1624,908,2503,22,1595,45
GO,92312,ARACU,2992,2506,542,3425,34,2883,100
GO,92320,MATRINCHA,2660,2194,1102,3639,24,2537,86
GO,92339,ARAGARCAS,10436,4448,3301,11068,112,7767,213
GO,92347,MIMOSO DE GOIAS,1414,2236,582,2507,22,1925,78
GO,92355,ARAGOIANIA,4692,3002,681,4698,55,4017,115
GO,92363,MONTIVIDIU,5124,4596,1525,6604,69,5079,150
GO,92444,NOVO PLANALTO,1902,1864,912,2878,16,1966,67
GO,92460,PALESTINA DE GOIAS,1590,1900,780,2600,20,1820,55
GO,92495,ARUANA,2430,2528,1305,3867,27,2562,56
GO,92517,AURILANDIA,3420,1648,1009,3686,37,2677,106
GO,92550,AVELINOPOLIS,1580,1800,460,2255,50,1795,55
GO,92568,SANTA FE DE GOIAS,2716,1718,1010,3346,42,2336,77
GO,92614,BALIZA,1218,578,692,1640,6,948,44
GO,92622,SAO JOAO DA PARAUNA,1314,1028,423,1638,14,1215,30
GO,92630,BARRO ALTO,4282,2600,2326,5985,70,3659,148
GO,92649,SAO LUIZ DO NORTE,2292,1970,1317,3570,35,2253,87
GO,92657,BELA VISTA DE GOIAS,11626,9570,3030,14255,198,11225,429
GO,92665,SAO MIGUEL DO PASSA QUATRO,2368,1662,566,2659,29,2093,49
GO,92673,BOM JARDIM DE GOIAS,4636,3494,2120,6357,46,4237,126
GO,92690,BOM JESUS,8950,9102,2414,11821,130,9407,251
GO,92703,SENADOR CANEDO,32492,16762,7570,33222,341,25652,684
GO,92711,BRAZABRANTES,1680,1624,404,2124,24,1720,44
GO,92720,SIMOLANDIA,3142,3224,1762,5123,43,3361,135
GO,92754,BRITANIA,3378,2406,1494,4486,26,2992,74
GO,92762,TERESINA DE GOIAS,1298,1194,582,1906,14,1324,64
GO,92770,BURITI ALEGRE,5226,5044,1246,6663,91,5417,191
GO,92789,TROMBAS,2210,1732,971,3036,25,2065,69
GO,92797,CABECEIRAS,4186,2876,1472,5156,49,3684,104
GO,92800,TURVELANDIA,2276,1382,809,2724,25,1915,61
GO,92819,CACHOEIRA ALTA,4602,3726,1770,6217,106,4447,177
GO,92827,RIO QUENTE,1858,1334,572,2250,23,1678,59
GO,92835,CACHOEIRA DE GOIAS,834,978,363,1325,14,962,42
GO,92851,CACU,6414,5152,2008,8145,90,6137,264
GO,92860,GUARINOS,1226,1880,726,2335,15,1609,41
GO,92878,CAIAPONIA,8396,5734,2151,9687,115,7536,356
GO,92886,COCALZINHO DE GOIAS,5878,7430,2441,9671,185,7230,391
GO,92894,CALDAS NOVAS,31032,19862,7779,34739,485,26960,1028
GO,92908,SANTO ANTONIO DE GOIAS,2994,1284,578,2802,32,2224,53
GO,92916,CAMPESTRE DE GOIAS,1696,1736,372,2152,22,1780,42
GO,92924,CHAPADAO DO CEU,2406,1580,628,2687,27,2059,39
GO,92932,CAMPINORTE,3360,4906,2324,6651,62,4327,132
GO,92940,ALTO HORIZONTE,1344,1668,709,2268,15,1559,38
GO,92959,CAMPO ALEGRE DE GOIAS,2720,2584,862,3627,44,2765,69
GO,92967,CASTELANDIA,2668,1582,920,3152,46,2232,61
GO,92975,CAMPOS BELOS,9174,5818,4290,12319,135,8029,398
GO,92983,JESUPOLIS,1662,1206,518,2013,23,1495,38
GO,92991,CARMO DO RIO VERDE,4936,3630,1333,5867,102,4534,149
GO,93009,APARECIDA DO RIO DOCE,1686,1388,671,2295,21,1624,66
GO,93017,CATALAO,50740,25194,6958,46759,716,39801,1118
GO,93025,CIDADE OCIDENTAL,25836,10792,4150,23374,342,19224,568
GO,93033,CATURAI,2810,2406,667,3392,26,2725,91
GO,93041,PROFESSOR JAMIL,2748,1244,738,2816,28,2078,54
GO,93050,CAVALCANTE,2664,2544,3185,6088,42,2903,257
GO,93068,PEROLANDIA,2150,696,628,2131,22,1503,58
GO,93076,CERES,12326,10548,2429,14353,144,11924,343
GO,93084,NOVA IGUACU DE GOIAS,1036,1616,617,1983,12,1366,28
GO,93092,DIVINOPOLIS DE GOIAS,3024,1778,1512,4087,38,2575,136
GO,93106,BURITI DE GOIAS,2324,1042,765,2619,75,1854,96
GO,93122,CALDAZINHA,2196,1488,564,2484,27,1920,51
GO,93149,GUARAITA,1972,1530,738,2609,60,1871,60
GO,93157,CORREGO DO OURO,1750,1822,877,2741,29,1864,49
GO,93165,INACIOLANDIA,3532,2350,976,4078,57,3102,104
GO,93173,CORUMBA DE GOIAS,3922,5952,1124,6407,108,5283,238
GO,93181,MONTIVIDIU DO NORTE,1406,2078,655,2495,28,1840,70
GO,93190,CORUMBAIBA,4364,3426,1211,5360,74,4149,180
GO,93203,SANTO ANTONIO DA BARRA,2072,2774,831,3352,23,2521,75
GO,93220,TEREZOPOLIS DE GOIAS,3132,2726,741,3812,48,3071,94
GO,93246,UIRAPURU,1462,1704,688,2339,24,1651,44
GO,93254,CRISTALINA,12762,18896,4537,21214,298,16677,550
GO,93262,BURITINOPOLIS,1118,2208,795,2539,13,1744,68
GO,93270,CRISTIANOPOLIS,2306,1712,708,2817,32,2109,68
GO,93289,VILA BOA,2142,1040,595,2240,12,1645,42
GO,93297,CRIXAS,8652,4782,3176,10158,93,6982,172
GO,93300,VALPARAISO,42812,18168,6341,38666,746,32325,1089
GO,93319,CROMINIA,2806,2304,556,3219,46,2663,62
GO,93327,NOVO GAMA,29334,16808,5323,29655,458,24332,803
GO,93335,CUMARI,2202,1448,415,2341,42,1926,59
GO,93343,AGUAS LINDAS,28206,17292,6302,30550,674,24248,825
GO,93351,DAMIANOPOLIS,1028,2654,922,2838,15,1916,60
GO,93360,ABADIA DE GOIAS,3200,2294,711,3567,43,2856,66
GO,93378,DAMOLANDIA,2202,1702,382,2449,35,2067,80
GO,93386,AMARALINA,978,1844,679,2155,16,1476,49
GO,93394,DAVINOPOLIS,1632,1186,217,1700,36,1483,38
GO,93408,BONOPOLIS,1090,1572,811,2177,11,1366,24
GO,93424,PORTEIRAO,1732,1332,847,2446,18,1599,49
GO,93432,DIORAMA,1622,1398,611,2198,29,1587,48
GO,93440,SANTA RITA DO NOVO DESTINO,2172,1684,1003,3045,32,2042,82
GO,93483,SAO PATRICIO,1152,1318,334,1650,28,1316,53
GO,93491,EDEIA,4978,5234,1751,7129,78,5378,194
GO,93505,VILA PROPICIO,2192,2142,1322,3620,26,2298,105
GO,93513,ESTRELA DO NORTE,1888,2028,939,2976,23,2037,56
GO,93530,FAZENDA NOVA,3836,3290,1567,5339,67,3772,142
GO,93548,IPIRANGA DE GOIAS,1620,1506,454,2105,29,1651,59
GO,93564,GAMELEIRA DE GOIAS,1136,1638,330,1768,17,1438,34
GO,93572,FIRMINOPOLIS,5696,5178,1263,6978,87,5715,191
GO,93580,CAMPO LIMPO DE GOIAS,2430,3240,719,3668,37,2949,77
GO,93599,FLORES DE GOIAS,2764,2752,1570,4491,36,2921,127
GO,93602,LAGOA SANTA,490,666,210,813,7,603,18
GO,93610,FORMOSA,46872,30916,9913,50665,558,40752,1300
GO,93637,FORMOSO,3006,2790,1552,4609,52,3057,107
GO,93670,GOIANAPOLIS,4820,6664,2325,8380,114,6055,199
GO,93696,GOIANDIRA,4140,2134,460,3749,44,3289,108
GO,93718,GOIANESIA,30808,19960,8383,35141,522,26758,852
GO,93734,GOIANIA,696714,484022,144130,762093,8431,617963,19164
GO,93750,GOIANIRA,12550,5940,2441,12128,148,9687,294
GO,93777,GOIAS,18376,10650,5602,20805,235,15203,455
GO,93793,GOIATUBA,17638,16270,5754,23719,357,17965,654
GO,93815,GUAPO,6970,6746,2009,9180,104,7171,209
GO,93831,GUARANI DE GOIAS,1700,2884,1036,3431,19,2395,84
GO,93874,HEITORAI,1868,1954,640,2644,25,2004,68
GO,93890,HIDROLANDIA,8622,6122,2158,9880,116,7722,234
GO,93912,HIDROLINA,2594,2434,939,3565,27,2626,85
GO,93939,IACIARA,3478,5610,2141,6963,50,4822,228
GO,93955,INHUMAS,29144,20938,6051,32083,302,26032,689
GO,93971,IPAMERI,14542,10002,4366,17420,221,13054,561
GO,93998,IPORA,17102,15206,5543,22521,280,16978,544
GO,94013,ISRAELANDIA,1554,2006,718,2566,25,1848,43
GO,94030,ITABERAI,14734,13714,4764,19729,248,14965,493
GO,94072,ITAGUARU,4264,2822,782,4505,58,3723,122
GO,94110,ITAJA,2870,2762,1000,3958,42,2958,100
GO,94137,ITAPACI,6618,8056,2560,10215,96,7655,222
GO,94153,ITAPIRAPUA,4748,3696,2287,6711,51,4424,151
GO,94196,ITAPURANGA,18400,10892,5327,20839,309,15512,557
GO,94218,ITARUMA,2304,2788,1252,3897,28,2645,71
GO,94234,ITAUCU,6000,4294,1038,6429,84,5391,160
GO,94250,ITUMBIARA,48468,42996,12577,60241,707,47664,1225
GO,94277,IVOLANDIA,1606,1766,605,2360,21,1755,48
GO,94293,JANDAIA,4956,3148,1369,5614,66,4245,127
GO,94315,JARAGUA,17892,15910,5131,23081,358,17950,691
GO,94331,JATAI,56272,23192,10600,52239,573,41639,1334
GO,94358,JAUPACI,2224,1208,618,2411,22,1793,55
GO,94374,JOVIANIA,4184,3498,1316,5410,88,4094,165
GO,94390,JUSSARA,11022,9184,4211,14776,158,10565,304
GO,94439,LEOPOLDO DE BULHOES,4402,3950,1875,6336,86,4461,199
GO,94455,LUZIANIA,66492,52700,12599,75465,1111,62866,2159
GO,94471,MAIRIPOTABA,1516,1440,472,2001,19,1529,32
GO,94498,MAMBAI,1534,3170,1063,3557,27,2494,115
GO,94510,MARA ROSA,3724,7114,2386,8073,73,5687,195
GO,94536,MARZAGAO,1236,1152,383,1635,15,1252,43
GO,94552,PARANAIGUARA,5178,4098,1808,6654,63,4846,145
GO,94579,MAURILANDIA,6158,3126,1931,6813,99,4882,141
GO,94595,MINEIROS,24572,15866,5497,26664,330,21167,618
GO,94650,MOIPORA,1016,1560,443,1773,15,1330,27
GO,94676,MONTE ALEGRE DE GOIAS,2370,3204,1967,4957,43,2990,160
GO,94714,MONTES CLAROS DE GOIAS,3818,4004,1382,5486,73,4104,120
GO,94730,MORRINHOS,26576,16350,5354,27752,294,22398,641
GO,94757,MOSSAMEDES,3814,1928,1496,4529,47,3033,115
GO,94773,MOZARLANDIA,6066,5796,2743,8923,64,6180,185
GO,94790,MUTUNOPOLIS,1876,2592,1019,3361,38,2342,70
GO,94854,NAZARIO,4232,3580,788,4856,56,4068,106
GO,94870,NEROPOLIS,12590,8896,2765,14079,181,11314,390
GO,94897,NIQUELANDIA,19392,14972,9843,27892,282,18049,585
GO,94919,NOVA AMERICA,1180,1746,351,1878,22,1527,42
GO,94935,NOVA AURORA,1310,1384,182,1587,32,1405,26
GO,94951,NOVA ROMA,1220,2086,1127,2880,22,1753,78
GO,94978,NOVA VENEZA,4680,3322,1000,5228,57,4228,170
GO,95010,NOVO BRASIL,2590,1850,1080,3394,39,2314,55
GO,95036,ORIZONA,9122,6118,1791,9853,143,8062,299
GO,95052,OURO VERDE DE GOIAS,2584,2566,918,3683,54,2765,136
GO,95079,OUVIDOR,3662,2354,557,3674,40,3117,69
GO,95095,PADRE BERNARDO,7356,7350,3558,11441,141,7883,389
GO,95117,PALMEIRAS DE GOIAS,8486,12944,3087,14247,144,11160,301
GO,95133,PALMELO,1640,1220,470,1961,20,1491,41
GO,95150,PALMINOPOLIS,1700,2390,594,2717,16,2123,62
GO,95176,PANAMA,1750,1716,534,2341,29,1807,45
GO,95230,PARAUNA,6858,3740,2404,7916,42,5512,171
GO,95311,PETROLINA DE GOIAS,4744,6168,1444,7175,85,5731,190
GO,95354,PILAR DE GOIAS,1352,2014,922,2686,32,1764,49
GO,95397,PIRACANJUBA,16908,9996,3791,17809,150,14018,416
GO,95419,PIRANHAS,7816,4430,1969,8450,126,6481,232
GO,95435,PIRENOPOLIS,10334,13892,3588,16460,250,12872,509
GO,95451,PIRES DO RIO,16750,12108,3918,19250,305,15332,598
GO,95494,PONTALINA,10656,8308,3177,13283,210,10106,414
GO,95559,PORANGATU,21052,15960,8567,27798,212,19231,513
GO,95575,PORTELANDIA,2810,1610,776,3112,61,2336,65
GO,95613,POSSE,11006,12700,5834,18325,152,12491,486
GO,95630,QUIRINOPOLIS,26860,14818,5558,27376,382,21818,597
GO,95656,RIALMA,5146,5814,1715,7471,88,5756,188
GO,95672,RIANAPOLIS,2586,2238,1250,3849,69,2599,118
GO,95710,RIO VERDE,58784,56692,14787,75265,879,60478,1861
GO,95737,RUBIATABA,8912,10358,3346,13499,183,10153,335
GO,95753,SANCLERLANDIA,5782,3012,1890,6512,96,4622,129
GO,95770,SANTA BARBARA DE GOIAS,3240,2062,709,3460,34,2751,66
GO,95796,SANTA CRUZ DE GOIAS,2136,1310,604,2413,37,1809,49
GO,95818,SANTA HELENA DE GOIAS,20364,19660,5957,26931,358,20974,604
GO,95834,SANTA RITA DO ARAGUAIA,2564,2610,978,3687,48,2709,74
GO,95850,SANTA ROSA DE GOIAS,2566,1698,584,2883,74,2299,93
GO,95877,SANTA TEREZA DE GOIAS,2378,2350,1355,3872,69,2517,84
GO,95893,SANTA TEREZINHA DE GOIAS,4522,6096,3050,8564,61,5514,144
GO,95915,SAO DOMINGOS,4360,3634,2712,6983,75,4271,199
GO,95931,SAO FRANCISCO DE GOIAS,2904,3438,633,3969,54,3336,111
GO,95958,PLANALTINA,39358,17806,7503,37828,691,30325,1052
GO,95974,SAO JOAO D ALIANCA,3620,2530,1775,5065,80,3290,135
GO,95990,SAO LUIS DE MONTES BELOS,14580,14622,5021,20478,264,15457,592
GO,96016,SAO MIGUEL DO ARAGUAIA,9078,10844,4607,15036,144,10429,324
GO,96059,SAO SIMAO,9958,5522,3329,11416,111,8087,236
GO,96075,SERRANOPOLIS,4136,2202,1233,4609,79,3376,128
GO,96091,SILVANIA,10676,7986,2187,11895,119,9708,258
GO,96113,SITIO D ABADIA,1376,1522,869,2375,6,1506,51
GO,96172,TAQUARAL DE GOIAS,1808,2312,643,2828,34,2185,91
GO,96237,TRES RANCHOS,2216,1238,316,2133,33,1817,57
GO,96253,TRINDADE,52426,32980,10384,54604,489,44220,1028
GO,96318,TURVANIA,3160,3130,871,4159,52,3288,91
GO,96334,URUACU,14998,16008,7612,23791,242,16179,434
GO,96350,URUANA,9284,6138,2473,10657,169,8184,304
GO,96377,URUTAI,1826,1494,383,2176,54,1793,79
GO,96393,VARJAO,2270,2826,939,3619,36,2680,96
GO,96415,VIANOPOLIS,4756,6510,1366,7277,110,5911,168
GO,96458,ACREUNA,11776,6438,2934,12446,142,9512,263
GO,96474,MINACU,17134,14542,8209,24760,260,16551,453
GO,96512,MUNDO NOVO DE GOIAS,2538,3062,1557,4487,38,2930,92
GO,96539,NOVA CRIXAS,3510,5048,2156,6620,30,4464,155
GO,96555,NOVA GLORIA,5154,3744,1948,6652,97,4704,158
GO,96571,VICENTINOPOLIS,4038,2506,1065,4562,86,3497,139
GO,96610,AMERICANO DO BRASIL,4240,2098,808,4110,43,3302,90
GO,96695,ARAGUAPAZ,3552,3388,1717,5394,71,3677,136
GO,96717,ARENOPOLIS,2682,1756,971,3303,31,2332,82
GO,96733,CACHOEIRA DOURADA,5470,4706,1415,6719,59,5304,157
GO,96750,DOVERLANDIA,4744,3386,1609,5895,74,4286,147
GO,96776,SANTO ANTONIO DO DESCOBERTO,23162,16892,5911,27178,465,21267,775
GO,96814,INDIARA,6574,4030,1934,7640,148,5706,256
GO,96873,CAMPINACU,1478,2248,1251,3200,34,1949,52
GO,96890,SANTA ISABEL,1572,2096,539,2485,32,1946,80
GO,96911,ADELANDIA,1546,1472,624,2208,30,1584,45
GO,96938,AGUA FRIA DE GOIAS,1664,2290,1216,3325,37,2109,95
MA,7005,AGUA DOCE,2266,5934,1808,6212,95,4404,209
MA,7013,AFONSO CUNHA,2354,1720,1171,3373,43,2202,122
MA,7021,ALTO ALEGRE DO MARANHAO,6280,5894,3489,10012,79,6523,357
MA,7030,ALCANTARA,9996,3428,3618,10962,235,7344,397
MA,7048,ALTO ALEGRE DO PINDARE,8198,8968,5490,14624,88,9134,463
MA,7056,ALDEIAS ALTAS,7864,4258,4509,11150,96,6641,484
MA,7064,APICUM ACU,1506,5298,2332,5889,33,3557,122
MA,7072,ALTAMIRA DO MARANHAO,4878,1636,1637,5104,32,3467,178
MA,7080,AMAPA DO MARANHAO,2034,2362,1414,3755,27,2341,116
MA,7099,ALTO PARNAIBA,2334,4400,2631,6239,51,3608,190
MA,7102,ARAGUANA,3400,2794,2824,6100,49,3276,130
MA,7110,AMARANTE DO MARANHAO,8058,11354,5219,15494,126,10275,443
MA,7129,BACABEIRA,6496,2916,1856,6921,98,5065,261
MA,7137,ANAJATUBA,13718,1602,6268,14481,134,8213,419
MA,7145,BACURITUBA,2232,1084,1743,3519,35,1776,83
MA,7153,ANAPURUS,3572,5996,2055,7198,87,5143,272
MA,7161,BELAGUA,3644,886,1266,3700,13,2434,156
MA,7170,ARAIOSES,6816,20530,7865,22477,245,14612,694
MA,7188,BELA VISTA,3898,2856,2408,5976,28,3568,163
MA,7196,ARARI,14842,5490,4716,15496,198,10780,416
MA,7200,BERNARDO DO MEARIM,2092,2688,921,3492,47,2571,134
MA,7218,AXIXA,2972,4502,2756,6734,83,3978,158
MA,7226,CACHOEIRA GRANDE,2940,1422,2013,4406,49,2393,163
MA,7234,BACABAL,48316,22190,19708,56839,533,37131,1345
MA,7242,DAVINOPOLIS,4646,4540,2712,7565,56,4853,204
MA,7250,BACURI,3552,6334,3467,8735,61,5268,264
MA,7269,BOM JESUS DAS SELVAS,4922,6802,3921,10173,50,6252,340
MA,7277,BALSAS,21326,22950,11624,35006,362,23382,882
MA,7285,BOM LUGAR,4802,4922,2835,7949,33,5114,219
MA,7293,BARAO DE GRAJAU,6238,7086,2731,9869,140,7138,336
MA,7307,BREJO DE AREIA,3990,2664,1834,5461,51,3627,249
MA,7315,BARRA DO CORDA,13918,37378,14241,41502,419,27261,1194
MA,7323,BOA VISTA DO GURUPI,2422,1722,1010,3170,7,2160,81
MA,7331,BARREIRINHAS,20464,10522,9166,25622,250,16456,713
MA,7340,BURITICUPU,17186,13754,7884,24203,175,16319,674
MA,7358,BENEDITO LEITE,1950,2448,1240,3603,21,2363,143
MA,7366,BURITIRANA,4220,6462,2662,8294,78,5632,213
MA,7374,BEQUIMAO,11376,1940,8323,15588,305,7265,302
MA,7382,CAMPESTRE DO MARANHAO,4290,4452,2046,6688,90,4642,181
MA,7390,BREJO,4614,17220,6270,17824,110,11554,527
MA,7404,CAPINZAL DO NORTE,4650,3498,1460,5783,56,4323,193
MA,7412,BURITI,6902,10482,5465,14865,183,9400,525
MA,7420,CENTRAL DO MARANHAO,3628,560,1993,4281,55,2288,139
MA,7439,BURITI BRAVO,7622,7320,3333,11414,133,8081,477
MA,7447,CENTRO DO GUILHERME,2786,1522,1461,3768,22,2307,131
MA,7455,CAJAPIO,4918,1818,2241,5847,62,3606,176
MA,7463,CENTRO NOVO DO MARANHAO,3088,4376,2378,6358,30,3980,218
MA,7471,CAJARI,7568,2992,5062,10698,62,5636,294
MA,7480,CIDELANDIA,4950,4186,2839,7690,61,4851,222
MA,7498,CANDIDO MENDES,2692,7872,4479,10003,44,5524,198
MA,7501,CONCEICAO DO LAGO ACU,2998,4176,3254,7064,33,3810,190
MA,7510,CANTANHEDE,5226,4356,3082,8205,65,5123,267
MA,7528,FEIRA NOVA DO MARANHAO,2870,2902,854,3946,46,3092,160
MA,7536,CAROLINA,9252,9682,5643,15725,137,10082,478
MA,7544,FERNANDO FALCAO,1286,3970,1756,4541,20,2785,137
MA,7552,CARUTAPERA,5170,7258,4361,10913,78,6552,260
MA,7560,FORMOSA DA SERRA NEGRA,2340,6932,2219,7097,42,4878,200
MA,7579,CAXIAS,62488,31660,32490,82104,639,49614,1901
MA,7595,CEDRAL,3752,1972,2843,6032,153,3189,174
MA,7609,GOVERNADOR EDSON LOBAO,3850,4432,1440,5763,33,4323,149
MA,7617,CHAPADINHA,24716,16598,11718,34026,575,22308,1076
MA,7625,GOVERNADOR LUIZ ROCHA,3094,4412,1545,5516,47,3971,171
MA,7633,CODO,34130,30086,28166,62217,544,34051,1399
MA,7641,GOVERNADOR NEWTON BELLO,2590,3300,2766,5897,25,3131,161
MA,7650,COELHO NETO,20172,11912,10071,27179,275,17108,791
MA,7668,GOVERNADOR NUNES FREIRE,5428,5974,2933,8976,55,6043,287
MA,7676,COLINAS,7230,14966,6696,18535,148,11839,593
MA,7684,IGARAPE DO MEIO,3594,2474,2308,5558,49,3250,167
MA,7692,COROATA,25748,17854,12225,35808,451,23583,1331
MA,7706,ITAIPAVA DO GRAJAU,2314,4742,1903,5638,32,3735,175
MA,7714,CURURUPU,8270,14056,6081,17880,256,11799,380
MA,7722,ITINGA DO MARANHAO,6964,9646,4309,12911,66,8602,231
MA,7730,DOM PEDRO,5902,11714,4959,14209,130,9250,312
MA,7749,JATOBA,1888,3374,1239,4003,24,2764,109
MA,7757,DUQUE BACELAR,5100,2206,2019,5947,50,3928,225
MA,7765,JENIPAPO DOS VIEIRAS,2218,7440,1640,6720,47,5080,204
MA,7773,ESPERANTINOPOLIS,8806,6322,2966,10984,106,8018,348
MA,7781,JUNCO DO MARANHAO,2274,2152,1131,3479,38,2348,97
MA,7790,FORTALEZA DOS NOGUEIRAS,5650,3368,2215,6991,93,4776,174
MA,7803,LAGO DOS RODRIGUES,5328,3676,1252,5993,39,4741,200
MA,7811,FORTUNA,5950,6578,3274,10038,137,6764,363
MA,7820,LAGOA DO MATO,2222,3250,2817,5718,17,2901,148
MA,7838,GODOFREDO VIANA,1426,3226,2036,4477,24,2441,91
MA,7846,LAGOA GRANDE DO MARANHAO,3478,4054,2812,6792,32,3980,182
MA,7854,GONCALVES DIAS,4444,7326,3890,10143,92,6253,276
MA,7862,LAJEADO NOVO,2270,2656,1094,3709,41,2615,111
MA,7870,GOVERNADOR ARCHER,2712,4612,2226,6112,42,3886,182
MA,7889,MARACACUME,3384,7158,4460,10048,54,5588,263
MA,7897,GOVERNADOR EUGENIO BARROS,6266,3840,1965,7408,80,5443,310
MA,7900,MARAJA DO SENA,2624,3888,1810,5330,42,3520,222
MA,7919,GRACA ARANHA,2992,2918,1401,4553,37,3152,160
MA,7927,MARANHAOZINHO,2892,2588,1588,4488,47,2900,113
MA,7935,GRAJAU,13294,17640,8421,24762,204,16341,670
MA,7943,MATOES DO NORTE,2914,1944,1848,4503,37,2655,189
MA,7951,GUIMARAES,6440,2456,2845,7765,230,4920,242
MA,7960,MILAGRES DO MARANHAO,1578,2774,1078,3367,14,2289,99
MA,7978,HUMBERTO DE CAMPOS,7824,5528,5465,12638,90,7173,407
MA,7986,NOVA COLINAS,2692,1188,838,2934,35,2096,121
MA,7994,ICATU,5198,8122,4679,11863,178,7184,346
MA,8001,NOVA OLINDA DO MARANHAO,4976,5884,2836,8656,81,5820,309
MA,8010,IGARAPE GRANDE,3554,5904,2260,7218,55,4958,174
MA,8028,OLINDA NOVA DO MARANHAO,2114,3804,2939,6126,56,3187,172
MA,8036,IMPERATRIZ,87902,98180,38096,134910,1393,96814,2380
MA,8044,PAULINO NEVES,3620,3800,2745,6808,90,4063,263
MA,8052,SAO LUIS GONZAGA DO MARANHAO,10584,6986,6174,15607,125,9433,523
MA,8060,PEDRO DO ROSARIO,5426,3144,3904,8598,83,4694,326
MA,8079,ITAPECURU MIRIM,24736,7864,10545,27978,287,17433,846
MA,8087,PERITORO,6884,5682,3274,9988,84,6714,347
MA,8095,JOAO LISBOA,8434,10968,5338,15589,156,10251,394
MA,8109,PORTO RICO DO MARANHAO,1588,3540,2498,5178,39,2680,77
MA,8117,JOSELANDIA,4616,7130,2509,8838,95,6329,361
MA,8125,PRESIDENTE MEDICI,2442,2322,837,3367,38,2530,110
MA,8133,LAGO DA PEDRA,13842,18398,11169,28280,224,17111,767
MA,8141,PRESIDENTE SARNEY,4762,2330,3468,7317,94,3849,209
MA,8150,LAGO DO JUNCO,4966,2880,1786,5960,57,4174,194
MA,8168,RAPOSA,9070,4380,4551,11950,146,7399,270
MA,8176,LAGO VERDE,6268,4050,3421,8932,73,5511,279
MA,8184,RIBAMAR FIQUENE,2132,3624,1413,4458,26,3045,141
MA,8192,LIMA CAMPOS,4890,6140,2028,7976,107,5948,326
MA,8206,SANTA FILOMENA DO MARANHAO,2288,2370,987,3469,35,2482,118
MA,8214,LORETO,3950,3316,2329,6205,47,3876,196
MA,8222,SANTANA DO MARANHAO,1628,3612,1307,4114,33,2807,154
MA,8230,LUIS DOMINGUES DO MARANHAO,1258,3486,1363,3851,14,2488,102
MA,8249,SANTO AMARO DO MARANHAO,3022,2376,3721,6642,55,2921,167
MA,8257,MAGALHAES DE ALMEIDA,4200,6798,3488,9296,55,5808,254
MA,8265,SAO DOMINGOS DO AZEITAO,3884,1298,1370,4170,35,2800,174
MA,8273,MATA ROMA,4204,7428,1921,8137,112,6216,288
MA,8281,SAO FRANCISCO DO BREJAO,2524,3704,1055,4326,35,3271,122
MA,8290,MATINHA,8044,6974,4192,12170,129,7978,340
MA,8303,SAO JOAO DO CARU,2664,4444,3675,7448,33,3773,186
MA,8311,MATOES,7104,7258,5954,13657,100,7703,422
MA,8320,SAO JOAO DO PARAISO,2600,5344,2051,6221,43,4170,155
MA,8338,MIRADOR,5740,6468,5062,11561,78,6499,317
MA,8346,SAO JOAO DO SOTER,3878,4416,3923,8383,34,4460,279
MA,8354,MIRINZAL,4662,3392,3484,7821,154,4337,156
MA,8362,SAO JOSE DOS BASILIOS,3130,3638,1502,5113,53,3611,174
MA,8370,MONCAO,7876,7764,5664,14046,100,8382,462
MA,8389,SAO PEDRO DA AGUA BRANCA,4428,3344,2540,6649,35,4109,188
MA,8397,MONTES ALTOS,4342,3936,1726,6129,87,4403,177
MA,8400,SAO PEDRO DOS CRENTES,1196,2570,645,2665,35,2020,102
MA,8419,MORROS,6234,2614,4032,8854,103,4822,295
MA,8427,SAO RAIMUNDO DA DOCA BEZERRA,2046,2794,1122,3681,32,2559,107
MA,8435,NINA RODRIGUES,4210,2698,1926,5627,39,3701,208
MA,8443,SAO ROBERTO,2428,1434,1072,3114,25,2042,86
MA,8451,NOVA IORQUE,1096,2756,1046,3085,18,2039,95
MA,8460,SATUBINHA,2866,1614,1532,3902,24,2370,106
MA,8478,OLHO D AGUA DAS CUNHAS,6340,8616,4463,12342,96,7879,305
MA,8486,SENADOR ALEXANDRE COSTA,2560,3438,2853,6068,31,3215,185
MA,8494,PACO DO LUMIAR,39138,9520,8787,34590,720,25803,754
MA,8508,SENADOR LA ROQUE,8012,8490,3587,12370,163,8783,369
MA,8516,PALMEIRANDIA,8950,2144,4242,10223,118,5981,316
MA,8524,SERRANO DO MARANHAO,2272,3340,3503,6576,46,3073,221
MA,8532,PARAIBANO,7240,7434,5160,13071,101,7911,473
MA,8540,SUCUPIRA DO RIACHAO,2174,2314,729,3150,38,2421,139
MA,8559,PARNARAMA,12106,8690,6744,17891,149,11147,600
MA,8567,TRIZIDELA DO VALE,10186,5990,3854,12415,123,8561,350
MA,8575,PASSAGEM FRANCA,3672,7532,4178,10155,77,5977,298
MA,8583,TUFILANDIA,1582,2988,1522,3962,30,2440,125
MA,8591,PASTOS BONS,6116,5984,3256,9763,70,6507,387
MA,8605,TURILANDIA,5628,2338,4747,9030,65,4283,235
MA,8613,PEDREIRAS,20492,12650,8374,25900,284,17526,671
MA,8621,VILA NOVA DOS MARTIRIOS,2342,2326,860,3321,39,2461,88
MA,8630,PENALVA,11462,7758,8284,18383,76,10099,413
MA,8656,PERI MIRIM,6176,2042,3945,8355,112,4410,189
MA,8672,PINDARE MIRIM,12294,9628,4711,16339,182,11628,485
MA,8699,PINHEIRO,30328,15688,17169,41625,674,24456,774
MA,8710,PIO XII,9990,6686,5455,14301,109,8846,399
MA,8737,PIRAPEMAS,6250,4470,3255,9035,110,5780,310
MA,8753,POCAO DE PEDRAS,6044,10166,4997,13630,118,8633,410
MA,8770,PORTO FRANCO,6108,8708,3245,10974,82,7729,239
MA,8796,PRESIDENTE DUTRA,13044,16880,8132,24062,310,15930,658
MA,8818,PRESIDENTE JUSCELINO,3516,1460,2933,5579,25,2646,133
MA,8834,PRESIDENTE VARGAS,4354,2940,2234,6214,90,3980,243
MA,8850,PRIMEIRA CRUZ,3460,3508,2854,6612,66,3758,208
MA,8877,RIACHAO,8778,5472,3950,11532,82,7582,375
MA,8893,SAO JOSE DE RIBAMAR,43790,13916,11486,41818,640,30332,839
MA,8915,ROSARIO,18448,7306,9174,22947,350,13773,546
MA,8931,SAMBAIBA,2478,1712,2117,4372,25,2255,135
MA,8958,SANTA HELENA,11720,6004,6700,16150,223,9450,365
MA,8974,SANTA LUZIA,25552,18724,15650,39240,278,23590,1174
MA,8990,SANTA QUITERIA DO MARANHAO,6002,12020,3408,13030,104,9622,507
MA,9016,SANTA RITA,7872,8690,6567,15418,188,8851,382
MA,9032,SANTO ANTONIO DOS LOPES,4652,6844,2631,8780,79,6149,322
MA,9059,SAO BENEDITO DO RIO PRETO,5902,5010,2975,8893,126,5918,336
MA,9075,SAO BENTO,10206,12546,7855,19980,263,12125,486
MA,9091,SAO BERNARDO,6118,12306,3730,13539,105,9809,492
MA,9113,SAO DOMINGOS DO MARANHAO,8214,17882,7005,20918,206,13913,659
MA,9130,SAO FELIX DE BALSAS,1512,2006,1251,3115,18,1864,87
MA,9156,SAO FRANCISCO DO MARANHAO,2402,6322,2909,7567,80,4658,216
MA,9172,SAO JOAO BATISTA,10812,3002,7330,14639,119,7309,283
MA,9199,SAO JOAO DOS PATOS,9460,8844,5220,15028,201,9808,455
MA,9210,SAO LUIS,674966,120580,130041,546213,7713,416172,10686
MA,9237,SAO MATEUS DO MARANHAO,10378,14826,7564,21096,221,13532,709
MA,9253,SAO RAIMUNDO DAS MANGABEIRAS,4486,6434,3758,9636,106,5878,312
MA,9270,SAO VICENTE FERRER,5120,4192,7245,12241,142,4996,198
MA,9296,SITIO NOVO,3562,8428,4054,10475,120,6421,306
MA,9318,SUCUPIRA DO NORTE,3558,3918,2584,6554,60,3970,172
MA,9334,TASSO FRAGOSO,1812,2706,1620,4043,47,2423,117
MA,9350,TIMBIRAS,7030,7742,5757,13667,89,7910,435
MA,9377,TIMON,77120,26688,23414,78437,712,55023,2407
MA,9393,TUNTUM,9344,16198,9161,22697,204,13536,561
MA,9415,TURIACU,7120,11966,7286,17492,138,10206,525
MA,9431,TUTOIA,8312,18666,7672,22224,250,14552,813
MA,9458,URBANO SANTOS,11368,3908,5144,13468,183,8324,503
MA,9474,VARGEM GRANDE,12078,10020,10665,22636,170,11971,752
MA,9490,VIANA,17504,12552,13677,29869,442,16192,722
MA,9512,VITORIA DO MEARIM,10230,9804,9778,20442,180,10664,467
MA,9539,VITORINO FREIRE,11382,12894,7050,20015,204,12965,623
MA,9555,BOM JARDIM,10208,12966,8446,20768,159,12322,576
MA,9571,SANTA INES,33544,27954,10725,43033,464,32308,1095
MA,9598,PAULO RAMOS,5328,9384,3422,11255,76,7833,401
MA,9610,ACAILANDIA,33318,35230,17053,52877,569,35824,981
MA,9636,ESTREITO,7146,11590,4385,14218,133,9833,332
MA,9652,SANTA LUZIA DO PARUA,6902,8818,3326,11659,144,8333,329
MA,9679,ARAME,7520,9076,5476,14247,60,8771,413
MA,9695,MIRANDA DO NORTE,9714,2128,4065,10411,125,6346,300
MA,9717,ZE DOCA,9332,18514,11803,26552,199,14749,627
MG,40002,ALFREDO VASCONCELOS,4184,2216,494,3899,58,3405,147
MG,40010,ABADIA DOS DOURADOS,3836,3898,1414,5542,102,4128,159
MG,40029,ARAPORA,5266,2292,1276,5256,62,3980,139
MG,40037,ABAETE,10952,12952,3547,16177,303,12630,375
MG,40045,BRASILANDIA DE MINAS,6180,4882,2018,7819,78,5801,192
MG,40053,ABRE CAMPO,7510,6502,1867,9379,168,7512,338
MG,40061,CAPITAO ANDRADE,2810,1774,1276,3724,28,2448,128
MG,40070,ACAIACA,2408,1738,801,3026,30,2225,122
MG,40088,CARNEIRINHO,5808,4172,1622,6801,59,5179,130
MG,40096,ACUCENA,7196,3304,2888,8801,206,5913,457
MG,40100,CATUJI,3832,3794,1564,5660,38,4096,245
MG,40118,AGUA BOA,4600,7282,4107,10509,85,6402,376
MG,40126,DIVISA ALEGRE,1842,2968,1078,3633,30,2555,120
MG,40134,AGUA COMPRIDA,1892,1432,736,2491,22,1755,71
MG,40142,DIVISOPOLIS,1748,5008,1587,5167,29,3580,173
MG,40150,AGUANIL,2720,1612,639,2969,66,2330,98
MG,40169,DURANDE,3446,3548,1326,5047,67,3721,157
MG,40177,AGUAS FORMOSAS,10670,5286,3925,12472,131,8547,438
MG,40185,ENTRE FOLHAS,3998,2674,1139,4659,51,3520,133
MG,40193,AGUAS VERMELHAS,2800,6668,3224,8261,63,5037,240
MG,40207,FERVEDOURO,5162,3692,1695,6447,97,4752,228
MG,40215,AIMORES,13692,13244,4911,19096,240,14185,477
MG,40223,FRANCISCOPOLIS,1142,3188,1535,3932,45,2397,187
MG,40231,AIURUOCA,3688,2994,1048,4649,63,3601,197
MG,40240,ICARAI DE MINAS,2866,5406,2589,6918,28,4329,165
MG,40258,ALAGOA,1122,2134,462,2183,23,1721,70
MG,40266,IPABA,10154,4652,2053,9829,137,7776,236
MG,40274,ALBERTINA,1762,1462,421,2119,27,1698,59
MG,40282,JAIBA,8980,11874,4500,15579,168,11079,484
MG,40290,ALEM PARAIBA,30198,9608,5173,26232,413,21059,743
MG,40304,JAMPRUCA,3158,1394,1063,3543,47,2480,157
MG,40312,ALFENAS,44562,28450,7904,46033,691,38129,932
MG,40320,JUATUBA,12500,3724,1727,10476,222,8749,415
MG,40339,ALMENARA,15658,15064,8092,24548,204,16456,891
MG,40347,LAGOA GRANDE,4530,3012,1287,5224,66,3937,100
MG,40355,ALPERCATA,5202,2864,1632,5906,62,4274,179
MG,40363,LIMEIRA DO OESTE,4948,1874,1130,4714,56,3584,117
MG,40371,ALPINOPOLIS,11388,7568,2263,12324,241,10061,342
MG,40380,LONTRA,2380,4904,2164,6029,71,3865,152
MG,40398,ALTEROSA,5970,8896,1508,9367,152,7859,274
MG,40401,MAMONAS,1290,5566,1453,5039,35,3586,123
MG,40410,ALTO RIO DOCE,5740,7574,3635,10816,182,7181,342
MG,40428,MATA VERDE,1776,4436,1710,5062,32,3352,214
MG,40436,ALVARENGA,3510,2308,1353,4410,36,3057,112
MG,40444,MATIAS CARDOSO,1770,4324,2075,5400,38,3325,240
MG,40452,ALVINOPOLIS,14482,3282,2323,11787,151,9464,431
MG,40460,MONTEZUMA,888,4686,1531,4561,35,3030,208
MG,40479,ALVORADA DE MINAS,1960,1034,1026,2681,25,1655,133
MG,40487,NAQUE,4248,1684,944,4131,53,3187,168
MG,40495,AMPARO DO SERRA,3476,2168,580,3609,43,3029,164
MG,40509,NOVO ORIENTE DE MINAS,4900,3406,3123,7696,67,4573,353
MG,40517,ANDRADAS,20278,17298,2947,22923,404,19976,784
MG,40525,PALMOPOLIS,3258,2268,2567,5559,29,2992,200
MG,40533,CACHOEIRA DE PAJEU,3570,4132,2167,6262,57,4095,187
MG,40541,PEDRAS DE MARIA DA CRUZ,2890,3832,1868,5451,49,3583,173
MG,40550,ANDRELANDIA,7614,6220,2739,10136,169,7397,311
MG,40568,PERIQUITO,4928,2276,1579,5421,81,3842,159
MG,40576,ANTONIO CARLOS,10564,3060,1416,8685,137,7269,320
MG,40584,PONTO DOS VOLANTES,4040,3856,1725,6045,57,4320,315
MG,40592,ANTONIO DIAS,7448,3018,1638,7315,141,5677,303
MG,40606,RIACHINHO,4416,2310,1222,4791,57,3569,149
MG,40614,ANTONIO PRADO DE MINAS,1722,684,219,1503,22,1284,59
MG,40622,ROSARIO DA LIMEIRA,3728,2096,870,3949,59,3079,108
MG,40630,ARACAI,2034,626,418,1838,18,1420,72
MG,40649,SANTA BARBARA DO LESTE,4334,4252,1293,5841,73,4548,182
MG,40657,ARACITABA,1420,1092,151,1546,56,1395,83
MG,40665,SANTA RITA DE MINAS,3482,2256,615,3705,72,3090,149
MG,40673,ARACUAI,15068,15338,8247,24315,188,16068,677
MG,40681,SANTANA DO PARAISO,10536,5696,2025,10628,177,8603,310
MG,40690,ARAGUARI,67944,48784,12416,73569,921,61153,1868
MG,40703,SAO JOAO DA LAGOA,2990,1482,806,3195,45,2389,108
MG,40711,ARANTINA,2948,732,586,2554,58,1968,70
MG,40720,SAO JOAO DO MANHUACU,4712,4846,1178,6217,93,5039,167
MG,40738,ARAPONGA,4702,2336,1451,5428,113,3977,345
MG,40746,SAO JOAO DO MANTENINHA,2692,2532,948,3716,57,2768,99
MG,40754,ARAPUA,1338,2432,379,2400,53,2021,83
MG,40762,SAO JOAO DO PACUI,2458,1048,963,2835,25,1872,94
MG,40770,ARAUJOS,3644,3738,679,4554,85,3875,99
MG,40789,SAO JOSE DA LAPA,14792,3144,1210,10615,199,9405,238
MG,40797,ARAXA,54890,39314,8823,58579,837,49756,1817
MG,40800,SARZEDO,11548,3132,1020,8949,254,7929,335
MG,40819,ARCEBURGO,4336,5142,1256,6363,107,5107,261
MG,40827,SEM-PEIXE,2704,1110,910,3020,81,2110,122
MG,40835,ARCOS,25482,14004,3302,24457,635,21155,777
MG,40843,SENADOR AMARAL,3784,2048,946,4016,57,3070,97
MG,40851,AREADO,6440,8586,1607,9521,157,7914,244
MG,40860,UBAPORANGA,5860,5540,2287,8293,81,6006,225
MG,40878,ARGIRITA,3218,836,354,2483,35,2129,67
MG,40886,URUCUIA,2978,3464,1578,5026,76,3448,151
MG,40894,ARINOS,8222,6542,3495,11537,194,8042,466
MG,40908,VARGEM ALEGRE,4034,3026,1573,5353,65,3780,185
MG,40916,ASTOLFO DUTRA,8848,5570,1467,9000,126,7533,198
MG,40924,JOSENOPOLIS,2178,1396,1043,3012,21,1969,161
MG,40932,ATALEIA,9306,4536,4363,11760,118,7397,358
MG,40940,JUVENILIA,1738,3926,1308,4293,32,2985,121
MG,40959,AUGUSTO DE LIMA,3138,2062,838,3654,68,2816,148
MG,40967,LEME DO PRADO,1864,2084,1131,3232,32,2101,95
MG,40975,BAEPENDI,12416,8650,2076,13194,203,11118,382
MG,40983,LUISBURGO,2112,4258,850,4201,46,3351,120
MG,40991,BALDIM,6302,2580,1782,6471,81,4689,167
MG,41009,LUISLANDIA,2692,2884,1504,4453,34,2949,127
MG,41017,BAMBUI,12760,12470,3563,17000,294,13437,528
MG,41025,MARIO CAMPOS,6530,2212,860,5529,96,4669,202
MG,41033,BANDEIRA,1698,2772,794,3213,29,2419,155
MG,41041,MARTINS SOARES,4058,2276,806,4140,40,3334,127
MG,41050,BANDEIRA DO SUL,3236,3110,653,4041,77,3388,138
MG,41068,MIRAVANIA,1170,2904,941,3096,26,2155,92
MG,41076,BARAO DE COCAIS,23996,3572,2647,17019,188,14372,400
MG,41084,MONTE FORMOSO,2656,1574,898,3191,25,2293,153
MG,41092,BARAO DE MONTE ALTO,3594,3624,1031,4858,55,3827,163
MG,41106,NATALANDIA,2604,1048,1033,2932,31,1899,42
MG,41114,BARBACENA,101240,32524,11101,81763,1117,70662,2663
MG,41122,NINHEIRA,1740,5354,2289,6161,53,3872,272
MG,41130,BARRA LONGA,3882,3908,1949,6187,95,4238,248
MG,41149,NOVA BELEM,2082,2002,1114,3294,35,2180,103
MG,41157,TRES MARIAS,15608,10392,4304,18181,323,13877,554
MG,41165,NOVA PORTEIRINHA,4052,3152,1127,4938,43,3811,166
MG,41173,BARROSO,14662,8390,2145,14415,317,12270,427
MG,41181,NOVORIZONTE,1850,3018,1126,3697,31,2571,106
MG,41190,BELA VISTA DE MINAS,10182,1678,1555,7791,113,6236,193
MG,41203,OLHOS DAGUA,2466,1574,1008,3198,32,2190,138
MG,41211,BELMIRO BRAGA,3258,1438,555,3026,35,2471,88
MG,41220,ORATORIOS,3338,1488,800,3396,52,2596,131
MG,41238,BELO HORIZONTE,1979952,637482,253509,1646041,27869,1392532,55946
MG,41246,ORIZANIA,4154,2630,1050,4631,52,3581,137
MG,41254,BELO ORIENTE,15434,5810,3061,14486,322,11425,481
MG,41262,PADRE CARVALHO,2378,1804,1172,3448,29,2276,156
MG,41270,BELO VALE,5924,3478,837,5876,130,5039,208
MG,41289,PAI PEDRO,1854,3416,1431,4272,46,2841,160
MG,41297,BERILO,3134,7424,2823,8569,115,5746,352
MG,41300,PATIS,2212,2144,1571,3897,22,2326,126
MG,41319,BERTOPOLIS,2648,1300,1367,3488,23,2121,124
MG,41327,PEDRA BONITA,2552,3984,755,4232,49,3477,160
MG,41335,BETIM,219768,68194,24877,178120,3258,153243,6004
MG,41343,PIEDADE DE CARATINGA,2542,2896,948,3812,38,2864,107
MG,41351,BIAS FORTES,3686,1482,946,3707,49,2761,128
MG,41360,PINGO DAGUA,2926,1254,952,3197,38,2245,117
MG,41378,BICAS,12182,4052,1652,10308,164,8656,375
MG,41386,PINTOPOLIS,2164,3360,1585,4510,42,2925,121
MG,41394,BIQUINHAS,1564,1662,595,2330,62,1735,60
MG,41408,PONTO CHIQUE,1382,2186,949,2836,15,1887,88
MG,41416,BOA ESPERANCA,22454,15628,5294,25458,482,20164,641
MG,41424,REDUTO,3462,2064,737,3672,52,2935,120
MG,41432,BOCAINA DE MINAS,2610,3066,987,4062,86,3075,151
MG,41440,SANTA BARBARA DO MONTE VERDE,2512,1306,480,2559,46,2079,124
MG,41459,BOCAIUVA,30326,10076,7530,29089,382,21559,976
MG,41467,SANTA CRUZ DE MINAS,5768,2660,541,4921,63,4380,103
MG,41475,BOM DESPACHO,30420,16402,5087,29803,489,24716,816
MG,41483,SANTA CRUZ DE SALINAS,1646,2824,1072,3500,42,2428,151
MG,41491,BOM JARDIM DE MINAS,4754,3068,1235,5422,106,4187,170
MG,41505,SANTA HELENA DE MINAS,2850,2532,1311,4215,45,2904,168
MG,41513,BOM JESUS DA PENHA,1832,2404,379,2599,34,2220,68
MG,41521,SANTO ANTONIO DO RETIRO,758,5008,1034,4198,59,3164,222
MG,41530,BOM JESUS DO AMPARO,4318,1678,708,3961,72,3253,183
MG,41548,SAO DOMINGOS DAS DORES,3246,2100,851,3693,69,2842,100
MG,41556,BOM JESUS DO GALHO,9582,7628,3297,12518,188,9221,428
MG,41564,SAO FELIX DE MINAS,1664,1824,892,2781,28,1889,117
MG,41572,BOM REPOUSO,6610,4006,1091,6734,115,5643,220
MG,41580,SAO GERALDO DO BAIXIO,1860,1208,819,2453,31,1634,69
MG,41599,BOM SUCESSO,10522,8894,2540,12983,258,10443,477
MG,41602,SAO JOAO DAS MISSOES,2792,3808,1716,5437,67,3721,354
MG,41610,BONFIM,5162,3870,1155,6111,179,4956,261
MG,41629,SAO JOAQUIM DE BICAS,12930,3760,1934,10792,199,8858,314
MG,41637,BONFINOPOLIS DE MINAS,4900,1364,1498,4776,36,3278,110
MG,41645,SAO JOSE DA BARRA,4814,1962,947,4478,61,3531,82
MG,41653,BORDA DA MATA,9640,7588,1644,10794,188,9150,348
MG,41661,ALTO CAPARAO,1982,3106,741,3422,46,2681,91
MG,41670,BOTELHOS,10140,6932,2241,11237,175,8996,285
MG,41688,ANGELANDIA,1906,4338,1664,5021,55,3357,180
MG,41696,BOTUMIRIM,2680,2724,1634,4520,42,2886,142
MG,41700,ARICANDUVA,1724,2706,804,3265,35,2461,211
MG,41718,BRASILIA DE MINAS,15982,11898,7141,21923,276,14782,566
MG,41726,BERIZAL,1460,2602,872,3023,20,2151,100
MG,41734,BRAS PIRES,2470,2684,1439,4187,59,2748,112
MG,41742,BONITO DE MINAS,2496,2946,2023,5005,46,2982,215
MG,41750,BRAUNAS,3210,2030,1467,4402,91,2935,224
MG,41769,BUGRE,2780,2380,924,3690,44,2766,142
MG,41777,BRAZOPOLIS,7532,9852,2188,11371,145,9183,346
MG,41785,CABECEIRA GRANDE,3630,2848,1803,5252,60,3449,150
MG,41793,BRUMADINHO,22714,7402,2573,18668,334,16095,703
MG,41807,CAMPO AZUL,1056,2622,1295,3224,20,1929,70
MG,41815,BUENO BRANDAO,4918,6778,1217,7541,209,6324,267
MG,41823,CANTAGALO,1682,2006,862,2898,46,2036,146
MG,41831,BUENOPOLIS,4110,4848,2504,7363,126,4859,254
MG,41840,CATAS ALTAS,3876,1214,565,3268,54,2703,104
MG,41858,BURITIS,10788,8092,4207,14327,208,10120,472
MG,41866,CATUTI,1790,3654,1091,3969,23,2878,133
MG,41874,BURITIZEIRO,13812,7788,5410,16872,210,11462,452
MG,41882,CHAPADA GAUCHA,2732,3938,1757,5383,60,3626,231
MG,41890,CABO VERDE,6854,6938,1696,8999,120,7303,287
MG,41904,CONEGO MARINHO,2352,3874,1659,4986,40,3327,174
MG,41912,CACHOEIRA DA PRATA,4108,1032,590,3295,53,2705,82
MG,41920,CONFINS,5572,1100,611,4125,57,3514,121
MG,41939,CACHOEIRA DE MINAS,6134,6370,1166,7807,130,6641,259
MG,41947,CORREGO FUNDO,4832,1696,415,3851,71,3436,101
MG,41955,CACHOEIRA DOURADA,1480,1258,630,2045,10,1415,36
MG,41963,CRISOLITA,3056,1872,1391,4051,16,2660,180
MG,41971,CAETANOPOLIS,7638,2016,924,6024,111,5100,162
MG,41980,CUPARAQUE,1698,2606,1351,3641,39,2290,99
MG,41998,CAETE,34554,9880,4624,28078,394,23454,843
MG,42005,CURRAL DE DENTRO,1562,4628,1399,4684,39,3285,151
MG,42013,CAIANA,2896,1940,667,3251,54,2584,112
MG,42021,DELTA,4178,1072,286,3030,38,2744,81
MG,42030,CAJURI,3446,1760,488,3296,69,2808,136
MG,42048,DOM BOSCO,2938,1194,1092,3259,23,2167,78
MG,42056,CALDAS,6604,9538,1890,10358,140,8468,257
MG,42064,FREI LAGONEGRO,1550,2104,977,2968,29,1991,135
MG,42072,CAMACHO,1962,2340,358,2637,53,2279,75
MG,42080,FRUTA DE LEITE,1796,3496,1710,4576,27,2866,193
MG,42099,CAMANDUCAIA,9314,11298,2174,13155,284,10981,391
MG,42102,GAMELEIRAS,1310,3986,1286,4096,22,2810,140
MG,42110,CAMBUI,15082,10464,2447,15875,194,13428,461
MG,42129,GLAUCILANDIA,3048,1084,758,2960,39,2202,97
MG,42137,CAMBUQUIRA,7532,6156,1539,8789,95,7250,311
MG,42145,GOIABEIRA,1592,2012,1018,2935,30,1917,85
MG,42153,CAMPANARIO,2260,1290,1058,2940,24,1882,83
MG,42161,GOIANA,3102,1256,658,2988,49,2330,102
MG,42170,CAMPANHA,8658,6800,1694,9875,169,8181,283
MG,42188,GUARACIAMA,4076,1668,1161,4219,36,3058,150
MG,42196,CAMPESTRE,10168,12294,2552,14401,245,11849,373
MG,42200,IBIRACATU,2414,2768,1588,4418,39,2830,200
MG,42218,CAMPINA VERDE,11574,8638,3499,14150,202,10651,343
MG,42226,IMBE DE MINAS,3806,2276,1379,4597,33,3218,144
MG,42234,CAMPO BELO,27936,26682,6365,35327,667,28962,986
MG,42242,INDAIABIRA,1456,4500,1605,4843,38,3238,222
MG,42250,CAMPO DO MEIO,6758,6142,1858,8675,158,6817,209
MG,42269,JAPONVAR,2026,4750,1912,5526,51,3614,175
MG,42277,CAMPO FLORIDO,3038,2860,1389,4449,43,3060,68
MG,42285,JENIPAPO DE MINAS,1410,3116,1773,4235,43,2462,156
MG,42293,CAMPOS ALTOS,5242,7206,1881,8480,150,6599,225
MG,42307,JOSE GONCALVES DE MINAS,1002,2826,866,2926,20,2060,126
MG,42315,CAMPOS GERAIS,15528,11540,3480,17772,259,14292,499
MG,42323,JOSE RAYDAN,1976,1574,882,2853,27,1971,169
MG,42331,CANAA,3492,2092,878,3950,92,3072,188
MG,42340,SAO SEBASTIAO DA VARGEM ALEGRE,1518,1904,576,2413,31,1837,95
MG,42358,CANAPOLIS,8434,3900,2225,8683,99,6458,192
MG,42366,SAO SEBASTIAO DO ANTA,3076,1756,877,3430,27,2553,110
MG,42374,CANA VERDE,3228,3284,883,4350,70,3467,141
MG,42382,SERRANOPOLIS DE MINAS,968,3802,1019,3553,41,2534,108
MG,42390,CANDEIAS,6898,9652,1662,10567,244,8905,386
MG,42404,SETUBINHA,1916,5322,1857,5990,87,4133,427
MG,42412,CAPARAO,1844,2608,682,3054,49,2372,97
MG,42420,TAPARUBA,2210,2198,619,2932,32,2313,77
MG,42439,CAPELA NOVA,2890,2972,656,3845,113,3189,145
MG,42447,UNIAO DE MINAS,3258,1626,1120,3650,36,2530,52
MG,42455,CAPELINHA,12286,13942,6169,20340,254,14171,803
MG,42463,URUANA DE MINAS,2388,1024,1056,2886,26,1830,98
MG,42471,CAPETINGA,3146,4502,1347,5429,93,4082,165
MG,42480,VARGEM GRANDE DO RIO PARDO,836,3554,838,3156,19,2318,104
MG,42498,CAPIM BRANCO,6310,2514,772,5459,118,4687,157
MG,42501,VARJAO DE MINAS,2106,3192,1125,3876,49,2751,53
MG,42510,CAPINOPOLIS,10220,6728,3014,11859,139,8845,232
MG,42528,VERDELANDIA,3248,1792,1489,4187,35,2698,143
MG,42536,CAPITAO ENEAS,7772,4758,2836,9572,117,6736,354
MG,42544,VEREDINHA,2832,2110,1008,3680,38,2672,163
MG,42552,CAPITOLIO,6264,3138,1200,6112,77,4912,134
MG,42560,VERMELHO NOVO,3276,2380,859,3849,57,2990,105
MG,42579,CAPUTIRA,5898,3498,1115,6142,134,5027,195
MG,42587,TOCOS DO MOJI,2448,2806,395,3123,34,2728,67
MG,42595,CARAI,8460,4922,3964,11411,131,7447,625
MG,42617,CARANAIBA,2014,2468,524,2948,80,2424,103
MG,42633,CARANDAI,16710,9396,1833,16114,538,14281,690
MG,42650,CARANGOLA,18716,14974,5016,22994,302,17978,831
MG,42676,CARATINGA,46368,33554,12434,54951,847,42517,1709
MG,42692,CARBONITA,6272,2508,2011,6660,55,4649,204
MG,42714,CAREACU,3684,3054,986,4523,51,3537,117
MG,42730,CARLOS CHAGAS,12322,7198,5396,15818,185,10422,477
MG,42757,CARMESIA,1758,662,496,1818,35,1322,77
MG,42773,CARMO DA CACHOEIRA,7150,4510,2145,8428,146,6283,307
MG,42790,CARMO DA MATA,7176,5796,1376,8392,211,7016,319
MG,42811,CARMO DE MINAS,6914,5218,1298,7793,145,6495,284
MG,42838,CARMO DO CAJURU,14648,6530,1632,13034,384,11402,429
MG,42854,CARMO DO PARANAIBA,13776,15460,3369,19043,417,15674,639
MG,42870,CARMO DO RIO CLARO,12836,7916,2477,13378,178,10901,347
MG,42897,CARMOPOLIS DE MINAS,8730,7834,1540,10277,164,8737,291
MG,42919,CARRANCAS,2500,2028,815,3248,41,2433,128
MG,42935,CARVALHOPOLIS,2142,1734,383,2435,34,2052,80
MG,42951,CARVALHOS,2868,2858,966,4066,65,3100,172
MG,42978,CASA GRANDE,1874,1182,286,1974,73,1688,87
MG,42994,CASCALHO RICO,1664,1812,415,2230,33,1815,44
MG,43010,CASSIA,8668,9764,2447,12296,180,9849,453
MG,43036,CONCEICAO DA BARRA DE MINAS,2082,2694,553,3081,48,2528,92
MG,43052,CATAGUASES,59646,16314,7273,47329,684,40056,1392
MG,43079,CATAS ALTAS DA NORUEGA,2518,1566,781,2986,59,2205,104
MG,43095,CAXAMBU,17502,7590,2828,15984,200,13156,410
MG,43117,CEDRO DO ABAETE,558,1038,251,1090,17,839,24
MG,43133,CENTRAL DE MINAS,2916,4244,1669,5459,60,3790,150
MG,43150,CENTRALINA,6692,3498,1962,7314,73,5352,184
MG,43176,CHACARA,2356,918,329,2055,28,1726,61
MG,43192,CHALE,3172,3156,826,4171,48,3345,133
MG,43214,CHAPADA DO NORTE,3866,5670,3806,9061,88,5255,399
MG,43230,CHIADOR,2494,1260,529,2544,47,2015,91
MG,43257,CIPOTANEA,2744,3468,1771,5200,152,3429,171
MG,43273,CLARAVAL,1872,3168,472,3090,30,2618,68
MG,43290,CLARO DOS POCOES,4724,3770,1410,5931,76,4521,198
MG,43311,CLAUDIO,13982,11490,1793,15314,381,13521,404
MG,43338,COIMBRA,4524,3468,719,5028,122,4309,191
MG,43354,COLUNA,3882,3566,1823,5970,87,4147,336
MG,43370,COMENDADOR GOMES,1280,1866,153,1791,25,1638,40
MG,43397,COMERCINHO,4354,3794,2095,6503,60,4408,274
MG,43419,CONCEICAO DA APARECIDA,5322,4570,1595,6776,93,5181,142
MG,43435,CONCEICAO DA PEDRA,1904,1506,282,2109,42,1827,80
MG,43451,CONCEICAO DAS ALAGOAS,12588,7384,2902,13358,154,10456,316
MG,43478,CONCEICAO DE IPANEMA,2560,2934,395,3245,19,2850,84
MG,43494,CONCEICAO DO MATO DENTRO,11600,4322,4355,13151,167,8796,668
MG,43516,CONCEICAO DO PARA,3822,2258,782,4003,77,3221,104
MG,43532,CONCEICAO DO RIO VERDE,7862,5326,1894,8879,132,6985,259
MG,43559,CONCEICAO DOS OUROS,5186,5188,1030,6473,103,5443,153
MG,43575,CONGONHAL,4664,5354,407,5585,69,5178,100
MG,43591,CONGONHAS,43592,7366,3470,30215,486,26745,780
MG,43613,CONGONHAS DO NORTE,2602,1626,1095,3489,39,2394,241
MG,43630,CONQUISTA,4094,3542,1210,5245,70,4035,147
MG,43656,CONSELHEIRO LAFAIETE,97922,24184,9038,73367,1104,64329,2172
MG,43672,CONSELHEIRO PENA,11998,9414,5855,17263,258,11408,444
MG,43699,CONSOLACAO,1094,1172,262,1453,17,1191,41
MG,43710,CONTAGEM,487180,106680,52536,368705,6410,316169,12829
MG,43737,COQUEIRAL,6072,3882,1452,6684,92,5232,163
MG,43753,CORACAO DE JESUS,14288,9558,5420,18133,206,12713,584
MG,43770,CORDISBURGO,5932,3020,1430,6221,116,4791,199
MG,43796,CORDISLANDIA,2198,1902,574,2728,27,2154,77
MG,43818,CORINTO,18786,6378,5029,18287,210,13258,466
MG,43834,COROACI,4552,5366,2500,7865,124,5365,282
MG,43850,COROMANDEL,15504,13538,4682,20252,385,15570,664
MG,43877,CORONEL FABRICIANO,83606,22956,12902,68647,984,55745,1480
MG,43893,CORONEL MURTA,3802,4810,2228,6834,59,4606,241
MG,43915,CORONEL PACHECO,2996,1024,227,2337,33,2110,67
MG,43931,CORONEL XAVIER CHAVES,2404,1462,356,2403,33,2047,81
MG,43958,CORREGO DANTA,2182,2040,610,2841,42,2231,78
MG,43974,CORREGO DO BOM JESUS,2784,2492,622,3397,37,2775,100
MG,43990,CORREGO NOVO,2240,1708,557,2663,46,2106,86
MG,44016,COUTO DE MAGALHAES DE MINAS,3306,1004,1019,3334,40,2315,120
MG,44032,CRISTAIS,6256,3966,1111,6582,125,5471,235
MG,44059,CRISTALIA,2194,2632,1037,3616,41,2579,125
MG,44075,CRISTIANO OTONI,3522,2488,464,3712,66,3248,177
MG,44091,CRISTINA,5290,5674,1434,7282,100,5848,266
MG,44113,CRUCILANDIA,2674,2900,464,3451,90,2987,110
MG,44130,CRUZEIRO DA FORTALEZA,2458,1966,514,2832,36,2318,70
MG,44156,CRUZILIA,8962,6466,1700,9796,94,8096,288
MG,44172,CURVELO,46402,21868,10040,46029,699,35989,1155
MG,44199,DATAS,3370,1764,972,3721,50,2749,132
MG,44210,DELFIM MOREIRA,4106,5058,1107,5930,94,4823,147
MG,44237,DELFINOPOLIS,3736,3060,1659,5257,71,3598,129
MG,44253,DESCOBERTO,3994,1882,465,3579,59,3114,117
MG,44270,DESTERRO DE ENTRE RIOS,2978,4552,1193,5282,116,4089,208
MG,44296,DESTERRO DO MELO,2002,2248,418,2696,43,2278,110
MG,44318,DIAMANTINA,28106,13494,7160,29138,319,21978,859
MG,44334,DIOGO DE VASCONCELOS,2524,1762,582,2920,41,2338,154
MG,44350,DIONISIO,8106,1886,2260,7577,113,5317,208
MG,44377,DIVINESIA,2944,1272,510,2735,27,2225,90
MG,44393,DIVINO,10346,7878,3092,12787,148,9695,435
MG,44415,DIVINO DAS LARANJEIRAS,2534,3254,1273,4373,69,3100,137
MG,44431,DIVINOLANDIA DE MINAS,3948,2210,1087,4429,64,3342,199
MG,44458,DIVINOPOLIS,169440,49228,14147,128601,2017,114454,3103
MG,44474,DIVISA NOVA,4084,1838,745,3846,51,3101,89
MG,44490,DOM CAVATI,3022,3216,1024,4340,65,3316,132
MG,44512,DOM JOAQUIM,3274,1304,1353,3901,57,2548,202
MG,44539,DOM SILVERIO,5026,1646,713,4288,90,3575,149
MG,44555,DOM VICOSO,1370,2430,550,2551,42,2001,59
MG,44571,DONA EUSEBIA,3702,3184,639,4248,74,3609,92
MG,44598,DORES DE CAMPOS,6770,3678,689,6475,258,5786,304
MG,44610,DORES DE GUANHAES,3868,1524,1447,4498,105,3051,250
MG,44636,DORES DO INDAIA,8152,8080,3080,11721,228,8641,297
MG,44652,DORES DO TURVO,3424,1942,760,3688,78,2928,167
MG,44679,DORESOPOLIS,868,1064,318,1330,18,1012,28
MG,44695,DOURADOQUARA,1158,1036,270,1431,26,1161,38
MG,44717,ELOI MENDES,13164,11692,2040,15083,176,13043,439
MG,44733,ENGENHEIRO CALDAS,4202,3544,635,4802,103,4167,191
MG,44750,ENGENHEIRO NAVARRO,5192,1996,1966,5850,87,3884,203
MG,44776,ENTRE RIOS DE MINAS,9484,6142,1916,10325,198,8409,398
MG,44792,ERVALIA,11016,8012,3258,13703,259,10445,672
MG,44814,ESMERALDAS,29326,11874,4994,26883,492,21889,797
MG,44830,ESPERA FELIZ,12886,8716,3503,14988,207,11485,477
MG,44857,ESPINOSA,7544,21254,7603,22709,164,15106,543
MG,44873,ESPIRITO SANTO DO DOURADO,3116,2474,438,3427,60,2989,134
MG,44890,ESTIVA,5700,5588,1029,7024,130,5995,221
MG,44911,ESTRELA DALVA,2522,592,465,2109,32,1644,55
MG,44938,ESTRELA DO INDAIA,2000,2174,925,3156,52,2231,92
MG,44954,ESTRELA DO SUL,3948,3830,1427,5542,87,4115,139
MG,44970,EUGENOPOLIS,7564,4226,1681,8055,176,6374,303
MG,44997,EWBANK DA CAMARA,3612,1080,395,2893,47,2498,105
MG,45012,EXTREMA,13890,9024,2127,14117,198,11990,335
MG,45039,FAMA,1932,1046,365,1951,44,1586,53
MG,45055,FARIA LEMOS,2838,1516,639,2994,32,2355,146
MG,45071,FELICIO DOS SANTOS,1618,3192,1480,4065,55,2585,125
MG,45098,SAO GONCALO DO RIO PRETO,2048,1136,843,2587,41,1744,111
MG,45110,FELISBURGO,3606,1914,1534,4489,26,2955,169
MG,45136,FELIXLANDIA,7990,5592,2148,9372,169,7224,264
MG,45152,FERNANDES TOURINHO,1978,1754,503,2460,25,1957,66
MG,45179,FERROS,6640,5212,2790,9342,155,6552,471
MG,45195,FLORESTAL,5232,1418,612,4168,69,3556,162
MG,45217,FORMIGA,44468,30702,6522,46484,896,39962,1481
MG,45233,FORMOSO,3454,2194,1825,4887,44,3062,194
MG,45250,FORTALEZA DE MINAS,2876,1938,793,3424,77,2631,147
MG,45276,FORTUNA DE MINAS,1692,1006,292,1737,42,1445,54
MG,45292,FRANCISCO BADARO,2186,6428,2244,6788,53,4544,184
MG,45314,FRANCISCO DUMONT,2294,1814,1118,3335,45,2217,118
MG,45330,FRANCISCO SA,14470,7424,5372,17084,192,11712,573
MG,45357,FREI GASPAR,3506,1620,971,3785,41,2814,210
MG,45373,FREI INOCENCIO,5716,2520,1616,6021,107,4405,180
MG,45390,FRONTEIRA,5704,3956,544,5631,77,5087,180
MG,45411,FRUTAL,28206,22588,6400,33086,533,26686,756
MG,45438,FUNILANDIA,2688,1382,689,2896,42,2207,130
MG,45454,GALILEIA,4180,3192,1989,5915,80,3926,160
MG,45470,GONCALVES,2088,2332,592,2966,51,2374,113
MG,45497,GONZAGA,1986,3266,1425,4304,67,2879,186
MG,45519,GOUVEA,8600,2684,2305,8327,117,6022,263
MG,45535,GOVERNADOR VALADARES,137190,109528,40109,171027,3030,130918,4529
MG,45551,GRAO MOGOL,4000,6902,3264,9194,95,5930,384
MG,45578,GRUPIARA,1024,920,280,1315,24,1035,39
MG,45594,GUANHAES,13442,12498,5737,20185,439,14448,1039
MG,45616,GUAPE,8090,5994,1697,9135,148,7438,248
MG,45632,GUARACIABA,5090,5358,1141,6787,77,5646,345
MG,45659,GUARANESIA,12996,7068,2027,12646,223,10619,364
MG,45675,GUARANI,7722,2708,1280,6780,80,5500,205
MG,45691,GUARARA,3748,1016,559,3122,50,2563,131
MG,45713,GUARDA-MOR,3568,2598,1298,4542,65,3244,96
MG,45730,GUAXUPE,38530,14858,5178,33258,499,28080,887
MG,45756,GUIDOVAL,5492,3680,992,5916,135,4924,203
MG,45772,GUIMARANIA,4482,2836,1026,4933,76,3907,172
MG,45799,GUIRICEMA,7374,3318,1336,7113,166,5777,265
MG,45810,GURINHATA,4028,3766,1695,5768,63,4073,113
MG,45837,HELIODORA,3424,3150,658,4126,50,3468,131
MG,45853,IAPU,5916,4444,1641,7134,104,5493,209
MG,45870,IBERTIOGA,4240,2032,450,3801,67,3351,148
MG,45896,IBIA,13568,9244,3094,15173,257,12079,416
MG,45918,IBIAI,2920,3220,1560,4811,50,3251,131
MG,45934,IBIRACI,5852,5648,1445,7442,79,5997,168
MG,45950,IBIRITE,88522,19070,8744,65975,1284,57231,2151
MG,45977,IBITIURA DE MINAS,2248,2008,468,2747,50,2279,101
MG,45993,IBITURUNA,1532,1730,318,2015,20,1697,46
MG,46019,IGARAPE,18734,7500,2765,16779,342,14014,555
MG,46035,IGARATINGA,5448,2508,711,4946,140,4235,117
MG,46051,IGUATAMA,6590,3384,1300,6561,98,5261,176
MG,46078,IJACI,3618,3042,463,4033,81,3570,159
MG,46094,ILICINEA,7022,4306,1392,7279,110,5887,113
MG,46116,INCONFIDENTES,4362,4144,861,5315,86,4454,115
MG,46132,INDIANOPOLIS,3228,1904,517,3210,45,2693,82
MG,46159,INGAI,1622,1376,383,1987,29,1604,76
MG,46175,INHAPIM,15738,10780,6154,20161,246,14007,502
MG,46191,INHAUMA,4208,1606,726,3764,46,3038,85
MG,46213,INIMUTABA,3976,2458,951,4362,58,3411,136
MG,46230,IPANEMA,8984,9460,3217,13062,197,9845,426
MG,46256,IPATINGA,165954,65808,24944,146797,2595,121853,3377
MG,46272,IPIACU,2846,1798,1010,3439,36,2429,71
MG,46299,IPUIUNA,5552,5604,1105,6957,94,5852,180
MG,46310,IRAI DE MINAS,3334,3176,672,4110,73,3438,110
MG,46337,ITABIRA,96822,21550,10703,73326,1022,62623,2415
MG,46353,ITABIRINHA,4450,3946,791,5417,148,4626,280
MG,46370,ITABIRITO,38486,8976,3114,27984,417,24870,722
MG,46396,ITACAMBIRA,1906,2348,1165,3447,40,2282,115
MG,46418,ITACARAMBI,9714,4360,3388,10973,104,7585,444
MG,46434,ITAGUARA,7704,5576,1188,8402,237,7214,337
MG,46450,ITAIPE,3922,4198,2054,6550,73,4496,363
MG,46477,ITAJUBA,67690,28814,9159,59512,644,50353,1457
MG,46493,ITAMARANDIBA,12244,13790,5113,19083,210,13970,743
MG,46515,ITAMARATI DE MINAS,3446,1450,475,3074,55,2599,96
MG,46531,ITAMBACURI,10962,9592,5641,16928,221,11287,789
MG,46558,ITAMBE DO MATO DENTRO,1578,1004,323,1786,43,1463,129
MG,46574,ITAMOGI,7170,4922,1741,8217,122,6476,308
MG,46590,ITAMONTE,6868,7276,1356,8902,188,7546,286
MG,46612,ITANHANDU,9286,6504,1424,9714,141,8290,254
MG,46639,ITANHOMI,7074,5014,3168,9645,109,6477,324
MG,46655,ITAOBIM,9954,9468,4775,15198,158,10423,554
MG,46671,ITAPAGIPE,6384,6562,2017,8791,133,6774,168
MG,46698,ITAPECERICA,16390,9758,3613,17479,245,13866,547
MG,46710,ITAPEVA,3428,4688,1029,5299,67,4270,145
MG,46736,ITATIAIUCU,7038,2570,1072,6155,109,5083,170
MG,46752,ITAUNA,74734,18256,5644,54352,827,48708,1386
MG,46779,ITAVERAVA,4048,3458,959,5019,105,4060,202
MG,46795,ITINGA,5606,6164,3066,9366,80,6300,335
MG,46817,ITUETA,3286,3382,1231,4738,60,3507,113
MG,46833,ITUIUTABA,64594,34802,15318,66915,640,51597,1259
MG,46850,ITUMIRIM,3890,3798,840,4937,85,4097,168
MG,46876,ITURAMA,23214,9274,4614,21569,243,16955,468
MG,46892,ITUTINGA,2686,2102,606,3147,45,2541,102
MG,46914,JABOTICATUBAS,10628,5408,2254,10905,200,8651,433
MG,46930,JACINTO,3802,6852,3512,9216,96,5704,281
MG,46957,JACUI,3088,5024,1005,5303,97,4298,145
MG,46973,JACUTINGA,11522,9876,2393,13686,236,11293,358
MG,46990,JAGUARACU,2924,802,436,2382,32,1946,51
MG,47015,JANAUBA,34782,22548,10625,40960,562,30335,1108
MG,47031,JANUARIA,30334,24000,13204,42135,504,28931,1260
MG,47058,JAPARAIBA,2528,1760,343,2570,31,2227,52
MG,47074,JECEABA,5122,2072,895,4688,71,3793,125
MG,47090,JEQUERI,7048,5626,3301,10310,196,7009,476
MG,47112,JEQUITAI,5146,2634,2123,6306,76,4183,217
MG,47139,JEQUITIBA,3358,2980,1101,4464,66,3363,128
MG,47155,JEQUITINHONHA,13584,6280,5034,15717,143,10683,608
MG,47171,JESUANIA,3726,2010,745,3781,52,3036,116
MG,47198,JOAIMA,8444,3384,2828,9387,110,6559,535
MG,47210,JOANESIA,4096,1984,1985,5366,127,3381,214
MG,47236,JOAO MONLEVADE,63872,16786,8580,50686,657,42106,1120
MG,47252,JOAO PINHEIRO,23500,18256,8181,30207,434,22026,714
MG,47279,JOAQUIM FELICIO,2214,1738,458,2564,47,2106,83
MG,47295,JORDANIA,3898,4456,2593,7079,63,4486,246
MG,47317,NOVA UNIAO,4390,1886,985,4351,73,3366,155
MG,47333,JUIZ DE FORA,451048,90022,42934,329757,5083,286823,11205
MG,47350,JURAMENTO,3020,1838,890,3467,33,2577,115
MG,47376,JURUAIA,3692,4930,1185,5742,86,4557,160
MG,47392,LADAINHA,6024,6252,3570,10320,106,6750,506
MG,47414,LAGAMAR,4320,4730,1699,6432,77,4733,131
MG,47430,LAGOA DA PRATA,23792,18792,3607,26015,443,22408,673
MG,47457,LAGOA DOS PATOS,2358,1816,1204,3432,35,2228,106
MG,47473,LAGOA DOURADA,6110,6692,946,7911,250,6965,314
MG,47490,LAGOA FORMOSA,7756,10974,2934,12875,341,9941,235
MG,47511,LAGOA SANTA,31092,11414,4563,27259,604,22696,839
MG,47538,LAJINHA,9422,9226,3681,13592,195,9911,392
MG,47554,LAMBARI,11924,9650,2267,13682,159,11415,469
MG,47570,LAMIM,2308,1992,566,2883,64,2317,103
MG,47597,LARANJAL,4906,2942,777,4972,90,4195,181
MG,47619,LASSANCE,3780,2212,1277,4432,40,3155,119
MG,47635,LAVRAS,62372,27706,8045,56108,897,48063,2127
MG,47651,LEANDRO FERREIRA,2804,1256,576,2745,45,2169,94
MG,47678,LEOPOLDINA,44262,11634,6783,36210,582,29427,897
MG,47694,LIBERDADE,4000,2808,1000,4629,64,3629,161
MG,47716,LIMA DUARTE,13456,5244,2423,12398,222,9975,403
MG,47732,LUMINARIAS,2964,2822,656,3834,97,3178,188
MG,47759,LUZ,9880,8752,2904,12841,278,9937,343
MG,47775,MACHACALIS,4416,2038,2013,5459,52,3446,167
MG,47791,MACHADO,22010,16354,3782,23992,369,20210,659
MG,47813,MADRE DE DEUS DE MINAS,3754,1974,834,3878,60,3044,120
MG,47830,MALACACHETA,6264,10542,5463,14711,190,9248,655
MG,47856,MANGA,8342,8872,4566,13835,183,9269,479
MG,47872,MANHUACU,40558,27650,8750,44981,805,36231,1322
MG,47899,MANHUMIRIM,12182,9332,3036,14435,203,11399,439
MG,47910,MANTENA,15078,10236,6126,19773,311,13647,679
MG,47937,MARAVILHAS,3826,3240,759,4516,77,3757,147
MG,47953,MAR DE ESPANHA,7044,5660,1425,8204,123,6779,304
MG,47970,MARIA DA FE,7708,8938,1518,10251,113,8733,297
MG,47996,MARIANA,40576,12284,5339,33474,643,28135,1062
MG,48011,MARILAC,2592,1626,1283,3612,50,2329,170
MG,48038,MARIPA DE MINAS,2058,1510,373,2295,43,1922,95
MG,48054,MARLIERIA,4266,768,662,3322,51,2660,92
MG,48070,MARMELOPOLIS,2262,1652,646,2688,34,2042,51
MG,48097,MARTINHO CAMPOS,6852,5656,2118,8874,206,6756,296
MG,48119,MATERLANDIA,2322,1738,1193,3486,81,2293,182
MG,48135,MATEUS LEME,18026,6140,2462,15565,386,13103,634
MG,48151,MATIAS BARBOSA,12624,2418,1263,9235,132,7972,319
MG,48178,MATIPO,8442,7964,2513,11430,255,8917,459
MG,48194,MATO VERDE,4548,10010,2874,10595,105,7721,337
MG,48216,MATOZINHOS,28382,7502,3140,22222,440,19082,700
MG,48232,MATUTINA,2024,2292,881,3226,64,2345,123
MG,48259,MEDEIROS,1448,1936,476,2252,41,1776,43
MG,48275,MEDINA,11022,8160,6419,16851,215,10432,626
MG,48291,MENDES PIMENTEL,2980,3692,1748,5366,80,3618,202
MG,48313,MERCES,6664,4366,1844,7843,156,5999,328
MG,48330,MESQUITA,3990,2640,1072,4686,106,3614,193
MG,48356,MINAS NOVAS,7762,12490,7374,18579,207,11205,872
MG,48372,MINDURI,3368,984,824,3156,40,2332,116
MG,48399,MIRABELA,6804,4524,3053,9068,92,6015,259
MG,48410,MIRADOURO,8020,3154,1340,7467,197,6127,343
MG,48437,MIRAI,8378,5766,2421,10010,160,7589,357
MG,48453,MOEDA,3692,1896,548,3554,83,3006,129
MG,48470,MOEMA,3352,4344,1112,5149,64,4037,125
MG,48496,MONJOLOS,1430,1286,799,2273,31,1474,85
MG,48518,MONSENHOR PAULO,5710,2504,610,4953,79,4343,157
MG,48534,MONTALVANIA,3870,9014,3577,10489,92,6912,378
MG,48550,MONTE ALEGRE DE MINAS,9898,9124,3323,13658,315,10335,509
MG,48577,MONTE AZUL,7810,17140,5132,18286,139,13154,540
MG,48593,MONTE BELO,6300,8436,1681,9543,241,7862,253
MG,48615,MONTE CARMELO,32728,15236,5716,30908,499,25192,711
MG,48631,MONTE SANTO DE MINAS,8950,13138,2894,14615,245,11721,432
MG,48658,MONTES CLAROS,233440,60952,35693,191954,2491,156261,6574
MG,48674,MONTE SIAO,8816,10888,2080,12533,202,10453,399
MG,48690,MORADA NOVA DE MINAS,3022,5040,1067,5374,90,4307,186
MG,48712,MORRO DA GARCA,1396,1780,723,2392,24,1669,57
MG,48739,MORRO DO PILAR,2848,1204,797,3008,36,2211,149
MG,48755,MUNHOZ,4006,3578,909,4995,126,4086,168
MG,48771,MURIAE,60194,34776,13124,64490,1346,51366,2535
MG,48798,MUTUM,14480,13156,5227,19942,292,14715,605
MG,48810,MUZAMBINHO,10778,12120,2601,14628,235,12027,343
MG,48836,NACIP RAYDAN,1292,1596,970,2519,24,1549,81
MG,48852,NANUQUE,19570,19910,10090,31064,388,20974,846
MG,48879,NATERCIA,2348,3372,599,3634,83,3035,92
MG,48895,NAZARENO,4896,3516,1114,5601,87,4487,194
MG,48917,NEPOMUCENO,15070,12026,3245,17631,280,14386,558
MG,48933,NOVA ERA,16654,3748,2571,13268,147,10697,349
MG,48950,NOVA LIMA,63804,12692,5499,45567,640,40068,1180
MG,48976,NOVA MODICA,1960,2076,1236,3408,35,2172,119
MG,48992,NOVA PONTE,6176,4350,1096,6590,88,5494,143
MG,49018,NOVA RESENDE,6924,8054,1337,9332,213,7995,293
MG,49034,NOVA SERRANA,19026,18750,3419,23566,703,20147,556
MG,49050,NOVO CRUZEIRO,9772,10992,7536,19021,212,11485,891
MG,49077,OLARIA,1886,1236,247,1902,22,1655,72
MG,49093,OLIMPIO NORONHA,1988,1126,362,2000,12,1638,69
MG,49115,OLIVEIRA,28032,15558,3981,27127,441,23146,910
MG,49131,OLIVEIRA FORTES,1872,852,299,1776,31,1477,84
MG,49158,ONCA DE PITANGUI,2472,1132,423,2318,39,1895,54
MG,49174,OURO BRANCO,28114,6438,3173,21220,265,18047,506
MG,49190,OURO FINO,15664,17822,3306,20810,294,17504,467
MG,49212,OURO PRETO,60534,18668,7098,48940,666,41842,1575
MG,49239,OURO VERDE DE MINAS,3824,2992,2185,5896,76,3711,227
MG,49255,PADRE PARAISO,8812,6696,4622,12956,114,8334,466
MG,49271,PAINEIRAS,2716,2956,862,3855,69,2993,88
MG,49298,PAINS,6352,3310,1135,6244,95,5109,183
MG,49310,PAIVA,1534,540,255,1383,47,1128,44
MG,49336,PALMA,5944,2106,1338,5649,84,4311,202
MG,49352,FRONTEIRA DOS VALES,2958,2092,1008,3712,26,2704,153
MG,49379,PAPAGAIOS,7686,5612,1620,8768,230,7148,269
MG,49395,PARACATU,45614,27634,8839,47650,979,38811,1208
MG,49417,PARA DE MINAS,59860,20884,6086,49101,880,43015,1763
MG,49433,PARAGUACU,13316,8698,1875,13382,178,11507,322
MG,49450,PARAISOPOLIS,12658,8190,2122,13112,201,10990,365
MG,49476,PARAOPEBA,15748,6658,2118,13953,238,11835,394
MG,49492,PASSABEM,1030,1160,426,1644,29,1218,94
MG,49514,PASSA QUATRO,11268,6618,1515,10858,125,9343,275
MG,49530,PASSA TEMPO,5232,4216,1431,6588,126,5157,307
MG,49557,PASSA VINTE,1900,818,283,1765,39,1482,84
MG,49573,PASSOS,77424,30240,10841,66864,812,56023,1379
MG,49590,PATOS DE MINAS,75932,60794,16395,88568,1579,72173,2231
MG,49611,PATROCINIO,48048,27358,8666,48402,787,39736,1246
MG,49638,PATROCINIO DO MURIAE,3464,2448,554,3713,68,3159,135
MG,49654,PAULA CANDIDO,7162,2480,1522,6780,114,5258,323
MG,49670,PAULISTAS,2842,1802,1512,4078,64,2566,180
MG,49697,PAVAO,4778,3860,2231,6826,58,4595,218
MG,49719,PECANHA,5402,8622,4358,12172,205,7814,597
MG,49735,PEDRA AZUL,11128,10912,5743,17593,160,11850,670
MG,49751,PEDRA DO ANTA,2628,1796,585,3013,74,2428,142
MG,49778,PEDRA DO INDAIA,1740,3180,251,2838,46,2587,81
MG,49794,PEDRA DOURADA,1452,668,108,1244,30,1136,46
MG,49816,PEDRALVA,6440,6906,1401,8426,103,7025,249
MG,49832,PEDRINOPOLIS,2424,1844,611,2874,45,2263,84
MG,49859,PEDRO LEOPOLDO,47954,13414,4150,36514,612,32364,1068
MG,49875,PEDRO TEIXEIRA,1900,742,271,1643,17,1372,34
MG,49891,PEQUERI,2858,1046,470,2535,43,2065,70
MG,49913,PEQUI,3298,1612,654,3251,75,2597,67
MG,49930,PERDIGAO,3344,3890,697,4578,107,3881,157
MG,49956,PERDIZES,5826,6920,2533,9172,90,6639,176
MG,49972,PERDOES,9172,12408,1952,13619,342,11667,535
MG,49999,PESCADOR,2486,1400,1388,3470,38,2082,101
MG,50016,PIAU,2474,1724,449,2673,39,2224,86
MG,50032,PIEDADE DE PONTE NOVA,2918,1768,907,3431,56,2524,125
MG,50059,PIEDADE DO RIO GRANDE,3078,2462,990,4008,71,3018,177
MG,50075,PIEDADE DOS GERAIS,2368,2872,804,3656,107,2852,125
MG,50091,PIMENTA,4160,4394,999,5672,167,4673,229
MG,50113,PIRACEMA,4728,3346,946,5319,110,4373,226
MG,50130,PIRAJUBA,2076,1522,400,2285,29,1885,57
MG,50156,PIRANGA,7270,8658,3442,12122,219,8680,497
MG,50172,PIRANGUCU,2578,3538,643,3825,39,3182,85
MG,50199,PIRANGUINHO,5732,2898,861,5406,80,4545,150
MG,50210,PIRAPETINGA,8388,4000,1394,8192,187,6798,417
MG,50237,PIRAPORA,36130,12224,8285,33881,462,25596,957
MG,50253,PIRAUBA,8176,4076,1479,8026,168,6547,253
MG,50270,PITANGUI,19730,7198,2847,17094,300,14247,483
MG,50296,PIUMHI,18598,13900,4146,21337,422,17191,520
MG,50318,PLANURA,5280,4158,1496,6433,92,4937,126
MG,50334,POCO FUNDO,10222,7308,1533,10801,235,9268,268
MG,50350,POCOS DE CALDAS,82608,65900,14350,92522,1178,78172,2740
MG,50377,POCRANE,4754,5936,2331,7982,87,5651,219
MG,50393,POMPEU,19586,7050,3696,18151,466,14455,671
MG,50415,PONTE NOVA,46472,15068,8272,40660,544,32388,1074
MG,50431,PORTEIRINHA,13146,22816,7193,26399,361,19206,864
MG,50458,PORTO FIRME,6156,3410,2571,7700,100,5129,246
MG,50474,POTE,5362,7432,2985,9933,113,6948,438
MG,50490,POUSO ALEGRE,76990,40664,10385,72120,896,61735,2012
MG,50512,POUSO ALTO,3330,4432,861,4978,71,4117,165
MG,50539,PRADOS,5520,3980,691,5855,162,5164,252
MG,50555,PRATA,15030,10344,4173,17586,236,13413,490
MG,50571,PRATAPOLIS,5264,6028,1637,7669,124,6032,262
MG,50598,PRATINHA,1398,2018,467,2316,44,1849,97
MG,50610,PRESIDENTE BERNARDES,3400,3238,788,4297,62,3509,128
MG,50636,PRESIDENTE JUSCELINO,2812,1466,1105,3443,48,2338,151
MG,50652,PRESIDENTE KUBITSCHEK,1120,2172,388,2117,11,1729,72
MG,50679,PRESIDENTE OLEGARIO,10728,7894,3318,13217,196,9899,392
MG,50695,ALTO JEQUITIBA,3092,5672,1185,5844,70,4659,207
MG,50717,PRUDENTE DE MORAIS,6656,2660,902,5905,133,5003,212
MG,50733,QUARTEL GERAL,1598,2450,799,2934,47,2135,64
MG,50750,QUELUZITO,2130,1036,184,1872,39,1688,66
MG,50776,RAPOSOS,15710,2366,1427,10946,178,9519,303
MG,50792,RAUL SOARES,15042,10472,5087,18774,283,13687,647
MG,50814,RECREIO,8458,3268,2051,8260,107,6209,239
MG,50830,RESENDE COSTA,6254,5636,1178,7487,141,6309,223
MG,50857,RESPLENDOR,8134,9796,4408,13909,186,9501,350
MG,50873,RESSAQUINHA,3602,2422,352,3543,62,3191,117
MG,50890,RIACHO DOS MACHADOS,3078,5926,2173,6982,65,4809,242
MG,50911,RIBEIRAO DAS NEVES,154186,43816,20209,126173,2634,105964,4329
MG,50938,RIBEIRAO VERMELHO,3776,954,395,2879,39,2484,80
MG,50954,RIO ACIMA,7664,1794,845,5869,105,5024,190
MG,50970,RIO CASCA,11392,4862,3755,12532,225,8777,425
MG,50997,RIO DOCE,1890,920,414,1916,20,1502,77
MG,51012,RIO DO PRADO,2988,1868,1312,3940,42,2628,158
MG,51039,RIO ESPERA,3278,3898,1565,5446,107,3881,186
MG,51055,RIO MANSO,3570,1590,302,3039,59,2737,98
MG,51071,RIO NOVO,5680,4746,1268,6902,118,5634,303
MG,51098,RIO PARANAIBA,6990,4898,1623,7996,171,6373,258
MG,51110,RIO PARDO DE MINAS,5664,16764,4126,16210,184,12084,686
MG,51136,RIO PIRACICABA,12932,3610,2287,11073,168,8786,347
MG,51152,RIO POMBA,13332,6012,2290,12643,274,10353,407
MG,51179,RIO PRETO,4806,1824,452,3962,60,3510,135
MG,51195,RIO VERMELHO,4974,5336,4274,10149,198,5875,522
MG,51217,RITAPOLIS,3332,3350,1103,4638,62,3535,132
MG,51233,ROCHEDO DE MINAS,1828,760,295,1665,19,1370,57
MG,51250,RODEIRO,4288,1970,471,3806,72,3335,134
MG,51276,ROMARIA,2580,1568,645,2803,32,2158,52
MG,51292,RUBELITA,4202,4404,2395,6949,61,4554,190
MG,51314,RUBIM,3206,5002,2782,7167,51,4385,230
MG,51330,SABARA,92852,21814,9226,70340,1450,61114,2331
MG,51357,SABINOPOLIS,9228,4218,3501,10932,201,7431,507
MG,51373,SACRAMENTO,10042,13886,3148,15574,120,12426,342
MG,51390,SALINAS,19826,16070,6647,25771,304,19124,872
MG,51411,SALTO DA DIVISA,3408,2022,1885,4771,25,2886,146
MG,51438,SANTA BARBARA,23370,5086,3334,18310,224,14976,524
MG,51454,SANTA BARBARA DO TUGURIO,3560,2658,713,4045,63,3332,160
MG,51470,SANTA CRUZ DO ESCALVADO,3080,2192,467,3329,55,2862,171
MG,51497,SANTA EFIGENIA DE MINAS,1620,2674,1243,3605,64,2362,151
MG,51519,SANTA FE DE MINAS,1582,1514,1285,2911,18,1626,60
MG,51535,SANTA JULIANA,4828,4484,1190,6121,119,4931,156
MG,51551,SANTA LUZIA,146494,39534,17755,116780,2288,99025,3723
MG,51578,SANTA MARGARIDA,7340,7504,1671,9637,204,7966,340
MG,51594,SANTA MARIA DE ITABIRA,6600,3688,1505,7123,150,5618,324
MG,51616,SANTA MARIA DO SALTO,1872,3024,1027,3635,43,2608,117
MG,51632,SANTA MARIA DO SUACUI,6848,5408,4233,10945,106,6712,478
MG,51659,SANTANA DA VARGEM,5938,2790,1176,5748,76,4572,132
MG,51675,SANTANA DE CATAGUASES,2506,1938,337,2703,49,2366,95
MG,51691,SANTANA DE PIRAPAMA,5114,3240,2362,6886,128,4524,219
MG,51713,SANTANA DO DESERTO,3200,954,279,2475,43,2196,76
MG,51730,SANTANA DO GARAMBEU,1124,1398,389,1765,34,1376,81
MG,51756,SANTANA DO JACARE,2864,2412,831,3673,75,2842,129
MG,51772,SANTANA DO MANHUACU,4306,3766,1734,6034,89,4300,175
MG,51799,SANTANA DO RIACHO,2568,1804,984,3351,62,2367,119
MG,51810,SANTANA DOS MONTES,2186,2756,601,3246,67,2645,107
MG,51837,SANTA RITA DE CALDAS,5416,4908,1017,6437,70,5420,188
MG,51853,SANTA RITA DE JACUTINGA,4216,2308,911,4426,89,3515,164
MG,51870,SANTA RITA DO IBITIPOCA,2510,1768,427,2721,49,2294,106
MG,51896,SANTA RITA DO ITUETO,3150,3156,1329,4607,42,3278,83
MG,51918,SANTA RITA DO SAPUCAI,17594,19020,3455,22739,358,19284,619
MG,51934,SANTA ROSA DA SERRA,1590,2000,648,2566,57,1918,66
MG,51950,SANTA VITORIA,11160,7334,3450,13138,194,9688,247
MG,51977,SANTO ANTONIO DO AMPARO,8864,7482,1651,10475,231,8824,420
MG,51993,SANTO ANTONIO DO AVENTUREIRO,2712,1854,596,3082,70,2486,133
MG,52019,SANTO ANTONIO DO GRAMA,2974,1928,816,3405,43,2589,95
MG,52035,SANTO ANTONIO DO ITAMBE,2540,904,1014,2997,43,1983,218
MG,52051,SANTO ANTONIO DO JACINTO,4334,5402,4080,9446,93,5366,405
MG,52078,SANTO ANTONIO DO MONTE,10442,13590,2025,14710,305,12685,364
MG,52094,SANTO ANTONIO DO RIO ABAIXO,1344,540,628,1700,37,1072,93
MG,52116,SANTO HIPOLITO,2066,1262,906,2707,37,1801,100
MG,52132,SANTOS DUMONT,44688,12388,5276,35422,527,30146,1081
MG,52159,SAO BENTO ABADE,2164,2540,509,3021,39,2512,121
MG,52175,SAO BRAS DO SUACUI,3470,822,410,2701,70,2291,75
MG,52191,SAO DOMINGOS DO PRATA,14668,5084,3170,13799,191,10629,562
MG,52213,SAO FRANCISCO,18608,21636,10486,31871,295,21385,968
MG,52230,SAO FRANCISCO DE PAULA,3552,4026,833,4842,69,4009,151
MG,52256,SAO FRANCISCO DE SALES,3840,2112,1036,4189,80,3153,97
MG,52272,SAO FRANCISCO DO GLORIA,4044,1694,892,4034,96,3142,177
MG,52299,SAO GERALDO,5836,2466,1040,5587,120,4547,276
MG,52310,SAO GERALDO DA PIEDADE,3310,1172,1702,4163,46,2461,174
MG,52337,SAO GONCALO DO ABAETE,2158,2758,894,3511,76,2617,83
MG,52353,SAO GONCALO DO PARA,6234,3098,946,5977,167,5031,198
MG,52370,SAO GONCALO DO RIO ABAIXO,7586,2164,1197,6425,108,5228,245
MG,52396,SAO GONCALO DO SAPUCAI,14182,10584,2807,15828,177,13021,461
MG,52418,SAO GOTARDO,12516,16152,4250,19561,411,15311,566
MG,52434,SAO JOAO BATISTA DO GLORIA,4990,2412,811,4687,56,3876,119
MG,52450,SAO JOAO DA MATA,2212,1596,474,2476,33,2002,65
MG,52477,SAO JOAO DA PONTE,7098,14006,7248,18425,124,11177,501
MG,52493,SAO JOAO DEL REI,68762,28004,8688,59173,728,50485,1374
MG,52515,SAO JOAO DO ORIENTE,5552,3336,1739,6486,111,4747,192
MG,52531,SAO JOAO DO PARAISO,5408,12492,4245,14013,195,9768,623
MG,52558,SAO JOAO EVANGELISTA,7748,6840,3942,11846,134,7904,476
MG,52574,SAO JOAO NEPOMUCENO,23558,5372,2809,17912,227,15103,411
MG,52590,SAO JOSE DA SAFIRA,1808,1924,970,2997,38,2027,123
MG,52612,SAO JOSE DA VARGINHA,2784,1076,426,2489,49,2063,84
MG,52639,SAO JOSE DO ALEGRE,2362,2264,420,2882,43,2462,106
MG,52655,SAO JOSE DO DIVINO,1876,1800,1053,3050,43,1997,116
MG,52671,SAO JOSE DO GOIABAL,5584,996,1312,4836,46,3524,188
MG,52698,SAO JOSE DO JACURI,2968,2346,1731,4758,97,3027,273
MG,52710,SAO JOSE DO MANTIMENTO,1852,1100,399,2001,46,1602,80
MG,52736,SAO LOURENCO,22304,20486,4016,26512,383,22496,718
MG,52752,SAO MIGUEL DO ANTA,3362,3460,344,4032,114,3688,163
MG,52779,SAO PEDRO DA UNIAO,2218,3424,901,3973,112,3072,139
MG,52795,SAO PEDRO DOS FERROS,6090,3016,918,5805,77,4887,257
MG,52817,SAO PEDRO DO SUACUI,2676,2648,1691,4618,44,2927,221
MG,52833,SAO ROMAO,4038,2024,2293,5516,43,3223,149
MG,52850,SAO ROQUE DE MINAS,2814,3922,1093,4699,86,3606,152
MG,52876,SAO SEBASTIAO DA BELA VISTA,2630,2728,723,3561,51,2838,108
MG,52892,SAO SEBASTIAO DO MARANHAO,2526,5918,3175,7898,92,4723,409
MG,52914,SAO SEBASTIAO DO OESTE,3714,2668,581,3964,72,3383,120
MG,52930,SAO SEBASTIAO DO PARAISO,37638,24560,6992,39818,590,32826,1137
MG,52957,SAO SEBASTIAO DO RIO PRETO,1252,608,383,1424,36,1041,75
MG,52973,SAO SEBASTIAO DO RIO VERDE,1490,1118,259,1654,45,1395,46
MG,52990,SAO TIAGO,5524,6490,1262,7726,189,6464,268
MG,53015,SAO TOMAS DE AQUINO,3146,4188,1066,4946,70,3880,143
MG,53031,SAO TOME DAS LETRAS,3770,2874,898,4449,50,3551,179
MG,53058,SAO VICENTE DE MINAS,4962,1936,1130,4839,65,3709,195
MG,53074,SAPUCAI MIRIM,3144,2514,765,3722,37,2957,91
MG,53090,SARDOA,2302,2312,1017,3543,72,2526,147
MG,53112,SENADOR CORTES,1688,884,230,1618,28,1388,74
MG,53139,SENADOR FIRMINO,5946,2402,1537,5957,69,4420,177
MG,53155,SENADOR JOSE BENTO,1224,1306,312,1648,25,1336,46
MG,53171,SENADOR MODESTINO GONCALVES,2614,2378,1805,4511,41,2706,169
MG,53198,SENHORA DE OLIVEIRA,3160,3042,783,4169,102,3386,183
MG,53210,SENHORA DO PORTO,1616,1978,1178,3248,71,2070,202
MG,53236,SENHORA DOS REMEDIOS,4370,5814,1778,7263,106,5485,287
MG,53252,SERICITA,3314,4624,1446,5699,104,4253,180
MG,53279,SERITINGA,1192,872,301,1433,27,1132,73
MG,53295,SERRA AZUL DE MINAS,2212,1218,959,2903,36,1944,193
MG,53317,SERRA DA SAUDADE,732,484,235,869,7,634,19
MG,53333,SERRA DOS AIMORES,4546,2948,2251,6246,51,3995,197
MG,53350,SERRA DO SALITRE,4602,4458,1337,6091,102,4754,122
MG,53376,SERRANIA,4338,3362,1148,5204,74,4056,132
MG,53392,SERRANOS,1556,1086,403,1819,23,1416,72
MG,53414,SERRO,8120,8804,3929,13252,152,9323,709
MG,53430,SETE LAGOAS,162182,45224,17699,127098,2133,109399,3563
MG,53457,SILVEIRANIA,2208,688,217,1744,25,1527,54
MG,53473,SILVIANOPOLIS,3368,3464,899,4515,47,3616,153
MG,53490,SIMAO PEREIRA,2628,760,303,2107,19,1804,91
MG,53511,SIMONESIA,7968,8726,2768,11659,187,8891,357
MG,53538,SOBRALIA,3394,2968,1707,5136,51,3429,197
MG,53554,SOLEDADE DE MINAS,3558,2838,656,4008,58,3352,96
MG,53570,TABULEIRO,3024,2200,677,3475,68,2798,118
MG,53597,TAIOBEIRAS,9690,18500,5762,20827,221,15065,749
MG,53619,TAPIRA,2488,2014,888,3266,55,2378,72
MG,53635,TAPIRAI,1268,1216,431,1736,14,1305,49
MG,53651,TAQUARACU DE MINAS,2650,2068,785,3323,60,2538,119
MG,53678,TARUMIRIM,9142,7082,2412,10976,124,8564,328
MG,53694,TEIXEIRAS,9392,4374,1739,9113,122,7374,369
MG,53716,TEOFILO OTONI,85082,37532,25512,91130,1368,65618,2943
MG,53732,TIMOTEO,69198,13542,7729,50817,680,43088,1038
MG,53759,TIRADENTES,4614,2946,617,4563,51,3946,115
MG,53775,TIROS,2250,4586,1929,5561,98,3632,116
MG,53791,TOCANTINS,8408,9502,1762,11262,209,9500,336
MG,53813,TOLEDO,2218,3446,806,3844,96,3038,110
MG,53830,TOMBOS,5972,4344,1570,6995,62,5425,205
MG,53856,TRES CORACOES,46178,27060,6869,45575,678,38706,1409
MG,53872,TRES PONTAS,38182,18192,5831,35394,550,29563,826
MG,53899,TUMIRITINGA,3078,2510,890,3850,60,2960,106
MG,53910,TUPACIGUARA,14852,11970,2392,16501,268,14109,430
MG,53937,TURMALINA,8604,5648,2964,10615,134,7651,391
MG,53953,TURVOLANDIA,2250,2028,515,2839,92,2324,93
MG,53970,UBA,66712,23356,7889,55345,808,47456,1614
MG,53996,UBAI,2506,6786,3084,8121,62,5037,329
MG,54011,UBERABA,226458,74596,31312,188255,2128,156943,4288
MG,54038,UBERLANDIA,381508,157702,48799,334454,5132,285655,10918
MG,54054,UMBURATIBA,1372,1564,874,2429,17,1555,70
MG,54070,UNAI,45180,25348,12443,49390,626,36947,1057
MG,54097,URUCANIA,5590,4838,1839,7424,100,5585,271
MG,54119,VARGEM BONITA,1678,1146,502,1994,42,1492,38
MG,54135,VARGINHA,85288,40656,9611,75464,1014,65853,1867
MG,54151,VARZEA DA PALMA,20230,11034,5534,22025,253,16491,606
MG,54178,VARZELANDIA,7060,7122,4257,11858,113,7601,397
MG,54194,VAZANTE,15480,4854,4169,15016,299,10847,381
MG,54216,WENCESLAU BRAZ,2532,950,311,2122,17,1811,53
MG,54232,VERISSIMO,2492,1418,1078,3141,37,2063,71
MG,54259,VESPASIANO,61152,16264,8084,49211,886,41127,1533
MG,54275,VICOSA,57164,14954,6678,44525,703,37847,1085
MG,54291,VIEIRAS,3556,1134,991,3499,48,2508,115
MG,54313,MATHIAS LOBATO,2202,1446,965,2954,47,1989,118
MG,54330,VIRGEM DA LAPA,4858,6210,3195,9160,69,5965,362
MG,54356,VIRGINIA,3838,5610,1194,6189,68,4995,203
MG,54372,VIRGINOPOLIS,6696,3334,2355,7868,124,5513,374
MG,54399,VIRGOLANDIA,3458,1858,1730,4617,64,2887,165
MG,54410,VISCONDE DO RIO BRANCO,29814,10220,3458,24827,553,21369,799
MG,54437,VOLTA GRANDE,3820,1308,864,3632,73,2768,131
MG,54453,ITAU DE MINAS,10308,5832,1660,10291,184,8631,377
MS,55000,NOVA ALVORADA DO SUL,5122,4278,1486,6350,55,4864,109
MS,55018,ALCINOPOLIS,1520,2210,751,2686,27,1935,43
MS,55026,LAGUNA CARAPA,2616,2560,532,3210,27,2678,63
MS,55034,JAPORA,3550,1558,1251,3950,26,2699,119
MS,55042,NOVO HORIZONTE DO SUL,3126,2454,1100,4028,39,2928,99
MS,90034,AGUA CLARA,4598,4954,2205,7155,58,4950,116
MS,90115,AMAMBAI,15578,11814,4780,18997,159,14217,362
MS,90131,ANASTACIO,15112,7866,3725,15663,178,11938,271
MS,90158,ANAURILANDIA,3180,5044,1219,5492,47,4273,114
MS,90174,ANTONIO JOAO,4782,3384,1019,5239,24,4220,113
MS,90190,APARECIDA DO TABUADO,10058,9428,2434,12695,186,10261,332
MS,90212,AQUIDAUANA,27218,15952,8317,30612,225,22295,485
MS,90298,BANDEIRANTES,3402,3722,1231,4952,36,3721,123
MS,90379,BATAGUACU,8142,8000,2156,10585,110,8429,248
MS,90395,BATAIPORA,6308,5032,1719,7626,74,5907,163
MS,90417,BELA VISTA,11978,8538,3746,14320,124,10574,192
MS,90433,BONITO,9506,8998,2873,12457,115,9584,217
MS,90450,BRASILANDIA,6036,5484,2880,8951,106,6071,205
MS,90492,CAMAPUA,8564,9298,2932,12175,91,9243,221
MS,90514,CAMPO GRANDE,401254,313212,74107,445346,4646,371239,9360
MS,90530,CARACOL,2650,2090,612,3056,33,2444,41
MS,90557,CAARAPO,10778,10026,3771,14670,200,10899,297
MS,90573,CASSILANDIA,9146,14172,3329,15565,211,12236,366
MS,90611,CORGUINHO,2148,1782,751,2791,19,2040,56
MS,90638,CORUMBA,58460,30570,13692,59374,380,45682,787
MS,90654,COXIM,13708,16546,6092,21825,181,15733,425
MS,90735,DOURADOS,98044,83502,21595,115402,1119,93807,1915
MS,90751,FATIMA DO SUL,8704,12534,2116,13230,200,11114,295
MS,90794,GLORIA DE DOURADOS,5330,5900,1665,7550,111,5885,159
MS,90816,GUIA LOPES DA LAGUNA,6010,5128,1740,7589,104,5849,176
MS,90859,IGUATEMI,6584,5744,1938,8322,55,6384,165
MS,90875,INOCENCIA,3594,4308,1329,5457,48,4128,129
MS,90891,ITAPORA,8796,8522,2409,11469,164,9060,237
MS,90930,IVINHEMA,11068,12130,4208,16514,329,12306,378
MS,90972,JARAGUARI,2108,2606,601,3053,20,2452,75
MS,90999,JARDIM,13840,10474,3168,15736,157,12568,254
MS,91014,JATEI,1994,2424,659,2979,45,2320,66
MS,91030,LADARIO,9122,3670,1866,8487,78,6621,147
MS,91073,MARACAJU,15986,12704,3592,18338,131,14746,270
MS,91111,MIRANDA,14050,8654,3393,15211,122,11818,344
MS,91138,NAVIRAI,23170,17758,5454,26811,356,21357,537
MS,91154,NIOAQUE,8258,5198,2187,9277,99,7090,263
MS,91235,NOVA ANDRADINA,17614,18370,5714,24347,244,18633,397
MS,91251,PARANAIBA,19486,21236,6245,27483,300,21238,577
MS,91278,PEDRO GOMES,4140,4674,1542,6151,65,4609,137
MS,91316,PONTA PORA,35844,27006,9434,41893,353,32459,681
MS,91375,PORTO MURTINHO,5620,4610,1789,7047,36,5258,107
MS,91413,RIBAS DO RIO PARDO,7262,6898,3082,10420,87,7338,171
MS,91430,RIO BRILHANTE,12378,9422,2412,13827,181,11415,334
MS,91456,RIO NEGRO,3106,2994,1018,4202,44,3184,90
MS,91472,RIO VERDE DE MATO GROSSO,8116,9812,2976,12277,103,9301,234
MS,91499,ROCHEDO,2326,2756,715,3351,31,2636,64
MS,91570,SIDROLANDIA,15730,8042,2533,14832,163,12299,250
MS,91596,TERENOS,6148,5840,1583,7805,82,6222,146
MS,91650,TRES LAGOAS,51956,30464,11183,54223,680,43040,1150
MS,91693,ANGELICA,4338,3712,1223,5426,75,4203,103
MS,91715,ARAL MOREIRA,3930,3624,887,4817,31,3930,122
MS,91731,ELDORADO,5728,5498,1666,7544,96,5878,169
MS,91758,DEODAPOLIS,4862,7346,1942,8362,131,6420,185
MS,91782,CHAPADAO DO SUL,5812,5826,1774,7779,93,6005,93
MS,91790,MUNDO NOVO,8416,7646,2537,10859,116,8322,175
MS,91804,DOIS IRMAOS DO BURITI,5986,3010,1972,6658,53,4686,135
MS,91820,JUTY,2930,2474,795,3639,40,2844,102
MS,91847,PARANHOS,4000,3402,1234,5097,26,3863,136
MS,91863,SANTA RITA DO PARDO,3268,2802,1489,4623,32,3134,67
MS,91880,SONORA,5048,5358,1647,7095,72,5448,173
MS,91901,VICENTINA,2950,3728,768,4279,76,3511,96
MS,98019,BODOQUENA,5196,3354,1518,5939,51,4421,95
MS,98035,COSTA RICA,7972,9658,2763,11872,94,9109,200
MS,98051,DOURADINA,3020,2694,677,3711,55,3034,122
MS,98078,ITAQUIRAI,7592,6930,2723,10294,97,7571,213
MS,98094,SAO GABRIEL DO OESTE,9248,8874,2520,11869,116,9349,172
MS,98116,SELVIRIA,4030,2440,961,4325,43,3364,86
MS,98132,SETE QUEDAS,5762,5686,2151,8118,55,5967,188
MS,98159,TACURU,4018,2786,1257,4774,23,3517,92
MS,98175,TAQUARUSSU,1824,2076,447,2486,29,2039,60
MS,98590,CORONEL SAPUCAIA,7024,5116,2821,9154,56,6333,207
MT,89788,COLNIZA,6684,4906,3333,9402,115,6069,159
MT,89796,COLIDER,8626,18386,6292,20312,186,14020,328
MT,89800,CURVELANDIA,2056,2552,1143,3535,30,2392,58
MT,89818,NOVA BRASILANDIA,1520,2986,566,2933,25,2367,89
MT,89826,NOVA SANTA HELENA,1622,1468,771,2382,20,1611,46
MT,89834,PARANATINGA,5768,8006,3852,11001,96,7149,166
MT,89843,SANTO ANTONIO DO LESTE,936,1060,602,1634,12,1032,22
MT,89850,SINOP,39628,35718,12510,51399,522,38889,694
MT,89877,ALTA FLORESTA,20344,23626,4913,27723,320,22810,505
MT,89893,ARAPUTANGA,6412,6990,3323,10352,120,7029,208
MT,89915,JAURU,3192,7324,3241,8786,88,5545,199
MT,89958,RIO BRANCO,2860,2254,1257,3936,33,2679,89
MT,89960,RONDOLANDIA,1616,902,851,2181,13,1330,58
MT,89974,SALTO DO CEU,1966,2354,1443,3723,41,2280,79
MT,89990,PONTES E LACERDA,11596,19616,8695,25007,238,16312,468
MT,90018,ACORIZAL,3254,2374,2126,5041,21,2915,80
MT,90026,SAO JOSE DO POVO,1310,2560,649,2645,23,1996,38
MT,90042,ALTO DA BOA VISTA,1116,1884,1119,2665,16,1546,30
MT,90050,ALTO ARAGUAIA,5140,6740,2842,9049,85,6207,182
MT,90069,QUERENCIA,3608,2438,1565,4734,65,3169,81
MT,90077,ALTO GARCAS,3890,5058,1345,5996,44,4651,133
MT,90085,CANABRAVA DO NORTE,1326,2748,1250,3378,21,2128,70
MT,90093,ALTO PARAGUAI,3742,4316,2425,6628,44,4203,130
MT,90107,SANTA CARMEM,1800,1582,811,2580,43,1769,35
MT,90123,NOVA MARINGA,1614,2074,1152,3056,19,1904,41
MT,90140,NOVA GUARITA,2926,1602,1110,3462,33,2352,55
MT,90166,NOVA MARILANDIA,830,1236,669,1738,14,1069,22
MT,90182,PORTO ESTRELA,1944,1944,1381,3406,16,2025,65
MT,90204,GLORIA D'OESTE,1276,1966,577,2263,17,1686,48
MT,90220,TABAPORA,2640,3434,1275,4421,41,3146,68
MT,90239,ARAGUAINHA,912,472,220,950,11,730,27
MT,90247,SAO JOSE DO XINGU,1534,2230,1454,3429,22,1975,71
MT,90255,ARENAPOLIS,3044,6646,2947,8009,71,5062,146
MT,90263,APIACAS,2472,3354,1467,4524,37,3057,107
MT,90271,ARIPUANA,6636,4202,2386,8006,70,5620,131
MT,90280,CONFRESA,5776,7392,4691,11554,93,6863,186
MT,90301,LAMBARI D'OESTE,2082,2722,1586,4101,34,2515,79
MT,90310,BARAO DE MELGACO,2712,3654,1722,5032,34,3310,93
MT,90328,SANTO AFONSO,1080,1972,1211,2785,10,1574,38
MT,90336,BARRA DO BUGRES,15944,10400,6153,19976,240,13823,411
MT,90344,PLANALTO DA SERRA,1064,1338,284,1542,22,1258,35
MT,90352,BARRA DO GARCAS,34266,17300,12140,38958,372,26818,663
MT,90360,NOVA MONTE VERDE,3348,3466,1342,4905,53,3563,103
MT,90387,NOVA BANDEIRANTE,3242,2906,1561,4802,67,3241,100
MT,90409,SAO PEDRO DA CIPA,1972,2242,738,2947,32,2209,70
MT,90425,COTRIGUACU,4188,2808,1675,5348,73,3673,102
MT,90441,RIBEIRAOZINHO,1036,1106,419,1530,5,1111,35
MT,90468,BRASNORTE,4718,4312,2262,6973,76,4711,120
MT,90476,CACERES,44286,30036,15553,53929,368,38376,847
MT,90484,CAMPO NOVO DO PARECIS,9948,6698,4649,13217,91,8568,154
MT,90506,CAMPO VERDE,9978,8434,3409,12951,142,9542,194
MT,90522,CLAUDIA,4508,4424,1689,6304,48,4615,101
MT,90549,CASTANHEIRA,3286,3644,1967,5582,60,3615,90
MT,90565,JANGADA,2940,3888,1658,5214,31,3556,111
MT,90581,JURUENA,3506,1914,1060,3938,60,2878,108
MT,90590,CHAPADA DOS GUIMARAES,6714,6120,1366,8050,74,6684,193
MT,90603,LUCAS DO RIO VERDE,12844,7758,4404,15080,166,10676,209
MT,90620,MATUPA,5390,5904,2588,8443,80,5855,128
MT,90646,NOVA MUTUM,7282,6686,2474,9697,105,7223,134
MT,90662,RIBEIRAO CASCALHEIRA,2768,4202,2023,5636,30,3613,98
MT,90670,CUIABA,338708,172684,77090,341257,2775,264167,5696
MT,90697,DIAMANTINO,8664,8980,4279,13436,136,9157,199
MT,90700,PONTAL DO ARAGUAIA,3238,1940,951,3617,26,2666,51
MT,90719,DOM AQUINO,3938,4890,1888,6537,57,4649,178
MT,90727,SAPEZAL,3594,3252,1963,5506,55,3543,65
MT,90743,CAMPOS DE JULIO,1406,1886,689,2383,24,1694,24
MT,90760,CARLINDA,4872,5852,3159,8707,54,5548,132
MT,90778,GENERAL CARNEIRO,3208,1752,1442,4015,34,2573,59
MT,90786,FELIZ NATAL,2138,3102,1392,4080,24,2688,44
MT,90808,NOVO MUNDO,2840,1862,1268,3705,41,2437,45
MT,90824,GAUCHA DO NORTE,1450,1754,725,2396,28,1671,41
MT,90832,GUIRATINGA,4502,9514,3145,10456,91,7311,212
MT,90840,UNIAO DO SUL,1524,1288,816,2266,21,1450,23
MT,90867,NOVA LACERDA,1718,1444,1134,2760,13,1626,32
MT,90883,NOVA UBIRATA,2150,1500,1149,3036,21,1887,41
MT,90905,BOM JESUS DO ARAGUAIA,738,1486,928,2080,12,1152,28
MT,90913,ITIQUIRA,3710,4768,2540,6936,58,4396,99
MT,90921,SERRA NOVA DOURADA,382,438,364,794,3,430,17
MT,90948,NOVO SANTO ANTONIO,468,678,489,1078,3,589,13
MT,90956,JACIARA,10218,12754,3911,15806,144,11895,265
MT,90964,NOVA NAZARE,556,668,405,1043,7,638,19
MT,90980,SANTA CRUZ DO XINGU,542,776,440,1119,14,679,6
MT,91006,CONQUISTA D'OESTE,970,1388,663,1909,18,1246,49
MT,91022,VALE DE SAO DOMINGOS,1186,1958,1198,2837,16,1639,51
MT,91049,SANTA RITA DO TRIVELATO,552,704,386,1040,8,654,18
MT,91057,LUCIARA,1038,1286,422,1644,13,1222,47
MT,91065,BOA ESPERANCA DO NORTE,1132,606,415,1319,19,904,16
MT,91081,IPIRANGA DO NORTE,1204,774,333,1365,17,1032,26
MT,91103,ITANHANGA,1396,1456,752,2236,27,1484,31
MT,91170,NOBRES,5460,8186,3687,10753,37,7066,206
MT,91197,NORTELANDIA,3560,3864,2199,6058,30,3859,117
MT,91219,NOSSA SENHORA DO LIVRAMENTO,5548,5862,3452,9434,55,5982,222
MT,91294,POCONE,14726,10264,3114,16123,133,13009,381
MT,91332,PONTE BRANCA,1200,1078,307,1478,6,1171,26
MT,91359,PORTO DOS GAUCHOS,2100,2926,975,3598,37,2623,73
MT,91391,POXOREO,7020,11064,4980,14442,91,9462,329
MT,91510,RONDONOPOLIS,76314,69474,26708,102264,858,75556,1804
MT,91537,ROSARIO OESTE,6946,8738,4660,12858,100,8198,256
MT,91553,SANTO ANTONIO DO LEVERGER,9544,7062,2628,11177,66,8549,180
MT,91618,TESOURO,1228,1732,1096,2652,14,1556,62
MT,91634,TORIXOREU,2250,2760,477,3076,30,2599,64
MT,91677,VARZEA GRANDE,134132,70972,33584,139697,1159,106113,2402
MT,91774,MIRASSOL D'OESTE,7294,14012,5310,16403,148,11093,292
MT,91812,PEDRA PRETA,7506,7256,3236,10970,137,7734,216
MT,91839,SAO FELIX DO ARAGUAIA,3710,4050,3210,7269,49,4059,130
MT,91855,TANGARA DA SERRA,33480,28070,11962,43890,385,31928,768
MT,91898,JUSCIMEIRA,4556,6908,3393,9384,75,5991,184
MT,91910,AGUA BOA,7412,6774,3756,11196,147,7440,200
MT,91936,CANARANA,6792,6296,3342,10177,141,6835,150
MT,91952,NOVA XAVANTINA,8016,8440,4404,12912,77,8508,203
MT,91979,SANTA TEREZINHA,1982,2146,2259,4439,23,2180,93
MT,91995,SAO JOSE DO RIO CLARO,3984,8076,3035,9321,91,6286,165
MT,98191,JUARA,12214,14314,5790,19547,193,13757,300
MT,98310,JUINA,15714,17936,6404,23842,238,17438,375
MT,98337,DENISE,2918,3912,1469,5044,60,3575,100
MT,98612,ALTO TAQUARI,1704,2900,964,3349,33,2385,50
MT,98639,ARAGUAIANA,1482,1036,302,1616,15,1314,40
MT,98655,CAMPINAPOLIS,3786,5594,3166,8017,51,4851,110
MT,98671,COCALINHO,1940,1830,2848,4800,20,1952,47
MT,98698,ITAUBA,2508,2492,1293,3892,37,2599,62
MT,98710,MARCELANDIA,4710,7468,2760,9124,90,6364,185
MT,98736,NOVA OLIMPIA,8310,5974,3696,11168,127,7472,203
MT,98752,NOVA CANAA DO NORTE,4394,5972,2328,7724,67,5396,146
MT,98779,NOVO SAO JOAQUIM,3006,3994,2852,6466,30,3614,84
MT,98795,NOVO HORIZONTE DO NORTE,1968,2312,758,3004,28,2246,78
MT,98817,PEIXOTO DE AZEVEDO,9148,11878,7883,18811,122,10928,293
MT,98833,PARANAITA,3662,5000,1903,6409,67,4506,108
MT,98850,PORTO ALEGRE DO NORTE,2494,4520,2715,6323,22,3608,79
MT,98892,PRIMAVERA DO LESTE,17688,15696,6012,23365,286,17353,375
MT,98914,RESERVA DO CABACAL,1034,1014,211,1307,22,1096,50
MT,98930,SORRISO,21384,15012,5842,24753,326,18911,387
MT,98957,TERRA NOVA DO NORTE,6436,5332,2885,9030,110,6145,151
MT,98973,VERA,4844,3274,1906,6154,66,4248,123
MT,98990,VILA RICA,5620,7892,2695,9707,87,7012,169
MT,99015,COMODORO,5746,8056,4335,11492,64,7157,192
MT,99058,GUARANTA DO NORTE,11024,11478,4434,16205,204,11771,316
MT,99074,INDIAVAI,1114,1226,441,1669,15,1228,43
PA,4006,GOIANESIA DO PARA,7248,7972,4736,12679,82,7943,251
PA,4014,ABAETETUBA,64806,35118,12032,63349,313,51317,1042
PA,4022,TAILANDIA,12650,15458,10329,24980,148,14651,449
PA,4030,ACARA,11534,16872,8179,22979,125,14800,472
PA,4049,BOM JESUS DO TOCANTINS,4512,4654,2803,7616,59,4813,171
PA,4057,AFUA,7512,5702,5641,12598,56,6957,294
PA,4065,SAO JOAO DE PIRABAS,4216,8754,3776,10545,70,6769,214
PA,4073,ALENQUER,16256,21190,9785,29107,137,19322,462
PA,4081,TUCUMA,11504,8690,6204,16776,162,10572,313
PA,4090,ALMERIM,13422,8970,7123,18822,120,11699,383
PA,4103,MAE DO RIO,8864,14206,4802,16718,102,11916,279
PA,4111,ALTAMIRA,28092,31052,12036,42707,356,30671,743
PA,4120,ELDORADO DO CARAJAS,7414,6402,4653,11941,117,7288,263
PA,4138,ANAJAS,1400,6936,3550,7886,23,4336,145
PA,4146,SANTA LUZIA DO PARA,7104,6928,3045,10330,60,7285,209
PA,4154,ANANINDEUA,169052,110304,29161,172718,1331,143557,2548
PA,4162,PALESTINA DO PARA,1574,3896,1271,4134,34,2863,94
PA,4170,AUGUSTO CORREA,7096,18638,8013,21465,97,13452,488
PA,4189,IPIXUNA DO PARA,4782,7928,3272,9858,44,6586,187
PA,4197,AVEIRO,4070,4094,2266,6479,34,4213,97
PA,4200,JACAREACANGA,1660,5646,2189,5953,24,3764,87
PA,4219,BAGRE,2878,3722,3204,6680,31,3476,145
PA,4227,BRASIL NOVO,5286,7618,2545,9257,90,6712,170
PA,4235,BAIAO,8848,9096,3301,12588,86,9287,229
PA,4243,SANTA BARBARA DO PARA,6666,6618,1635,8443,49,6808,117
PA,4251,BARCARENA,32684,20474,9017,36339,221,27322,522
PA,4260,AGUA AZUL DO NORTE,4290,4074,2941,7363,55,4422,185
PA,4278,BELEM,803978,563054,144908,848052,6461,703144,13167
PA,4286,TRAIRAO,2134,4760,1951,5536,38,3585,100
PA,4294,BENEVIDES,16638,15294,3989,20329,114,16340,260
PA,4308,PAU D'ARCO,3258,2782,1721,4942,54,3221,147
PA,4316,BONITO,2744,7624,1856,7237,30,5381,167
PA,4324,ULIANOPOLIS,3796,5888,2966,8013,54,5047,151
PA,4332,BRAGANCA,26130,42706,18637,54024,221,35387,748
PA,4340,AURORA DO PARA,4782,7896,3213,9888,54,6675,282
PA,4359,BREVES,19974,16774,20527,39700,152,19173,647
PA,4367,TERRA SANTA,6014,4472,2004,7367,38,5363,82
PA,4375,BUJARU,7320,7894,3823,11673,59,7850,184
PA,4383,NOVO PROGRESSO,5918,4942,3719,9370,90,5651,131
PA,4391,CACHOEIRA DO ARARI,5714,6972,4331,10930,54,6599,202
PA,4405,VITORIA DO XINGU,2822,5344,1906,6129,31,4223,109
PA,4413,CAMETA,29800,46676,13295,52521,226,39226,762
PA,4421,NOVO REPARTIMENTO,11904,14802,9560,23636,136,14076,587
PA,4430,CAPANEMA,22912,28734,11117,37793,329,26676,524
PA,4448,BREU BRANCO,10110,15198,5101,18254,92,13153,407
PA,4456,CAPITAO POCO,11204,22110,7891,25331,227,17440,556
PA,4464,SAO DOMINGOS DO ARAGUAIA,7854,7472,3462,11543,106,8081,312
PA,4472,CASTANHAL,52594,59862,16807,74727,603,57920,1089
PA,4480,NOVA ESPERANCA DO PIRIA,2842,5676,2403,6904,66,4501,176
PA,4499,CHAVES,2510,5926,4118,8582,44,4464,202
PA,4502,ABEL FIGUEIREDO,3578,2416,1301,4455,43,3154,114
PA,4510,COLARES,4378,5008,1714,6533,34,4819,92
PA,4529,CUMARU DO NORTE,2010,1932,1275,3332,25,2057,61
PA,4537,CONCEICAO DO ARAGUAIA,19046,14204,13249,30758,240,17509,644
PA,4545,TERRA ALTA,4652,3928,1684,6092,34,4408,84
PA,4553,CURRALINHO,5198,5288,3570,9004,20,5434,171
PA,4561,FLORESTA DO ARAGUAIA,4988,5944,4351,10103,84,5752,202
PA,4570,CURUCA,10930,13502,5423,18071,94,12648,338
PA,4588,BANNACH,1372,2248,1176,3039,13,1863,40
PA,4596,FARO,3560,1916,1196,4016,22,2820,60
PA,4600,NOVA IPIXUNA,4636,5442,2771,8086,64,5315,212
PA,4618,GURUPA,7508,4510,2598,8824,25,6226,192
PA,4626,PLACAS,4316,5006,1609,6519,80,4910,169
PA,4634,IGARAPE ACU,11422,14410,2756,16169,160,13413,337
PA,4642,MARITUBA,32684,22874,8140,36681,267,28541,495
PA,4650,IGARAPE-MIRI,19602,19358,10483,30734,190,20251,581
PA,4669,TRACUATEUA,5696,12724,4449,14006,60,9557,287
PA,4677,INHANGAPI,3284,5584,2046,6627,40,4581,107
PA,4685,QUATIPURU,2256,5786,2409,6560,38,4151,92
PA,4693,IRITUIA,13172,11564,4952,17968,213,13016,435
PA,4707,CANAA DOS CARAJAS,5818,3816,2427,7499,110,5072,145
PA,4715,ITAITUBA,24544,40006,22635,55912,244,33277,758
PA,4723,ANAPU,2712,5908,2094,6621,41,4527,176
PA,4731,ITUPIRANGA,15186,8934,8178,20890,147,12712,505
PA,4740,CURUA,3218,4420,1199,5138,24,3939,96
PA,4758,JACUNDA,13954,19780,9896,27410,189,17514,458
PA,4766,CACHOEIRA DO PIRIA,3392,5700,2982,7702,35,4720,139
PA,4774,JURUTI,10396,11424,3922,15175,53,11253,290
PA,4782,PICARRA,2340,4136,2703,6124,48,3421,135
PA,4790,LIMOEIRO DO AJURU,7188,8742,2592,10836,65,8244,214
PA,4804,BELTERRA,8720,4616,2213,9143,56,6930,206
PA,4812,MAGALHAES BARATA,2966,4858,1856,5849,20,3993,61
PA,4820,SAO JOAO DA PONTA,1628,3350,1150,3704,19,2554,46
PA,4839,MARABA,76474,48088,24501,88890,595,64389,1513
PA,4847,SAPUCAIA,1734,2330,1362,3509,27,2147,88
PA,4855,MARACANA,7614,16338,6210,18536,92,12326,258
PA,4871,MARAPANIM,8810,12672,4500,15539,87,11039,211
PA,4898,MELGACO,2372,7340,3753,8718,6,4965,103
PA,4910,MOCAJUBA,7846,10304,3722,13080,88,9358,195
PA,4936,MOJU,19452,16488,11441,30008,111,18567,486
PA,4952,MONTE ALEGRE,23292,19252,8051,29928,162,21877,443
PA,4979,MUANA,9064,8450,4958,14099,87,9141,297
PA,4995,NOVA TIMBOTEUA,6148,6180,1625,8013,80,6388,144
PA,5010,OBIDOS,21820,13160,8127,26243,161,18116,465
PA,5037,OEIRAS DO PARA,5512,9836,3205,11204,54,7999,271
PA,5053,ORIXIMINA,23356,17228,8366,29331,177,20965,496
PA,5070,OUREM,5554,7118,2901,9484,64,6583,183
PA,5096,PARAGOMINAS,24270,27078,17103,43714,305,26611,632
PA,5118,PEIXE-BOI,2746,5504,1276,5564,38,4288,125
PA,5134,PONTA DE PEDRAS,5932,9090,4553,12396,80,7843,252
PA,5150,PORTEL,8724,12376,8351,19359,57,11008,401
PA,5177,PORTO DE MOZ,6214,6886,2890,9716,40,6826,236
PA,5193,PRAINHA,8710,9022,3992,13137,53,9145,226
PA,5215,PRIMAVERA,2554,7824,2507,7859,32,5352,131
PA,5231,SALINOPOLIS,12068,12746,4579,17323,101,12744,236
PA,5258,SALVATERRA,5118,7828,2671,9343,52,6672,147
PA,5274,SANTA CRUZ DO ARARI,2790,2612,1304,4106,15,2802,86
PA,5290,SANTA IZABEL DO PARA,16518,22418,5936,26094,276,20158,414
PA,5312,SANTA MARIA DO PARA,7002,11946,4138,14015,123,9877,280
PA,5339,SANTANA DO ARAGUAIA,5624,8656,4459,12001,97,7542,305
PA,5355,SANTAREM,169324,59988,40938,159503,1142,118565,2767
PA,5371,SANTAREM NOVO,2278,4476,1551,5035,27,3484,80
PA,5398,SANTO ANTONIO DO TAUA,8700,12196,3201,13946,91,10745,206
PA,5410,SAO CAETANO DE ODIVELAS,5094,8728,3276,10351,41,7075,123
PA,5436,SAO DOMINGOS DO CAPIM,6350,12066,4784,14357,68,9573,297
PA,5452,SAO FELIX DO XINGU,11162,8212,6682,16888,143,10206,376
PA,5479,SAO FRANCISCO DO PARA,4964,7546,1696,8112,44,6416,117
PA,5495,SAO JOAO DO ARAGUAIA,3664,4086,1578,5672,43,4094,176
PA,5517,SAO MIGUEL DO GUAMA,12288,17936,7725,23383,154,15658,392
PA,5533,SAO SEBASTIAO DA BOA VISTA,8590,6636,3096,10968,53,7872,206
PA,5550,SENADOR JOSE PORFIRIO,3072,3420,2235,5634,38,3399,115
PA,5576,SOURE,9720,7316,4530,13322,93,8792,181
PA,5592,TOME ACU,14364,17600,10067,26676,178,16609,449
PA,5614,TUCURUI,36290,32092,12937,48361,381,35424,852
PA,5630,VIGIA,16258,17238,7346,24653,177,17307,382
PA,5657,VIZEU,16756,17992,11409,29587,158,18178,646
PA,5673,REDENCAO,28354,27944,12396,41634,335,29238,754
PA,5690,RIO MARIA,8226,6308,5021,12636,119,7615,229
PA,5711,XINGUARA,14618,13552,7844,22594,216,14750,449
PA,5738,RONDON DO PARA,15828,13208,9495,24777,232,15282,532
PA,5754,URUARA,10532,14910,4674,18162,218,13488,549
PA,5770,MEDICILANDIA,6814,11110,3000,12431,136,9431,333
PA,5797,SAO GERALDO DO ARAGUAIA,7004,11744,7345,17227,132,9882,376
PA,5819,CONCORDIA DO PARA,7124,9326,5653,14237,87,8584,272
PA,5835,PARAUAPEBAS,47126,23670,13619,50388,498,36769,873
PA,5851,CURIONOPOLIS,7680,8828,6568,15176,119,8608,235
PA,5878,GARRAFAO DO NORTE,4504,10614,4531,12522,94,7991,338
PA,5894,RUROPOLIS,6810,9776,3252,11874,85,8622,244
PA,5916,PACAJA,7052,11260,4576,14253,129,9677,392
PA,5932,BREJO GRANDE DO ARAGUAIA,2734,3720,1696,5075,30,3379,122
PA,5959,OURILANDIA DO NORTE,5550,5602,3808,9644,67,5836,193
PA,5975,DOM ELISEU,11352,14542,6855,20503,224,13648,477
PA,5991,SANTA MARIA DAS BARREIRAS,2722,3632,2803,6172,52,3369,140
PB,19003,RIACHAO DO POCO,2452,2098,367,2820,33,2453,145
PB,19011,AGUA BRANCA,2600,5250,873,5165,59,4292,308
PB,19020,SOBRADO,2666,4012,1037,4772,79,3735,317
PB,19038,AGUIAR,4580,2166,650,4355,22,3705,310
PB,19046,SAO JOSE DOS RAMOS,2964,1914,753,3435,32,2682,211
PB,19054,ALAGOA GRANDE,16852,10486,3263,18730,352,15467,1446
PB,19062,CAPIM,1722,2712,832,3349,83,2517,217
PB,19070,ALAGOA NOVA,8968,8788,2038,12124,226,10086,982
PB,19089,CUITE DE MAMANGUAPE,3538,2450,1284,4672,66,3388,328
PB,19097,ALAGOINHA,7650,4540,1176,8121,151,6945,699
PB,19100,CURRAL DE CIMA,1458,3792,1312,4300,73,2988,290
PB,19119,ALHANDRA,9294,8622,2877,12942,266,10065,841
PB,19127,RIACHAO DO BACAMARTE,2240,2336,844,3387,61,2543,194
PB,19135,SAO JOAO DO RIO DO PEIXE,9552,9194,1927,12282,238,10355,744
PB,19143,MATINHAS,1888,2158,888,3193,76,2305,206
PB,19151,ARACAGI,9732,5998,3943,12679,163,8736,708
PB,19160,LOGRADOURO,2556,1290,394,2496,23,2102,156
PB,19178,ARARA,4618,4908,1289,6607,77,5318,478
PB,19186,SERTAOZINHO,2716,1448,396,2656,34,2260,144
PB,19194,ARARUNA,9460,6706,1449,10488,169,9039,787
PB,19208,RIACHAO,1488,1916,424,2238,10,1814,102
PB,19216,AREIA,12110,10400,2138,14955,342,12817,1220
PB,19224,SAO DOMINGOS DO CARIRI,1256,1718,359,1916,13,1557,57
PB,19232,AREIAL,2952,3066,627,3957,66,3330,255
PB,19240,CARAUBAS,1638,2704,393,2755,41,2362,150
PB,19259,AROEIRAS,5240,12640,1977,12042,212,10065,913
PB,19267,SANTO ANDRE,962,2050,271,1936,36,1665,123
PB,19275,DAMIAO,2858,1690,567,3001,16,2434,144
PB,19283,SOSSEGO,1018,1938,182,1786,30,1604,96
PB,19291,BAIA DA TRAICAO,1992,3286,1081,4123,107,3042,296
PB,19305,BARAUNAS,1440,2088,341,2313,43,1972,165
PB,19313,BANANEIRAS,12724,8160,2183,13851,241,11668,985
PB,19321,ASSUNCAO,1156,2598,231,2215,28,1984,79
PB,19330,BARRA DE SANTA ROSA,6830,6718,904,8076,55,7172,343
PB,19348,ZABELE,744,1560,179,1434,35,1255,68
PB,19356,BARRA DE SAO MIGUEL,2122,3816,872,4036,44,3164,151
PB,19364,CACIMBAS,1060,4418,1498,4680,94,3182,349
PB,19372,BAYEUX,65718,25808,10841,61788,1378,50947,3806
PB,19380,CAJAZEIRINHAS,2572,1682,411,2747,28,2336,181
PB,19399,BELEM,9044,6960,2049,10830,224,8781,555
PB,19402,SAO BENTINHO,2638,1074,637,2701,23,2064,185
PB,19410,BELEM DO BREJO DO CRUZ,2258,4444,681,4387,68,3706,287
PB,19429,SAO DOMINGOS DE POMBAL,1348,2606,666,2772,26,2106,103
PB,19437,BOA VENTURA,3398,2174,799,3954,44,3155,325
PB,19445,SAO JOSE DE PRINCESA,1658,1780,809,2800,27,1991,245
PB,19453,BOM JESUS,2254,560,213,1747,31,1534,96
PB,19461,MARIZOPOLIS,4192,2210,664,4333,113,3669,355
PB,19470,BOM SUCESSO,3348,2714,605,3898,56,3293,206
PB,19488,MATO GROSSO,476,2506,202,1765,2,1563,70
PB,19496,BONITO DE SANTA FE,4034,4736,1104,5978,76,4874,413
PB,19500,BERNARDINO BATISTA,1848,796,293,1823,18,1530,190
PB,19518,BOQUEIRAO,8644,9038,3021,12505,121,9484,522
PB,19526,POCO DE JOSE DE MOURA,3436,1552,381,3098,36,2717,187
PB,19534,IGARACY,3628,2580,1083,4520,44,3437,289
PB,19542,SAO JOSE DO BREJO CRUZ,1218,802,197,1297,31,1100,59
PB,19550,BORBOREMA,2926,1774,533,3159,52,2626,224
PB,19569,SANTA INES,1452,2714,453,2716,15,2263,165
PB,19577,BREJO DO CRUZ,4864,7372,2320,9039,124,6719,477
PB,19585,AMPARO,892,1392,196,1405,11,1209,56
PB,19593,BREJO DOS SANTOS,2796,4428,917,4785,68,3868,188
PB,19607,CASSERENGUE,3102,3526,626,4312,50,3686,322
PB,19615,CAAPORA,10672,7488,3484,13565,280,10081,721
PB,19623,GADO BRAVO,1754,6478,1850,6454,104,4604,384
PB,19631,CABACEIRAS,2958,2552,440,3413,63,2973,155
PB,19640,POCO DANTAS,1550,1732,394,2276,36,1882,205
PB,19658,CABEDELO,26378,14650,4713,27336,590,22623,1519
PB,19666,SANTAREM,1874,1230,510,2198,17,1688,119
PB,19674,CACHOEIRA DOS INDIOS,4942,3174,945,5371,82,4426,286
PB,19682,TENORIO,1712,954,370,1829,16,1459,110
PB,19690,CACIMBA DE AREIA,1882,2182,412,2582,40,2170,98
PB,19704,COXIXOLA,900,964,146,1191,38,1045,75
PB,19712,CACIMBA DE DENTRO,7394,9096,1757,10668,78,8911,588
PB,19720,PARARI,922,1186,243,1394,18,1151,79
PB,19739,CAICARA,5038,2782,948,5177,65,4229,254
PB,19747,PEDRO REGIS,1574,2302,841,3118,84,2277,255
PB,19755,CAJAZEIRAS,36592,15614,9943,38249,573,28306,1630
PB,19763,ALCANTIL,2020,3192,331,3147,42,2816,168
PB,19771,CALDAS BRANDAO,3676,2076,506,3730,116,3224,232
PB,19780,BARRA DE SANTANA,2232,6236,645,5266,81,4621,306
PB,19798,CAMALAU,2796,2896,489,3744,111,3255,298
PB,19801,CATURITE,1756,3094,249,2858,45,2609,139
PB,19810,CAMPINA GRANDE,222486,150054,39690,239849,3960,200159,9929
PB,19828,RIACHO DE SANTO ANTONIO,764,1360,154,1282,12,1128,54
PB,19836,CARRAPATEIRA,1564,638,463,1678,8,1215,106
PB,19844,APARECIDA,4226,2956,804,4789,83,3985,311
PB,19852,CATINGUEIRA,2864,2600,731,3703,50,2972,190
PB,19860,SAO FRANCISCO,2612,2102,368,2922,32,2554,165
PB,19879,CATOLE DO ROCHA,15142,14616,2075,17811,202,15736,655
PB,19887,VIEIROPOLIS,3838,1858,568,3780,44,3212,320
PB,19895,CONCEICAO,9686,7444,2374,12154,144,9780,1071
PB,19909,AREIA DE BARAUNAS,754,1624,176,1441,22,1265,54
PB,19917,CONDADO,3768,3914,1120,5312,55,4192,296
PB,19925,ALGODAO DE JANDAIRA,1478,1152,257,1674,11,1417,91
PB,19933,CONDE,9184,5192,2923,11333,280,8410,942
PB,19941,BOA VISTA,2614,3930,534,4026,56,3492,164
PB,19950,CONGO,2416,2552,395,3106,66,2711,161
PB,19968,MARCACAO,1546,2856,1046,3607,93,2561,267
PB,19976,COREMAS,8298,6912,1536,9726,132,8190,453
PB,19984,MATUREIA,2010,3586,1056,4117,44,3061,219
PB,19992,CRUZ DO ESPIRITO SANTO,9500,4978,981,9431,358,8450,853
PB,20001,SANTA CECILIA DE UMBUZEIRO,1256,5106,1146,4602,50,3456,225
PB,20010,CUBATI,2380,4772,567,4461,66,3894,252
PB,20036,CUITE,7928,12178,3624,14611,192,10987,742
PB,20052,CUITEGI,3296,2924,599,4046,70,3447,267
PB,20079,CURRAL VELHO,860,1974,398,1911,13,1513,83
PB,20095,DESTERRO,2040,5842,790,5017,63,4227,223
PB,20117,VISTA SERRANA,1304,1956,448,2160,16,1712,66
PB,20133,DIAMANTE,3250,3244,876,4544,78,3668,343
PB,20150,DONA INES,6094,4372,1145,6838,45,5693,415
PB,20176,DUAS ESTRADAS,2714,1778,528,2938,35,2410,129
PB,20192,EMAS,1982,1598,313,2261,23,1948,135
PB,20214,ESPERANCA,15106,15156,5236,21746,332,16510,1047
PB,20230,FAGUNDES,5082,6992,1786,8442,69,6656,550
PB,20257,FREI MARTINHO,1542,2004,151,2063,24,1912,115
PB,20273,GUARABIRA,35484,16620,4019,32079,539,28060,1469
PB,20290,GURINHEM,7816,6360,2296,10029,141,7733,504
PB,20311,GURJAO,1514,2260,251,2315,27,2064,150
PB,20338,IBIARA,2306,4106,800,4352,88,3552,258
PB,20354,IMACULADA,3290,6126,1113,6423,102,5310,500
PB,20370,INGA,10280,6884,3758,13268,194,9510,734
PB,20397,ITABAIANA,13492,12668,6018,20543,336,14525,1109
PB,20419,ITAPORANGA,11330,8944,4213,15213,158,11000,705
PB,20435,ITAPOROROCA,4392,9088,1121,8642,147,7521,634
PB,20451,ITATUBA,5176,4694,1983,7482,120,5499,444
PB,20478,JACARAU,6494,6986,1583,8972,119,7389,530
PB,20494,JERICO,4272,3478,773,4982,62,4209,272
PB,20516,JOAO PESSOA,454224,142860,52887,376822,6285,323935,19108
PB,20532,JUAREZ TAVORA,5094,2270,738,4953,143,4215,390
PB,20559,JUAZEIRINHO,6894,8212,1192,9493,167,8301,581
PB,20575,JUNCO DO SERIDO,2100,4160,784,4202,87,3418,201
PB,20591,JURIPIRANGA,7448,3028,2780,8706,125,5926,563
PB,20613,JURU,3006,5652,2279,7132,79,4853,445
PB,20630,LAGOA,3286,1998,561,3507,62,2946,242
PB,20656,LAGOA DE DENTRO,3672,3356,936,4832,76,3896,306
PB,20672,LAGOA SECA,10704,12066,1341,14013,377,12672,910
PB,20699,LASTRO,3236,934,321,2648,29,2327,213
PB,20710,LIVRAMENTO,2094,4560,582,4237,63,3655,265
PB,20737,LUCENA,5144,3224,1912,6749,209,4837,444
PB,20753,MAE D AGUA,1868,2570,459,2879,38,2420,163
PB,20770,MALTA,3050,3078,923,4330,86,3407,257
PB,20796,MAMANGUAPE,14682,20974,6652,26533,478,19881,1575
PB,20818,MANAIRA,5206,3992,2591,7719,69,5128,460
PB,20834,MARI,9876,7378,1941,11662,267,9721,827
PB,20850,MASSARANDUBA,5714,6260,1477,8362,245,6885,653
PB,20877,MATARACA,3148,3164,683,4156,84,3473,233
PB,20893,MOGEIRO,5766,6416,2662,9301,102,6639,446
PB,20915,MONTADAS,2510,1748,478,2878,40,2400,231
PB,20931,MONTE HOREBE,2380,1730,697,3005,33,2308,220
PB,20958,MONTEIRO,13512,15514,2610,18475,283,15865,1069
PB,20974,MULUNGU,6070,4504,932,6646,102,5714,325
PB,20990,NATUBA,1616,5894,793,5122,111,4329,463
PB,21016,NAZAREZINHO,5278,2594,1029,5470,72,4441,433
PB,21032,NOVA FLORESTA,2596,6598,831,5758,78,4927,252
PB,21059,NOVA OLINDA,2318,3688,1842,5176,49,3334,282
PB,21075,NOVA PALMEIRA,1822,2558,344,2680,37,2336,109
PB,21091,OLHO D AGUA,3736,5726,761,5820,41,5059,287
PB,21113,OLIVEDOS,2032,2044,535,2772,48,2237,151
PB,21130,OURO VELHO,1988,1716,333,2291,26,1958,80
PB,21156,PASSAGEM,1040,1562,183,1568,26,1385,58
PB,21172,PATOS,44520,42686,12687,58873,716,46186,1867
PB,21199,PAULISTA,3822,8286,1312,7800,82,6488,352
PB,21210,PEDRA BRANCA,1588,2844,397,2743,24,2346,106
PB,21237,PEDRA LAVRADA,3236,4936,653,5004,45,4351,220
PB,21253,PEDRAS DE FOGO,13124,11872,5297,19468,343,14171,1330
PB,21270,PIANCO,7600,8810,1575,10406,108,8831,518
PB,21296,PICUI,6512,11310,2901,12749,164,9848,773
PB,21318,PILAR,7396,3506,815,7043,124,6228,653
PB,21334,PILOES,5956,1470,772,5023,84,4251,454
PB,21350,PILOEZINHOS,3102,2568,622,3736,66,3114,213
PB,21377,PIRPIRITUBA,5174,4132,987,6064,96,5077,328
PB,21393,PITIMBU,4302,5606,1634,7090,116,5456,386
PB,21415,POCINHOS,7234,9464,1190,10194,167,9004,488
PB,21431,POMBAL,19066,12992,2867,20253,276,17386,1081
PB,21458,PRATA,1564,2558,793,3056,38,2263,164
PB,21474,PRINCESA ISABEL,7426,9358,1904,11062,155,9158,611
PB,21490,PUXINANA,5874,6744,655,7583,174,6928,445
PB,21512,QUEIMADAS,14486,21412,4067,23771,445,19704,1310
PB,21539,QUIXABA,754,1452,192,1368,14,1176,59
PB,21555,REMIGIO,7966,6970,1563,9828,167,8265,630
PB,21571,RIACHO DOS CAVALOS,2566,5934,790,5401,89,4611,272
PB,21598,RIO TINTO,11106,9818,4710,16436,348,11726,916
PB,21610,SALGADINHO,854,2254,443,2175,36,1732,142
PB,21636,SALGADO DE SAO FELIX,5446,4876,3011,8845,124,5834,549
PB,21652,SANTA CRUZ,5094,2304,1184,5276,57,4092,336
PB,21679,SANTA HELENA,4494,1902,585,4158,60,3573,315
PB,21695,SANTA LUZIA,5386,11286,1763,10603,201,8840,303
PB,21717,SANTANA DE MANGUEIRA,1938,3780,722,3881,59,3159,241
PB,21733,SANTANA DOS GARROTES,3564,4444,823,5240,58,4417,355
PB,21750,SANTA RITA,68580,30754,13693,69815,1661,56122,4794
PB,21776,SANTA TERESINHA,2538,3510,745,3971,50,3226,152
PB,21792,SAO BENTO,12118,15522,3541,18306,206,14765,739
PB,21814,SAO JOAO DO CARIRI,2450,2444,477,3182,56,2705,202
PB,21830,SAO JOAO DO TIGRE,1818,2474,373,2761,29,2388,213
PB,21857,SAO JOSE DA LAGOA TAPADA,3808,4628,1486,6209,86,4723,419
PB,21873,SAO JOSE DE CAIANA,2432,3194,867,4032,50,3165,302
PB,21890,SAO JOSE DE ESPINHARAS,2868,3380,743,4114,50,3371,197
PB,21911,SAO JOSE DE PIRANHAS,10402,6692,2149,11706,216,9557,794
PB,21938,SAO JOSE DO BONFIM,2518,1848,232,2555,25,2323,115
PB,21954,SAO JOSE DO SABUGI,1272,3760,245,2935,45,2690,129
PB,21970,SAO JOSE DOS CORDEIROS,2132,2166,413,2815,48,2402,205
PB,21997,SAO MAMEDE,4364,5138,1148,6197,65,5049,233
PB,22012,SAO MIGUEL DE TAIPU,3232,1886,510,3486,82,2976,335
PB,22039,SAO SEB. DE LAGOA DE ROCA,4880,5318,1171,6877,143,5706,464
PB,22055,SAO SEBASTIAO DO UMBUZEIRO,2052,1288,267,2139,36,1872,166
PB,22071,SAPE,26144,16794,9573,33722,682,24149,1998
PB,22098,SAO VICENTE DO SERIDO,2322,6502,1470,6326,82,4856,362
PB,22110,SERRA BRANCA,6058,6106,1244,7986,162,6742,498
PB,22136,SERRA DA RAIZ,1646,1992,444,2399,36,1955,100
PB,22152,SERRA GRANDE,1460,1646,323,2008,22,1685,110
PB,22179,SERRA REDONDA,4556,2978,787,5016,83,4229,379
PB,22195,SERRARIA,3736,3682,1026,5176,89,4150,352
PB,22217,SOLANEA,11864,14328,6667,21135,295,14468,1077
PB,22233,SOLEDADE,6210,6924,1430,8633,152,7203,484
PB,22250,SOUSA,35152,21774,10225,41684,743,31459,2253
PB,22276,SUME,7506,7394,1628,9997,189,8369,730
PB,22292,CAMPO DE SANTANA,4236,4808,943,5938,89,4995,384
PB,22314,TAPEROA,5086,8612,1255,8670,105,7415,461
PB,22330,TAVARES,4528,6710,1691,7927,117,6236,500
PB,22357,TEIXEIRA,4468,8228,1167,8072,120,6905,437
PB,22373,TRIUNFO,3786,5000,1898,6691,85,4793,315
PB,22390,UIRAUNA,8096,7092,1207,9351,93,8144,457
PB,22411,UMBUZEIRO,3010,5884,1005,5856,69,4851,335
PB,22438,VARZEA,1408,1740,206,1862,22,1656,60
PE,23000,QUIXABA,3382,3742,2182,6021,65,3839,212
PE,23019,AFOGADOS DA INGAZEIRA,16384,13032,6743,22377,264,15634,662
PE,23027,LAGOA DO CARRO,8632,6218,2259,10018,123,7759,211
PE,23035,AFRANIO,7224,9560,2354,11460,167,9106,547
PE,23043,SANTA CRUZ DA BAIXA VERDE,5598,6452,1525,7961,119,6436,292
PE,23051,AGRESTINA,11256,10808,5443,17410,283,11967,652
PE,23060,XEXEU,3762,6138,2829,8080,67,5251,234
PE,23078,AGUA PRETA,15594,7766,7756,20246,277,12490,533
PE,23086,VERTENTE DO LERIO,2798,5872,2542,7174,80,4632,217
PE,23094,AGUAS BELAS,13192,18938,10060,27636,327,17576,1184
PE,23108,SANTA CRUZ,5262,4634,2754,8133,97,5379,334
PE,23116,ALAGOINHA,6902,6716,2540,9745,102,7205,294
PE,23124,JUCATI,3542,6394,2017,7336,98,5319,253
PE,23132,ALIANCA,19940,13402,9121,27015,501,17894,722
PE,23140,DORMENTES,9860,5190,2628,10801,163,8173,485
PE,23159,ALTINHO,9030,12146,4507,16204,470,11697,639
PE,23167,CARNAUBEIRA DA PENHA,6554,1248,2813,7018,45,4205,259
PE,23175,AMARAJI,12976,6078,5260,15520,309,10260,424
PE,23183,LAGOA GRANDE,11792,3602,4336,12579,138,8243,408
PE,23191,ANGELIM,5024,5328,939,6417,62,5478,240
PE,23205,ARACOIABA,10740,4392,2382,10407,165,8025,294
PE,23213,ARARIPINA,25904,27978,15467,44561,501,29094,1652
PE,23221,CASINHAS,5170,7246,2869,9607,116,6738,414
PE,23230,ARCOVERDE,33304,22540,10493,39915,530,29422,970
PE,23248,MANARI,1978,8574,2451,8074,54,5623,293
PE,23256,BARRA DE GUABIRABA,4532,5726,2784,8278,121,5494,244
PE,23264,JATOBA,9106,2476,2421,8504,79,6083,213
PE,23272,BARREIROS,15794,17092,11243,28890,559,17647,645
PE,23280,TAMANDARE,8974,4610,3461,10649,163,7188,233
PE,23299,BELEM DE MARIA,4380,5874,3183,8786,133,5603,343
PE,23302,JAQUEIRA,5654,4006,2324,7482,65,5158,263
PE,23310,BELEM DE SAO FRANCISCO,8912,5874,5483,13356,100,7873,380
PE,23329,SANTA FILOMENA,3954,5728,2706,7882,73,5176,262
PE,23337,BELO JARDIM,36538,28778,13080,48288,890,35208,1660
PE,23353,BETANIA,3034,7690,1930,7723,87,5793,344
PE,23370,BEZERROS,22672,31052,9016,38154,841,29138,1435
PE,23396,BODOCO,11616,16860,3081,18325,186,15244,820
PE,23418,BOM CONSELHO,11528,23860,11163,30383,347,19220,1179
PE,23434,BOM JARDIM,14300,19956,8130,26437,365,18307,814
PE,23450,BONITO,15308,16300,7255,24569,533,17314,977
PE,23477,BREJAO,6070,4500,914,6615,98,5701,318
PE,23493,BREJINHO,2264,5368,1997,6069,70,4072,186
PE,23515,BREJO DA MADRE DE DEUS,10474,20122,5985,22439,332,16454,824
PE,23531,BUENOS AIRES,8070,4644,3233,10020,145,6787,285
PE,23558,BUIQUE,10228,27688,8147,29303,473,21156,1725
PE,23574,CABO,112142,53304,22223,110669,2743,88446,2980
PE,23590,CABROBO,9708,13104,6140,18271,173,12131,552
PE,23612,CACHOEIRINHA,7322,10122,3642,12937,213,9295,360
PE,23639,CAETES,10066,7572,4225,13821,176,9596,601
PE,23655,CALCADO,2198,6196,1935,6444,86,4509,226
PE,23671,CALUMBI,4090,3300,2066,6021,60,3955,200
PE,23698,CAMOCIM DE SAO FELIX,9230,6426,3537,12073,218,8536,490
PE,23710,CAMUTANGA,6136,3502,2125,7244,112,5119,188
PE,23736,CANHOTINHO,7140,12470,5873,16466,198,10593,590
PE,23752,CAPOEIRAS,8574,8488,4387,13634,251,9247,465
PE,23779,CARNAIBA,8332,9592,4904,14569,184,9665,519
PE,23795,CARPINA,36672,24410,9237,41675,842,32438,1055
PE,23817,CARUARU,96790,137448,28994,153997,3523,125003,4361
PE,23833,CATENDE,14014,14654,7151,22638,397,15487,756
PE,23850,CEDRO,4434,4800,2301,7256,77,4955,261
PE,23876,CHA DE ALEGRIA,6824,6124,2626,9605,172,6979,333
PE,23892,CHA GRANDE,7158,10672,2225,11880,254,9655,486
PE,23914,CONDADO,12046,7524,4534,15007,281,10473,407
PE,23930,CORRENTES,8242,6124,3981,11776,193,7795,419
PE,23957,CORTES,7284,6008,4557,11679,140,7122,336
PE,23973,CUMARU,7672,9968,4355,13792,209,9437,408
PE,23990,CUPIRA,8162,12640,6178,17424,299,11246,546
PE,24015,CUSTODIA,13152,13724,8119,22419,263,14300,599
PE,24031,ESCADA,35236,21620,10844,40799,619,29955,908
PE,24058,EXU,17312,10418,8440,23308,199,14868,804
PE,24074,FEIRA NOVA,6800,12956,4318,14937,263,10619,478
PE,24090,FERREIROS,8808,2342,2588,8540,141,5952,236
PE,24112,FLORES,10518,9024,5798,16398,188,10600,641
PE,24139,FLORESTA,18308,3876,5975,17690,136,11715,487
PE,24155,FREI MIGUELINHO,3686,11026,1656,9447,133,7791,302
PE,24171,GAMELEIRA,11336,5740,4747,13912,207,9165,420
PE,24198,GARANHUNS,69970,30034,16495,69503,1075,53008,1931
PE,24210,GLORIA DO GOITA,10310,13954,5474,18600,293,13126,701
PE,24236,GOIANA,38034,30470,11432,47654,924,36222,1046
PE,24252,GRANITO,3278,2322,878,3877,37,2999,162
PE,24279,GRAVATA,23118,39580,13412,47009,918,33597,1330
PE,24295,IATI,5356,9812,4784,12984,112,8200,504
PE,24317,IBIMIRIM,7316,12008,6629,16975,141,10346,543
PE,24333,IBIRAJUBA,2582,5192,2091,6269,86,4178,205
PE,24350,IGARASSU,49608,29092,10322,51996,1055,41674,1269
PE,24376,IGUARACI,5418,5120,3091,8774,88,5683,326
PE,24392,INAJA,3386,6896,2389,7890,108,5501,252
PE,24414,INGAZEIRA,2768,2144,1095,3718,53,2623,114
PE,24430,IPOJUCA,33776,22522,10286,40306,810,30020,1061
PE,24457,IPUBI,6642,11374,5155,14877,155,9722,559
PE,24473,ITACURUBA,3054,1050,1390,3549,19,2159,88
PE,24490,ITAIBA,8172,11350,5115,15686,156,10571,654
PE,24511,ITAMARACA,10232,6908,2761,11734,202,8973,201
PE,24538,ITAPETIM,5084,8736,3644,11130,204,7486,372
PE,24554,ITAQUITINGA,10028,3748,3441,10813,199,7372,285
PE,24570,JABOATAO,336196,185342,59292,334794,6594,275502,8139
PE,24597,JATAUBA,5312,8858,2873,10463,135,7590,370
PE,24619,JOAO ALFREDO,9662,17048,7049,21554,328,14505,822
PE,24635,JOAQUIM NABUCO,10496,4620,4530,12598,173,8068,337
PE,24651,JUPI,5794,6950,2935,9866,199,6931,360
PE,24678,JUREMA,3382,8584,1612,8118,119,6506,404
PE,24694,LAGOA DE ITAENGA,11546,11984,4247,16784,296,12537,476
PE,24716,LAGOA DO OURO,4816,7526,2961,9618,98,6657,388
PE,24732,LAGOA DOS GATOS,4226,8498,3884,10842,179,6958,417
PE,24759,LAJEDO,14850,19142,8477,26539,382,18062,684
PE,24775,LIMOEIRO,27468,30866,11160,42404,940,31244,1137
PE,24791,MACAPARANA,13040,9768,7865,20377,300,12512,808
PE,24813,MACHADOS,5016,5580,2815,8580,174,5765,293
PE,24830,MARAIAL,6016,5284,3758,9871,106,6113,357
PE,24856,MIRANDIBA,8118,4390,3564,10251,98,6687,335
PE,24872,MORENO,33080,17968,8725,35988,832,27263,907
PE,24899,NAZARE DA MATA,19408,12504,5639,22936,707,17297,634
PE,24910,OLINDA,283852,147652,39513,265800,4420,226287,6115
PE,24937,OROBO,7762,12668,5604,16665,283,11061,563
PE,24953,OROCO,5828,4914,2738,8489,80,5751,300
PE,24970,OURICURI,15504,29600,11647,35808,389,24161,1220
PE,24996,PALMARES,31670,19310,13421,40551,624,27130,1016
PE,25011,PALMEIRINA,2974,5498,1887,6504,66,4617,315
PE,25038,PANELAS,5718,18092,5802,18645,162,12843,776
PE,25054,PARANATAMA,5458,6220,3536,9940,129,6404,436
PE,25070,PARNAMIRIM,7830,9848,4058,13494,151,9436,446
PE,25097,PASSIRA,12652,16438,6274,21894,408,15620,667
PE,25119,PAUDALHO,17888,23706,5844,28024,616,22180,767
PE,25135,PAULISTA,172972,80152,26783,159644,2810,132861,3489
PE,25151,PEDRA,8396,11948,4562,15512,215,10950,563
PE,25178,PESQUEIRA,34766,20674,11787,41273,467,29486,1299
PE,25194,PETROLANDIA,20514,5362,4452,17996,170,13544,436
PE,25216,PETROLINA,140566,46812,28152,127832,1839,99680,4152
PE,25232,POCAO,5120,6480,1208,7526,146,6318,372
PE,25259,POMBOS,10620,13436,5526,18497,422,12971,521
PE,25275,PRIMAVERA,6732,4452,2474,8453,158,5979,229
PE,25291,QUIPAPA,7636,9818,6247,15795,231,9548,590
PE,25313,RECIFE,1004504,578046,152719,982511,17717,829792,20800
PE,25330,RIACHO DAS ALMAS,7652,12106,4426,15238,433,10812,500
PE,25356,RIBEIRAO,21782,13904,9710,28836,501,19126,782
PE,25372,RIO FORMOSO,11612,8692,5833,16633,198,10800,450
PE,25399,SAIRE,6340,8650,3478,11656,231,8178,452
PE,25410,SALGADINHO,2392,4424,673,4315,84,3642,150
PE,25437,SALGUEIRO,26324,18112,8298,31752,391,23454,845
PE,25453,SALOA,4954,8906,3213,10810,162,7597,505
PE,25470,SANHARO,11162,7050,4437,14260,209,9823,508
PE,25496,SANTA CRUZ DO CAPIBARIBE,26258,29692,8741,38713,1052,29972,945
PE,25518,SANTA MARIA DA BOA VISTA,19562,6796,6007,20020,193,14013,641
PE,25534,SANTA MARIA DO CAMBUCA,4042,8042,3339,9823,136,6484,306
PE,25550,SANTA TEREZINHA,4632,4812,2402,7368,57,4966,187
PE,25577,SAO BENEDITO DO SUL,3346,4522,2821,7180,120,4359,305
PE,25593,SAO BENTO DO UNA,17906,19276,8491,28430,411,19939,937
PE,25615,SAO CAETANO,12714,21114,6191,24602,551,18411,946
PE,25631,SAO JOAO,9236,7642,4001,13259,223,9258,596
PE,25658,SAO JOAQUIM DO MONTE,7160,11588,4548,14887,294,10339,671
PE,25674,SAO JOSE DA COROA GRANDE,4634,7864,4614,11247,133,6633,251
PE,25690,SAO JOSE DO BELMONTE,12210,13588,8532,22416,204,13884,781
PE,25712,SAO JOSE DO EGITO,13812,13456,6831,21367,272,14536,630
PE,25739,SAO LOURENCO DA MATA,54320,34168,12396,59173,1100,46777,1433
PE,25755,SAO VICENTE FERRER,7410,7178,4090,12036,204,7946,448
PE,25771,SERRA TALHADA,31668,29602,15961,48438,461,32477,1381
PE,25798,SERRITA,6612,9922,3583,12253,78,8670,325
PE,25810,SERTANIA,15712,14112,8365,24298,301,15933,720
PE,25836,SIRINHAEM,19256,11432,7821,24170,372,16349,633
PE,25852,MOREILANDIA,5512,4376,3045,8315,50,5270,276
PE,25879,SOLIDAO,3100,2952,1634,4872,29,3238,183
PE,25895,SURUBIM,19628,26960,8371,33196,617,24825,914
PE,25917,TABIRA,13896,9108,5088,17432,236,12344,606
PE,25933,TACAIMBO,3920,7034,2536,8466,144,5930,309
PE,25950,TACARATU,5550,7516,4169,11146,136,6977,308
PE,25976,ITAMBE,16296,10870,6236,20852,289,14616,744
PE,25992,TAQUARITINGA DO NORTE,8998,10354,2913,13297,232,10384,476
PE,26018,TEREZINHA,2306,4652,1772,5548,90,3776,207
PE,26034,TERRA NOVA,3742,5514,1086,5942,68,4856,160
PE,26050,TIMBAUBA,34300,17494,13347,40567,538,27220,785
PE,26077,TORITAMA,7350,12226,3519,13890,275,10371,308
PE,26093,TRACUNHAEM,7914,4342,2816,9361,188,6545,229
PE,26115,TRINDADE,6048,12368,5091,14995,174,9904,522
PE,26131,TRIUNFO,8724,6834,4168,12419,151,8251,321
PE,26158,TUPANATINGA,3386,13422,4954,13989,133,9035,498
PE,26174,TUPARETAMA,6160,3312,2490,7558,98,5068,234
PE,26190,VENTUROSA,5582,8610,3297,10838,151,7541,294
PE,26212,VERDEJANTE,3934,5274,2200,7161,75,4961,282
PE,26239,VERTENTES,5446,10500,1911,10418,170,8507,364
PE,26255,VICENCIA,17874,7618,7448,21224,370,13776,660
PE,26271,VITORIA DE SANTO ANTAO,55530,57292,18577,78504,1566,59927,1950
PE,26298,CAMARAGIBE,93536,45154,13540,86682,1768,73142,2029
PE,26310,ABREU E LIMA,68540,33574,11213,65509,1468,54296,1771
PE,26336,ITAPISSUMA,11990,8218,3247,14156,357,10909,448
PE,30015,FERNANDO DE NORONHA,1256,318,358,1175,16,817,14
PI,10006,BRASILEIRA,3296,4084,1182,5143,73,3961,198
PI,10014,AGRICOLANDIA,4168,1906,1598,4825,41,3227,149
PI,10022,ALEGRETE DO PIAUI,2238,2592,535,3102,24,2567,128
PI,10030,AGUA BRANCA,8826,5552,2234,9895,103,7661,369
PI,10049,BAIXA GRANDE DO RIBEIRO,1858,3730,1577,4567,23,2990,173
PI,10057,ALTO LONGA,7580,5910,2874,10200,90,7326,491
PI,10065,BOM PRINCIPIO DO PIAUI,2694,3178,1402,4515,24,3113,153
PI,10073,ALTOS,23120,11164,4033,22331,236,18298,920
PI,10081,BONFIM DO PIAUI,1606,3564,699,3395,16,2696,95
PI,10090,AMARANTE,7386,8636,2598,11141,118,8543,414
PI,10103,BURITI DOS MONTES,2394,4096,1105,4590,58,3485,182
PI,10111,ANGICAL DO PIAUI,5732,2530,1180,5544,54,4364,179
PI,10120,CABECEIRAS DO PIAUI,5482,3012,1436,5911,28,4475,200
PI,10138,ANISIO DE ABREU,3684,3296,951,4656,36,3705,179
PI,10146,CALDEIRAO GRANDE DO PIAUI,2754,2932,707,3740,33,3033,157
PI,10154,ANTONIO ALMEIDA,1762,1594,718,2497,27,1779,74
PI,10162,CANAVIEIRA,1628,2246,592,2637,10,2045,98
PI,10170,AROAZES,4156,1674,1140,4311,52,3171,204
PI,10189,COIVARAS,2824,1906,834,3345,34,2511,112
PI,10197,ARRAIAL,1320,3114,718,3094,20,2376,139
PI,10200,COLONIA DO GURGUEIA,2214,2988,792,3542,31,2750,118
PI,10219,AVELINO LOPES,5888,4126,1626,6975,92,5349,250
PI,10227,COLONIA DO PIAUI,4100,2652,1213,4855,38,3642,228
PI,10235,BARRAS,20390,14388,5475,24125,181,18650,1080
PI,10243,CORONEL JOSE DIAS,3324,2138,727,3623,28,2896,137
PI,10251,BARREIRAS DO PIAUI,1688,1400,592,2231,17,1639,78
PI,10260,FARTURA DO PIAUI,3034,1666,642,3150,16,2508,142
PI,10278,BARRO DURO,3846,2950,1425,5013,35,3588,155
PI,10286,JACOBINA DO PIAUI,3208,2130,883,3720,32,2837,136
PI,10294,BATALHA,12990,9388,3656,15669,149,12013,675
PI,10308,JARDIM DO MULATO,1592,2614,590,2815,33,2225,89
PI,10316,BENEDITINOS,4150,6486,1810,7573,89,5763,356
PI,10324,LAGOA ALEGRE,2900,3578,1511,4921,26,3410,145
PI,10332,BERTOLINIA,2156,3064,832,3627,26,2795,159
PI,10340,LAGOA DO BARRO DO PIAUI,2330,1894,744,3038,46,2294,136
PI,10359,BOCAINA,4674,2824,617,4534,32,3917,136
PI,10367,MARCOLANDIA,2478,4084,1145,4733,66,3588,241
PI,10375,BOM JESUS,5948,8888,1797,9739,91,7942,433
PI,10383,PATOS DO PIAUI,3432,2818,807,4240,57,3433,251
PI,10391,BURITI DOS LOPES,7104,9850,4422,13364,83,8942,382
PI,10405,PASSAGEM FRANCA DO PIAUI,2106,2158,717,2974,29,2257,96
PI,10413,CAMPINAS DO PIAUI,3006,2504,870,3845,30,2975,190
PI,10421,QUEIMADA NOVA,5830,1490,1165,5178,97,4013,256
PI,10430,CAMPO MAIOR,28634,16140,5356,29090,289,23734,1058
PI,10448,SANTA CRUZ DOS MILAGRES,2194,1018,936,2642,22,1706,78
PI,10456,CANTO DO BURITI,8872,9742,2368,12323,116,9955,532
PI,10464,SANTA ROSA DO PIAUI,2464,2890,768,3630,35,2862,150
PI,10472,CAPITAO DE CAMPOS,4640,5788,1520,7182,104,5662,344
PI,10480,SANTANA DO PIAUI,1232,3958,464,3208,20,2744,129
PI,10499,CARACOL,3354,4914,1095,5606,52,4511,325
PI,10502,SAO BRAZ DO PIAUI,2126,2266,519,2824,17,2305,92
PI,10510,CASTELO DO PIAUI,6912,9832,3394,12410,132,9016,512
PI,10529,SAO JOSE DO DIVINO,2984,2486,705,3620,29,2915,151
PI,10537,COCAL,8522,12758,4423,15892,174,11469,655
PI,10545,SIGEFREDO PACHECO,4124,4008,1141,5463,45,4322,211
PI,10553,CONCEICAO DO CANINDE,3354,1698,958,3727,71,2769,172
PI,10561,SAO LOURENCO DO PIAUI,3750,1704,763,3702,32,2939,180
PI,10570,CORRENTE,9584,9422,3985,14067,101,10082,478
PI,10588,VARZEA BRANCA,1740,2652,675,3002,18,2327,113
PI,10596,CRISTALANDIA DO PIAUI,1946,3484,1397,4250,16,2853,122
PI,10600,BARRA D'ALCANTARA,2298,944,832,2605,18,1773,134
PI,10618,CRISTINO CASTRO,4350,3500,1314,5575,51,4261,285
PI,10626,BELA VISTA DO PIAUI,2304,1236,275,2244,53,1969,146
PI,10634,CURIMATA,4146,5644,1066,6182,57,5116,164
PI,10642,BREJO DO PIAUI,1348,2386,525,2535,22,2010,121
PI,10650,DEMERVAL LOBAO,8098,4562,1349,8099,69,6750,351
PI,10669,BOA HORA,3116,2442,1084,4002,17,2918,122
PI,10677,DOM EXPEDITO LOPES,4668,2936,1233,5235,47,4002,153
PI,10685,DOM INOCENCIO,4214,3758,1023,5342,61,4319,272
PI,10693,ELESBAO VELOSO,9072,5864,3580,11627,102,8047,477
PI,10707,CAPITAO GERVASIO OLIVEIRA,2192,1560,878,2906,21,2028,131
PI,10715,ELISEU MARTINS,2386,2304,595,3073,19,2478,114
PI,10723,CAMPO GRANDE DO PIAUI,2698,2346,424,3144,33,2720,165
PI,10731,ESPERANTINA,21626,10100,4199,21206,219,17007,925
PI,10740,CAMPO LARGO DO PIAUI,1758,2950,759,3271,19,2512,139
PI,10758,FLORES DO PIAUI,1578,3512,567,3244,25,2677,107
PI,10766,CURRAIS,1304,3046,968,3300,22,2332,135
PI,10774,FLORIANO,28788,19656,6237,31816,422,25579,935
PI,10782,GEMINIANO,2932,2280,585,3435,56,2850,188
PI,10790,FRANCINOPOLIS,4104,1580,1080,4135,36,3055,177
PI,10804,GUARIBAS,898,2432,731,2530,11,1799,123
PI,10812,FRANCISCO AYRES,1566,3664,819,3584,24,2765,126
PI,10820,ILHA GRANDE,5612,2528,1027,5365,69,4338,199
PI,10839,FRANCISCO SANTOS,5264,2504,1615,5773,72,4158,202
PI,10847,JUREMA,2132,2500,489,2990,24,2501,161
PI,10855,FRONTEIRAS,4858,4852,1587,6775,82,5188,251
PI,10863,LAGOA DE SAO FRANCISCO,2710,3026,743,3839,59,3096,169
PI,10871,GILBUES,4162,4094,1641,6036,35,4395,232
PI,10880,MORRO CABECA NO TEMPO,1680,2022,1134,3103,17,1969,101
PI,10898,GUADALUPE,5264,3732,1598,6334,48,4736,190
PI,10901,NOVO SANTO ANTONIO,2410,1658,1111,3305,24,2194,136
PI,10910,HUGO NAPOLEAO,2556,1752,899,3169,22,2270,94
PI,10928,NOSSA SENHORA DE NAZARE,3508,1586,756,3441,28,2685,110
PI,10936,INHUMA,9410,4884,2727,10403,102,7676,427
PI,10944,PAQUETA,3668,1176,654,3261,20,2607,165
PI,10952,IPIRANGA DO PIAUI,5212,3488,877,5587,70,4710,290
PI,10960,NOVA SANTA RITA,2416,1716,707,2938,37,2231,128
PI,10979,ISAIAS COELHO,4906,2374,1017,4972,48,3955,267
PI,10987,SAO JOAO DO ARRAIAL,2884,3006,993,4116,24,3123,154
PI,10995,ITAINOPOLIS,6748,5054,1464,7809,110,6345,334
PI,11010,ITAUEIRA,5434,4754,1750,7281,120,5531,317
PI,11037,JAICOS,7770,6980,1713,9652,108,7939,456
PI,11053,JERUMENHA,2412,2420,768,3320,31,2552,105
PI,11070,JOAQUIM PIRES,5714,5644,1663,7767,77,6104,348
PI,11088,SAO JOAO DA CANABRAVA,2522,2410,645,3295,49,2650,135
PI,11096,JOSE DE FREITAS,16506,14754,5107,21767,309,16660,721
PI,11118,LANDRI SALES,2270,3012,877,3660,39,2783,103
PI,11134,LUIS CORREIA,11096,14556,4568,18125,144,13557,587
PI,11150,LUZILANDIA,7688,13292,2896,14076,153,11180,537
PI,11177,MANOEL EMIDIO,1798,3214,617,3271,24,2654,124
PI,11193,MARCOS PARENTE,2488,2266,1080,3621,53,2541,111
PI,11215,MATIAS OLIMPIO,2672,6378,1517,6356,63,4839,251
PI,11231,MIGUEL ALVES,11634,9086,4710,16033,148,11323,815
PI,11258,MIGUEL LEAO,310,938,182,836,3,654,27
PI,11274,MONSENHOR GIL,7968,2774,1360,7099,75,5739,293
PI,11290,MONSENHOR HIPOLITO,4604,3434,1307,5700,68,4393,306
PI,11312,MONTE ALEGRE DO PIAUI,3064,5424,1773,6235,33,4462,185
PI,11339,NAZARE DO PIAUI,4710,2712,1396,5423,33,4027,283
PI,11355,NOSSA SENHORA DOS REMEDIOS,3342,3496,1322,4994,43,3672,210
PI,11371,NOVO ORIENTE DO PIAUI,4850,1582,1401,4874,42,3473,215
PI,11398,OEIRAS,20798,12832,4718,22753,265,18035,955
PI,11410,DOMINGOS MOURAO,2426,1556,818,2961,41,2143,111
PI,11436,PADRE MARCOS,3760,3280,936,4751,65,3815,230
PI,11452,PAES LANDIM,2658,1796,431,2775,33,2344,84
PI,11479,PALMEIRA DO PIAUI,2192,2760,952,3586,23,2634,135
PI,11495,PALMEIRAIS,6196,6030,2160,8614,87,6454,254
PI,11517,PARNAGUA,3286,3908,1299,5143,30,3844,217
PI,11533,PARNAIBA,76270,37774,18956,78668,705,59712,1985
PI,11550,PAULISTANA,10358,5832,3598,12339,126,8741,520
PI,11576,PEDRO II,16458,18124,5269,23879,280,18610,1039
PI,11592,PICOS,35408,22202,5913,36402,406,30489,1278
PI,11614,PIMENTEIRAS,7776,3324,1381,7245,48,5864,266
PI,11630,PIO IX,11288,4786,1684,10361,134,8677,506
PI,11657,PIRACURUCA,11880,12562,3442,16532,168,13090,701
PI,11673,PIRIPIRI,21634,30566,6721,34669,532,27948,1316
PI,11690,PORTO,3254,4590,1881,6063,43,4182,217
PI,11711,PRATA DO PIAUI,1802,1916,1120,3103,16,1983,108
PI,11738,REDENCAO DO GURGUEIA,2200,4932,1090,4889,30,3799,203
PI,11754,REGENERACAO,8970,6080,2611,10757,97,8146,524
PI,11770,RIBEIRO GONCALVES,3152,2104,1184,3964,28,2780,124
PI,11797,RIO GRANDE DO PIAUI,3538,3142,1604,5202,56,3598,202
PI,11819,SANTA CRUZ DO PIAUI,4544,1888,874,4356,56,3482,210
PI,11835,SANTA FILOMENA,1382,3064,923,3303,27,2380,130
PI,11851,SANTA LUZ,1746,3110,499,3099,29,2600,143
PI,11878,SANTO ANTONIO DE LISBOA,3984,2198,644,3941,46,3297,160
PI,11894,SANTO INACIO DO PIAUI,1554,2390,577,2667,25,2090,93
PI,11916,SAO FELIX DO PIAUI,3154,658,772,2792,23,2020,91
PI,11932,SAO FRANCISCO DO PIAUI,4224,2136,1123,4579,35,3456,241
PI,11959,SAO GONCALO DO PIAUI,2858,2202,687,3381,35,2694,129
PI,11975,SAO JOAO DA SERRA,3740,3094,1611,5297,65,3686,204
PI,11991,SAO JOAO DO PIAUI,7826,7188,2333,10279,75,7946,364
PI,12009,SAO JOAO DA FRONTEIRA,1860,2778,835,3268,15,2433,99
PI,12017,SAO JOSE DO PEIXE,1984,1868,625,2690,40,2065,99
PI,12025,SAO JOAO DA VARJOTA,2376,2164,480,2913,29,2433,134
PI,12033,SAO JOSE DO PIAUI,3718,3454,901,4791,77,3890,227
PI,12041,SEBASTIAO BARROS,1930,2438,957,3270,28,2313,101
PI,12050,SAO JULIAO,3754,2640,668,4075,16,3407,194
PI,12068,SEBASTIAO LEAL,1494,2102,627,2557,41,1930,91
PI,12076,SAO MIGUEL DO TAPUIO,5752,11738,2707,12072,111,9365,509
PI,12084,ALVORADA DO GURGUEIA,1998,1690,586,2558,24,1972,104
PI,12092,SAO PEDRO DO PIAUI,5758,6328,1762,8147,47,6385,295
PI,12106,ASSUNCAO DO PIAUI,2176,4546,1128,4798,61,3670,248
PI,12114,SAO RAIMUNDO NONATO,13348,11916,3219,16426,99,13207,476
PI,12122,BETANIA DO PIAUI,2430,3556,848,3999,29,3151,129
PI,12130,SIMOES,5732,5680,2277,8446,91,6169,372
PI,12149,BOQUEIRAO DO PIAUI,2428,2578,837,3535,48,2698,147
PI,12157,SIMPLICIO MENDES,6568,4484,1572,7419,69,5847,252
PI,12165,CARIDADE DO PIAUI,2360,1622,787,2931,23,2144,130
PI,12173,SOCORRO DO PIAUI,2236,2794,763,3413,20,2650,115
PI,12181,CURRAL NOVO DO PIAUI,1898,1338,917,2672,42,1755,95
PI,12190,TERESINA,538120,133876,81448,430830,3817,349382,9567
PI,12203,JULIO BORGES,3518,1426,558,3150,24,2592,96
PI,12211,UNIAO,25402,9216,5568,24136,207,18568,1052
PI,12220,LAGOA DO SITIO,3164,1496,777,3326,33,2549,186
PI,12238,URUCUI,6780,7226,2751,10218,103,7467,361
PI,12246,MILTON BRANDAO,1834,4258,950,4203,15,3253,192
PI,12254,VALENCA DO PIAUI,11566,7560,2923,13300,165,10377,649
PI,12262,PAJEU DO PIAUI,1346,1686,985,2611,31,1626,79
PI,12270,VARZEA GRANDE,2866,1748,916,3435,44,2519,168
PI,12289,PAVUSSU,2428,1880,837,3118,14,2281,113
PI,12297,DIRCEU ARCOVERDE,2476,3372,981,4097,26,3116,166
PI,12300,RIACHO FRIO,2572,1844,552,2896,28,2344,108
PI,12319,ALAGOINHA,3902,4266,701,5082,46,4381,251
PI,12327,ACAUA,3232,3052,762,4118,68,3356,146
PI,12335,BELEM DO PIAUI,2188,884,306,1947,26,1641,79
PI,12343,CAJAZEIRAS DO PIAUI,1400,1732,539,2214,24,1675,85
PI,12351,CAMPO ALEGRE DO FIDALGO,1928,2758,835,3353,17,2518,158
PI,12360,COCAL DE TELHA,2904,1708,799,3317,39,2518,173
PI,12378,FRANCISCO MACEDO,1350,1178,244,1636,31,1392,97
PI,12386,JOAO COSTA,2684,970,463,2420,33,1957,97
PI,12394,JATOBA DO PIAUI,3342,2260,854,3869,38,3015,176
PI,12408,JOCA MARQUES,1322,2624,1087,3211,21,2124,130
PI,12416,JUAZEIRO DO PIAUI,3632,3108,1191,4753,40,3562,152
PI,12424,LAGOA DO PIAUI,2546,1342,453,2531,15,2078,119
PI,12432,LAGOINHA DO PIAUI,1302,1662,452,1995,10,1543,51
PI,12440,MADEIRO,2472,3734,1142,4420,28,3278,147
PI,12459,MORRO DO CHAPEU DO PIAUI,3338,2526,1118,4227,18,3109,159
PI,12467,MASSAPE DO PIAUI,3770,2816,762,4371,78,3609,238
PI,12475,MURICI DOS PORTELAS,2156,3648,1110,4200,18,3090,170
PI,12483,OLHO DAGUA DO PIAUI,1322,1538,539,2049,17,1510,63
PI,12491,PEDRO LAURENTINO,1482,1190,420,1847,10,1427,81
PI,12505,SAO FRANCISCO DE ASSIS DO PIAUI,2718,1288,729,2930,36,2201,162
PI,12513,SUSSUAPARA,4836,2028,634,4289,57,3655,166
PI,12521,TANQUE DO PIAUI,1346,1168,361,1719,30,1358,71
PI,12530,TAMBORIL DO PIAUI,658,2528,586,2272,6,1686,87
PI,12548,VILA NOVA DO PIAUI,2520,752,357,2137,49,1780,95
PI,12556,VERA MENDES,1684,1674,377,2248,38,1871,154
PI,12564,WALL FERRAZ,1936,2580,629,3067,34,2438,146
PI,12572,CAJUEIRO DA PRAIA,3694,2582,1190,4489,35,3299,126
PI,12580,CURRALINHOS,2284,1302,521,2431,21,1910,96
PI,12599,PORTO ALEGRE DO PIAUI,1650,306,352,1372,5,1020,37
PI,12602,RIBEIRA DO PIAUI,2080,1868,575,2686,16,2111,121
PI,12610,SAO GONCALO DO GURGUEIA,1092,1076,497,1655,15,1158,59
PI,12629,SAO LUIS DO PIAUI,1370,1644,319,1908,13,1589,69
PI,12637,FLORESTA DO PIAUI,846,2002,552,2069,10,1517,83
PI,12653,SANTO ANTONIO DOS MILAGRES,1672,438,332,1460,12,1128,61
PI,12661,SAO MIGUEL DA BAIXA GRANDE,1498,1022,457,1796,15,1339,64
PI,12670,CARAUBAS DO PIAUI,1318,3462,859,3449,42,2590,158
PI,12688,CAXINGO,2250,1984,743,3046,36,2303,150
PI,12696,COCAL DOS ALVES,1578,3562,629,3385,46,2756,140
PI,12700,SAO MIGUEL DO FIDALGO,1756,1176,478,2040,13,1562,83
PI,12718,PAU DARCO DO PIAUI,2554,1332,997,3075,25,2078,110
PR,74004,GODOY MOREIRA,1754,2090,504,2686,46,2182,214
PR,74012,ABATIA,2778,4728,533,4750,103,4217,361
PR,74020,IBEMA,4318,1096,1514,4539,58,3025,260
PR,74039,ADRIANOPOLIS,3308,2364,927,4237,71,3310,403
PR,74047,LINDOESTE,4252,1500,806,3962,46,3156,234
PR,74055,AGUDOS DO SUL,4612,3448,699,5214,132,4515,353
PR,74063,OURO VERDE DO OESTE,3120,3062,511,3916,72,3405,242
PR,74071,ALMIRANTE TAMANDARE,44132,18138,2544,36895,741,34351,2475
PR,74080,SANTA TEREZA DO OESTE,4334,1926,304,3717,70,3413,213
PR,74098,ALTO PARANA,7084,5186,1071,7991,121,6920,664
PR,74101,ANAHY,1794,1394,348,2112,34,1764,136
PR,74110,ALTO PIQUIRI,4226,5844,1375,7052,126,5677,516
PR,74128,ANGULO,1184,2076,447,2267,29,1820,161
PR,74136,ALVORADA DO SUL,4426,5126,1907,7183,114,5276,386
PR,74144,BOA ESPERANCA DO IGUACU,2454,1092,280,2157,23,1877,81
PR,74152,AMAPORA,2738,1950,964,3621,52,2657,261
PR,74160,BOM SUCESSO DO SUL,2326,1504,275,2352,27,2077,135
PR,74179,AMPERE,11584,4052,960,9459,113,8499,568
PR,74187,BRASILANDIA DO SUL,1600,2250,698,2875,52,2177,200
PR,74195,ANDIRA,12198,10534,3742,16569,285,12827,1176
PR,74209,CAFEZAL DO SUL,1762,3074,563,3251,58,2688,212
PR,74217,ANTONINA,11258,8612,3206,14208,233,11002,834
PR,74225,CANDOI,9082,3946,2208,9509,111,7301,676
PR,74233,ANTONIO OLINTO,3886,3162,386,4362,95,3976,357
PR,74241,CRUZEIRO DO IGUACU,3400,1004,1046,3414,23,2368,143
PR,74250,APUCARANA,52482,64426,14204,78084,1190,63880,4236
PR,74268,DIAMANTE DO SUL,2118,1312,571,2509,29,1938,194
PR,74276,ARAPONGAS,50314,45620,12107,64884,1267,52777,3543
PR,74284,ENTRE RIOS DO OESTE,2726,1722,272,2616,27,2344,93
PR,74292,ARAPOTI,12494,11856,3677,17134,251,13457,1031
PR,74306,FAROL,2176,1430,837,2882,44,2045,198
PR,74314,ARARUNA,6092,8208,2042,9785,100,7743,493
PR,74322,FAZENDA RIO GRANDE,40592,12966,6204,35512,605,29308,1924
PR,74330,MARILANDIA DO SUL,3800,5772,872,6225,118,5353,449
PR,74349,FLOR DA SERRA DO SUL,4120,1474,623,3683,59,3060,204
PR,74357,ARAUCARIA,77968,26622,8946,65983,1158,57037,3584
PR,74365,HONORIO SERPA,4648,1344,1552,4823,44,3271,231
PR,74373,ASSAI,6090,11822,2298,12310,227,10012,829
PR,74381,IGUATU,1342,1262,331,1736,13,1405,90
PR,74390,ASTORGA,11036,15976,3685,18668,346,14983,1131
PR,74403,IRACEMA DO OESTE,1782,1406,496,2337,49,1841,198
PR,74411,ATALAIA,1904,2296,334,2653,69,2319,150
PR,74420,NOVO ITACOLOMI,1508,1930,227,2103,42,1876,115
PR,74438,BALSA NOVA,8046,3608,507,6965,157,6458,474
PR,74446,ITAPERUCU,14634,6600,2415,14260,271,11845,957
PR,74454,BANDEIRANTES,18904,14916,3237,22264,434,19027,1683
PR,74462,IVATE,3036,4180,1428,5404,61,3976,307
PR,74470,BARBOSA FERRAZ,5560,6716,2020,9047,170,7027,719
PR,74489,LIDIANOPOLIS,2446,2384,540,3257,53,2717,249
PR,74497,BARRACAO,5172,3370,2061,6748,77,4687,339
PR,74500,MARIPA,3908,3486,843,4784,56,3941,188
PR,74519,BARRA DO JACARE,2198,1342,518,2491,38,1973,165
PR,74527,MATO RICO,1984,2150,1154,3456,39,2302,196
PR,74535,BELA VISTA DO PARAISO,6566,10314,2393,11700,174,9307,693
PR,74543,MAUA DA SERRA,2536,4468,777,4703,65,3926,359
PR,74551,BITURUNA,11048,4872,1804,10602,169,8798,669
PR,74560,MERCEDES,3582,2220,312,3411,60,3099,138
PR,74578,BOA ESPERANCA,2520,2734,329,3244,73,2915,215
PR,74586,NOVA LARANJEIRAS,6022,2854,2366,7318,116,4952,398
PR,74594,BOCAIUVA DO SUL,5968,3650,1393,6820,115,5427,503
PR,74608,NOVA SANTA BARBARA,1800,2150,429,2673,56,2244,213
PR,74616,BOM SUCESSO,2858,3506,652,4282,80,3630,368
PR,74624,PATO BRAGADO,3086,2304,338,3157,29,2819,95
PR,74632,BORRAZOPOLIS,4388,5704,945,6433,107,5488,335
PR,74640,PINHAL DE SAO BENTO,2106,584,257,1696,10,1439,84
PR,74659,CAFEARA,1642,1176,258,1823,34,1565,122
PR,74667,PITANGUEIRAS,1244,1764,295,1960,28,1665,133
PR,74675,CALIFORNIA,3988,4460,1192,5933,148,4741,369
PR,74683,QUATRO PONTES,2794,1914,486,3016,49,2530,127
PR,74691,CAMBARA,17444,6618,1972,15283,195,13311,1085
PR,74705,RAMILANDIA,1796,1890,463,2521,33,2058,182
PR,74713,CAMBE,53452,39690,9796,61674,1209,51878,4098
PR,74721,RANCHO ALEGRE D'OESTE,1742,1732,499,2367,32,1868,99
PR,74730,CAMBIRA,4030,3750,532,4835,85,4303,328
PR,74748,RIO BONITO DO IGUACU,8092,2086,1692,7294,58,5602,455
PR,74756,CAMPINA DA LAGOA,7196,7868,1973,10369,150,8396,714
PR,74764,SANTA LUCIA,3288,1046,554,2974,47,2420,206
PR,74772,CAMPINA GRANDE DO SUL,21012,13008,4641,23452,385,18811,1416
PR,74780,CAMPO BONITO,3464,1106,1039,3560,44,2521,192
PR,74799,CAMPO DO TENENTE,3276,2996,309,3788,64,3479,279
PR,74802,SANTA MARIA DO OESTE,7004,3524,3050,8856,94,5806,448
PR,74810,CAMPO LARGO,63532,37602,8868,64785,1478,55917,3872
PR,74829,SANTA MONICA,1826,1458,463,2311,22,1848,184
PR,74837,CAMPO MOURAO,49814,27344,13802,56033,850,42231,2802
PR,74845,SAO MANOEL DO PARANA,1062,1382,304,1633,30,1329,77
PR,74853,CANDIDO DE ABREU,9054,8248,3934,13590,175,9656,830
PR,74861,SAO PEDRO DO IGUACU,4556,2832,899,5064,72,4165,399
PR,74870,CAPANEMA,13446,5952,3565,13899,153,10334,482
PR,74888,TUNAS DO PARANA,1550,2158,867,2973,34,2106,218
PR,74896,CAPITAO LEONIDAS MARQUES,11282,3378,3443,11460,152,8017,535
PR,74900,VENTANIA,4108,3394,1000,5334,128,4334,455
PR,74918,CARLOPOLIS,4968,8042,1520,8929,185,7409,719
PR,74926,VILA ALTA,2330,1270,765,2827,27,2062,235
PR,74934,CASCAVEL,158592,78888,40780,169405,2213,128625,7672
PR,74942,DOUTOR ULYSSES,1718,3732,782,3904,100,3122,297
PR,74950,CASTRO,30006,31474,7300,42097,989,34797,3068
PR,74969,VIRMOND,2802,1688,578,3036,52,2458,161
PR,74977,CATANDUVAS,5684,3168,681,5557,77,4876,373
PR,74985,LARANJAL,2492,2140,1550,4237,36,2687,335
PR,74993,CENTENARIO DO SUL,6178,5234,2927,9476,140,6549,703
PR,75000,ITAIPULANDIA,6238,1734,578,4811,53,4233,194
PR,75019,CERRO AZUL,6508,8160,3110,11649,390,8539,815
PR,75027,NOVA ESPERANCA DO SUDOESTE,3708,2036,634,3763,62,3129,195
PR,75035,CHOPINZINHO,14240,6380,3394,14543,166,11149,673
PR,75043,PINHAIS,76618,33246,11691,71888,1291,60197,3974
PR,75051,CIANORTE,33680,29792,8532,43460,853,34928,2339
PR,75060,SAUDADE DO IGUACU,2890,1566,545,2972,42,2427,157
PR,75078,CIDADE GAUCHA,6778,3704,963,6783,109,5820,470
PR,75086,ARIRANHA DO IVAI,1686,1388,1017,2718,24,1701,140
PR,75094,CLEVELANDIA,12322,5500,3853,13585,121,9732,700
PR,75108,ARAPUA,2260,2230,1328,3806,29,2478,204
PR,75116,MANGUEIRINHA,11968,4882,3387,12629,121,9242,696
PR,75124,BELA VISTA DA CAROBA,3126,1518,994,3489,32,2495,141
PR,75132,COLOMBO,116344,45938,16242,105136,1846,88894,5907
PR,75140,BOA VENTURA DE SAO ROQUE,4600,1948,1131,4684,42,3553,237
PR,75159,COLORADO,13486,9472,3624,16503,337,12879,1063
PR,75167,BOM JESUS DO SUL,2540,2060,1114,3632,24,2518,194
PR,75175,CONGONHINHAS,3058,4518,790,5046,73,4256,395
PR,75183,CAMPINA DO SIMAO,2592,1208,239,2381,38,2142,204
PR,75191,CONSELHEIRO MAYRINCK,2066,1984,515,2796,41,2281,215
PR,75205,CAMPO MAGRO,10768,4828,631,9328,193,8697,706
PR,75213,CONTENDA,9514,4742,1275,9135,179,7860,553
PR,75221,CARAMBEI,9366,6806,1353,10314,198,8961,677
PR,75230,CORBELIA,9532,7456,1055,10248,158,9193,541
PR,75248,CORONEL DOMINGOS SOARES,3442,1658,1247,4116,41,2869,278
PR,75256,CORNELIO PROCOPIO,32974,18128,7410,35354,561,27944,1832
PR,75264,CRUZMALTINA,1898,2080,1216,3410,26,2194,179
PR,75272,CORONEL VIVIDA,15326,8386,4426,17400,266,12974,852
PR,75280,CORUMBATAI DO SUL,2324,2532,808,3632,66,2824,330
PR,75299,CRUZEIRO DO OESTE,10378,9874,2588,13939,235,11351,990
PR,75302,ESPERANCA NOVA,1400,1092,285,1724,56,1439,137
PR,75310,CRUZEIRO DO SUL,3324,2132,748,3766,43,3018,247
PR,75329,ESPIGAO ALTO DO IGUACU,3602,1548,1601,4440,57,2839,207
PR,75337,CRUZ MACHADO,10486,7330,1950,11754,206,9804,690
PR,75345,FERNANDES PINHEIRO,4062,2208,859,4394,61,3535,339
PR,75353,CURITIBA,1171096,638624,168877,1146460,19487,977583,53236
PR,75361,FOZ DO JORDAO,3344,1454,677,3368,41,2691,251
PR,75370,CURIUVA,5890,5626,2412,9116,193,6704,753
PR,75388,GOIOXIM,3946,1884,1268,4519,39,3251,297
PR,75396,DIAMANTE DO NORTE,2776,3272,984,4407,90,3423,309
PR,75400,DIAMANTE DO OESTE,3018,1684,561,3155,33,2594,210
PR,75418,DOIS VIZINHOS,22196,10664,5337,23049,322,17712,960
PR,75426,GUAMIRANGA,5128,2904,791,5246,110,4455,329
PR,75434,DOUTOR CAMARGO,2770,4484,669,4670,102,4001,272
PR,75442,IMBAU,4288,3348,1448,5795,102,4347,427
PR,75450,ENEAS MARQUES,4446,2324,694,4377,62,3683,236
PR,75469,MANFRINOPOLIS,2494,1256,708,2743,18,2035,142
PR,75477,ENGENHEIRO BELTRAO,6188,9098,3001,11352,176,8351,532
PR,75485,MARQUINHO,2716,2244,1301,4069,51,2768,237
PR,75493,FAXINAL,6790,8216,3488,11825,168,8337,666
PR,75507,PEROBAL,2480,3272,923,4140,53,3217,288
PR,75515,FENIX,2426,2512,574,3291,60,2717,188
PR,75523,PONTAL DO PARANA,8196,5348,2365,9726,119,7361,470
PR,75531,FLORAI,2648,3864,514,4104,85,3590,249
PR,75540,PORTO BARREIRO,3212,1030,507,2783,38,2276,117
PR,75558,FLORESTA,2494,3804,498,3913,57,3415,209
PR,75566,PRADO FERREIRA,1926,1800,408,2479,30,2071,178
PR,75574,FLORESTOPOLIS,7062,5746,2530,9785,156,7255,695
PR,75582,QUARTO CENTENARIO,2134,2704,369,3151,79,2782,284
PR,75590,FLORIDA,1806,1004,231,1819,39,1588,144
PR,75604,RESERVA DO IGUACU,4138,1794,1291,4587,44,3296,286
PR,75612,FORMOSA DO OESTE,4542,4592,1230,6299,104,5069,398
PR,75620,RIO BRANCO DO IVAI,1252,2072,444,2310,34,1866,170
PR,75639,FOZ DO IGUACU,184000,53900,40905,169931,1838,129026,8238
PR,75647,SERRANOPOLIS DO IGUACU,3490,2368,297,3352,36,3055,90
PR,75655,FRANCISCO BELTRAO,49934,22338,11499,50306,605,38807,2066
PR,75663,TAMARANA,3920,5518,1032,6363,122,5331,490
PR,75671,GENERAL CARNEIRO,8650,4236,2334,9525,165,7191,583
PR,75698,GOIOERE,12528,16376,3044,19155,368,16111,1291
PR,75710,GUAIRA,20032,9294,6617,22829,301,16212,1248
PR,75736,GUAIRACA,2342,3676,1308,4687,67,3379,303
PR,75744,ROSARIO DO IVAI,1906,4470,892,4426,53,3534,293
PR,75752,GUAPIRAMA,2218,2306,532,3024,52,2492,178
PR,75760,NOVA TEBAS,4746,3324,789,5443,112,4654,507
PR,75779,GUAPOREMA,1312,1104,231,1574,23,1343,112
PR,75787,SULINA,2798,1464,949,3260,37,2311,143
PR,75795,GUARACI,1950,3164,421,3266,53,2845,235
PR,75809,LUISIANIA,3666,2982,1132,4921,64,3789,401
PR,75817,GUARANIACU,11236,5078,4049,13183,191,9134,786
PR,75833,GUARAPUAVA,110596,40654,19502,101371,1229,81869,5015
PR,75850,GUARAQUECABA,2638,4162,1915,5733,66,3818,352
PR,75876,GUARATUBA,14856,11942,4727,19438,274,14711,1038
PR,75892,IBAITI,12078,13458,3070,17352,265,14282,1249
PR,75914,IBIPORA,21212,25182,5787,31698,689,25911,2025
PR,75930,ICARAIMA,3622,6248,2185,7642,119,5457,403
PR,75957,IGUARACU,1886,2170,339,2583,37,2244,179
PR,75973,IMBITUVA,15544,10300,2227,16615,328,14388,1138
PR,75990,INACIO MARTINS,5702,4452,1775,7542,126,5767,564
PR,76015,INAJA,2044,1166,302,2093,14,1791,172
PR,76031,IPIRANGA,5656,7764,1597,9068,194,7471,567
PR,76058,IPORA,8054,8318,2207,11347,239,9140,715
PR,76074,IRATI,39712,17228,6211,37334,574,31123,2079
PR,76090,IRETAMA,5954,4604,1716,7772,138,6056,639
PR,76112,ITAGUAGE,2724,1992,507,3148,47,2641,236
PR,76139,ITAMBARACA,3130,4068,696,4759,82,4063,382
PR,76155,ITAMBE,3126,3324,504,4026,55,3522,242
PR,76171,ITAPEJARA DO OESTE,6626,3470,700,6133,81,5433,304
PR,76198,ITAUNA DO SUL,2068,1572,690,2825,68,2135,247
PR,76210,IVAI,5988,6790,1555,8506,109,6951,453
PR,76236,IVAIPORA,17964,14396,9124,26865,281,17741,1280
PR,76252,IVATUBA,1414,1624,331,2028,28,1697,150
PR,76279,JABOTI,2574,2342,499,3218,69,2719,192
PR,76295,JACAREZINHO,23936,16130,7569,29870,486,22301,1782
PR,76317,JAGUAPITA,5000,6486,1821,8327,201,6506,562
PR,76333,JAGUARIAIVA,17626,12052,4142,20812,399,16670,1432
PR,76350,JANDAIA DO SUL,11424,10242,1441,13308,223,11867,811
PR,76376,JANIOPOLIS,3950,3702,1261,5616,112,4355,417
PR,76392,JAPIRA,2788,2186,553,3290,45,2737,205
PR,76414,JAPURA,3218,6202,769,5900,121,5131,300
PR,76430,JARDIM ALEGRE,5048,6282,1392,7709,150,6317,502
PR,76457,JARDIM OLINDA,1250,472,175,1130,13,955,81
PR,76473,JATAIZINHO,5364,6162,2076,8570,157,6494,574
PR,76490,JOAQUIM TAVORA,4832,5114,2023,7584,140,5561,448
PR,76511,JUNDIAI DO SUL,2320,1110,545,2446,33,1901,153
PR,76538,JUSSARA,3996,2520,633,4357,131,3724,335
PR,76554,KALORE,2150,3314,618,3671,74,3053,247
PR,76570,LAPA,31296,15388,5005,30657,489,25652,1821
PR,76597,LARANJEIRAS DO SUL,19632,8308,5883,21120,233,15237,1034
PR,76619,LEOPOLIS,2294,1880,228,2588,43,2360,230
PR,76635,LOANDA,9406,10108,3447,14247,239,10800,804
PR,76651,LOBATO,3158,1470,306,2873,45,2567,208
PR,76678,LONDRINA,212440,263520,54603,315555,5925,260952,17047
PR,76694,LUPIONOPOLIS,2486,1990,466,3009,57,2543,248
PR,76716,MALLET,10046,4086,1545,9293,152,7748,530
PR,76732,MAMBORE,7262,7882,1659,10103,196,8444,676
PR,76759,MANDAGUACU,9294,9164,2421,12909,302,10488,957
PR,76775,MANDAGUARI,16644,18406,4616,23929,472,19313,1316
PR,76791,MANDIRITUBA,12842,5798,2344,12572,207,10228,701
PR,76813,MANOEL RIBAS,6384,6206,777,7597,114,6820,411
PR,76830,MARECHAL CANDIDO RONDON,30030,15952,2308,27152,454,24844,1399
PR,76856,MARIA HELENA,2708,3510,752,4123,42,3371,220
PR,76872,MARIALVA,14570,17204,3824,21287,481,17463,1095
PR,76899,MARILUZ,5722,4372,1365,7068,113,5703,543
PR,76910,MARINGA,151160,164476,36423,208199,3869,171776,10089
PR,76937,MARIOPOLIS,4692,2510,1158,5076,62,3918,255
PR,76953,MARMELEIRO,9064,3684,2512,9434,159,6922,389
PR,76970,MARUMBI,2274,2722,456,3249,60,2793,235
PR,76996,MATELANDIA,9380,6280,2248,10795,177,8547,540
PR,77011,MEDIANEIRA,25240,15426,5735,27627,340,21892,1219
PR,77038,MIRADOR,1252,940,272,1536,29,1264,139
PR,77054,MIRASELVA,1020,1616,260,1707,21,1447,108
PR,77070,MOREIRA SALLES,4662,7652,1496,8499,162,7003,684
PR,77097,MORRETES,9140,7318,2682,11993,236,9311,846
PR,77119,MUNHOZ DE MELLO,1512,1988,312,2298,38,1986,198
PR,77135,NOSSA SENHORA DAS GRACAS,2544,1736,421,2836,38,2415,237
PR,77151,NOVA ALIANCA DO IVAI,808,798,140,1044,18,904,83
PR,77178,NOVA AMERICA DA COLINA,1316,2336,291,2333,70,2042,146
PR,77194,NOVA CANTU,5058,2730,2347,6712,80,4365,391
PR,77216,NOVA ESPERANCA,14430,13708,4858,20261,285,15403,1049
PR,77232,NOVA FATIMA,3324,4518,913,5343,99,4430,410
PR,77259,NOVA LONDRINA,4780,8178,3045,10259,145,7214,590
PR,77275,ORTIGUEIRA,9564,11252,7274,19159,283,11885,1194
PR,77291,OURIZONA,2268,1834,541,2842,57,2301,193
PR,77313,PAICANDU,16966,13166,3680,20812,490,17132,1576
PR,77330,PALMAS,19228,11900,4671,21864,301,17193,1328
PR,77356,PALMEIRA,19472,13368,3397,21611,366,18214,1428
PR,77372,PALMITAL,8270,6290,4076,12193,132,8117,705
PR,77399,PALOTINA,17324,11594,3607,19097,246,15490,785
PR,77410,PARAISO DO NORTE,5862,5160,1535,7723,129,6188,548
PR,77437,PARANACITY,5352,3948,1754,6971,99,5217,468
PR,77453,PARANAGUA,89136,42300,11696,82772,1173,71076,4185
PR,77470,PARANAPOEMA,1772,848,235,1677,23,1442,109
PR,77496,PARANAVAI,34020,45550,12958,56421,936,43463,2742
PR,77518,PATO BRANCO,43912,19284,9484,43586,569,34102,1935
PR,77534,PAULA FREITAS,3570,2338,719,4002,73,3283,256
PR,77550,PAULO FRONTIN,4320,2962,829,4770,69,3941,231
PR,77577,PEABIRU,6946,6548,2743,10269,191,7526,588
PR,77593,PEROLA D OESTE,5750,2298,687,5010,72,4323,227
PR,77615,PIEN,6076,3664,315,5703,150,5388,368
PR,77631,PINHALAO,2882,3702,766,4437,76,3671,303
PR,77658,PINHAO,17082,8080,4583,18851,361,14268,1326
PR,77674,PIRAI DO SUL,12270,11352,3232,16497,366,13265,1088
PR,77690,PIRAQUARA,43050,15788,7351,39682,661,32331,2251
PR,77712,PITANGA,18772,15062,6421,24954,294,18533,1322
PR,77739,PLANALTINA DO PARANA,2748,1404,365,2703,79,2338,183
PR,77755,PLANALTO,11264,3336,1333,9117,108,7784,376
PR,77771,PONTA GROSSA,156292,134172,30293,189269,3710,158976,10034
PR,77798,PORECATU,8168,8346,4044,13420,235,9376,884
PR,77810,PORTO AMAZONAS,2636,1774,396,2885,69,2489,215
PR,77836,PORTO RICO,1304,1622,376,1974,29,1598,106
PR,77852,PORTO VITORIA,2698,1450,364,2669,68,2305,163
PR,77879,PRESIDENTE CASTELO BRANCO,3100,2138,503,3376,39,2873,215
PR,77895,PRIMEIRO DE MAIO,4048,7164,611,6830,130,6219,483
PR,77917,PRUDENTOPOLIS,27446,22388,7636,34988,461,27352,1974
PR,77933,QUATIGUA,3636,4750,1289,5891,91,4602,318
PR,77950,QUATRO BARRAS,10608,7660,2283,12370,229,10087,724
PR,77976,QUERENCIA DO NORTE,6108,4146,2105,7918,90,5813,596
PR,77992,QUINTA DO SOL,2642,2708,601,3728,117,3127,335
PR,78018,QUITANDINHA,8042,6600,706,9067,278,8361,762
PR,78034,RANCHO ALEGRE,1996,2720,418,3103,79,2685,248
PR,78050,REALEZA,10100,5166,1101,9437,151,8336,552
PR,78077,REBOUCAS,9656,5498,1997,10336,166,8339,596
PR,78093,RENASCENCA,4812,2742,1446,5519,63,4073,233
PR,78115,RESERVA,14628,8306,4699,17598,248,12899,1184
PR,78131,RIBEIRAO CLARO,5654,6718,2494,9393,180,6899,533
PR,78158,RIBEIRAO DO PINHAL,6636,6840,3596,11160,152,7564,674
PR,78174,RIO AZUL,9886,4192,1312,9061,172,7749,538
PR,78190,RIO BOM,1860,2064,368,2579,56,2211,193
PR,78212,RIO BRANCO DO SUL,18122,11378,2209,18729,414,16520,1356
PR,78239,RIO NEGRO,19512,11826,3348,20399,330,17051,1052
PR,78255,ROLANDIA,23422,32314,7008,37344,643,30336,1825
PR,78271,RONCADOR,6882,5960,1502,8551,95,7049,533
PR,78298,RONDON,5284,3858,866,6014,89,5148,488
PR,78310,SABAUDIA,3564,3180,601,4366,122,3765,271
PR,78336,SALGADO FILHO,3400,1954,515,3429,70,2914,167
PR,78352,SALTO DO ITARARE,2462,3398,1245,4521,80,3276,266
PR,78379,SALTO DO LONTRA,8130,4756,1700,8763,145,7063,475
PR,78395,SANTA AMELIA,2488,2094,510,3138,82,2628,255
PR,78417,SANTA CECILIA DO PAVAO,1856,2106,557,2817,53,2260,226
PR,78433,SANTA CRUZ DO MONTE CASTELO,3412,4536,844,5372,90,4528,464
PR,78450,SANTA FE,3988,6122,1542,7210,155,5668,458
PR,78476,SANTA INES,1074,1176,256,1529,18,1273,130
PR,78492,SANTA IZABEL DO IVAI,3772,5382,1121,6258,121,5137,439
PR,78514,SANTA IZABEL DO OESTE,7062,3740,735,6749,119,6014,494
PR,78530,SANTA MARIANA,7670,5750,1473,8960,151,7487,626
PR,78557,SANTA ANA DO ITARARE,2748,2832,691,3812,53,3121,278
PR,78573,SANTO ANTONIO DO SUDOESTE,9496,6358,1041,9795,143,8754,684
PR,78590,SANTO ANTONIO DA PLATINA,21054,18678,7849,30189,626,22340,1848
PR,78611,SANTO ANTONIO DO CAIUA,1902,1400,286,2088,20,1802,131
PR,78638,SANTO ANTONIO DO PARAISO,1344,1384,278,1809,43,1531,124
PR,78654,SANTO INACIO,3094,2314,556,3553,43,2997,250
PR,78670,SAO CARLOS DO IVAI,2058,3978,831,4218,87,3387,282
PR,78697,SAO JERONIMO DA SERRA,4736,5912,1334,7478,104,6144,716
PR,78719,SAO JOAO,8320,3736,1085,7566,104,6481,349
PR,78735,SAO JOAO DO CAIUA,3050,3098,1295,4818,69,3523,380
PR,78751,SAO JOAO DO IVAI,6196,7088,1789,9218,133,7429,654
PR,78778,SAO JOAO DO TRIUNFO,9294,3784,1423,8743,162,7320,619
PR,78794,SAO JORGE DO IVAI,3124,3674,918,4661,87,3743,257
PR,78816,SAO JORGE D OESTE,7598,2712,1117,6728,93,5611,363
PR,78832,SAO JOSE DA BOA VISTA,2560,3960,692,4265,47,3573,266
PR,78859,SAO JOSE DOS PINHAIS,134686,64634,18594,127769,2434,109175,7081
PR,78875,SAO MATEUS DO SUL,25610,14598,3822,25827,403,22005,1498
PR,78891,SAO MIGUEL DO IGUACU,18658,8898,4172,19006,222,14834,834
PR,78913,SAO PEDRO DO IVAI,4164,4990,932,6074,107,5142,458
PR,78930,SAO PEDRO DO PARANA,1052,1818,295,1878,38,1583,110
PR,78956,SAO SEBASTIAO DA AMOREIRA,4600,4000,858,5710,92,4852,460
PR,78972,SAO TOME,2084,3418,498,3548,79,3050,220
PR,78999,SAPOPEMA,4000,2262,533,4083,80,3550,339
PR,79014,SENGES,9436,6772,2574,11893,247,9319,968
PR,79030,SERTANEJA,3162,3786,655,4472,94,3817,249
PR,79057,SERTANOPOLIS,7550,9528,2032,11422,196,9390,655
PR,79073,SIQUEIRA CAMPOS,9964,7038,2793,12291,205,9498,792
PR,79090,TAMBOARA,1756,2878,387,3007,84,2620,219
PR,79111,TAPEJARA,5818,6902,1281,8438,187,7157,610
PR,79138,TEIXEIRA SOARES,5042,3696,1190,6072,114,4882,399
PR,79154,TELEMACO BORBA,41630,19218,8958,42185,635,33227,2168
PR,79170,TERRA BOA,5428,10330,1297,10074,200,8777,698
PR,79197,TERRA RICA,5818,8514,1538,9475,139,7937,632
PR,79219,TERRA ROXA,7942,9442,1640,11219,184,9579,703
PR,79235,TIBAGI,8702,7330,2842,11865,195,9023,812
PR,79251,TIJUCAS DO SUL,6220,5764,1942,8626,153,6684,539
PR,79278,TOLEDO,65318,39500,12444,69750,1101,57306,3796
PR,79294,TOMAZINA,3022,5878,930,5908,93,4978,435
PR,79316,TUNEIRAS DO OESTE,4106,4276,981,5773,118,4792,483
PR,79332,UBIRATA,10126,11430,2421,14384,265,11963,920
PR,79359,UMUARAMA,54656,40896,17469,69548,1056,52079,3247
PR,79375,UNIAO DA VITORIA,33850,19230,7283,35991,455,28708,1713
PR,79391,UNIFLOR,1978,1022,558,2206,23,1648,125
PR,79413,URAI,5920,6582,1259,8254,162,6995,582
PR,79430,WENCESLAU BRAZ,8518,9894,1381,11596,207,10215,802
PR,79456,VERE,6864,3216,758,6173,96,5415,279
PR,79472,VITORINO,3990,2124,959,4291,50,3332,225
PR,79499,XAMBRE,3756,3382,874,4842,103,3968,296
PR,79510,ALTONIA,7950,11434,2432,13292,292,10860,876
PR,79537,ASSIS CHATEAUBRIAND,17782,17466,3625,22852,417,19227,1186
PR,79553,QUEDAS DO IGUACU,16968,6420,5530,18554,261,13024,1069
PR,79570,CEU AZUL,7524,3856,1049,7253,98,6204,416
PR,79596,GRANDES RIOS,2760,4222,988,4823,44,3835,300
PR,79618,INDIANOPOLIS,2002,2444,356,2864,72,2508,213
PR,79634,MATINHOS,14150,10104,4778,17987,268,13209,814
PR,79650,NOVA AURORA,7360,5598,783,8016,169,7233,585
PR,79677,NOVA OLIMPIA,3266,2676,713,3971,50,3258,237
PR,79693,PEROLA,5076,5230,2113,7835,158,5722,411
PR,79715,SANTA HELENA,16844,8476,2137,15528,185,13391,546
PR,79731,TAPIRA,3054,2974,765,4155,65,3390,311
PR,79758,MARILENA,2946,3708,1356,5168,87,3812,398
PR,79774,FRANCISCO ALVES,3264,4090,1092,5209,123,4117,317
PR,79790,NOVA SANTA ROSA,3672,4756,525,5101,133,4576,229
PR,79812,BOA VISTA DA APARECIDA,4138,3252,692,4821,117,4129,317
PR,79839,BRAGANEY,3804,2314,607,4055,68,3448,321
PR,79855,CAFELANDIA,7148,4676,1340,7777,122,6437,403
PR,79871,TRES BARRAS DO PARANA,6744,4568,1276,7547,112,6271,503
PR,79898,VERA CRUZ DO OESTE,3818,5302,1129,6296,92,5167,515
PR,79910,PRANCHITA,4318,2296,552,4110,57,3558,194
PR,79936,TUPASSI,4250,4918,799,5865,116,5066,366
PR,79952,NOVA PRATA DO IGUACU,7554,3064,1548,7273,77,5725,339
PR,79979,JESUITAS,5124,4840,1287,6889,119,5602,501
PR,79995,SAO JORGE DO PATROCINIO,3154,3626,875,4621,89,3746,267
PR,84514,CANTAGALO,7858,3716,2926,9382,114,6456,555
PR,84530,TURVO,9042,4226,1151,8554,128,7403,641
PR,84557,ALTAMIRA DO PARANA,1840,2952,1854,4527,34,2673,243
PR,84573,FIGUEIRA,4918,3368,1058,5743,94,4685,448
PR,84590,LUNARDELLI,2398,3170,570,3761,79,3191,328
PR,84611,SARANDI,32838,34692,8660,46693,1033,38033,3235
PR,84638,JURANDA,4388,3668,1708,6271,135,4563,400
PR,84654,DOURADINA,3450,3232,686,4363,56,3677,280
PR,84670,SANTA TEREZINHA DE ITAIPU,13862,5858,2461,13125,164,10664,640
PR,84697,MISSAL,8336,3780,806,7211,57,6405,290
PR,84719,SAO JOSE DAS PALMEIRAS,2514,1476,384,2680,76,2296,225
RJ,58009,QUISSAMA,13220,3350,2249,10856,118,8607,204
RJ,58017,ANGRA DOS REIS,73474,53792,14873,82486,1490,67613,2490
RJ,58025,QUATIS,9136,2790,1081,7404,112,6323,248
RJ,58033,ARARUAMA,55322,31438,13143,60088,1360,46945,2205
RJ,58041,BELFORD ROXO,339088,54252,40652,248385,3884,207733,7179
RJ,58050,BARRA DO PIRAI,84424,20340,9218,63947,840,54729,1507
RJ,58068,CARDOSO MOREIRA,8706,5780,3139,10817,146,7678,289
RJ,58076,BARRA MANSA,147396,41518,16653,116488,1764,99835,3614
RJ,58084,VARRE E SAI,3546,6010,1432,6572,90,5140,272
RJ,58092,BOM JARDIM,15400,11244,3378,17710,290,14332,720
RJ,58106,GUAPIMIRIM,32314,7490,5431,26378,355,20947,690
RJ,58114,BOM JESUS DO ITABAPOANA,16856,22468,7126,28137,381,21011,968
RJ,58122,QUEIMADOS,99656,16554,13509,75220,1338,61711,2268
RJ,58130,CABO FRIO,83830,35926,15583,79547,1764,63964,2322
RJ,58149,JAPERI,65860,11722,9284,50628,905,41344,1648
RJ,58157,CACHOEIRAS DE MACACU,34086,15344,6500,32995,644,26495,1136
RJ,58165,COMENDADOR LEVY GASPARIAN,8536,1864,1055,6559,97,5504,207
RJ,58173,CAMBUCI,7050,8946,2350,10908,187,8558,373
RJ,58181,APERIBE,5760,4836,1448,7150,124,5702,280
RJ,58190,CAMPOS,324290,104782,58185,283864,4346,225679,6797
RJ,58203,RIO DAS OSTRAS,21288,11140,4324,21472,386,17148,548
RJ,58211,CANTAGALO,13154,11312,2167,15209,239,13042,570
RJ,58220,AREAL,7226,6372,1364,8577,141,7213,273
RJ,58238,CARMO,12334,6876,2352,12591,150,10239,484
RJ,58246,PINHEIRAL,15608,4466,1653,12190,159,10537,341
RJ,58254,CASIMIRO DE ABREU,17588,9602,3997,18331,269,14334,470
RJ,58262,IGUABA GRANDE,13192,6374,3171,13598,238,10427,406
RJ,58270,CONCEICAO DE MACABU,14392,6874,3409,14727,219,11318,466
RJ,58289,SAO FRANCISCO DE ITABAPOANA,16624,21810,10780,31252,508,20472,747
RJ,58297,CORDEIRO,13866,6436,2371,13152,197,10781,433
RJ,58300,CARAPEBUS,8680,2678,1668,7680,126,6012,207
RJ,58319,DUAS BARRAS,6488,5200,1958,8204,107,6246,295
RJ,58327,PORTO REAL,10254,2562,976,7730,114,6754,232
RJ,58335,DUQUE DE CAXIAS,692300,111910,82589,506886,7435,424297,14757
RJ,58343,SAO JOSE DE UBA,3384,4972,1088,5540,106,4452,168
RJ,58351,ENGENHEIRO PAULO DE FRONTIN,13726,4156,2164,11664,172,9500,387
RJ,58360,TANGUA,19150,8274,3061,17550,305,14489,472
RJ,58378,ITABORAI,135266,37718,18526,110843,2326,92317,3499
RJ,58386,MACUCO,6924,1986,1435,6080,53,4645,137
RJ,58394,ITAGUAI,74578,21600,11134,62095,1168,50961,1704
RJ,58408,ARMACAO DE BUZIOS,14274,7404,2928,14394,234,11466,393
RJ,58416,ITAOCARA,10802,14496,4743,18487,385,13744,710
RJ,58424,SEROPEDICA,49486,10096,5946,37308,579,31362,992
RJ,58432,ITAPERUNA,56450,41068,13632,65522,1180,51890,1951
RJ,58440,ITATIAIA,21422,7002,3169,18025,224,14856,420
RJ,58459,LAJE DO MURIAE,4832,4326,1394,6291,97,4897,221
RJ,58467,MESQUITA,150760,25566,15948,109577,1854,93629,3612
RJ,58475,MACAE,100000,33464,15977,85808,1259,69831,1840
RJ,58491,MAGE,172444,30510,21695,128534,2074,106839,3288
RJ,58513,MANGARATIBA,23934,7128,2795,19139,267,16344,546
RJ,58530,MARICA,59652,17800,10295,51345,845,41050,1479
RJ,58556,MENDES,18192,4538,2491,14486,236,11995,394
RJ,58572,MIGUEL PEREIRA,17748,9550,1742,16395,324,14653,680
RJ,58599,MIRACEMA,16184,11620,5263,20341,386,15078,790
RJ,58610,NATIVIDADE,9342,7194,2694,11696,155,9002,579
RJ,58637,NILOPOLIS,197404,33078,22194,144079,2350,121885,4294
RJ,58653,NITEROI,489944,118902,62485,382994,5100,320509,10986
RJ,58670,NOVA FRIBURGO,136802,60766,19414,124572,2231,105158,4143
RJ,58696,NOVA IGUACU,588546,119140,76392,453494,7997,377102,15262
RJ,58718,PARACAMBI,34238,12312,4609,29523,482,24914,1157
RJ,58734,PARAIBA DO SUL,34612,10456,5163,29006,436,23843,873
RJ,58750,PARATI,14122,13536,3745,18426,290,14681,562
RJ,58777,PETROPOLIS,239480,101080,28120,207877,3688,179757,5789
RJ,58793,PIRAI,23762,5762,3643,19219,250,15576,564
RJ,58815,PORCIUNCULA,9160,7334,3191,12167,182,8976,547
RJ,58831,RESENDE,77856,30910,13392,71264,1253,57872,2236
RJ,58858,RIO BONITO,34146,22624,7063,37524,729,30461,1347
RJ,58874,RIO CLARO,12406,6478,2260,12383,204,10123,477
RJ,58890,RIO DAS FLORES,6468,2054,543,5093,75,4550,214
RJ,58912,SANTA MARIA MADALENA,7964,3636,2740,9040,116,6300,384
RJ,58939,SANTO ANTONIO DE PADUA,26356,14018,6155,27889,501,21734,1046
RJ,58955,SAO FIDELIS,18342,22980,7442,29340,435,21898,802
RJ,58971,SAO GONCALO,745448,140886,87303,561405,10604,474102,20331
RJ,58998,SAO JOAO DA BARRA,21346,12294,7243,24996,370,17753,563
RJ,59013,SAO JOAO DE MERITI,440084,70340,49789,320350,4950,270561,10399
RJ,59030,SAO PEDRO DA ALDEIA,45716,17978,8534,42922,1007,34388,1534
RJ,59056,SAO SEBASTIAO DO ALTO,4656,4956,1213,6386,130,5173,237
RJ,59072,SAPUCAIA,12322,9060,1741,13177,175,11436,570
RJ,59099,SAQUAREMA,37216,19988,9597,40230,700,30633,1331
RJ,59110,SILVA JARDIM,11922,7364,3240,13757,296,10517,578
RJ,59137,SUMIDOURO,6640,10652,2197,11302,154,9105,305
RJ,59153,TERESOPOLIS,94138,69926,16314,103286,1706,86972,3234
RJ,59170,TRAJANO DE MORAIS,7104,4512,2438,8777,140,6339,391
RJ,59196,TRES RIOS,66836,16660,7992,52119,913,44127,1466
RJ,59218,VALENCA,66136,16022,8528,51666,636,43138,1423
RJ,59234,VASSOURAS,24400,13326,4526,24604,387,20078,828
RJ,59250,VOLTA REDONDA,261506,48198,26470,187626,2123,161156,4181
RJ,59277,ARRAIAL DO CABO,21810,7912,4114,19921,425,15807,521
RJ,59293,ITALVA,8270,6370,3145,10937,199,7792,273
RJ,59315,PATI DO ALFERES,15692,11164,3559,18019,364,14460,668
RJ,59331,SAO JOSE DO VALE DO RIO PRETO,7950,11300,1741,11809,157,10068,286
RJ,60011,RIO DE JANEIRO,5515914,1296444,715562,4327481,61723,3611919,144017
RN,16004,TENENTE LAURENTINO CRUZ,1600,3258,605,3370,61,2765,275
RN,16012,ACARI,7160,4742,1685,8450,163,6765,651
RN,16020,SERRA DO MEL,3538,3808,866,5243,173,4377,531
RN,16039,ASSU,28216,16170,7305,32987,746,25682,2743
RN,16047,CAICARA DO NORTE,1834,3516,1241,4327,66,3086,345
RN,16055,AFONSO BEZERRA,4924,6330,1697,8231,127,6534,780
RN,16063,SAO MIGUEL DE TOUROS,2732,3106,896,4361,80,3465,466
RN,16071,AGUA NOVA,1028,1826,415,2031,18,1616,171
RN,16080,ITAJA,4134,2990,678,4760,84,4082,436
RN,16098,ALEXANDRIA,7526,6560,3066,11041,111,7975,821
RN,16101,BODO,1256,1638,359,2068,37,1709,225
RN,16110,ALMINO AFONSO,2648,3930,530,4209,73,3679,317
RN,16128,TRIUNFO POTIGUAR,1356,2588,449,2697,39,2248,237
RN,16136,ALTO DO RODRIGUES,6162,3706,465,6158,156,5693,603
RN,16144,FERNANDO PEDROSA,1512,1498,561,2327,66,1766,195
RN,16152,ANGICOS,6766,6318,1951,9323,170,7372,660
RN,16160,MAJOR SALES,1330,1928,539,2361,14,1822,179
RN,16179,ANTONIO MARTINS,3558,3972,1437,5787,103,4350,482
RN,16187,VENHA VER,890,2478,587,2631,39,2044,321
RN,16195,APODI,19792,14508,4078,23201,500,19123,1473
RN,16209,SERRINHA DOS PINTOS,1906,2858,792,3596,95,2804,327
RN,16217,AREIA BRANCA,17450,8594,3937,18487,346,14550,1182
RN,16225,TIBAU,2122,1110,339,2177,43,1838,179
RN,16233,ARES,6370,6056,1784,9033,225,7249,811
RN,16241,SANTA MARIA,1884,2396,713,3235,59,2522,323
RN,16250,CAMPO GRANDE,4744,5012,1697,7269,164,5572,530
RN,16268,RIO DO FOGO,3862,5370,2636,7952,115,5316,585
RN,16276,BAIA FORMOSA,3534,3410,2002,6070,112,4068,484
RN,16284,PORTO DO MANGUE,1702,2336,476,2862,39,2386,328
RN,16292,BARCELONA,1642,2890,527,3133,48,2606,292
RN,16306,JUNDIA,1752,1602,843,2858,50,2015,288
RN,16314,BENTO FERNANDES,2980,2310,780,3906,68,3126,413
RN,16330,BOM JESUS,3526,5010,1787,6833,149,5046,629
RN,16357,BREJINHO,3450,6504,1574,7471,147,5897,773
RN,16373,CAICARA DO RIO DO VENTO,2272,1872,269,2621,37,2352,243
RN,16390,CAICO,39032,17846,7937,39473,826,31536,2271
RN,16411,CAMPO REDONDO,3638,5276,1132,6466,170,5334,707
RN,16438,CANGUARETAMA,16556,6208,4992,18440,357,13448,1709
RN,16454,CARAUBAS,10896,8748,3548,15435,673,11887,1392
RN,16470,CARNAUBA DOS DANTAS,3284,4438,672,4942,118,4270,291
RN,16497,CARNAUBAIS,5344,4310,1233,6867,180,5634,627
RN,16519,CEARA MIRIM,26652,25042,10425,40184,724,29759,3188
RN,16535,CERRO-CORA,3102,6504,1766,7290,89,5524,632
RN,16551,CORONEL EZEQUIEL,1526,3470,709,3642,78,2933,357
RN,16578,CORONEL JOAO PESSOA,1514,2802,1109,3743,60,2634,416
RN,16594,CRUZETA,5174,3950,1436,6656,173,5220,485
RN,16616,CURRAIS NOVOS,20922,18432,7241,29903,763,22662,2222
RN,16632,DOUTOR SEVERIANO,2016,4602,1085,4911,80,3826,437
RN,16659,ENCANTO,3008,1750,924,3747,69,2823,375
RN,16675,EQUADOR,2446,2910,924,3996,48,3072,346
RN,16691,ESPIRITO SANTO,3658,4236,1283,5858,102,4575,526
RN,16713,EXTREMOZ,10178,9374,5122,16400,232,11278,1270
RN,16730,FELIPE GUERRA,4710,3438,453,4980,128,4527,325
RN,16756,FLORANIA,5372,5242,1672,7663,139,5991,545
RN,16772,FRANCISCO DANTAS,1554,1846,335,2345,44,2010,266
RN,16799,GALINHOS,1200,1000,233,1497,31,1264,133
RN,16810,GOIANINHA,9934,9468,2202,13674,291,11472,1480
RN,16837,GOVERNADOR DIX-SEPT ROSADO,7202,5026,1758,8825,278,7067,675
RN,16853,GROSSOS,4590,4406,779,5848,139,5069,432
RN,16870,GUAMARE,7074,4350,2356,8979,142,6623,769
RN,16896,IELMO MARINHO,4222,4530,1532,6771,133,5239,730
RN,16918,IPANGUACU,7280,5340,2197,9481,190,7284,784
RN,16934,IPUEIRA,1540,990,164,1559,34,1395,96
RN,16950,ITAU,3514,2810,743,4307,69,3564,333
RN,16977,JACANA,1720,5048,831,4741,89,3910,437
RN,16993,JANDAIRA,2068,4146,1075,4792,104,3717,506
RN,17019,JANDUIS,3508,2204,1303,4618,106,3315,353
RN,17035,BOA SAUDE,3238,4202,1316,5649,82,4333,531
RN,17051,JAPI,1746,4810,1317,5148,70,3831,483
RN,17078,JARDIM DE ANGICOS,1756,1632,260,2122,26,1862,142
RN,17094,JARDIM DE PIRANHAS,7402,5222,1936,9050,186,7114,616
RN,17116,JARDIM DO SERIDO,5224,8112,1768,9338,186,7570,716
RN,17132,JOAO CAMARA,17274,10108,5033,21037,449,16004,1864
RN,17159,JOAO DIAS,1426,1932,311,2178,19,1867,169
RN,17175,JOSE DA PENHA,1954,4572,1112,4780,38,3668,367
RN,17191,JUCURUTU,9654,9152,2783,13312,184,10529,942
RN,17213,MESSIAS TARGINO,3250,1506,430,3108,62,2678,238
RN,17230,LAGOA D ANTA,2152,3528,1157,4355,46,3198,312
RN,17256,LAGOA DE PEDRAS,2470,4190,894,4721,90,3827,407
RN,17272,LAGOA DE VELHOS,1236,2012,294,2167,41,1873,208
RN,17299,LAGOA NOVA,5158,7868,2181,9595,124,7414,777
RN,17310,LAGOA SALGADA,4028,4060,852,5874,248,5022,730
RN,17337,LAJES,5252,5898,1560,7860,87,6300,638
RN,17353,LAJES PINTADAS,2436,2404,692,3555,72,2863,371
RN,17370,LUCRECIA,2726,1174,342,2507,25,2165,190
RN,17396,LUIS GOMES,3782,5614,1785,7206,72,5421,651
RN,17418,MACAIBA,22622,24444,6916,34515,772,27599,3294
RN,17434,MACAU,17766,8820,5377,20095,295,14718,1130
RN,17450,MARCELINO VIEIRA,5280,3242,1411,6368,119,4957,577
RN,17477,MARTINS,4006,3810,1639,6049,94,4410,408
RN,17493,MAXARANGUAPE,4012,4856,2610,7735,98,5125,593
RN,17515,FRUTUOSO GOMES,2430,2532,1138,3919,46,2781,254
RN,17531,MONTANHAS,6414,3042,2321,7808,125,5487,634
RN,17558,MONTE ALEGRE,7422,7780,2849,11715,214,8866,1051
RN,17574,MONTE DAS GAMELEIRAS,1574,1006,432,1985,28,1553,235
RN,17590,MOSSORO,143506,54726,24793,135516,2493,110723,9114
RN,17612,NATAL,474956,195034,76315,446841,8007,370526,27524
RN,17639,NISIA FLORESTA,8808,6132,2101,11028,345,8927,1112
RN,17655,NOVA CRUZ,15180,14554,7222,24406,471,17184,1846
RN,17671,OLHO D'AGUA DO BORGES,2782,2572,905,3980,85,3075,313
RN,17698,OURO BRANCO,2496,3284,450,3639,55,3189,244
RN,17710,PARANA,2488,1768,541,2978,43,2437,266
RN,17736,PARAU,1872,2634,778,3444,107,2666,306
RN,17752,PARAZINHO,1774,2508,391,2918,53,2527,333
RN,17779,PARELHAS,8814,11406,3038,14486,308,11448,1030
RN,17795,PARNAMIRIM,61148,32952,10492,63429,1436,52937,4451
RN,17817,PASSA E FICA,1966,5604,1561,5954,71,4393,537
RN,17833,PASSAGEM,1784,1532,295,2222,49,1927,220
RN,17850,PATU,4996,7592,1180,8371,213,7191,684
RN,17876,PAU DOS FERROS,12018,9936,3447,15920,324,12473,1172
RN,17892,PEDRA GRANDE,2090,2002,710,3095,37,2385,302
RN,17914,PEDRA PRETA,1314,2178,389,2385,33,1996,217
RN,17930,PEDRO AVELINO,3562,4410,1456,6013,94,4557,477
RN,17957,PEDRO VELHO,8270,4168,3280,10632,216,7352,917
RN,17973,PENDENCIAS,7416,4400,2228,9148,162,6920,850
RN,17990,PILOES,2520,1314,490,2625,25,2135,193
RN,18015,POCO BRANCO,5762,5334,2216,8814,230,6598,820
RN,18031,PORTALEGRE,2868,4988,1027,5471,107,4444,409
RN,18058,SERRA CAIADA,2508,4990,1380,5709,80,4329,500
RN,18074,PUREZA,3378,3672,823,4889,74,4066,467
RN,18090,RAFAEL FERNANDES,2280,2564,726,3572,86,2846,338
RN,18112,RIACHO DA CRUZ,1300,2148,299,2270,49,1971,198
RN,18139,RIACHO DE SANTANA,2702,1532,712,3169,52,2457,288
RN,18155,RIACHUELO,3308,3400,758,4490,44,3732,334
RN,18171,RODOLFO FERNANDES,3616,2268,395,3737,52,3342,348
RN,18198,RUY BARBOSA,1004,3202,584,2906,30,2322,189
RN,18210,SAO FRANCISCO DO OESTE,1546,2420,630,2924,58,2294,253
RN,18236,SANTA CRUZ,13968,14974,4536,21321,446,16785,1868
RN,18252,SANTANA DO SERIDO,1388,1254,136,1642,41,1506,144
RN,18279,SANTANA DO MATOS,5726,7346,2560,10304,256,7744,952
RN,18295,SANTO ANTONIO,12438,5326,4044,15118,353,11074,1839
RN,18317,SAO BENTO DO NORTE,1906,1578,640,2685,34,2045,269
RN,18333,SAO BENTO DO TRAIRI,1182,3122,358,2783,31,2425,242
RN,18350,SAO FERNANDO,2536,1638,472,2826,78,2354,189
RN,18376,SAO GONCALO DO AMARANTE,34450,31250,11147,48914,897,37767,4020
RN,18392,SAO JOAO DO SABUGI,4022,3306,478,4445,52,3967,251
RN,18414,SAO JOSE DE MIPIBU,18374,11354,5394,23045,451,17651,2336
RN,18430,SAO JOSE DE CAMPESTRE,5834,5250,2283,9020,283,6737,912
RN,18457,SAO JOSE DO SERIDO,2814,1606,381,2934,117,2553,226
RN,18473,SAO MIGUEL,8704,9204,4303,15640,470,11337,1913
RN,18490,SAO PAULO DO POTENGI,5430,8600,2219,10275,207,8056,834
RN,18511,SAO PEDRO,3658,3508,775,4895,82,4120,455
RN,18538,SAO RAFAEL,4680,3990,1721,6749,143,5028,550
RN,18554,SAO TOME,4508,5752,2028,8137,160,6109,819
RN,18570,SAO VICENTE,1940,4048,583,4022,76,3439,369
RN,18597,SENADOR ELOI DE SOUZA,2214,2562,1040,3887,76,2847,383
RN,18619,SENADOR GEORGINO AVELINO,1998,2068,496,2845,59,2349,257
RN,18635,SERRA DE SAO BENTO,2560,2872,810,4071,67,3261,478
RN,18651,SERRA NEGRA DO NORTE,4858,2976,1723,6147,81,4424,426
RN,18678,SERRINHA,4908,2174,842,5091,113,4249,595
RN,18694,SEVERIANO MELO,4308,2928,2000,6268,110,4268,540
RN,18716,SITIO NOVO,1692,2742,965,3556,79,2591,295
RN,18732,TABOLEIRO GRANDE,1284,1440,251,1781,28,1530,140
RN,18759,TAIPU,6840,4204,2728,9312,180,6584,882
RN,18775,TANGARA,4196,7302,2272,9169,221,6897,927
RN,18791,TENENTE ANANIAS,3172,5536,1888,6924,88,5036,594
RN,18813,TIBAU DO SUL,4698,3074,884,5616,193,4732,653
RN,18830,TIMBAUBA DOS BATISTAS,1496,1242,254,1807,59,1553,125
RN,18856,TOUROS,8858,11318,4344,16427,375,12083,1620
RN,18872,UMARIZAL,6706,5214,2155,8938,202,6783,621
RN,18899,UPANEMA,5822,5908,1173,7911,198,6738,675
RN,18910,VARZEA,2974,2462,1149,4274,66,3125,341
RN,18937,RAFAEL GODEIRO,1426,2406,276,2377,36,2101,149
RN,18953,VERA CRUZ,4218,5202,1621,7337,248,5716,758
RN,18970,VICOSA,1220,742,360,1476,21,1116,114
RN,18996,VILA FLOR,1418,964,526,1959,56,1433,186
RN,30031,BARAUNA,8156,8120,3903,13623,289,9720,1293
RO,19,GUAJARA MIRIM,19236,11026,6187,22458,223,16271,917
RO,35,PORTO VELHO,209680,105086,44704,210986,2117,166282,6782
RO,51,JI PARANA,52164,46948,19138,71869,755,52731,2420
RO,78,ARIQUEMES,29956,37226,14078,49708,618,35630,1421
RO,94,CACOAL,34620,30208,13090,47389,597,34299,1288
RO,116,PIMENTA BUENO,14616,15114,6813,22522,280,15709,564
RO,132,VILHENA,29712,20588,10002,36758,477,26756,1129
RO,159,JARU,24150,23618,11703,37506,529,25803,1390
RO,175,OURO PRETO DO OESTE,18440,17246,8941,28093,347,19152,962
RO,191,PRESIDENTE MEDICI,12026,10972,6439,18742,276,12303,528
RO,213,COSTA MARQUES,4036,3812,1847,6057,70,4210,216
RO,230,COLORADO DO OESTE,10956,9060,4970,15854,313,10884,563
RO,256,ESPIGAO D'OESTE,13768,10776,4484,17543,296,13059,491
RO,272,CEREJEIRAS,8076,9510,4184,13537,212,9353,348
RO,299,ROLIM DE MOURA,22260,19690,8167,30753,492,22586,1119
RO,310,ALTA FLORESTA DO OESTE,13114,10808,4886,17671,200,12785,624
RO,337,ALVORADA DO OESTE,6738,10302,4578,13572,127,8994,347
RO,353,SANTA LUZIA DO OESTE,5630,4958,2779,8470,119,5691,278
RO,370,NOVA BRASILANDIA,7056,10060,3402,12456,142,9054,354
RO,396,MACHADINHO DO OESTE,9640,8974,3811,13873,168,10062,587
RO,418,SAO MIGUEL DO GUAPORE,5880,7614,2817,9900,119,7083,217
RO,434,NOVA MAMORE,4554,5190,2232,7483,84,5251,295
RO,450,CABIXI,3528,3098,1424,5016,112,3592,167
RO,477,CANDEIAS DO JAMARI,4888,3126,860,5212,87,4352,258
RO,493,ITAPUA DO OESTE,2164,2126,507,2797,31,2290,114
RO,515,NOVO HORIZONTE DO OESTE,5890,4868,2487,8248,91,5761,291
RO,531,CASTANHEIRAS,2070,1498,351,2287,30,1936,122
RO,558,VALE DO PARAISO,4478,3346,1982,6323,74,4341,355
RO,566,URUPA,5596,5238,2932,8897,176,5965,372
RO,574,MIRANTE DA SERRA,5058,6288,2736,8823,104,6087,310
RO,582,SERINGUEIRAS,4452,3870,1758,6156,72,4398,165
RO,590,THEOBROMA,4532,3408,2553,6920,96,4367,301
RO,604,MINISTRO ANDREAZZA,5252,3244,2211,6792,113,4581,220
RO,612,GOVERNADOR JORGE TEIXEIRA,4824,4276,2815,7842,121,5027,356
RO,620,CACAULANDIA,2428,2710,1047,3815,49,2768,150
RO,639,ALTO PARAISO,4086,6076,2844,8301,116,5457,260
RO,647,RIO CRESPO,1308,1588,955,2504,31,1549,70
RO,655,CORUMBIARA,4286,3108,1555,5501,77,3946,172
RO,663,MONTE NEGRO,4566,4928,2861,8011,90,5150,313
RO,671,CAMPO NOVO DE RONDONIA,2724,3706,2041,5463,59,3422,148
RO,680,CUJUBIM,2614,3004,1128,4211,61,3083,213
RO,698,VALE DO ANARI,2658,2566,1331,4164,45,2833,176
RO,701,PARECIS,1730,1966,970,2957,26,1987,113
RO,710,SAO FELIPE D OESTE,2952,3428,1433,4833,54,3400,156
RO,728,PRIMAVERA DE RONDONIA,2308,2184,953,3322,40,2369,83
RO,736,ALTO ALEGRE DOS PARECIS,4802,3336,1731,6075,85,4344,190
RO,744,NOVA UNIAO,3876,2546,1640,5148,79,3508,218
RO,752,TEIXEIROPOLIS,2776,2522,1467,4320,49,2853,155
RO,779,BURITIS,9446,9470,3980,14064,189,10084,437
RO,787,PIMENTEIRAS DO OESTE,940,994,502,1515,13,1013,33
RO,795,SAO FRANCISCO DO GUAPORE,3514,5506,1816,6542,67,4726,149
RO,809,CHUPINGUAIA,2474,1830,980,3286,32,2306,122
RR,3000,CAROEBE,3358,2846,695,4067,52,3372,218
RR,3018,BOA VISTA,140906,65998,21080,131665,1694,110585,5439
RR,3026,IRACEMA,3538,2070,772,3805,34,3033,195
RR,3034,CARACARAI,7644,5494,2358,9394,58,7036,409
RR,3042,AMAJARI,3526,1968,1183,4165,54,2982,181
RR,3050,ALTO ALEGRE,7040,4404,1601,7878,127,6277,428
RR,3069,CANTA,7272,3324,1785,7525,71,5740,371
RR,3077,BONFIM,3760,3218,1008,4825,50,3817,278
RR,3085,RORAINOPOLIS,7248,5252,1802,8586,70,6784,464
RR,3093,MUCAJAI,7760,4060,1531,7983,116,6452,426
RR,3107,UIRAMUTA,1836,1102,603,2290,26,1687,192
RR,3115,NORMANDIA,3570,2284,747,3954,54,3207,226
RR,3123,PACARAIMA,3062,2754,1201,4385,48,3184,228
RR,3131,SAO JOAO DA BALIZA,3634,2174,635,3759,45,3124,175
RR,3158,SAO LUIZ DO ANAUA,4020,2436,757,4243,65,3486,193
RS,84735,AUREA,2966,2032,494,3123,52,2629,78
RS,84743,TRES ARROIOS,2780,1744,250,2618,44,2368,62
RS,84751,NOVA ROMA DO SUL,1838,2646,235,2633,60,2398,96
RS,84760,PROGRESSO,3518,3646,1045,4921,78,3876,216
RS,84778,PIRAPO,1744,1796,904,2802,31,1898,97
RS,84786,JABOTICABA,2730,2300,648,3345,59,2697,123
RS,84794,SAO JORGE,1894,1900,452,2461,41,2009,71
RS,84808,ALTO ALEGRE,1632,1184,307,1814,49,1507,50
RS,84816,NOVA HARTZ,12014,5534,1249,10504,173,9255,308
RS,84824,DOIS LAJEADOS,2256,2022,331,2659,89,2328,100
RS,84832,SAO DOMINGOS DO SUL,1826,2200,386,2552,81,2166,72
RS,84840,TUNAS,2522,2592,821,3587,52,2766,157
RS,84859,SAO JOAO DA URTIGA,3504,3008,801,4314,120,3513,137
RS,84867,GUABIJU,1026,1176,348,1572,58,1224,65
RS,84875,QUINZE DE NOVEMBRO,2516,2452,299,2877,36,2578,58
RS,84883,DOUTOR MAURICIO CARDOSO,4602,3470,869,5074,35,4205,134
RS,84891,CAPELA DE SANTANA,6224,4446,801,6494,130,5693,228
RS,84905,JAQUIRANA,2028,2786,918,3614,112,2696,177
RS,84913,VANINI,1094,1286,215,1530,56,1315,69
RS,84921,BOQUEIRAO DO LEAO,4762,3980,974,5823,165,4849,313
RS,84930,FAGUNDES VARELA,1622,1878,226,2111,58,1885,77
RS,84948,AGUA SANTA,2058,2650,307,2795,44,2488,90
RS,84956,SILVEIRA MARTINS,1906,1736,360,2332,65,1972,86
RS,84964,IBIRAPUITA,2106,2846,692,3388,59,2696,161
RS,84972,IBARAMA,3466,2066,542,3469,65,2927,96
RS,84980,PANTANO GRANDE,7068,5152,1552,8251,216,6699,373
RS,84999,IPE,3106,4256,682,4720,176,4038,181
RS,85006,TRINDADE DO SUL,3258,3218,1305,4795,58,3490,194
RS,85014,AGUDO,10668,8960,1652,12328,415,10676,447
RS,85022,ERNESTINA,2712,1966,444,2904,33,2460,88
RS,85030,AJURICABA,5858,3940,795,5899,63,5104,142
RS,85049,DEZESSEIS DE NOVEMBRO,1676,2018,837,2851,60,2014,107
RS,85057,ALECRIM,5302,4530,1438,6635,69,5197,212
RS,85065,BROCHIER,2654,3460,433,3703,78,3270,135
RS,85073,ALEGRETE,47792,40786,11566,58571,886,47005,1830
RS,85081,EREBANGO,1942,1576,385,2277,38,1892,95
RS,85090,ALPESTRE,6214,4186,2279,7820,95,5541,246
RS,85103,ENTRE IJUIS,7724,3850,1598,7777,148,6179,244
RS,85111,ALVORADA,101252,83704,12788,111207,1884,98419,4057
RS,85120,NOVA ESPERANCA DO SUL,2384,2674,482,3272,106,2790,155
RS,85138,ANTA GORDA,3306,4416,756,4990,183,4234,190
RS,85146,PAVERAMA,3922,4578,750,5410,140,4660,270
RS,85154,ANTONIO PRADO,7790,7760,1025,9446,263,8421,383
RS,85162,TERRA DE AREIA,3286,5716,1239,6091,110,4852,241
RS,85170,ARATIBA,5196,4160,700,5607,106,4907,123
RS,85189,HARMONIA,2538,2628,262,3029,89,2767,95
RS,85197,ARROIO DO MEIO,12258,9332,1436,12921,310,11485,380
RS,85200,CAMPOS BORGES,2884,1712,633,3097,85,2464,81
RS,85219,ARROIO DOS RATOS,6926,7626,1656,9542,223,7886,387
RS,85227,CERRO GRANDE,2082,1216,785,2543,30,1758,79
RS,85235,ARROIO DO TIGRE,8340,7052,1191,9419,226,8228,306
RS,85243,IPIRANGA DO SUL,1030,1916,262,1813,27,1551,51
RS,85251,ARROIO GRANDE,12360,10092,2408,14440,331,12032,475
RS,85260,LAGOAO,1786,4486,1064,4541,69,3477,272
RS,85278,ARVOREZINHA,5932,4982,1497,7645,301,6148,390
RS,85286,ESTACAO,4248,3866,644,4939,79,4295,159
RS,85294,AUGUSTO PESTANA,5468,4288,1014,6188,117,5174,179
RS,85308,ARROIO DO SAL,3394,3074,1208,4653,73,3445,138
RS,85316,BAGE,79312,48876,11940,79785,1553,67845,2198
RS,85324,SAO JOSE DO HORTENCIO,2064,2310,203,2558,75,2355,93
RS,85332,BARAO DE COTEGIPE,4398,3750,582,4909,69,4327,184
RS,85340,PINHAL,1562,1276,427,1939,25,1512,68
RS,85359,BARRACAO,3502,2792,1074,4477,110,3403,146
RS,85367,TRES CACHOEIRAS,5004,5928,1121,6936,155,5815,194
RS,85375,BARRA DO RIBEIRO,6708,7290,1440,8862,139,7422,284
RS,85383,SAO VENDELINO,942,1618,139,1482,20,1343,43
RS,85391,BARROS CASSAL,5884,5404,1835,8146,179,6311,488
RS,85405,PROTASIO ALVES,1096,1944,315,1987,86,1672,66
RS,85413,BENTO GONCALVES,62380,42800,6392,62302,1237,55910,2083
RS,85421,POUSO NOVO,1370,1250,553,1961,32,1408,66
RS,85430,BOA VISTA DO BURICA,4756,3488,688,4986,68,4298,108
RS,85448,EUGENIO DE CASTRO,2144,1892,750,2912,54,2162,90
RS,85456,BOM JESUS,5010,8178,2398,9569,215,7171,362
RS,85464,CRISTAL,3520,4264,1102,5393,152,4291,247
RS,85472,BOM RETIRO DO SUL,7256,5570,1094,8093,239,6999,347
RS,85480,SAO MIGUEL DAS MISSOES,4932,3422,1211,5715,144,4504,183
RS,85499,BOSSOROCA,4816,3218,1490,5876,186,4386,183
RS,85502,GLORINHA,2532,4462,457,4246,82,3789,210
RS,85510,BRAGA,2276,2232,807,3257,55,2450,141
RS,85529,SEGREDO,4434,3868,841,5328,97,4487,239
RS,85537,BUTIA,13404,9918,2679,15165,320,12486,505
RS,85545,ALEGRIA,3364,2908,887,4264,67,3377,174
RS,85553,CACAPAVA DO SUL,20720,20562,5085,27679,797,22594,1156
RS,85561,SALDANHA MARINHO,2036,2258,460,2717,44,2257,66
RS,85570,CACEQUI,9786,5908,2656,11043,173,8387,367
RS,85588,SAO JOSE DO HERVAL,1448,1334,552,2084,34,1532,107
RS,85596,CACHOEIRA DO SUL,60334,37976,11471,63626,1200,52155,1800
RS,85600,VISTA ALEGRE,2518,1396,455,2527,22,2072,93
RS,85618,CACHOEIRINHA,74332,58046,9013,78967,1361,69954,2404
RS,85626,IVORA,1756,1464,328,2045,42,1717,65
RS,85634,CACIQUE DOBLE,2596,2946,756,3809,132,3053,150
RS,85642,VILA MARIA,2944,2548,445,3397,73,2952,133
RS,85650,CAIBATE,3918,2080,967,4219,116,3252,137
RS,85669,TAQUARUCU DO SUL,1974,1906,432,2467,28,2035,67
RS,85677,CAICARA,3280,3266,742,4206,66,3464,125
RS,85685,IMBE,7438,7848,2068,10153,124,8085,318
RS,85693,CAMAQUA,34892,34112,6544,43776,1119,37232,1611
RS,85707,SEDE NOVA,2062,1790,577,2626,40,2049,83
RS,85715,CAMBARA DO SUL,2918,4200,1216,5143,135,3927,233
RS,85723,TUPANDI,1502,2840,249,2576,67,2327,89
RS,85731,CAMPINA DAS MISSOES,5386,3470,1185,5866,113,4681,140
RS,85740,RIOZINHO,2606,2468,442,3217,95,2775,143
RS,85758,CAMPINAS DO SUL,3600,3632,621,4423,65,3802,121
RS,85766,RELVADO,976,2054,554,2190,43,1636,78
RS,85774,CAMPO BOM,44304,24858,4067,40415,613,36348,1154
RS,85782,IMIGRANTE,2018,2020,318,2519,91,2201,91
RS,85790,CAMPO NOVO,4100,3018,1432,5251,57,3819,203
RS,85804,CIDREIRA,5022,4900,2037,7281,79,5244,204
RS,85812,CANDELARIA,17980,15476,3232,22062,1021,18830,1081
RS,85820,MONTAURI,1538,788,232,1483,41,1251,47
RS,85839,CANDIDO GODOI,4424,4964,895,5935,133,5040,213
RS,85847,VISTA GAUCHA,1734,1782,357,2227,29,1870,83
RS,85855,CANELA,17270,20016,2607,22641,535,20034,856
RS,85863,VISTA ALEGRE DO PRATA,1196,1148,248,1499,42,1251,37
RS,85871,CANGUCU,21230,42174,6316,41256,1529,34940,1709
RS,85880,CASEIROS,1532,2226,456,2490,72,2034,83
RS,85898,CANOAS,217632,139114,23021,210646,3241,187625,6011
RS,85901,ITACURUBI,1990,1734,735,2740,43,2005,100
RS,85910,CARAZINHO,39374,25864,6259,40682,598,34423,1206
RS,85928,ENTRE RIOS DO SUL,2544,1510,702,2861,41,2159,91
RS,85936,CARLOS BARBOSA,15182,11886,1381,15782,332,14401,535
RS,85944,CERRO GRANDE DO SUL,4514,5344,1062,6532,202,5470,339
RS,85952,CASCA,5178,4762,894,6290,210,5396,216
RS,85960,CAMARGO,1764,1614,320,2134,42,1814,83
RS,85979,CATUIPE,7436,5544,1811,8696,159,6885,236
RS,85987,PARAISO DO SUL,4428,4276,598,5301,154,4703,197
RS,85995,CAXIAS DO SUL,217988,206992,22783,248366,4281,225583,8812
RS,86010,CERRO LARGO,10238,4536,2032,9853,153,7821,281
RS,86029,FAXINALZINHO,1786,1472,523,2283,36,1760,95
RS,86037,CHAPADA,6026,6720,1130,7891,168,6761,220
RS,86045,AMARAL FERRADOR,3102,3356,904,4492,143,3588,216
RS,86053,CHIAPETA,2722,2366,585,3291,62,2706,100
RS,86061,VILA FLORES,2266,2122,278,2659,84,2381,103
RS,86070,CIRIACO,3284,2768,893,4253,145,3360,189
RS,86088,CERRO BRANCO,3452,2168,469,3589,132,3120,178
RS,86096,COLORADO,2600,2708,534,3371,93,2837,90
RS,86100,ANDRE DA ROCHA,628,1018,275,1148,16,873,34
RS,86118,CONDOR,4408,3734,843,5149,76,4306,159
RS,86126,POCO DAS ANTAS,1248,1620,205,1761,66,1556,56
RS,86134,CONSTANTINA,5906,5412,1804,7871,147,6067,261
RS,86142,TRES PALMEIRAS,3214,2280,951,3943,84,2992,161
RS,86150,CORONEL BICACO,5204,3514,1952,6677,100,4725,266
RS,86169,NOVA ALVORADA,1726,1846,349,2303,59,1954,109
RS,86177,CRISSIUMAL,11564,6732,2622,12430,341,9808,319
RS,86185,MORRO REDONDO,2958,4964,819,5145,162,4326,203
RS,86193,CRUZ ALTA,44628,28754,9175,47811,683,38636,1262
RS,86207,SANTA MARIA DO HERVAL,3824,3964,242,4409,98,4167,175
RS,86215,CRUZEIRO DO SUL,8100,5532,989,8353,230,7364,318
RS,86223,BARAO,2508,3998,397,3911,88,3514,173
RS,86231,DAVID CANABARRO,2776,2988,561,3730,138,3169,149
RS,86240,ELDORADO DO SUL,16066,13858,2681,18629,317,15948,669
RS,86258,DOIS IRMAOS,15464,11540,1150,15289,226,14139,411
RS,86274,DOM FELICIANO,6682,7264,1726,9669,343,7943,627
RS,86282,ALTO FELIZ,1360,2272,236,2201,62,1965,87
RS,86290,DOM PEDRITO,24634,18292,5701,28865,639,23164,1062
RS,86304,AMETISTA DO SUL,3442,4074,1035,5101,96,4066,212
RS,86312,DONA FRANCISCA,2598,2288,556,3164,62,2608,103
RS,86320,ARAMBARE,2798,1930,746,3270,54,2524,106
RS,86339,ENCANTADO,13066,10114,1955,14388,347,12433,496
RS,86347,BARAO DO TRIUNFO,1960,4608,595,4187,90,3592,218
RS,86355,ENCRUZILHADA DO SUL,11064,15266,3666,18318,587,14652,900
RS,86363,BARRA DO GUARITA,1532,1862,488,2330,24,1842,121
RS,86371,ERECHIM,68300,33124,8742,62101,956,53359,1691
RS,86380,BARRA DO RIO AZUL,1890,1222,301,1922,20,1621,45
RS,86398,HERVAL,3930,4144,1231,5671,157,4440,246
RS,86401,BARRA FUNDA,2268,1052,296,2053,39,1757,58
RS,86410,ERVAL GRANDE,3812,2934,849,4451,77,3602,152
RS,86428,BOA VISTA DAS MISSOES,1630,1198,339,1867,36,1528,78
RS,86436,ERVAL SECO,5088,4096,1537,6520,115,4983,276
RS,86444,BOM PROGRESSO,1866,1384,555,2289,20,1734,89
RS,86452,ESMERALDA,1004,2848,677,2798,81,2121,114
RS,86460,CAMPESTRE DA SERRA,1518,2186,506,2548,75,2042,115
RS,86479,ESPUMOSO,9350,8610,1894,11503,271,9609,358
RS,86487,CANDIOTA,5718,3154,981,5712,95,4731,200
RS,86495,ESTANCIA VELHA,23894,17430,2392,24152,342,21760,756
RS,86509,CAPITAO,2148,1458,308,2292,98,1984,83
RS,86517,ESTEIO,64434,35894,6659,58961,773,52302,1365
RS,86525,CARLOS GOMES,1676,1090,297,1741,17,1444,44
RS,86533,ESTRELA,18490,15534,2613,20601,380,17988,596
RS,86541,CENTENARIO,2458,1714,357,2518,17,2161,58
RS,86550,FARROUPILHA,33974,34028,4287,40350,855,36063,1207
RS,86568,CHARRUA,1836,2216,342,2496,28,2154,100
RS,86576,FAXINAL DO SOTURNO,5152,3590,833,5453,100,4620,149
RS,86584,COLINAS,1768,1726,274,2140,51,1866,68
RS,86592,FELIZ,5880,8598,933,8712,247,7779,293
RS,86606,COQUEIROS DO SUL,1962,1932,361,2429,46,2068,75
RS,86614,FLORES DA CUNHA,12736,15996,1693,17283,443,15590,781
RS,86622,CORONEL BARROS,1846,1812,291,2202,25,1911,57
RS,86630,FONTOURA XAVIER,5348,5354,2269,8253,196,5984,437
RS,86649,COXILHA,2372,1736,507,2685,42,2178,82
RS,86657,FORMIGUEIRO,4164,4872,1350,6277,147,4927,262
RS,86665,DERRUBADAS,1904,2232,641,2852,38,2211,105
RS,86673,FREDERICO WESTPHALEN,16950,14028,3901,20272,253,16371,629
RS,86681,DOIS IRMAOS DAS MISSOES,1660,1052,509,1991,33,1482,93
RS,86690,GARIBALDI,16870,15964,2033,19581,507,17548,624
RS,86703,ENGENHO VELHO,1460,914,472,1750,26,1278,65
RS,86711,GAURAMA,5336,3236,780,5325,120,4545,139
RS,86720,GARRUCHOS,1946,1348,899,2715,69,1816,100
RS,86738,GENERAL CAMARA,5848,4732,1365,7077,166,5712,256
RS,86746,GENTIL,1288,1242,269,1634,43,1365,57
RS,86754,SAO VICENTE DO SUL,4496,5254,1340,6603,140,5263,248
RS,86762,GRAMADO DOS LOUREIROS,1708,1272,648,2235,27,1587,70
RS,86770,GETULIO VARGAS,7928,11662,1820,12142,180,10322,347
RS,86789,GRAMADO XAVIER,2126,2208,509,2872,59,2363,137
RS,86797,GIRUA,10476,10390,3140,14189,206,11049,410
RS,86800,HULHA NEGRA,3854,2622,750,4166,60,3416,118
RS,86819,GRAMADO,14338,21490,2427,21730,551,19303,838
RS,86827,INHACORA,1224,1426,668,2110,30,1442,87
RS,86835,GRAVATAI,129960,107254,14783,140805,2582,126022,4833
RS,86843,ITAPUCA,1190,1262,465,1827,64,1362,72
RS,86851,GUAIBA,53954,48244,7101,61245,1127,54144,1918
RS,86860,LAJEADO DO BUGRE,1732,990,506,1979,39,1473,73
RS,86878,GUAPORE,13760,10158,1872,14701,379,12829,491
RS,86886,LAGOA DOS TRES CANTOS,984,1318,171,1378,23,1207,33
RS,86894,GUARANI DAS MISSOES,7504,3240,1460,7139,109,5679,198
RS,86908,LINDOLFO COLLOR,3582,1938,349,3251,47,2902,95
RS,86916,HORIZONTINA,14244,8372,2243,13998,147,11755,300
RS,86924,LINHA NOVA,818,1166,163,1269,53,1106,61
RS,86932,CHARQUEADAS,18784,13652,2014,19033,278,17019,523
RS,86940,MANOEL VIANA,3934,3870,1223,5407,83,4184,199
RS,86959,HUMAITA,4244,2560,871,4502,91,3631,138
RS,86967,MAQUINE,4096,4344,1055,5629,112,4574,242
RS,86975,IBIACA,2658,3756,610,4040,109,3430,114
RS,86983,MARATA,1424,2242,263,2209,36,1946,77
RS,86991,IBIRAIARAS,4070,4940,723,5480,91,4757,161
RS,87009,MARIANA PIMENTEL,1602,3254,517,3120,39,2603,136
RS,87017,IBIRUBA,12500,10776,2120,14300,206,12180,336
RS,87025,MATO CASTELHANO,1622,1980,357,2325,64,1968,103
RS,87033,IGREJINHA,18240,13498,2050,19038,446,16988,673
RS,87041,MATO LEITAO,3310,1624,323,2962,69,2639,103
RS,87050,IJUI,57354,30094,9019,54632,642,45613,1247
RS,87068,MINAS DO LEAO,5396,3898,1176,6176,145,5000,208
RS,87076,ILOPOLIS,2132,2578,468,3036,91,2568,122
RS,87084,MONTE BELO DO SUL,2214,2444,324,2803,67,2479,83
RS,87092,INDEPENDENCIA,4858,3768,1013,5557,77,4544,154
RS,87106,MORMACO,1464,1810,381,2148,42,1767,88
RS,87114,IRAI,5706,4464,1534,6969,115,5435,235
RS,87122,MORRINHOS DO SUL,2046,2598,507,2979,72,2472,78
RS,87130,ITAQUI,25324,14272,5144,25908,281,20764,685
RS,87149,MORRO REUTER,2950,3898,341,4025,112,3684,148
RS,87157,ITATIBA DO SUL,3740,2682,696,4094,32,3398,155
RS,87165,MULITERNO,1188,1050,217,1427,41,1210,50
RS,87173,IVOTI,10270,9260,995,11340,210,10345,370
RS,87181,NICOLAU VERGUEIRO,1036,1588,333,1739,31,1406,63
RS,87190,JACUTINGA,2424,2220,323,2776,42,2453,89
RS,87203,NOVA BOA VISTA,1766,1354,164,1808,47,1644,37
RS,87211,JAGUARAO,19648,13416,3383,20994,376,17611,703
RS,87220,NOVA PADUA,1250,2362,210,2157,52,1947,89
RS,87238,JAGUARI,8240,6978,1828,10149,336,8321,376
RS,87246,NOVA SANTA RITA,9806,7090,1321,10297,202,8976,326
RS,87254,JULIO DE CASTILHOS,10832,11414,2859,14842,282,11983,578
RS,87262,NOVO BARREIRO,2916,2328,376,3102,14,2726,90
RS,87270,LAGOA VERMELHA,14220,15008,3589,19386,434,15797,749
RS,87289,NOVO MACHADO,2718,3468,823,4075,53,3252,106
RS,87297,LAJEADO,43132,30994,5453,44840,857,39387,1467
RS,87300,NOVO TIRADENTES,1614,992,475,1874,25,1399,71
RS,87319,LAVRAS DO SUL,4600,5246,1443,6819,140,5376,313
RS,87327,PARECI NOVO,1506,2518,269,2374,38,2105,55
RS,87335,LIBERATO SALZANO,4056,3258,1371,5310,82,3939,200
RS,87343,PASSO DO SOBRADO,4748,2482,482,4387,124,3905,166
RS,87351,MACHADINHO,3326,3430,971,4618,59,3647,210
RS,87360,PICADA CAFE,2658,3344,316,3496,70,3180,109
RS,87378,MARAU,18784,15006,2648,20591,401,17943,647
RS,87386,PINHAL GRANDE,3110,2296,583,3491,72,2908,133
RS,87394,MARCELINO RAMOS,4316,2910,866,4682,62,3816,141
RS,87408,PINHEIRINHO DO VALE,2290,2444,625,3168,59,2543,117
RS,87416,MARIANO MORO,2008,1218,176,1904,54,1728,61
RS,87424,PONTAO,3172,2216,409,3199,27,2790,69
RS,87432,MATA,2802,3552,935,4498,174,3563,212
RS,87440,PONTE PRETA,1584,1338,245,1785,26,1540,53
RS,87459,MAXIMILIANO DE ALMEIDA,3766,2736,921,4442,86,3521,184
RS,87467,PORTO MAUA,2076,1422,448,2298,32,1850,69
RS,87475,MIRAGUAI,3120,2642,1279,4375,56,3096,159
RS,87483,PORTO VERA CRUZ,1548,1454,491,2076,15,1585,69
RS,87491,MONTENEGRO,33516,28152,4531,37350,691,32819,1294
RS,87505,PRESIDENTE LUCENA,1444,1652,171,1799,25,1628,55
RS,87513,MOSTARDAS,4376,7706,1223,7823,206,6600,353
RS,87521,QUEVEDOS,1052,2012,380,2061,51,1681,98
RS,87530,MUCUM,3092,3514,653,4217,114,3564,147
RS,87548,RIO DOS INDIOS,2744,2134,1086,3781,76,2695,180
RS,87556,NAO ME TOQUE,10130,8174,1296,10957,188,9661,321
RS,87564,SAGRADA FAMILIA,1982,1082,762,2414,48,1652,72
RS,87572,NONOAI,6866,5626,2477,9338,189,6861,426
RS,87580,SALVADOR DAS MISSOES,2386,1308,366,2296,45,1930,38
RS,87599,NOVA ARACA,2246,2224,299,2694,76,2395,84
RS,87602,SANTA CLARA DO SUL,3848,3214,431,4207,100,3776,145
RS,87610,NOVA BASSANO,5206,4702,783,6098,151,5315,210
RS,87629,SANTA TEREZA,1818,1058,262,1811,40,1549,71
RS,87637,NOVA BRESCIA,1586,2572,473,2710,52,2237,106
RS,87645,SANTO ANTONIO DO PALMA,1724,1354,258,1890,27,1632,66
RS,87653,NOVA PALMA,4758,3392,646,4934,56,4288,157
RS,87661,SANTO ANTONIO DO PLANALTO,1704,1494,337,1992,16,1655,40
RS,87670,NOVA PETROPOLIS,8270,13970,1460,13409,321,11949,508
RS,87688,SANTO EXPEDITO DO SUL,1544,2030,417,2303,36,1886,63
RS,87696,NOVA PRATA,11220,10824,1933,13735,307,11802,473
RS,87700,SAO JOAO DO POLESINE,2124,1646,416,2401,27,1985,73
RS,87718,NOVO HAMBURGO,152746,109756,16714,154641,2373,137927,4303
RS,87726,SAO JOSE DOS AUSENTES,1056,2392,621,2505,42,1884,118
RS,87734,OSORIO,23562,21354,3787,27606,573,23819,788
RS,87742,SAO JOSE DO INHACORA,1986,1270,242,1950,26,1708,54
RS,87750,PAIM FILHO,3236,2478,611,3617,35,3006,114
RS,87769,SAO JOSE DAS MISSOES,2506,1520,816,2994,58,2178,107
RS,87777,PALMEIRA DAS MISSOES,18120,16404,4734,23104,332,18370,776
RS,87785,SAO MARTINHO DA SERRA,1724,2688,620,2983,64,2363,93
RS,87793,PALMITINHO,4444,3860,1006,5418,54,4412,206
RS,87807,SAO PEDRO DA SERRA,1736,2226,198,2305,60,2107,66
RS,87815,PANAMBI,23004,15074,3520,23634,436,20114,639
RS,87823,SAO PEDRO DO BUTIA,2502,1356,438,2503,44,2065,92
RS,87831,PARAI,3470,3682,461,4463,247,4002,179
RS,87840,SAO VALENTIM DO SUL,1848,1418,306,2060,55,1754,66
RS,87858,PASSO FUNDO,122062,68038,14993,114255,1485,99262,2727
RS,87866,SAO VALERIO DO SUL,1610,964,421,1792,12,1371,72
RS,87874,PEDRO OSORIO,6338,3420,1377,6652,181,5275,215
RS,87882,SENTINELA DO SUL,2452,3654,753,4095,103,3342,186
RS,87890,PEJUCARA,2966,2462,625,3474,54,2849,81
RS,87904,SERIO,1820,1738,292,2262,90,1970,101
RS,87912,PELOTAS,188860,172932,31568,226295,5036,194727,8795
RS,87920,SERTAO SANTANA,2044,4062,548,3854,86,3306,167
RS,87939,PINHEIRO MACHADO,8590,7084,1796,10399,341,8603,425
RS,87947,SINIMBU,8274,3628,1223,7828,259,6605,395
RS,87955,PIRATINI,9292,12264,2908,15162,707,12254,769
RS,87963,TIRADENTES DO SUL,5036,3690,1324,5971,69,4647,215
RS,87971,PLANALTO,6418,5630,1997,8436,152,6439,263
RS,87980,TRAVESSEIRO,1710,1784,303,2133,19,1830,64
RS,87998,PORTAO,16010,12680,2100,17443,364,15343,634
RS,88005,TRES FORQUILHAS,1708,2596,617,2932,60,2315,103
RS,88013,PORTO ALEGRE,932028,725466,124740,992387,14285,867647,24615
RS,88021,TUPANCI DO SUL,1070,1186,446,1671,45,1225,52
RS,88030,PORTO LUCENA,4008,3554,921,4914,74,3993,138
RS,88048,UNIAO DA SERRA,1444,1144,315,1715,49,1400,57
RS,88056,PORTO XAVIER,5586,6496,2205,8657,124,6452,287
RS,88064,VALE DO SOL,8638,3794,851,7739,307,6888,365
RS,88072,PUTINGA,2826,2928,1122,4275,92,3153,184
RS,88080,VALE REAL,2320,3110,313,3262,96,2949,138
RS,88099,QUARAI,17286,9540,3134,17451,293,14317,611
RS,88102,VILA NOVA DO SUL,2634,2666,916,3848,121,2932,161
RS,88110,REDENTORA,3886,3974,1373,5595,69,4222,223
RS,88129,VITORIA DAS MISSOES,3604,1594,865,3608,48,2743,96
RS,88137,RESTINGA SECA,10382,9026,2063,12433,213,10370,453
RS,88145,XANGRI-LA,4818,6156,1469,7259,109,5790,194
RS,88153,RIO GRANDE,134924,73668,17585,128453,2314,110868,4258
RS,88161,BOA VISTA DO SUL,1864,2048,276,2400,70,2124,98
RS,88170,RIO PARDO,29362,15060,4413,28191,550,23778,1017
RS,88188,DILERMANDO DE AGUIAR,1770,2258,561,2723,48,2162,100
RS,88196,ROCA SALES,6596,5028,1078,7405,268,6327,247
RS,88200,CAPIVARI DO SUL,1612,2172,332,2311,19,1979,68
RS,88218,RODEIO BONITO,3856,2962,906,4519,51,3613,153
RS,88226,NOVA CANDELARIA,2258,1648,336,2367,38,2031,40
RS,88234,ROLANTE,9936,9920,1372,12078,262,10706,516
RS,88242,FLORIANO PEIXOTO,1912,1410,440,2174,21,1734,52
RS,88250,RONDA ALTA,6640,5140,1299,7485,88,6186,208
RS,88269,CHUVISCA,2176,4254,498,3999,128,3501,158
RS,88277,RONDINHA,4360,3738,920,5139,58,4219,112
RS,88285,ESPERANCA DO SUL,2524,2096,706,3142,19,2436,107
RS,88293,ROQUE GONZALES,4916,4236,1628,6539,129,4911,206
RS,88307,DOUTOR RICARDO,1394,1366,318,1826,57,1508,71
RS,88315,ROSARIO DO SUL,23358,22310,6800,31413,573,24613,1206
RS,88323,HERVEIRAS,2740,780,479,2412,61,1933,112
RS,88331,SALVADOR DO SUL,3330,4654,449,4675,102,4226,132
RS,88340,CARAA,2892,5138,1172,5630,162,4458,281
RS,88358,SANANDUVA,6450,12372,1621,11568,214,9947,322
RS,88366,FAZENDA VILANOVA,1878,1654,331,2297,77,1966,123
RS,88374,SANTA BARBARA DO SUL,5918,5594,1379,7384,106,6005,143
RS,88382,ITAARA,2492,3078,619,3611,77,2992,130
RS,88390,SANTA CRUZ DO SUL,94884,37010,8934,79392,2029,70458,2482
RS,88404,ESTRELA VELHA,2276,2218,399,2806,53,2407,107
RS,88412,SANTA MARIA,154036,121668,25102,171402,3614,146300,4834
RS,88420,BENJAMIN CONSTANT DO SUL,1730,966,395,1854,31,1459,80
RS,88439,SANTANA DA BOA VISTA,3624,6090,1835,7550,437,5715,421
RS,88447,MACAMBARA,2256,2328,789,3233,33,2444,119
RS,88455,SANTANA DO LIVRAMENTO,62474,40234,11757,66087,937,54330,2039
RS,88463,DOM PEDRO DE ALCANTARA,2440,1782,357,2596,45,2239,83
RS,88471,SANTA ROSA,42330,28654,7641,44742,528,37101,1081
RS,88480,UNISTALDA,1428,2118,695,2605,57,1910,80
RS,88498,SANTA VITORIA DO PALMAR,23752,11706,3816,22845,479,19029,821
RS,88501,TURUCU,1676,3388,329,3044,70,2715,113
RS,88510,SANTIAGO,29948,25586,6659,36476,981,29817,1069
RS,88528,CRISTAL DO SUL,2116,1536,468,2403,26,1935,83
RS,88536,SANTO ANGELO,57832,27674,11358,56295,808,44937,1376
RS,88544,MUITOS CAPOES,914,2326,462,2245,63,1783,100
RS,88552,SANTO ANTONIO DA PATRULHA,16370,26032,4026,27428,840,23402,1361
RS,88560,NOVA RAMADA,2058,1568,356,2261,31,1905,61
RS,88579,SANTO ANTONIO DAS MISSOES,7588,4924,2849,9644,240,6795,299
RS,88587,JARI,1466,2596,441,2723,114,2282,137
RS,88595,SANTO AUGUSTO,9992,6302,2880,11509,129,8629,353
RS,88609,UBIRETAMA,1462,2006,327,2137,30,1810,46
RS,88617,SANTO CRISTO,11114,9332,1574,12150,122,10576,231
RS,88625,BARRA DO QUARAI,2704,1390,548,2693,23,2145,75
RS,88633,SAO BORJA,44546,23066,10593,46075,590,35482,1086
RS,88641,CERRITO,4110,4348,1063,5743,224,4680,227
RS,88650,SAO FRANCISCO DE ASSIS,10492,12218,3724,16099,507,12375,513
RS,88668,VALE VERDE,2040,1626,335,2351,78,2016,105
RS,88676,SAO FRANCISCO DE PAULA,9690,13168,2779,15211,371,12432,632
RS,88684,NOVO CABRAIS,2772,2334,332,3076,87,2744,104
RS,88692,SAO GABRIEL,36424,26710,8551,42449,978,33898,1353
RS,88706,SETE DE SETEMBRO,1832,1326,343,1998,23,1655,53
RS,88714,SAO JERONIMO,11478,12036,2454,15046,288,12592,547
RS,88722,TABAI,1932,2892,564,3171,81,2607,114
RS,88730,SAO JOSE DO NORTE,11150,18058,2524,18268,358,15744,782
RS,88749,VILA LANGARO,1812,1580,226,2030,34,1804,74
RS,88757,SAO JOSE DO OURO,3864,4946,943,5662,143,4719,171
RS,88765,SENADOR SALGADO FILHO,1436,2428,390,2444,29,2054,93
RS,88773,SAO LEOPOLDO,144892,76182,15657,131736,1985,116079,3557
RS,88781,VESPASIANO CORREA,1158,2214,347,2170,68,1823,69
RS,88790,SAO LOURENCO DO SUL,26386,26370,4771,32810,632,28039,1029
RS,88803,MONTE ALEGRE DOS CAMPOS,1526,2626,850,3146,100,2296,120
RS,88811,SAO LUIS GONZAGA,23172,14628,6579,26899,523,20320,897
RS,88820,MARQUES DE SOUZA,3248,2604,557,3699,92,3142,124
RS,88838,SAO MARCOS,9972,12220,1891,14203,491,12312,725
RS,88846,CHUI,3524,1118,688,3143,47,2455,87
RS,88854,SAO MARTINHO,4518,3004,757,4763,83,4006,162
RS,88862,ARARICA,2912,1900,374,2944,70,2570,94
RS,88870,SAO NICOLAU,3586,2902,1707,5201,72,3494,178
RS,88889,PASSA SETE,3198,2586,634,3784,80,3150,178
RS,88897,SAO PAULO DAS MISSOES,5200,3180,1137,5557,79,4420,151
RS,88900,TOROPI,1610,2584,422,2701,91,2279,91
RS,88919,SAO PEDRO DO SUL,9698,11020,2764,14027,450,11263,454
RS,88927,BALNEARIO PINHAL,3796,3994,1572,5730,65,4158,198
RS,88935,SAO SEBASTIAO DO CAI,14642,12246,1830,16095,270,14265,551
RS,88943,MAMPITUBA,2008,1922,621,2747,41,2126,120
RS,88951,SAO SEPE,14692,13040,3617,18669,531,15052,655
RS,88978,SAO VALENTIM,3048,2562,649,3636,47,2987,135
RS,88986,ACEGUA,1988,3138,671,3397,49,2726,114
RS,88994,SAPIRANGA,48468,31514,5326,47518,821,42192,1380
RS,89001,ALMIRANTE TAMANDARE DO SUL,1634,1336,252,1810,14,1558,59
RS,89010,SAPUCAIA DO SUL,107430,44586,9441,88923,1243,79482,2231
RS,89028,ARROIO DO PADRE,624,3132,244,2207,35,1963,50
RS,89036,SARANDI,12142,9736,2737,14370,271,11633,423
RS,89044,BOA VISTA DO CADEADO,1132,1366,446,1771,40,1325,36
RS,89052,SEBERI,6858,6264,1938,9076,205,7138,372
RS,89060,BOA VISTA DO INCRA,1476,1464,313,1839,23,1526,33
RS,89079,SELBACH,3042,3098,511,3756,64,3245,111
RS,89087,BOZANO,1736,1450,259,1919,17,1660,50
RS,89095,SERAFINA CORREA,7868,5670,1027,8342,265,7315,281
RS,89109,CANUDOS DO VALE,1396,1252,274,1712,37,1438,77
RS,89117,SERTAO,4122,4932,976,5781,89,4805,189
RS,89125,CAPAO BONITO DO SUL,1108,1672,461,1966,33,1505,82
RS,89133,SEVERIANO DE ALMEIDA,3298,2130,401,3279,59,2878,105
RS,89141,CAPAO DO CIPO,1358,1550,403,1965,44,1562,64
RS,89150,CAPAO DA CANOA,15098,18606,3615,21604,383,17989,754
RS,89168,COQUEIRO BAIXO,666,1350,488,1585,27,1097,62
RS,89176,SOBRADINHO,7080,8806,1685,10177,180,8492,369
RS,89184,CORONEL PILAR,1032,1484,229,1601,56,1372,58
RS,89192,SOLEDADE,17112,14154,3939,20832,424,16893,836
RS,89206,CRUZALTENSE,1826,1372,359,2062,38,1703,66
RS,89214,TAPEJARA,8660,8970,1084,10432,209,9348,324
RS,89222,FORQUETINHA,1618,1846,281,2198,83,1917,102
RS,89230,TAPERA,7052,5108,1080,7538,139,6458,239
RS,89247,SANTA CECILIA DO SUL,1166,1008,152,1302,26,1150,37
RS,89249,ITATI,1366,2468,721,2815,69,2094,108
RS,89257,TAPES,9726,9244,2206,12316,206,10110,419
RS,89265,JACUIZINHO,1476,1294,395,1889,38,1494,71
RS,89273,TAQUARA,25916,31738,4661,35314,619,30653,1207
RS,89281,LAGOA BONITA DO SUL,2054,1448,288,2151,38,1863,74
RS,89290,TAQUARI,16548,13944,2432,18759,418,16327,663
RS,89303,MATO QUEIMADO,1784,872,343,1761,31,1418,59
RS,89311,TENENTE PORTELA,7896,7506,2214,10384,93,8170,376
RS,89320,NOVO XINGU,1392,994,380,1628,11,1248,44
RS,89338,TORRES,18282,15342,3358,21387,403,18029,814
RS,89346,PAULO BENTO,1868,1058,217,1780,45,1563,55
RS,89354,TRAMANDAI,18138,16420,4359,22690,333,18331,719
RS,89362,PINHAL DA SERRA,1208,1304,498,1897,72,1399,71
RS,89370,TRES COROAS,12314,10672,1432,13857,355,12425,577
RS,89389,QUATRO IRMAOS,1438,914,215,1447,15,1232,41
RS,89397,TRES DE MAIO,15420,13538,3648,18824,233,15176,464
RS,89400,ROLADOR,1946,1488,643,2520,85,1877,75
RS,89419,TRES PASSOS,17192,12006,3684,19057,235,15373,539
RS,89435,TRIUNFO,13052,16068,3137,19028,491,15891,840
RS,89443,SANTA MARGARIDA DO SUL,1920,2068,591,2774,68,2183,121
RS,89451,TUCUNDUVA,4326,3790,886,5171,74,4285,153
RS,89460,SAO JOSE DO SUL,1354,1400,166,1660,47,1494,70
RS,89478,TUPANCIRETA,12010,11294,2752,15342,334,12590,604
RS,89486,SAO PEDRO DAS MISSOES,1318,1104,341,1643,26,1302,65
RS,89494,TUPARENDI,7578,4312,1237,7555,157,6318,216
RS,89508,TIO HUGO,1676,1178,203,1739,31,1536,78
RS,89516,URUGUAIANA,67434,63756,13462,82100,889,68638,2154
RS,89524,WESTFALIA,2038,1564,212,2125,55,1913,57
RS,89532,VACARIA,26980,33688,6456,39300,1052,32844,1458
RS,89540,PINTO BANDEIRA,1706,1578,224,1999,57,1775,76
RS,89559,VENANCIO AIRES,52748,21252,5048,45084,1343,40036,1693
RS,89567,PEDRAS ALTAS,1262,1428,484,1914,13,1430,72
RS,89575,VERA CRUZ,18960,6636,1535,15335,452,13800,550
RS,89591,VERANOPOLIS,11686,12866,1763,15219,561,13456,619
RS,89613,VIADUTOS,4700,2720,748,4698,94,3950,146
RS,89630,VIAMAO,122502,100990,15143,134281,2367,119138,5025
RS,89656,VICENTE DUTRA,3310,2884,1042,4400,79,3358,182
RS,89672,PALMARES DO SUL,6536,7102,1743,8962,112,7219,288
RS,89699,VICTOR GRAEFF,2176,2142,365,2617,43,2252,50
RS,89710,TAVARES,2294,4436,664,4320,113,3656,178
RS,89737,CAPAO DO LEAO,15452,10066,2428,16168,367,13740,614
RS,89753,SALTO DO JACUI,7432,5120,1386,8075,110,6689,303
RS,89770,COTIPORA,2692,2676,428,3421,160,2993,149
RS,98213,TEUTONIA,16198,11734,1740,16618,363,14878,549
RS,98230,BOM PRINCIPIO,5106,6744,562,6838,165,6276,186
RS,98256,PAROBE,32224,16364,3364,29058,444,25694,956
RS,98272,FORTALEZA DOS VALOS,3654,2314,566,3668,54,3102,64
RS,98299,JOIA,4402,4220,1070,5675,84,4605,210
SC,80004,MONTE CARLO,5576,3482,1411,6406,79,4995,387
SC,80012,ABELARDO LUZ,10612,4534,2759,11175,187,8416,656
SC,80020,IPORA DO OESTE,6722,2252,1131,5932,89,4801,225
SC,80039,AGROLANDIA,4524,4200,737,5531,124,4794,308
SC,80047,LINDOIA DO SUL,4928,1022,580,3768,45,3188,168
SC,80055,AGRONOMICA,2604,2294,202,2827,44,2625,132
SC,80063,APIUNA,5864,3570,1169,6428,134,5259,408
SC,80071,AGUA DOCE,4572,2848,831,4852,62,4021,249
SC,80080,DOUTOR PEDRINHO,2210,1794,331,2506,40,2175,133
SC,80098,AGUAS DE CHAPECO,5018,1486,994,4583,98,3589,239
SC,80101,JOSE BOITEUX,2620,2416,539,3254,50,2715,147
SC,80110,AGUAS MORNAS,2650,4380,268,4165,114,3897,268
SC,80128,VITOR MEIRELES,3774,2254,838,4090,63,3252,175
SC,80136,ALFREDO WAGNER,3450,6804,1260,6817,100,5557,330
SC,80144,UNIAO DO OESTE,2784,1214,562,2763,61,2201,141
SC,80152,ANCHIETA,5778,2080,1571,5813,66,4242,247
SC,80160,URUPEMA,1572,1450,201,1890,52,1689,126
SC,80179,ANGELINA,3936,3758,363,4515,85,4152,220
SC,80187,IRACEMINHA,3904,1770,760,3836,87,3076,152
SC,80195,ANITA GARIBALDI,4408,5110,2153,7472,143,5319,417
SC,80209,TIMBO GRANDE,2462,3222,1031,4238,63,3207,302
SC,80217,ANITAPOLIS,1984,1946,337,2490,66,2153,122
SC,80225,ABDON BATISTA,1934,1574,266,2159,39,1893,100
SC,80233,ANTONIO CARLOS,4126,4142,230,4707,104,4477,239
SC,80241,SANTA ROSA DO SUL,6012,3098,915,5900,130,4985,300
SC,80250,ARAQUARI,9324,5358,1949,10034,135,8085,609
SC,80268,CELSO RAMOS,1780,1168,278,1941,73,1663,116
SC,80276,ARARANGUA,39574,19424,6257,38141,613,31884,1772
SC,80284,SERRA ALTA,3004,738,476,2491,43,2015,101
SC,80292,ARMAZEM,4536,3386,814,5172,89,4358,308
SC,80306,COCAL DO SUL,12810,2922,1361,9868,144,8507,497
SC,80314,ARROIO TRINTA,3220,1232,385,2788,44,2403,133
SC,80322,NOVA ITABERABA,4132,1262,675,3567,33,2892,162
SC,80330,ASCURRA,5256,2840,787,5308,132,4521,341
SC,80349,SANTA TEREZINHA,6378,2718,893,5793,101,4900,251
SC,80357,ATALANTA,2894,1862,321,2918,68,2597,151
SC,80365,MIRIM DOCE,2006,1322,238,2013,16,1775,95
SC,80373,AURORA,4064,2534,566,4130,56,3564,209
SC,80381,CERRO NEGRO,2136,1954,993,3274,55,2281,181
SC,80403,PASSO DE TORRES,3152,2378,563,3558,59,2995,171
SC,80411,BARRA VELHA,7102,7566,2488,10634,178,8146,634
SC,80420,BRACO DO TROMBUDO,1618,2568,367,2616,25,2249,131
SC,80438,BENEDITO NOVO,6144,5384,749,7038,121,6289,404
SC,80446,SUL BRASIL,2866,754,452,2388,30,1936,96
SC,80454,BIGUACU,25116,20790,3633,28892,578,25259,1728
SC,80462,VARGEM,1818,1888,735,2760,48,2025,124
SC,80470,BLUMENAU,156704,139388,22784,184132,3002,161348,10300
SC,80489,ARABUTA,4170,1348,337,3261,49,2924,116
SC,80497,BOM RETIRO,3794,4970,1290,6191,109,4901,410
SC,80500,AGUAS FRIAS,2620,746,373,2180,30,1807,94
SC,80519,BOTUVERA,3894,1082,155,2876,70,2721,163
SC,80527,GUATAMBU,4338,1458,562,3774,53,3212,261
SC,80535,BRACO DO NORTE,17004,11394,1914,17341,304,15427,924
SC,80543,PLANALTO ALEGRE,2552,662,169,1881,31,1712,74
SC,80551,BRUSQUE,62470,29842,5640,54864,729,49224,2339
SC,80560,RIQUEZA,4456,1182,819,3978,56,3159,284
SC,80578,CACADOR,48894,16796,7478,43463,634,35985,2506
SC,80594,CAIBI,5752,1870,958,5050,84,4092,197
SC,80608,RIO RUFINO,1490,1360,350,1913,30,1563,108
SC,80616,CAMBORIU,21736,14574,4362,24509,483,20147,1509
SC,80624,PASSOS MAIA,2866,1418,585,2902,19,2317,156
SC,80632,CAMPO ALEGRE,5894,7208,1074,8209,120,7135,464
SC,80640,SAO JOAO DO OESTE,6204,1412,799,4793,44,3994,142
SC,80659,CAMPO BELO DO SUL,4220,3902,1761,6358,96,4597,440
SC,80667,CALMON,1958,1144,435,2244,102,1809,156
SC,80675,CAMPO ERE,6574,3190,2498,7920,93,5422,447
SC,80683,BALNEARIO DE BARRA DO SUL,3780,2890,988,4607,53,3619,231
SC,80691,CAMPOS NOVOS,18646,12282,4160,21056,364,16896,1068
SC,80705,PARAISO,3694,1670,789,3678,59,2889,148
SC,80713,CANELINHA,5862,3988,989,6477,143,5488,420
SC,80721,SANTA HELENA,2352,686,243,1887,51,1644,74
SC,80730,CANOINHAS,34310,21504,6241,36334,459,30093,1727
SC,80748,BELMONTE,2468,634,253,1941,23,1688,114
SC,80756,CAPINZAL,15922,5986,2083,13991,258,11908,696
SC,80764,NOVO HORIZONTE,2282,1364,446,2439,48,1993,122
SC,80772,CATANDUVAS,5580,3322,808,5623,88,4815,276
SC,80780,SAO MIGUEL DA BOA VISTA,1674,568,238,1449,25,1211,65
SC,80799,CAXAMBU DO SUL,5126,1576,761,4418,85,3657,221
SC,80802,ARVOREDO,2404,692,174,1835,26,1661,87
SC,80810,CHAPECO,89958,57092,15139,94702,1365,79563,4673
SC,80829,IPUACU,3828,1374,677,3533,44,2856,211
SC,80837,CONCORDIA,53120,19678,7045,46136,642,39091,2050
SC,80845,OURO VERDE,1882,1078,362,1950,27,1588,81
SC,80853,CORONEL FREITAS,7752,4350,1056,7647,139,6591,401
SC,80861,IRATI,1636,980,511,1917,24,1406,74
SC,80870,CORUPA,9758,5404,1187,9449,131,8262,550
SC,80888,FORMOSA DO SUL,2412,662,389,2098,61,1709,111
SC,80896,CRICIUMA,143876,44744,16516,118611,1876,102095,5909
SC,80900,MACIEIRA,1602,626,192,1410,25,1218,79
SC,80918,CUNHA PORA,7052,5462,1473,8266,170,6793,366
SC,80926,PONTE ALTA DO NORTE,1978,992,373,2022,25,1649,139
SC,80934,CURITIBANOS,23194,15210,5798,27020,384,21222,1636
SC,80942,SAO CRISTOVAO DO SUL,2762,1304,669,2924,40,2255,182
SC,80950,DESCANSO,8122,2676,1593,7441,113,5848,336
SC,80969,VARGEM BONITA,3718,1526,331,3212,53,2881,206
SC,80977,DIONISIO CERQUEIRA,8048,5790,3965,11638,133,7673,621
SC,80985,BOMBINHAS,4514,5046,1308,6578,111,5270,379
SC,80993,DONA EMMA,2372,1570,511,2641,36,2130,123
SC,81000,SANGAO,4282,3428,751,5082,140,4331,336
SC,81019,ERVAL VELHO,2784,2422,308,3159,42,2851,206
SC,81027,CAPIVARI DE BAIXO,18274,3734,1996,13909,137,11913,772
SC,81035,FAXINAL DOS GUEDES,7584,3118,1183,6992,84,5809,374
SC,81043,CORDILHEIRA ALTA,2970,978,125,2215,32,2090,84
SC,81051,FLORIANOPOLIS,270408,142514,34663,256004,3540,221341,11340
SC,81060,FORQUILHINHA,16926,4172,1364,12786,214,11422,659
SC,81078,FRAIBURGO,26290,6864,4631,22822,323,18191,1291
SC,81086,MORRO GRANDE,2442,1380,110,2159,38,2049,100
SC,81094,GALVAO,3226,1148,720,3142,68,2422,167
SC,81108,CORONEL MARTINS,1746,1138,419,1982,21,1563,100
SC,81116,GOVERNADOR CELSO RAMOS,5866,8248,1651,9330,163,7679,459
SC,81124,SAO JOAO DO ITAPERIU,1996,1876,541,2653,32,2112,144
SC,81132,GAROPABA,8044,7398,1738,10191,200,8453,532
SC,81140,JARDINOPOLIS,1910,558,310,1659,33,1349,82
SC,81159,GARUVA,6678,5244,1622,8118,90,6496,445
SC,81167,ERMO,2926,916,280,2392,64,2112,127
SC,81175,GASPAR,27182,22782,3822,31256,567,27434,1885
SC,81183,SAO PEDRO DE ALCANTARA,2878,2658,359,3369,53,3010,189
SC,81191,GRAO PARA,4468,3446,413,4785,124,4372,291
SC,81205,SANTIAGO DO SUL,1460,534,341,1391,13,1050,40
SC,81213,GRAVATAL,6348,4202,581,6337,101,5756,380
SC,81221,BELA VISTA DO TOLDO,3818,2588,608,4084,74,3476,199
SC,81230,GUABIRUBA,10922,4538,750,9127,169,8377,478
SC,81248,CAPAO ALTO,1930,1952,626,2783,38,2157,178
SC,81256,GUARACIABA,8548,3834,892,7590,159,6698,348
SC,81264,PAINEL,1784,1670,446,2330,40,1884,117
SC,81272,GUARAMIRIM,19112,8492,2242,17129,206,14887,879
SC,81280,BOCAINA DO SUL,1974,2062,523,2811,64,2288,206
SC,81299,GUARUJA DO SUL,3452,1870,827,3699,63,2872,148
SC,81302,ALTO BELA VISTA,2454,472,247,1793,15,1546,68
SC,81310,HERVAL DO OESTE,14936,6502,2206,13858,173,11652,760
SC,81329,FREI ROGERIO,2070,1072,371,2077,18,1706,117
SC,81337,IBICARE,3392,1252,271,2761,54,2490,114
SC,81345,TREVISO,3562,1074,282,2750,36,2468,114
SC,81353,IBIRAMA,9724,8050,1860,11578,151,9718,680
SC,81361,IOMERE,2208,1318,284,2175,40,1891,88
SC,81370,ICARA,40846,11976,4424,33102,610,28678,1657
SC,81388,BOM JESUS,2346,458,348,1887,28,1539,109
SC,81396,ILHOTA,7120,5312,1324,8272,160,6948,572
SC,81400,IBIAM,1956,676,289,1693,23,1404,65
SC,81418,IMARUI,8358,6190,2015,10016,184,8001,543
SC,81426,ENTRE RIOS,1876,1030,483,2101,36,1618,129
SC,81434,IMBITUBA,30288,9232,4566,26266,361,21700,1579
SC,81442,PAIAL,1810,826,360,1761,22,1401,61
SC,81450,IMBUIA,3042,3550,504,4050,93,3546,157
SC,81469,BOM JESUS DO OESTE,1772,786,234,1624,54,1390,57
SC,81477,INDAIAL,25138,20962,3713,29074,560,25361,1751
SC,81485,SAO BERNARDINO,2366,790,452,2155,35,1703,90
SC,81493,IPIRA,4178,1364,542,3535,56,2993,166
SC,81507,SANTA TEREZINHA DO PROGRESSO,2462,1134,846,2799,34,1953,121
SC,81515,IPUMIRIM,5958,2772,676,5336,107,4660,188
SC,81523,SALTINHO,3390,872,785,3133,82,2348,135
SC,81531,IRANI,7004,2126,871,5813,100,4942,277
SC,81540,JUPIA,1916,700,332,1758,20,1426,98
SC,81558,IRINEOPOLIS,6730,3428,1261,6833,88,5572,405
SC,81566,PALMEIRA,1866,1424,442,2252,52,1810,113
SC,81574,ITA,5554,1526,976,4735,40,3759,179
SC,81582,BANDEIRANTE,3252,766,702,2862,15,2160,136
SC,81590,ITAIOPOLIS,12706,7876,2384,13679,241,11295,763
SC,81604,FLOR DO SERTAO,1564,362,364,1442,31,1078,84
SC,81612,ITAJAI,96726,60918,15507,101330,1654,85823,5347
SC,81620,CUNHATAI,1452,942,207,1501,53,1294,44
SC,81639,ITAPEMA,13980,13554,3238,18224,311,14986,908
SC,81647,PRINCESA,2214,814,394,2038,41,1644,89
SC,81655,ITAPIRANGA,13104,3624,1992,10782,104,8790,322
SC,81663,ITAPOA,5452,3682,1713,6698,74,4985,344
SC,81671,ITUPORANGA,13792,10124,2158,15222,233,13064,873
SC,81680,TIGRINHOS,1858,554,346,1654,29,1308,73
SC,81698,JABORA,3850,1728,479,3493,65,3014,160
SC,81701,CHAPADAO DO LAGEADO,2188,1450,271,2197,20,1926,87
SC,81710,JACINTO MACHADO,8222,4166,724,7586,227,6862,441
SC,81728,BALNEARIO ARROIO DO SILVA,4972,2102,1059,4893,52,3834,245
SC,81736,JAGUARUNA,9512,6952,1627,10593,198,8966,536
SC,81744,BALNEARIO GAIVOTA,4512,2166,796,4425,71,3629,219
SC,81752,JARAGUA DO SUL,90012,38126,8714,77326,967,68612,3576
SC,81760,BARRA BONITA,2148,772,483,2062,21,1579,98
SC,81779,JOACABA,17710,10628,2999,18157,224,15158,765
SC,81787,BRUNOPOLIS,2396,1134,560,2577,54,2017,198
SC,81795,JOINVILLE,320000,154640,35870,290439,3312,254569,13937
SC,81809,LUZERNA,4902,2386,574,4470,66,3896,186
SC,81817,LACERDOPOLIS,1868,890,122,1626,32,1504,93
SC,81825,ZORTEA,2564,676,282,2013,33,1731,78
SC,81833,LAGES,86054,71378,18864,104391,1709,85527,5102
SC,81850,LAGUNA,32974,19658,4129,32840,470,28711,1925
SC,81876,LAURENTINO,3530,2686,257,3650,91,3393,194
SC,81892,LAURO MULLER,12858,4136,1491,10671,155,9180,528
SC,81914,LEBON REGIS,7760,3224,1846,8054,134,6208,582
SC,81930,LEOBERTO LEAL,2470,2362,498,3093,43,2595,136
SC,81957,LONTRAS,5592,4228,1030,6452,131,5422,381
SC,81990,MAFRA,36236,21064,5433,36748,652,31315,2013
SC,82015,MAJOR GERCINO,2108,1732,269,2361,52,2092,120
SC,82031,MAJOR VIEIRA,6178,1908,862,5219,60,4357,254
SC,82058,MARAVILHA,15186,6592,3122,14912,268,11790,633
SC,82066,MAREMA,2430,718,370,2089,41,1719,104
SC,82074,MASSARANDUBA,10290,5836,1165,9862,147,8697,487
SC,82090,MATOS COSTA,1930,1198,598,2355,43,1757,150
SC,82112,MELEIRO,5474,2816,428,4956,100,4528,283
SC,82139,MODELO,3574,1078,454,2950,55,2496,115
SC,82155,MONDAI,7372,2840,1271,6825,95,5554,353
SC,82171,MONTE CASTELO,5196,3424,1631,6431,122,4800,368
SC,82198,MORRO DA FUMACA,12414,4332,1247,10446,213,9199,613
SC,82210,NAVEGANTES,22564,16000,4697,25727,344,21030,1404
SC,82236,NOVA ERECHIM,3152,1326,333,2706,36,2373,98
SC,82252,NOVA TRENTO,7316,4880,1058,7821,252,6763,413
SC,82279,NOVA VENEZA,10138,3580,716,8095,122,7379,398
SC,82295,ORLEANS,14010,9294,1960,14790,341,12830,837
SC,82317,OURO,5856,3202,659,5535,94,4876,253
SC,82333,PALHOCA,59950,38388,6751,60539,1023,53788,3596
SC,82350,PALMA SOLA,6116,1938,1710,6118,84,4408,297
SC,82376,PALMITOS,11952,6434,2445,12293,197,9848,458
SC,82392,PAPANDUVA,12904,5054,2396,12196,181,9800,640
SC,82414,PAULO LOPES,3462,3278,514,4234,72,3720,278
SC,82430,PEDRAS GRANDES,3960,1712,300,3396,75,3096,185
SC,82457,PENHA,7680,9058,2822,12066,208,9244,667
SC,82473,PERITIBA,3370,936,254,2535,37,2281,91
SC,82490,PETROLANDIA,4300,3822,627,5013,91,4386,234
SC,82511,PICARRAS,6672,5694,1846,8594,94,6748,471
SC,82538,PINHALZINHO,10174,4536,1428,9278,113,7850,382
SC,82554,PINHEIRO PRETO,2374,964,294,2096,24,1802,109
SC,82570,PIRATUBA,3984,1948,380,3558,70,3178,142
SC,82597,POMERODE,16466,11606,1833,17049,268,15216,912
SC,82619,PONTE ALTA,3340,2310,889,4043,62,3154,267
SC,82635,PONTE SERRADA,7624,3266,1787,7783,108,5996,443
SC,82651,PORTO BELO,5302,5272,1391,7246,111,5855,457
SC,82678,PORTO UNIAO,21578,11406,4683,22549,312,17866,1062
SC,82694,POUSO REDONDO,7432,5676,1660,8833,152,7173,467
SC,82716,PRAIA GRANDE,5930,2858,1015,5802,105,4787,288
SC,82732,PRESIDENTE CASTELO BRANCO,2112,512,156,1556,22,1400,66
SC,82759,PRESIDENTE GETULIO,9206,5474,1204,9154,174,7950,436
SC,82775,PRESIDENTE NEREU,1664,1302,164,1745,23,1581,75
SC,82791,QUILOMBO,8274,3588,1460,7935,194,6475,350
SC,82813,RANCHO QUEIMADO,1800,1654,182,2069,62,1887,98
SC,82830,RIO DAS ANTAS,5392,2350,704,4958,102,4254,281
SC,82856,RIO DO CAMPO,4316,3292,963,5145,111,4182,267
SC,82872,RIO DO OESTE,5226,3026,672,5130,70,4458,262
SC,82899,RIO DOS CEDROS,7636,4314,921,7341,95,6420,350
SC,82910,RIO DO SUL,29212,29902,5841,37904,573,32063,1933
SC,82937,RIO FORTUNA,3686,2356,178,3439,102,3261,138
SC,82953,RIO NEGRINHO,27172,13500,3575,25702,282,22127,1509
SC,82970,RODEIO,7706,5086,977,8074,176,7097,525
SC,82996,ROMELANDIA,4816,1782,1833,5447,113,3614,202
SC,83011,SALETE,4752,3484,983,5381,74,4398,206
SC,83038,SALTO VELOSO,3104,1472,413,2922,43,2509,178
SC,83054,SANTA CECILIA,9560,4884,2312,10451,175,8139,742
SC,83070,SANTA ROSA DE LIMA,1810,892,97,1555,56,1458,51
SC,83097,SANTO AMARO DA IMPERATRIZ,10208,9642,1150,11975,201,10825,699
SC,83119,SAO BENTO DO SUL,52404,24376,5051,46170,401,41119,2328
SC,83135,SAO BONIFACIO,1138,2900,254,2451,72,2197,106
SC,83151,SAO CARLOS,7540,3358,1281,7209,138,5928,341
SC,83178,SAO DOMINGOS,7344,3364,1475,7370,166,5895,375
SC,83194,SAO FRANCISCO DO SUL,21738,13816,4560,23928,257,19368,1334
SC,83216,SAO JOAO BATISTA,10710,7290,1458,11472,363,10014,651
SC,83232,SAO JOAO DO SUL,5876,3068,676,5538,112,4862,278
SC,83259,SAO JOAQUIM,15018,10800,3246,17371,294,14125,922
SC,83275,SAO JOSE,119468,66726,13985,115079,1732,101094,6265
SC,83291,SAO JOSE DO CEDRO,10870,4574,2349,10658,187,8309,400
SC,83313,SAO JOSE DO CERRITO,4880,4944,2305,7733,103,5428,413
SC,83330,SAO LOURENCO DO OESTE,12728,8352,3307,14900,289,11593,764
SC,83356,SAO LUDGERO,6666,3486,701,6194,109,5493,308
SC,83372,SAO MARTINHO,2138,2332,248,2699,97,2451,119
SC,83399,SAO MIGUEL DO OESTE,25070,8686,5011,23111,300,18100,922
SC,83410,SAUDADES,6106,4042,786,6138,79,5352,199
SC,83437,SCHROEDER,10944,3332,900,8548,97,7648,413
SC,83453,SEARA,13016,6414,1686,12031,157,10345,473
SC,83470,SIDEROPOLIS,11820,2938,1360,9236,97,7876,400
SC,83496,SOMBRIO,16948,7866,2470,16005,312,13535,816
SC,83518,TAIO,10392,8674,2099,12523,253,10424,638
SC,83534,TANGARA,5708,4222,498,5847,90,5349,294
SC,83550,TIJUCAS,16256,12126,2914,18406,262,15492,1039
SC,83577,TIMBO,20778,15854,2161,21939,313,19778,1149
SC,83593,TRES BARRAS,12674,5220,2233,11962,135,9729,647
SC,83615,TREZE DE MAIO,5016,2490,386,4515,142,4129,234
SC,83631,TREZE TILIAS,1872,3534,556,3488,64,2932,165
SC,83658,TROMBUDO CENTRAL,3682,3514,803,4735,75,3932,259
SC,83674,TUBARAO,71362,31350,8314,63677,886,55363,3121
SC,83682,TUNAPOLIS,4500,1188,371,3377,53,3006,109
SC,83690,TURVO,9614,4810,1304,9165,196,7861,453
SC,83712,URUBICI,4698,5870,1482,7274,86,5792,422
SC,83739,URUSSANGA,18370,5558,1910,14755,224,12845,657
SC,83755,VARGEAO,2440,1132,655,2611,44,1956,126
SC,83771,VIDAL RAMOS,4008,3086,740,4631,117,3891,227
SC,83798,VIDEIRA,30590,13680,4520,28847,499,24327,1693
SC,83810,WITMARSUM,2280,1694,377,2545,59,2168,122
SC,83836,XANXERE,30734,10642,4968,27146,386,22178,1104
SC,83852,XAVANTINA,3952,1966,358,3432,34,3074,81
SC,83879,XAXIM,19730,5716,2784,16733,313,13949,913
SC,83895,BOM JARDIM DA SERRA,2184,2590,357,2979,55,2622,180
SC,83917,MARACAJA,5416,1922,506,4469,97,3963,197
SC,83933,TIMBE DO SUL,4144,2434,373,3960,86,3587,212
SC,83950,CORREIA PINTO,11118,5192,1246,10055,167,8809,487
SC,83976,OTACILIO COSTA,11010,5014,1927,10572,136,8645,497
SE,31003,SANTANA DO SAO FRANCISCO,2572,3292,469,3722,71,3253,250
SE,31011,AMPARO DO SAO FRANCISCO,1346,1190,313,1686,26,1373,79
SE,31038,AQUIDABA,7568,9840,3392,13440,241,10048,1103
SE,31054,ARACAJU,350704,140524,47976,311540,4631,263564,13319
SE,31070,ARAUA,4248,6450,1799,7788,136,5989,504
SE,31097,AREIA BRANCA,5200,7756,1050,8343,207,7293,608
SE,31119,BARRA DOS COQUEIROS,11662,5918,1759,11259,215,9500,495
SE,31135,BREJO GRANDE,3040,2828,1453,4758,77,3305,294
SE,31151,BOQUIM,15978,9476,3660,17752,328,14092,1037
SE,31194,CAMPO DO BRITO,7372,8886,1577,10674,182,9097,786
SE,31216,CANHOBA,2714,1596,364,2944,114,2580,311
SE,31232,CANINDE DO SAO FRANCISCO,11722,5626,2040,11819,181,9779,924
SE,31259,CAPELA,8764,12998,4126,16587,329,12461,1251
SE,31275,CARIRA,5448,12398,3086,13104,188,10018,907
SE,31291,CARMOPOLIS,7088,2624,1257,6713,184,5456,416
SE,31313,CEDRO DE SAO JOAO,3664,2832,658,4263,131,3605,226
SE,31330,CRISTINAPOLIS,7344,5400,2725,9909,134,7184,678
SE,31356,NOSSA SENHORA APARECIDA,2680,5472,560,5198,65,4638,497
SE,31372,CUMBE,2084,2582,541,3121,50,2580,197
SE,31399,DIVINA PASTORA,1764,1650,196,2114,50,1918,161
SE,31410,ESTANCIA,34328,16740,4527,33057,803,28530,2193
SE,31437,FEIRA NOVA,1664,3630,377,3334,45,2957,265
SE,31453,FREI PAULO,3852,9058,1271,8519,158,7248,635
SE,31470,GENERAL MAYNARD,1792,1098,383,2010,59,1627,123
SE,31496,GARARU,5482,6260,1511,8169,157,6658,630
SE,31518,GRACCHO CARDOSO,3736,2512,913,4455,97,3542,321
SE,31534,ILHA DAS FLORES,3330,4860,1376,5848,81,4472,296
SE,31550,INDIAROBA,4836,5464,1183,7170,154,5987,683
SE,31577,ITABAIANA,36766,38692,6114,47685,894,41571,2948
SE,31593,ITABAIANINHA,10562,19500,6158,23030,405,16872,1436
SE,31615,ITABI,2992,2006,419,3613,62,3194,633
SE,31631,ITAPORANGA D AJUDA,13702,11750,1740,16008,240,14268,1302
SE,31658,JAPARATUBA,7184,6288,2172,9795,212,7623,675
SE,31674,JAPOATA,5684,6416,1281,8087,160,6806,596
SE,31690,LAGARTO,43138,36818,11132,55326,816,44194,3400
SE,31712,LARANJEIRAS,15614,7104,1215,13846,367,12631,905
SE,31739,MACAMBIRA,2302,4612,753,4878,109,4125,559
SE,31755,MALHADA DOS BOIS,2536,918,386,2301,47,1915,141
SE,31771,MALHADOR,3974,7126,736,6942,162,6206,494
SE,31798,MARUIM,8848,6134,1271,9618,235,8347,621
SE,31810,MOITA BONITA,2238,8282,795,6683,147,5888,481
SE,31836,MONTE ALEGRE DE SERGIPE,4148,7058,1848,8070,96,6222,523
SE,31852,MURIBECA,2656,4648,1241,5397,126,4156,378
SE,31879,NEOPOLIS,9384,6898,1515,10772,231,9257,885
SE,31895,NOSSA SENHORA DA GLORIA,12484,12870,3268,17317,244,14049,1128
SE,31917,NOSSA SENHORA DAS DORES,8982,11658,2965,14910,465,11945,1160
SE,31933,NOSSA SENHORA DE LOURDES,3552,2502,332,3692,76,3360,257
SE,31950,NOSSA SENHORA DO SOCORRO,53120,32310,12366,58868,985,46502,2802
SE,31976,PACATUBA,4758,6296,2155,8449,164,6294,603
SE,31992,PEDRA MOLE,1398,726,251,2045,24,1794,708
SE,32018,PEDRINHAS,3648,4550,1322,5873,85,4551,367
SE,32034,PINHAO,2414,3880,814,4376,67,3562,348
SE,32050,PIRAMBU,3848,3634,1112,5327,108,4215,366
SE,32077,POCO REDONDO,11538,7838,2678,13447,143,10769,938
SE,32093,POCO VERDE,8850,12080,3662,15151,178,11489,846
SE,32115,PORTO DA FOLHA,12278,10264,3622,16252,247,12630,1112
SE,32131,PROPRIA,17040,8926,3578,17665,310,14087,794
SE,32158,RIACHAO DO DANTAS,9174,10022,2971,13841,304,10870,968
SE,32174,RIACHUELO,6452,3324,1181,6605,115,5424,421
SE,32190,RIBEIROPOLIS,6146,9124,1146,10058,102,8912,1175
SE,32212,ROSARIO DO CATETE,4978,3246,941,5510,120,4569,337
SE,32239,SALGADO,8948,7626,1228,10526,245,9298,766
SE,32255,SANTA LUZIA DO ITANHY,4160,5160,2075,7628,232,5553,661
SE,32298,SANTA ROSA DE LIMA,1788,2216,311,2569,90,2258,166
SE,32310,SANTO AMARO DAS BROTAS,5052,4740,1178,6669,123,5491,472
SE,32336,SAO CRISTOVAO,38110,17972,6221,37149,735,30928,2152
SE,32352,SAO DOMINGOS,3410,4934,1353,6105,103,4752,477
SE,32379,SAO FRANCISCO,1390,1982,356,2194,21,1838,131
SE,32395,SAO MIGUEL DO ALEIXO,740,2430,313,2433,23,2120,512
SE,32417,SIMAO DIAS,18858,17414,3138,24015,461,20877,2280
SE,32433,SIRIRI,3662,3352,910,4886,120,3976,349
SE,32450,TELHA,1952,1310,297,2074,44,1777,102
SE,32476,TOBIAS BARRETO,18470,23958,7611,31170,454,23559,1891
SE,32492,TOMAR DO GERU,5036,6338,2149,8821,127,6672,858
SE,32514,UMBAUBA,6032,9954,1851,10961,322,9110,795
SP,61000,EUCLIDES DA CUNHA PAULISTA,5506,4518,2130,7436,106,5306,188
SP,61018,ADAMANTINA,17006,19892,5516,25250,719,19734,566
SP,61026,BOREBI,866,1596,250,1538,21,1288,36
SP,61034,ADOLFO,2454,1754,360,2608,69,2248,75
SP,61042,TARUMA,7894,4766,1341,7966,139,6625,156
SP,61050,AGUAI,17766,12576,3685,19790,331,16105,603
SP,61069,MOTUCA,2716,1826,640,3024,45,2384,68
SP,61077,AGUAS DA PRATA,4368,4030,1085,5513,72,4428,157
SP,61085,IARAS,1302,1556,576,2056,20,1480,31
SP,61093,AGUAS DE LINDOIA,6886,9332,2081,10686,181,8605,315
SP,61107,GUATAPARA,2636,3284,932,4094,95,3162,107
SP,61115,AGUAS DE SAO PEDRO,1230,2010,347,2020,17,1673,36
SP,61123,DIRCE REIS,1020,1110,238,1382,51,1144,28
SP,61131,AGUDOS,21602,13906,4393,23524,542,19131,835
SP,61140,ESPIRITO SANTO DO TURVO,2100,1902,735,2848,54,2113,58
SP,61158,ALFREDO MARCONDES,2262,2588,304,2864,53,2560,82
SP,61166,ROSANA,14490,8676,4958,17075,188,12117,346
SP,61174,ALTAIR,1816,1912,826,2835,72,2009,73
SP,61182,EMBAUBA,2136,1192,576,2349,56,1773,53
SP,61190,ALTINOPOLIS,10776,7296,2096,11604,203,9508,269
SP,61204,ILHA SOLTEIRA,15370,11660,4195,18614,362,14419,542
SP,61212,ALTO ALEGRE,2478,2728,376,3182,92,2806,111
SP,61220,ALUMINIO,13298,6616,2102,12472,161,10370,252
SP,61239,ALVARES FLORENCE,2410,3204,897,3917,111,3020,102
SP,61247,PEDRINHAS PAULISTA,1712,1786,459,2271,25,1812,38
SP,61255,ALVARES MACHADO,12608,8754,2325,13631,260,11306,365
SP,61263,ARACARIGUAMA,6466,6734,1902,8811,140,6909,169
SP,61271,ALVARO DE CARVALHO,1532,2136,427,2433,54,2006,118
SP,61280,BERTIOGA,16320,16744,5672,22885,274,17213,407
SP,61298,ALVINLANDIA,1554,1722,370,2082,32,1712,42
SP,61301,SUZANOPOLIS,1784,1382,540,2251,56,1711,72
SP,61310,AMERICANA,143012,85682,17506,137521,2508,120015,3160
SP,61328,SANTO ANTONIO DO ARACANGUA,4382,3582,1081,5189,50,4108,76
SP,61336,AMERICO BRASILIENSE,22002,9708,3042,19796,291,16754,608
SP,61344,CANITAR,2242,1844,547,2731,61,2184,80
SP,61352,AMERICO DE CAMPOS,2876,4004,620,4280,114,3660,106
SP,61360,BARRA DO CHAPEU,1588,3882,949,3845,54,2896,107
SP,61379,AMPARO,30434,37748,5898,41978,720,36080,1269
SP,61387,EMILIANOPOLIS,2294,1220,280,2154,58,1874,59
SP,61395,ANALANDIA,1974,2904,812,3341,35,2529,55
SP,61409,NOVAIS,1788,2660,407,2756,28,2349,97
SP,61417,ANDRADINA,29166,30168,8648,40210,914,31562,981
SP,61425,NOVA CANAA PAULISTA,1094,1572,264,1695,51,1431,47
SP,61433,ANGATUBA,12548,8450,2163,13198,195,11035,341
SP,61441,SALTINHO,3346,4576,317,4503,127,4186,98
SP,61450,ANHEMBI,2330,2626,997,3601,55,2604,71
SP,61468,UBARANA,3164,1898,753,3445,69,2692,92
SP,61476,ANHUMAS,2442,1264,292,2255,43,1963,67
SP,61484,CAJATI,11420,15046,4472,18356,237,13884,414
SP,61492,APARECIDA,20384,16008,1706,20563,300,18857,361
SP,61506,CAMPINA DO MONTE ALEGRE,2866,2650,612,3500,63,2888,67
SP,61514,APARECIDA D OESTE,2202,3364,604,3564,109,2960,68
SP,61522,ASPASIA,1104,1332,486,1788,27,1302,57
SP,61530,APIAI,10154,15354,5163,18612,294,13449,401
SP,61549,VARGEM,3960,4024,1081,5295,105,4214,117
SP,61557,ARACATUBA,80772,107020,21736,119762,1663,98026,2467
SP,61565,POTIM,8690,5800,1197,8658,88,7461,128
SP,61573,ARACOIABA DA SERRA,12148,13958,3077,16854,325,13777,399
SP,61581,ALAMBARI,1446,2816,545,2760,27,2215,57
SP,61590,ARAMINA,3482,1896,378,3267,86,2889,114
SP,61603,ITAOCA,1528,1880,1045,2888,59,1843,80
SP,61611,ARANDU,2750,2740,447,3374,74,2927,108
SP,61620,TUIUTI,2794,3276,776,4008,105,3232,92
SP,61638,ARARAQUARA,113336,88042,18635,124981,2057,106346,3600
SP,61646,ARAPEI,1848,1186,348,1970,41,1622,64
SP,61654,ARARAS,70008,51008,9126,73054,1445,63928,1975
SP,61662,ESTIVA GERBI,7090,3064,830,6177,100,5347,170
SP,61670,AREALVA,3378,4446,613,4797,148,4184,124
SP,61689,ENGENHEIRO COELHO,5082,5134,1209,6577,110,5368,150
SP,61697,AREIAS,1992,2112,691,2859,41,2168,75
SP,61700,RIBEIRAO GRANDE,5346,2850,844,5231,141,4387,148
SP,61719,AREIOPOLIS,6434,3918,1396,6935,180,5539,183
SP,61727,HORTOLANDIA,96282,36338,13669,83365,1408,69696,1978
SP,61735,ARIRANHA,6710,2608,871,5855,147,4984,178
SP,61743,HOLAMBRA,5834,5554,1082,6996,113,5914,107
SP,61751,ARTUR NOGUEIRA,21850,13458,3362,21917,428,18555,473
SP,61760,ELISIARIO,1432,1754,167,1821,30,1654,31
SP,61778,ARUJA,35890,30234,8254,43062,735,34808,1011
SP,61786,BOM SUCESSO DE ITARARE,1572,1662,669,2365,30,1696,49
SP,61794,ASSIS,55026,38210,11668,60566,917,48898,1363
SP,61808,PONTALINDA,2326,1594,571,2651,61,2080,59
SP,61816,ATIBAIA,45678,68898,12824,73357,1332,60533,1913
SP,61824,PARISI,1236,1222,196,1503,44,1307,34
SP,61832,AURIFLAMA,9122,7246,2401,11041,220,8640,236
SP,61840,TAQUARIVAI,2128,2474,824,3215,41,2391,49
SP,61859,AVAI,3028,2250,897,3640,43,2743,61
SP,61867,MARAPOAMA,1336,1580,446,2020,65,1574,51
SP,61875,AVANHANDAVA,4968,4712,1329,6436,108,5107,159
SP,61883,SAO JOAO DE IRACEMA,1354,794,250,1386,22,1136,40
SP,61891,AVARE,41090,35680,8258,48734,768,40476,1323
SP,61905,SAO LOURENCO DA SERRA,4806,6814,1376,7497,150,6121,161
SP,61913,BADY BASSIT,6324,6134,1590,8276,225,6686,232
SP,61921,ZACARIAS,1556,1068,384,1791,30,1407,65
SP,61930,BALBINOS,642,1064,156,1074,41,918,24
SP,61948,ITAPIRAPUA PAULISTA,1728,2252,774,2917,60,2143,93
SP,61956,BALSAMO,4540,4450,1209,5982,160,4773,118
SP,61964,MESOPOLIS,884,1316,243,1416,47,1173,26
SP,61972,BANANAL,6272,4598,856,6666,128,5810,247
SP,61980,NOVA CAMPINA,3036,4486,1007,4946,65,3939,113
SP,61999,BARBOSA,3310,3236,1157,4634,85,3477,119
SP,62006,ILHA COMPRIDA,3076,4870,1283,5424,65,4141,103
SP,62014,BARAO DE ANTONINA,1284,1772,457,2086,50,1629,51
SP,62022,LOURDES,984,1610,313,1685,25,1372,50
SP,62030,BARIRI,17128,14484,3622,20594,625,16972,541
SP,62049,TORRE DE PEDRA,1352,1384,449,1902,35,1453,50
SP,62057,BARRA BONITA,27494,14800,4121,26532,582,22411,682
SP,62065,ARCO IRIS,1554,1746,626,2360,37,1734,47
SP,62073,BARRA DO TURVO,2986,4426,2412,6339,43,3927,178
SP,62081,BREJO ALEGRE,1766,1096,373,1902,37,1529,61
SP,62090,BARRETOS,57956,53424,13229,71460,1040,58231,1501
SP,62103,CANAS,1928,2066,385,2446,27,2061,37
SP,62111,BARRINHA,16968,8416,3513,16918,357,13405,356
SP,62120,PRACINHA,682,1120,333,1286,23,953,29
SP,62138,BARUERI,154802,106742,26708,164421,2917,137713,4024
SP,62146,PRATANIA,2010,2428,657,3009,50,2352,83
SP,62154,BASTOS,9436,14048,3667,16050,366,12383,275
SP,62162,QUADRA,1654,1692,663,2410,38,1747,36
SP,62170,BATATAIS,24094,33296,5437,35613,621,30176,860
SP,62189,SANTA CRUZ DA ESPERANCA,1030,1232,394,1594,31,1200,38
SP,62197,BAURU,209836,119566,33256,207934,3608,174678,6369
SP,62200,SANTA SALETE,1058,1070,300,1426,38,1126,24
SP,62219,BEBEDOURO,36088,41514,10484,51282,878,40798,1119
SP,62227,VITORIA BRASIL,1256,1114,358,1631,52,1273,36
SP,62235,BENTO DE ABREU,1302,1856,441,2078,15,1637,43
SP,62243,IPIGUA,2314,2238,598,2964,59,2366,31
SP,62251,BERNADINO DE CAMPOS,6698,4966,1592,7683,100,6091,159
SP,62260,TAQUARAL,1970,942,354,1895,45,1541,40
SP,62278,BILAC,2784,4742,525,4519,99,3994,132
SP,62286,FERNAO,912,902,338,1281,15,943,21
SP,62294,BIRIGUI,50406,51272,9023,63446,1555,54423,2029
SP,62308,GAVIAO PEIXOTO,2478,1942,498,2823,58,2325,57
SP,62316,BIRITIBA MIRIM,11236,15198,3311,17211,326,13900,357
SP,62324,JUMIRIM,924,1604,255,1569,25,1314,25
SP,62332,BOA ESPERANCA DO SUL,8402,5046,1875,9049,188,7174,262
SP,62340,NANTES,1012,1454,533,1829,18,1296,45
SP,62359,BOCAINA,6702,4156,1137,6844,136,5707,142
SP,62367,NOVA CASTILHO,816,908,312,1209,15,897,20
SP,62375,BOFETE,3790,4108,1865,6099,127,4234,158
SP,62383,OUROESTE,3744,3622,1350,5308,160,3958,115
SP,62391,BOITUVA,16308,21670,4041,24306,474,20265,802
SP,62405,PAULISTANIA,814,1330,391,1517,27,1126,27
SP,62413,BOM JESUS DOS PERDOES,6196,9050,1842,9881,172,8039,244
SP,62421,RIBEIRAO DOS INDIOS,1590,1216,367,1893,52,1526,71
SP,62430,BORA,646,836,274,1077,33,803,29
SP,62448,TRABIJU,1120,776,333,1318,11,985,26
SP,62456,BORACEIA,3360,1548,753,3375,100,2622,68
SP,62472,BORBOREMA,8410,5798,2002,9840,304,7838,430
SP,62499,BOTUCATU,65754,49836,11568,73284,1325,61716,2596
SP,62510,BRAGANCA PAULISTA,71852,66592,12997,86311,1631,73314,2461
SP,62553,BRAUNA,1786,3286,378,3114,112,2736,88
SP,62570,BRODOWSKI,9332,10038,2008,12344,293,10336,358
SP,62596,BROTAS,10164,10082,2494,13374,317,10880,440
SP,62618,BURI,7912,8896,2345,11139,186,8794,204
SP,62634,BURITAMA,7016,8368,2209,10495,270,8286,324
SP,62650,BURITIZAL,1910,2148,342,2505,60,2163,74
SP,62677,CABRALIA PAULISTA,3442,1564,724,3391,74,2667,90
SP,62693,CABREUVA,17666,14750,3507,20424,293,16917,416
SP,62715,CACAPAVA,49754,38882,6641,53280,878,46639,1443
SP,62731,CACHOEIRA PAULISTA,20458,10466,3446,19647,294,16201,445
SP,62758,CACONDE,6458,11614,2549,12114,206,9565,323
SP,62774,CAFELANDIA,8428,8908,2585,11750,238,9165,259
SP,62790,CAIABU,2532,2230,428,3048,142,2620,97
SP,62812,CAIEIRAS,42356,28840,5551,43414,946,37863,1319
SP,62839,CAIUA,2104,2364,374,2692,22,2318,62
SP,62855,CAJAMAR,36626,19318,3661,32828,459,29167,736
SP,62871,CAJOBI,6224,4318,1625,7337,224,5712,217
SP,62898,CAJURU,12328,10440,2885,15001,292,12116,440
SP,62910,CAMPINAS,644092,401212,105041,656596,10172,551555,18731
SP,62936,CAMPO LIMPO PAULISTA,46030,26028,6851,44835,670,37984,1285
SP,62952,CAMPOS DO JORDAO,19554,28882,5935,31602,630,25667,819
SP,62979,CAMPOS NOVOS PAULISTA,1880,2744,939,3416,79,2477,86
SP,62995,CANANEIA,4644,7086,2159,8294,99,6135,171
SP,63010,CANDIDO MOTA,17338,15232,4220,21620,621,17400,494
SP,63037,CANDIDO RODRIGUES,1994,1266,276,2062,88,1786,68
SP,63053,CAPAO BONITO,25850,21938,6969,32279,637,25310,779
SP,63070,CAPELA DO ALTO,6504,8452,1510,9381,218,7871,175
SP,63096,CAPIVARI,19144,23250,4240,26734,588,22494,709
SP,63118,CARAGUATATUBA,40728,37924,10959,52568,851,41609,1432
SP,63134,CARAPICUIBA,221848,128908,33483,216989,3467,183506,4661
SP,63150,CARDOSO,7264,5328,2989,9758,234,6769,239
SP,63177,CASA BRANCA,13866,12936,3672,17836,337,14164,426
SP,63193,CASSIA DOS COQUEIROS,1666,2484,722,2922,30,2200,95
SP,63215,CASTILHO,10188,6466,3082,11911,231,8829,271
SP,63231,CATANDUVA,58052,53974,9691,68933,1258,59242,1971
SP,63258,CATIGUA,5402,3108,864,5477,142,4613,216
SP,63274,CEDRAL,4226,3678,966,5219,163,4253,138
SP,63290,CERQUEIRA CESAR,7978,8468,2136,10882,265,8746,258
SP,63312,CERQUILHO,17292,16796,2637,20764,406,18127,677
SP,63339,CESARIO LANGE,5724,8192,1623,9167,289,7544,297
SP,63355,CHARQUEADA,7802,8498,1724,10287,185,8563,228
SP,63371,CHAVANTES,8236,4964,1779,8811,176,7032,256
SP,63398,CLEMENTINA,3124,3152,962,4334,88,3372,146
SP,63410,COLINA,9564,8970,2673,12426,216,9753,270
SP,63436,COLOMBIA,3454,3196,1738,5252,69,3514,120
SP,63452,CONCHAL,10700,14120,3008,16342,511,13334,413
SP,63479,CONCHAS,7360,8784,2113,10618,200,8505,233
SP,63495,CORDEIROPOLIS,13026,7044,1396,11920,223,10524,266
SP,63517,COROADOS,2324,2638,537,3133,51,2596,64
SP,63533,CORONEL MACEDO,3412,3040,715,4074,58,3359,75
SP,63550,CORUMBATAI,1812,2514,749,3045,61,2296,72
SP,63576,COSMOPOLIS,33130,17760,4634,31451,638,26817,734
SP,63592,COSMORAMA,3502,5370,1294,6020,177,4726,113
SP,63614,COTIA,87202,64770,14185,93393,1360,79208,1862
SP,63630,CRAVINHOS,13458,17214,2802,19026,304,16224,584
SP,63657,CRISTAIS PAULISTA,2964,4224,936,4677,71,3741,76
SP,63673,CRUZALIA,1862,1698,414,2265,36,1851,35
SP,63690,CRUZEIRO,53998,29028,7990,51737,729,43747,1505
SP,63711,CUBATAO,91492,40810,12368,81550,1307,69182,1724
SP,63738,CUNHA,10576,13138,4213,16870,366,12657,434
SP,63754,DESCALVADO,18468,14812,3393,21285,565,17892,687
SP,63770,DIADEMA,297334,110970,36446,250960,3876,214514,6486
SP,63797,DIVINOLANDIA,5050,8402,1752,9044,287,7292,279
SP,63819,DOBRADA,4896,3052,1131,5319,88,4188,126
SP,63835,DOIS CORREGOS,13522,10272,2713,15447,471,12734,366
SP,63851,DOLCINOPOLIS,1218,1544,290,1765,38,1475,56
SP,63878,DOURADO,6072,3724,1089,6433,243,5344,203
SP,63894,DRACENA,19974,26258,6895,31312,613,24417,688
SP,63916,DUARTINA,9270,4954,2137,9676,146,7539,281
SP,63932,DUMONT,3934,3278,638,4467,111,3829,112
SP,63959,ECHAPORA,3680,3406,1271,5019,80,3748,125
SP,63975,ELDORADO,5146,8408,3121,10359,159,7238,302
SP,63991,ELIAS FAUSTO,7242,7214,2225,9949,200,7724,296
SP,64017,EMBU,113888,97820,19574,130737,2270,111163,3039
SP,64033,EMBU GUACU,26688,31598,8287,38961,664,30674,867
SP,64050,ESTRELA D OESTE,4616,5318,1359,6662,152,5303,184
SP,64076,ESTRELA DO NORTE,1258,1524,389,1865,22,1476,63
SP,64092,FARTURA,8116,8422,2424,11156,203,8732,260
SP,64114,FERNANDOPOLIS,33836,33754,8380,43831,845,35451,811
SP,64130,FERNANDO PRESTES,3970,2330,651,4116,218,3465,97
SP,64157,FERRAZ DE VASCONCELOS,80728,50524,13565,82808,1457,69243,2160
SP,64173,FLORA RICA,1526,1072,341,1699,24,1358,35
SP,64190,FLOREAL,2150,1776,378,2517,103,2139,73
SP,64211,FLORIDA PAULISTA,4804,7088,1988,8380,234,6392,212
SP,64238,FLORINEA,2140,1448,355,2241,47,1886,45
SP,64254,FRANCA,148132,153966,24225,182490,2967,158265,4249
SP,64270,FRANCISCO MORATO,65776,46362,12423,71727,1389,59304,1846
SP,64297,FRANCO DA ROCHA,67122,41418,9556,67468,1342,57912,2300
SP,64319,GABRIEL MONTEIRO,1554,1764,262,2062,31,1800,110
SP,64335,GALIA,3908,3612,1386,5323,75,3937,102
SP,64351,GARCA,18590,25784,6659,30255,631,23596,778
SP,64378,GASTAO VIDIGAL,2042,2162,482,2752,80,2270,88
SP,64394,GENERAL SALGADO,6246,6152,1918,8518,225,6600,176
SP,64416,GETULINA,5838,5340,1995,7938,111,5943,243
SP,64432,GLICERIO,2976,2930,1022,4127,50,3105,102
SP,64459,GUAICARA,5718,3396,1281,6045,104,4764,103
SP,64475,GUAIMBE,2624,2682,529,3350,54,2821,114
SP,64491,GUAIRA,18716,20586,4778,25310,466,20532,415
SP,64513,GUAPIACU,9282,8168,1985,11263,288,9278,265
SP,64530,GUAPIARA,9202,9036,3443,13151,194,9708,395
SP,64556,GUARA,11062,9348,2838,13614,284,10776,287
SP,64572,GUARACAI,5124,4728,1456,6736,184,5280,170
SP,64599,GUARACI,4816,4754,2145,7142,94,4997,118
SP,64610,GUARANI D OESTE,1372,966,458,1678,20,1220,31
SP,64637,GUARANTA,2954,3548,1052,4528,137,3476,88
SP,64653,GUARARAPES,13326,18546,4149,21019,399,16870,535
SP,64670,GUARAREMA,11458,13538,3284,16373,262,13089,329
SP,64696,GUARATINGUETA,72546,47440,10927,73707,1177,62780,1610
SP,64718,GUAREI,5282,5452,1368,7289,275,5921,279
SP,64734,GUARIBA,22380,13444,3924,22694,387,18770,471
SP,64750,GUARUJA,178210,100944,28269,176038,3705,147769,4487
SP,64777,GUARULHOS,514092,440944,84344,592740,10468,508396,20410
SP,64793,GUZOLANDIA,2334,2642,1132,3760,58,2628,82
SP,64815,HERCULANDIA,4128,4602,1242,5893,87,4651,199
SP,64831,IACANGA,4838,4874,1505,6701,170,5196,170
SP,64858,IACRI,3596,4118,1349,5429,102,4080,121
SP,64874,IBATE,16580,9268,2500,16442,477,13942,541
SP,64890,IBIRA,4468,6292,1317,7069,169,5752,203
SP,64912,IBIRAREMA,3392,3818,1017,4881,132,3864,127
SP,64939,IBITINGA,28560,22644,5642,32981,824,27339,913
SP,64955,IBIUNA,18848,45872,8624,42719,637,34095,1098
SP,64971,ICEM,5448,2924,1495,5870,93,4375,96
SP,64998,IEPE,3826,4434,1539,5870,82,4331,119
SP,65013,IGARACU DO TIETE,17320,7828,2582,16259,514,13677,589
SP,65030,IGARAPAVA,16618,11990,4221,19493,486,15272,482
SP,65056,IGARATA,4366,6308,1645,7257,117,5612,158
SP,65072,IGUAPE,11062,19202,4681,20570,255,15889,502
SP,65099,ILHABELA,8020,12314,2739,13294,153,10555,235
SP,65110,INDAIATUBA,107414,54986,13979,99703,1950,85724,2574
SP,65137,INDIANA,3034,3052,741,3988,98,3247,106
SP,65153,INDIAPORA,1858,2470,569,2843,71,2274,39
SP,65170,INUBIA PAULISTA,1396,2764,532,2718,37,2186,69
SP,65196,IPAUCU,7506,5934,1743,8781,153,7038,165
SP,65218,IPERO,10974,6872,2439,11829,179,9390,288
SP,65234,IPEUNA,2258,2594,615,3161,51,2546,69
SP,65250,IPORANGA,1944,1870,912,2976,58,2064,99
SP,65277,IPUA,7342,5340,1551,8254,167,6703,195
SP,65293,IRACEMAPOLIS,10218,8892,1054,10998,166,9944,223
SP,65315,IRAPUA,3080,4426,1198,5230,136,4032,143
SP,65331,IRAPURU,3564,4556,1824,6166,119,4342,163
SP,65358,ITABERA,10506,8394,2530,12565,256,10035,329
SP,65374,ITAI,12588,9256,3212,14802,288,11590,380
SP,65390,ITAJOBI,8792,7858,2242,11333,425,9091,341
SP,65412,ITAJU,1516,1774,283,2044,56,1761,60
SP,65439,ITANHAEM,36952,34478,11685,49413,819,37728,1194
SP,65455,ITAPECERICA DA SERRA,64316,62450,12026,78252,1228,66226,1615
SP,65471,ITAPETININGA,70124,56212,12652,79414,1600,66762,1994
SP,65498,ITAPEVA,45328,37862,9843,53168,810,43325,920
SP,65510,ITAPEVI,92344,55416,15442,92992,1576,77550,2094
SP,65536,ITAPIRA,44890,27856,6426,45301,1158,38875,1344
SP,65552,ITAPOLIS,22522,17590,5052,26987,944,21935,935
SP,65579,ITAPORANGA,6012,9644,3065,11387,235,8322,259
SP,65595,ITAPUI,6876,3570,1010,6516,150,5506,133
SP,65617,ITAPURA,2372,1732,894,3077,63,2183,68
SP,65633,ITAQUAQUECETUBA,122416,79076,25882,132640,2530,106758,3482
SP,65650,ITARARE,21208,25656,6093,30800,652,24707,623
SP,65676,ITARIRI,3936,6848,1876,7546,122,5670,156
SP,65692,ITATIBA,45914,40526,7058,52888,1170,45830,1440
SP,65714,ITATINGA,9090,6880,2152,10520,153,8368,230
SP,65730,ITIRAPINA,6236,5444,1572,7749,146,6177,191
SP,65757,ITIRAPUA,2994,3014,899,4110,72,3211,135
SP,65773,ITOBI,3766,4260,962,5188,112,4226,101
SP,65790,ITU,85426,59108,14150,90067,1307,75917,2343
SP,65811,ITUPEVA,16726,13018,3964,19658,345,15694,477
SP,65838,ITUVERAVA,22714,18134,4855,26280,467,21425,534
SP,65854,JABORANDI,4446,2624,1020,4844,139,3824,150
SP,65870,JABOTICABAL,35212,36076,8126,45543,827,37417,946
SP,65897,JACAREI,124248,85828,18947,128830,1701,109883,3144
SP,65919,JACI,2198,2724,409,3008,66,2599,72
SP,65935,JACUPIRANGA,6910,9714,2737,11397,136,8660,212
SP,65951,JAGUARIUNA,20206,13738,3164,20998,407,17834,455
SP,65978,JALES,26344,24368,6855,33781,853,26926,717
SP,65994,JAMBEIRO,2330,3340,639,3573,35,2934,64
SP,66010,JANDIRA,52018,45958,10004,61318,1004,51314,1322
SP,66036,JARDINOPOLIS,16296,15912,3455,20558,488,17103,511
SP,66052,JARINU,6750,10128,2508,11366,199,8858,220
SP,66079,JAU,69800,55382,10234,76520,1836,66286,1859
SP,66095,JERIQUARA,1906,1820,582,2530,35,1948,50
SP,66117,JOANOPOLIS,4036,7640,1517,7712,170,6195,187
SP,66133,JOAO RAMALHO,1864,2570,640,2983,44,2343,82
SP,66150,JOSE BONIFACIO,16128,14858,3010,19493,585,16483,405
SP,66176,JULIO MESQUITA,2926,2190,459,3175,51,2716,107
SP,66192,JUNDIAI,248248,137714,28757,231793,2866,203036,7189
SP,66214,JUNQUEIROPOLIS,8034,10368,3114,12844,280,9730,249
SP,66230,JUQUIA,6772,13372,4670,15283,215,10613,326
SP,66257,JUQUITIBA,9412,17444,4122,18317,300,14195,467
SP,66273,LAGOINHA,2710,4652,961,4831,89,3870,100
SP,66290,LARANJAL PAULISTA,10952,14664,2398,15983,369,13585,408
SP,66311,LAVINIA,3262,2682,965,4152,81,3187,134
SP,66338,LAVRINHAS,4358,3238,821,4809,62,3988,128
SP,66354,LEME,54528,33162,7914,54144,985,46230,1400
SP,66370,LENCOIS PAULISTA,30538,28394,5316,36631,844,31315,1005
SP,66397,LIMEIRA,169690,101174,22629,164548,2642,141919,3845
SP,66419,LINDOIA,2460,4300,890,4464,73,3574,121
SP,66435,LINS,30250,41896,9018,46989,766,37971,1132
SP,66451,LORENA,52220,33898,9717,54639,781,44922,1082
SP,66478,LOUVEIRA,13918,14414,2520,17421,346,14901,389
SP,66494,LUCELIA,10070,10296,3156,13892,183,10736,370
SP,66516,LUCIANOPOLIS,1488,1170,299,1714,41,1415,45
SP,66532,LUIS ANTONIO,4744,3572,1219,5604,75,4385,152
SP,66559,LUISIANIA,2558,2234,431,2986,63,2555,96
SP,66575,LUPERCIO,2566,2040,685,3083,35,2398,60
SP,66591,LUTECIA,1692,1692,830,2652,49,1822,81
SP,66613,MACATUBA,11106,6350,2098,11341,251,9243,264
SP,66630,MACAUBAL,3110,5568,1290,6011,272,4721,110
SP,66656,MACEDONIA,2358,2132,669,3054,67,2385,73
SP,66672,MAGDA,2186,1814,391,2489,62,2098,36
SP,66699,MAIRINQUE,29234,16194,5310,29173,517,23863,632
SP,66710,MAIRIPORA,27218,33752,5235,37440,704,32205,1016
SP,66737,MANDURI,4896,5202,1341,6685,161,5344,134
SP,66753,MARABA PAULISTA,1836,2682,747,3138,45,2391,87
SP,66770,MARACAI,9254,6668,2095,10436,187,8341,193
SP,66796,MARIAPOLIS,1686,2448,385,2638,110,2253,76
SP,66818,MARILIA,118544,90986,22857,133414,2543,110557,3249
SP,66834,MARINOPOLIS,1382,1562,280,1849,49,1569,48
SP,66850,MARTINOPOLIS,9690,13808,3454,15853,304,12399,346
SP,66877,MATAO,54900,27202,7222,50288,734,43066,1281
SP,66893,MAUA,274508,116230,31108,236980,3602,205872,6901
SP,66915,MENDONCA,2534,1732,307,2665,140,2358,85
SP,66931,MERIDIANO,2520,2280,490,3031,53,2541,88
SP,66958,MIGUELOPOLIS,9704,11310,3431,14491,239,11060,314
SP,66974,MINEIROS DO TIETE,7912,4558,1279,7906,190,6627,202
SP,66990,MIRACATU,6586,12932,3991,14209,170,10218,289
SP,67016,MIRA ESTRELA,1818,1574,444,2223,31,1779,52
SP,67032,MIRANDOPOLIS,13300,13502,4111,18491,473,14380,506
SP,67059,MIRANTE DO PARANAPANEMA,8898,8172,3457,12513,257,9056,264
SP,67075,MIRASSOL,30316,22116,5529,33321,754,27792,822
SP,67091,MIRASSOLANDIA,1896,2592,350,2721,59,2371,68
SP,67113,MOCOCA,37890,31898,7882,45155,1088,37273,1291
SP,67130,MOGI DAS CRUZES,196562,155360,30895,216213,3698,185318,5659
SP,67156,MOJI GUACU,91556,49184,11916,86166,1536,74250,2344
SP,67172,MOJI MIRIM,45936,38926,7491,52524,1144,45033,1458
SP,67199,MOMBUCA,1824,1944,526,2569,62,2043,97
SP,67210,MONCOES,1054,1292,320,1613,87,1293,33
SP,67237,MONGAGUA,18246,16374,5937,24095,338,18158,510
SP,67253,MONTE ALEGRE DO SUL,3452,4314,827,5010,90,4183,210
SP,67270,MONTE ALTO,26466,22470,5227,31424,1062,26197,667
SP,67296,MONTE APRAZIVEL,11048,10554,2896,14487,424,11591,366
SP,67318,MONTE AZUL PAULISTA,10486,11270,2501,14196,379,11695,438
SP,67334,MONTE CASTELO,2638,1934,445,2889,60,2444,98
SP,67350,MONTEIRO LOBATO,2138,2334,409,2782,49,2373,88
SP,67377,MONTE MOR,23074,15688,5253,25778,448,20525,696
SP,67393,MORRO AGUDO,14024,10786,3142,16340,367,13198,426
SP,67415,MORUNGABA,5754,7192,1437,8243,142,6806,191
SP,67431,MURUTINGA DO SUL,2328,2302,427,2893,59,2466,92
SP,67458,NARANDIBA,2436,2190,754,3189,43,2435,79
SP,67474,NATIVIDADE DA SERRA,4014,4004,1018,5334,117,4316,190
SP,67490,NAZARE PAULISTA,5278,9018,2029,9731,265,7702,289
SP,67512,NEVES PAULISTA,5682,4830,1257,6956,261,5699,182
SP,67539,NHANDEARA,5316,6428,1124,7451,313,6327,142
SP,67555,NIPOA,1784,2184,335,2417,46,2082,52
SP,67571,NOVA ALIANCA,3224,2688,535,3707,101,3172,115
SP,67598,NOVA EUROPA,5858,2892,1157,5766,92,4609,142
SP,67610,NOVA GRANADA,10056,9430,2510,12841,250,10331,338
SP,67636,NOVA GUATAPORANGA,1194,1512,261,1709,25,1448,70
SP,67652,NOVA INDEPENDENCIA,1460,1476,561,2101,16,1540,56
SP,67679,NOVA LUZITANIA,1490,2124,361,2242,38,1881,36
SP,67695,NOVA ODESSA,35226,15430,4060,30615,545,26555,682
SP,67717,NOVO HORIZONTE,22508,13142,4208,23102,552,18894,517
SP,67733,NUPORANGA,3584,3732,859,4770,118,3911,135
SP,67750,OCAUCU,2552,2464,1057,3753,80,2696,108
SP,67776,OLEO,1706,1760,307,2167,58,1860,69
SP,67792,OLIMPIA,25450,24206,6683,33269,957,26586,801
SP,67814,ONDA VERDE,2114,2066,606,2798,54,2192,48
SP,67830,ORIENTE,4092,3100,501,4308,88,3807,123
SP,67857,ORINDIUVA,2158,2544,753,3240,58,2487,78
SP,67873,ORLANDIA,18944,21274,3470,24655,412,21185,664
SP,67890,OSASCO,478300,261300,67118,453152,6041,386034,10193
SP,67911,OSCAR BRESSANE,1310,1756,285,1911,34,1626,59
SP,67938,OSVALDO CRUZ,13924,19482,4969,22520,414,17551,434
SP,67954,OURINHOS,53524,43574,11098,61705,885,50607,1173
SP,67970,OURO VERDE,4390,3626,1395,5623,71,4228,149
SP,67997,PACAEMBU,5000,7080,1131,7591,193,6460,227
SP,68012,PALESTINA,3862,6590,1080,6707,227,5627,174
SP,68039,PALMARES PAULISTA,4608,4188,1073,5880,189,4807,220
SP,68055,PALMEIRA D OESTE,5574,5850,2061,8244,273,6183,198
SP,68071,PALMITAL,11114,12384,2833,15139,274,12306,283
SP,68098,PANORAMA,5564,7066,1911,8642,188,6731,228
SP,68110,PARAGUACU PAULISTA,20906,18964,5199,26468,678,21269,656
SP,68136,PARAIBUNA,8562,9454,1510,10987,167,9477,302
SP,68152,PARAISO,3224,2926,726,4077,143,3351,133
SP,68179,PARANAPANEMA,9656,7230,2291,11085,125,8794,226
SP,68195,PARANAPUA,1628,2616,405,2667,73,2262,67
SP,68217,PARAPUA,5320,5636,1896,7897,194,6001,329
SP,68233,PARDINHO,2866,2740,1077,4046,66,2969,100
SP,68250,PARIQUERA-ACU,7610,10978,2577,12346,195,9769,280
SP,68276,PATROCINIO PAULISTA,6244,6942,1434,8300,115,6866,158
SP,68292,PAULICEIA,2726,2476,553,3285,54,2732,77
SP,68314,PAULINIA,47596,18296,5828,40361,707,34533,880
SP,68330,PAULO DE FARIA,3838,5146,1708,6491,121,4783,170
SP,68357,PEDERNEIRAS,21860,17068,4483,25169,555,20686,667
SP,68373,PEDRA BELA,2462,3278,847,3932,103,3085,112
SP,68390,PEDRANOPOLIS,1612,1660,254,1957,28,1703,39
SP,68411,PEDREGULHO,8424,8784,2903,12172,295,9269,370
SP,68438,PEDREIRA,25272,15974,3021,25163,605,22142,914
SP,68454,PEDRO DE TOLEDO,3994,4610,1695,6244,82,4549,165
SP,68470,PENAPOLIS,36226,24016,7045,38798,761,31753,871
SP,68497,PEREIRA BARRETO,13600,12734,5110,18974,356,13864,341
SP,68519,PEREIRAS,3878,3594,1171,5087,78,3916,102
SP,68535,PERUIBE,23432,27420,8542,35260,549,26718,743
SP,68551,PIACATU,2456,3062,875,3854,49,2979,171
SP,68578,PIEDADE,15588,32154,5031,30387,739,25356,746
SP,68594,PILAR DO SUL,10346,13934,2298,15042,317,12744,287
SP,68616,PINDAMONHANGABA,75928,56608,11097,80484,1229,69387,1890
SP,68632,PINDORAMA,8766,7204,1517,10074,291,8557,281
SP,68659,ESPIRITO SANTO DO PINHAL,25570,20634,4667,29142,628,24475,745
SP,68675,PINHALZINHO,4892,7120,1428,7812,185,6384,193
SP,68691,PIQUEROBI,2226,2036,661,2929,57,2268,80
SP,68713,PIQUETE,12366,6184,2527,12235,168,9708,265
SP,68730,PIRACAIA,10538,14728,3086,16385,301,13299,365
SP,68756,PIRACICABA,185124,175568,29815,218504,3493,188689,4850
SP,68772,PIRAJU,16464,14242,4191,20522,386,16331,592
SP,68799,PIRAJUI,9592,10658,3117,13944,342,10827,360
SP,68810,PIRANGI,5368,5062,1404,7122,317,5718,186
SP,68837,PIRAPORA DO BOM JESUS,5066,6320,1513,7466,96,5953,164
SP,68853,PIRAPOZINHO,14646,11060,3199,16772,312,13573,408
SP,68870,PIRACUNUNGA,41652,29972,8065,46015,1018,37950,1120
SP,68896,PIRATININGA,6360,6146,1624,8334,224,6710,233
SP,68918,PITANGUEIRAS,17736,13234,4655,21128,447,16473,541
SP,68934,PLANALTO,1776,2580,654,2981,56,2327,93
SP,68950,PLATINA,1566,1944,550,2405,44,1855,56
SP,68977,POA,65990,40800,9909,66059,1081,56150,1674
SP,68993,POLONI,2310,3440,569,3634,113,3065,77
SP,69019,POMPEIA,10874,11286,2452,14241,267,11789,442
SP,69035,PONGAI,2064,2518,531,2966,79,2435,65
SP,69051,PONTAL,18688,12268,4290,20690,426,16400,496
SP,69078,PONTES GESTAL,1528,1570,828,2475,41,1647,57
SP,69094,POPULINA,2602,2416,557,3272,88,2715,118
SP,69116,PORANGABA,3546,3490,693,4443,90,3750,142
SP,69132,PORTO FELIZ,23642,24392,4513,29945,672,25432,743
SP,69159,PORTO FERREIRA,32612,19768,4723,32446,768,27723,765
SP,69175,POTIRENDABA,7808,7340,1770,10190,490,8420,356
SP,69191,PRADOPOLIS,10400,5828,1463,9934,143,8471,214
SP,69213,PRAIA GRANDE,100926,77468,26400,120919,2140,94519,3182
SP,69230,PRESIDENTE ALVES,2460,2260,596,3117,77,2521,84
SP,69256,PRESIDENTE BERNARDES,8896,7138,1964,10347,180,8383,186
SP,69272,PRESIDENTE EPITACIO,18934,19266,5489,25485,365,19996,531
SP,69299,PRESIDENTE PRUDENTE,116236,98646,25946,138913,2231,112967,3295
SP,69310,PRESIDENTE VENCESLAU,18118,22294,5548,26807,481,21259,572
SP,69337,PROMISSAO,21802,13196,4350,22795,456,18445,490
SP,69353,QUATA,6850,5742,2304,9059,232,6755,227
SP,69370,QUEIROZ,1330,1282,295,1670,24,1375,45
SP,69396,QUELUZ,5880,3996,1427,6628,103,5201,160
SP,69418,QUINTANA,3150,3174,944,4365,108,3421,151
SP,69434,RAFARD,6000,6086,1285,7673,168,6388,177
SP,69450,RANCHARIA,15860,15724,4736,21296,344,16560,424
SP,69477,REDENCAO DA SERRA,2392,2922,580,3361,51,2781,73
SP,69493,REGENTE FEIJO,10290,8554,2014,11959,220,9945,303
SP,69515,REGINOPOLIS,2422,3496,676,3862,111,3186,116
SP,69531,REGISTRO,23754,31224,9244,37708,416,28464,559
SP,69558,RESTINGA,3978,2302,408,3690,63,3282,79
SP,69574,RIBEIRA,1486,2048,391,2266,52,1875,56
SP,69590,RIBEIRAO BONITO,6736,6154,2095,9053,235,6958,278
SP,69612,RIBEIRAO BRANCO,6708,9966,3458,12331,236,8873,300
SP,69639,RIBEIRAO CORRENTE,2098,1968,395,2526,33,2131,65
SP,69655,RIBEIRAO DO SUL,3436,2234,747,3715,72,2968,61
SP,69671,RIBEIRAO PIRES,71114,44544,10832,72078,1273,61246,2144
SP,69698,RIBEIRAO PRETO,273202,271212,56576,345079,4703,288503,11593
SP,69710,RIVERSUL,3658,4442,1912,6242,144,4330,136
SP,69736,RIFAINA,2254,2186,552,2894,62,2342,60
SP,69752,RINCAO,5600,4904,1381,6971,147,5590,191
SP,69779,RINOPOLIS,3428,6904,1006,6524,165,5518,187
SP,69795,RIO CLARO,99534,83982,16490,114146,1869,97656,4029
SP,69817,RIO DAS PEDRAS,15614,13900,3080,18638,415,15558,386
SP,69833,RIO GRANDE DA SERRA,26692,17142,5131,28393,627,23262,718
SP,69850,RIOLANDIA,3212,4698,1960,6178,118,4218,145
SP,69876,ROSEIRA,4616,4674,1029,5807,61,4778,72
SP,69892,RUBIACEA,942,1594,268,1643,40,1375,67
SP,69914,RUBINEIA,1862,1246,471,2152,38,1681,89
SP,69930,SABINO,3638,2292,602,3756,76,3154,113
SP,69957,SAGRES,1076,1520,240,1602,23,1362,41
SP,69973,SALES,2456,2862,450,3283,76,2833,98
SP,69990,SALES OLIVEIRA,4724,5768,871,6372,102,5501,153
SP,70017,SALESOPOLIS,6396,11572,2261,11749,228,9488,276
SP,70033,SALMORAO,1792,2976,481,3017,51,2536,101
SP,70050,SALTO,72022,33594,9078,64215,934,55137,1395
SP,70076,SALTO DE PIRAPORA,19812,13644,3291,20908,410,17617,479
SP,70092,SALTO GRANDE,4518,3762,1358,5817,146,4459,173
SP,70114,SANDOVALINA,2282,1224,398,2226,27,1828,48
SP,70130,SANTA ADELIA,9986,5212,1718,9852,231,8134,304
SP,70157,SANTA ALBERTINA,2194,3930,721,4010,113,3289,114
SP,70173,SANTA BARBARA D OESTE,121194,52086,13656,105378,2313,91722,2769
SP,70190,AGUAS DE SANTA BARBARA,2924,2654,887,3836,54,2949,106
SP,70211,SANTA BRANCA,8626,6788,1908,9954,137,8046,202
SP,70238,SANTA CLARA D OESTE,1140,1694,450,1954,57,1504,30
SP,70254,SANTA CRUZ DA CONCEICAO,2432,1974,616,2926,55,2310,52
SP,70270,SANTA CRUZ DAS PALMEIRAS,16576,12080,2884,18014,420,15130,382
SP,70297,SANTA CRUZ DO RIO PARDO,20894,24036,4639,28483,628,23844,751
SP,70319,SANTA ERNESTINA,5044,1866,1010,4640,70,3630,105
SP,70335,SANTA FE DO SUL,14598,15496,4251,20200,442,15949,460
SP,70351,SANTA GERTRUDES,12380,6416,1594,11605,249,10011,364
SP,70378,SANTA ISABEL,22706,27108,4462,30756,510,26294,877
SP,70394,SANTA LUCIA,7430,2474,1052,6341,163,5289,174
SP,70416,SANTA MARIA DA SERRA,2638,2266,890,3501,64,2611,95
SP,70432,SANTA MERCEDES,1330,1460,363,1863,37,1500,68
SP,70459,SANTANA DA PONTE PENSA,1186,1128,255,1539,67,1284,60
SP,70475,SANTANA DE PARNAIBA,34624,33716,7283,43029,718,35746,858
SP,70491,SANTA RITA D OESTE,1810,1746,310,2193,63,1883,42
SP,70513,SANTA RITA DO PASSA QUATRO,16624,13200,3393,19185,392,15792,488
SP,70530,SANTA ROSA DE VITERBO,15266,9808,2824,16217,367,13393,489
SP,70556,SANTO ANASTACIO,12002,11040,3553,15935,391,12382,470
SP,70572,SANTO ANDRE,526372,275888,76261,500320,6902,424059,16027
SP,70599,SANTO ANTONIO DA ALEGRIA,4112,2734,741,4379,67,3638,148
SP,70610,SANTO ANTONIO DA POSSE,10100,9354,2078,12353,271,10275,277
SP,70637,SANTO ANTONIO DO JARDIM,4184,3770,963,5207,123,4244,144
SP,70653,SANTO ANTONIO DO PINHAL,2854,4682,1032,5004,81,3972,123
SP,70670,SANTO EXPEDITO,2222,1332,614,2509,33,1895,85
SP,70696,SANTOPOLIS DO AGUAPEI,1838,2196,385,2616,82,2231,132
SP,70718,SANTOS,322096,213556,53107,335023,5062,281916,9028
SP,70734,SAO BENTO DO SAPUCAI,4098,7430,1500,7580,129,6080,187
SP,70750,SAO BERNARDO DO CAMPO,532800,243854,65279,472848,5786,407569,13456
SP,70777,SAO CAETANO DO SUL,93716,83450,10885,104253,1507,93368,3278
SP,70793,SAO CARLOS,116940,96136,19044,132153,2446,113109,4125
SP,70815,SAO FRANCISCO,1938,1634,733,2674,85,1941,70
SP,70831,SAO JOAO DA BOA VISTA,50400,37422,8158,54399,813,46241,1517
SP,70858,SAO JOAO DAS DUAS PONTES,1668,1822,552,2426,41,1874,88
SP,70874,SAO JOAO DO PAU D ALHO,1218,1496,240,1688,38,1448,53
SP,70890,SAO JOAQUIM DA BARRA,29134,17442,4307,28712,473,24405,644
SP,70912,SAO JOSE DA BELA VISTA,4056,3632,1258,5461,188,4203,171
SP,70939,SAO JOSE DO BARREIRO,2394,2712,939,3634,40,2695,102
SP,70955,SAO JOSE DO RIO PARDO,28862,25158,5690,34148,652,28458,796
SP,70971,SAO JOSE DO RIO PRETO,197534,189094,39263,243186,4515,203923,6094
SP,70998,SAO JOSE DOS CAMPOS,352684,223848,53978,353716,4127,299738,7345
SP,71013,SAO LUIS DO PARAITINGA,5834,8654,1621,9270,196,7649,209
SP,71030,SAO MANUEL,24852,14988,4577,26020,651,21443,872
SP,71056,SAO MIGUEL ARCANJO,14742,15154,4045,19861,389,15816,479
SP,71072,SAO PAULO,6115920,5861240,1176608,7531597,130556,6354989,235853
SP,71099,SAO PEDRO,12546,17006,4085,19752,372,15667,519
SP,71110,SAO PEDRO DO TURVO,3012,4516,1210,5159,98,3949,87
SP,71137,SAO ROQUE,37362,36242,7015,45626,768,38611,1041
SP,71153,SAO SEBASTIAO,29120,26604,7881,37240,624,29359,873
SP,71170,SAO SEBASTIAO DA GRAMA,5804,5958,1908,8247,201,6339,257
SP,71196,SAO SIMAO,7986,7312,2039,10154,198,8115,268
SP,71218,SAO VICENTE,200736,118056,30380,199147,4019,168767,5352
SP,71234,SARAPUI,4096,4426,1234,5753,107,4519,151
SP,71250,SARUTAIA,2174,1720,410,2457,38,2047,62
SP,71277,SEBASTIANOPOLIS DO SUL,1460,1910,371,2151,50,1780,45
SP,71293,SERRA AZUL,4340,3664,1149,5392,66,4243,175
SP,71315,SERRANA,19678,15960,3831,22794,530,18963,614
SP,71331,SERRA NEGRA,11400,16686,3523,18363,323,14840,474
SP,71358,SERTAOZINHO,67286,32586,9680,62648,1248,52968,1784
SP,71374,SETE BARRAS,5354,6906,3060,9560,117,6500,253
SP,71390,SEVERINIA,7332,7272,2094,9813,223,7719,194
SP,71412,SILVEIRAS,3030,3620,957,4497,113,3540,102
SP,71439,SOCORRO,14606,21384,3651,22918,446,19267,826
SP,71455,SOROCABA,332476,204822,42375,324269,4488,281894,8757
SP,71471,SUD MENUCCI,4846,3746,1614,6173,145,4559,118
SP,71498,SUMARE,129640,57928,17708,116264,2008,98556,2764
SP,71510,SUZANO,136248,96278,22973,145038,2412,122065,3390
SP,71536,TABAPUA,6988,5118,1085,7624,213,6539,273
SP,71552,TABATINGA,8062,6150,1938,9667,328,7729,295
SP,71579,TABOAO DA SERRA,130748,105852,23921,148278,2514,124357,3543
SP,71595,TACIBA,3764,2752,1047,4499,78,3452,116
SP,71617,TAGUAI,4158,4384,1126,5546,64,4420,85
SP,71633,TAIACU,3052,2626,784,3862,129,3078,110
SP,71650,TAIUVA,3560,2808,831,4181,84,3350,82
SP,71676,TAMBAU,12754,11184,2023,14666,299,12643,375
SP,71692,TANABI,12682,14142,3218,17248,339,14030,279
SP,71714,TAPIRAI,2836,4792,1386,5437,89,4051,148
SP,71730,TAPIRATIBA,9602,4312,1638,8935,118,7297,222
SP,71757,TAQUARITINGA,36218,18132,6283,35338,985,29055,895
SP,71773,TAQUARITUBA,13268,10570,3527,16168,381,12641,341
SP,71790,TARABAI,4472,2608,1187,4925,65,3738,133
SP,71811,TATUI,49184,50900,10318,63798,1326,53480,2112
SP,71838,TAUBATE,168684,92992,23940,161095,2431,137155,3886
SP,71854,TEJUPA,2834,2380,935,3708,48,2773,118
SP,71870,TEODORO SAMPAIO,9666,9964,3793,14178,218,10385,352
SP,71897,TERRA ROXA,5670,3480,1073,5853,98,4780,107
SP,71919,TIETE,13502,21190,3244,21556,385,18312,581
SP,71935,TIMBURI,1776,1446,335,2050,48,1715,56
SP,71951,TORRINHA,5446,4042,1038,6176,215,5138,179
SP,71978,TREMEMBE,17126,13952,2983,19438,341,16455,575
SP,71994,TRES FRONTEIRAS,2958,3054,686,3902,109,3216,101
SP,72010,TUPA,30806,37266,8912,44685,669,35773,1068
SP,72036,TUPI PAULISTA,7220,8992,2468,10979,153,8511,252
SP,72052,TURIUBA,1242,1418,410,1812,26,1402,46
SP,72079,TURMALINA,1314,1394,333,1807,72,1474,48
SP,72095,UBATUBA,29322,36612,8676,43445,752,34769,1050
SP,72117,UBIRAJARA,2266,2164,407,2736,41,2329,73
SP,72133,UCHOA,5202,5374,1229,6861,150,5632,194
SP,72150,UNIAO PAULISTA,714,1184,240,1231,30,991,12
SP,72176,URANIA,5394,4906,1547,7057,195,5510,165
SP,72192,URU,704,1022,395,1316,29,921,29
SP,72214,URUPES,5204,8504,1585,8808,152,7223,217
SP,72230,VALENTIM GENTIL,4382,5204,1024,6066,151,5042,98
SP,72257,VALINHOS,60972,38658,9121,61723,1177,52602,1610
SP,72273,VALPARAIZO,9616,10470,2807,13299,221,10492,228
SP,72311,VARGEM GRANDE DO SUL,17056,21134,4202,24422,608,20220,517
SP,72338,VARZEA PAULISTA,73248,26886,7563,60217,924,52654,1663
SP,72354,VERA CRUZ,7090,5598,1765,8488,153,6723,226
SP,72370,VINHEDO,31758,28124,5224,36786,758,31562,863
SP,72397,VIRADOURO,9744,8322,1789,11341,261,9552,258
SP,72419,VISTA ALEGRE DO ALTO,3744,1934,676,3776,185,3100,76
SP,72435,VOTORANTIM,78468,28690,7421,63408,848,55987,1560
SP,72451,VOTUPORANGA,37304,45200,8547,51736,906,43189,1031
SP,72737,VARGEM GRANDE PAULISTA,20246,17490,4662,24419,398,19757,491
TO,73008,ABREULANDIA,1288,732,506,1560,9,1054,35
TO,73016,PIRAQUE,1218,1258,523,1825,13,1302,51
TO,73024,RIACHINHO,1890,1414,692,2439,22,1747,73
TO,73032,DARCINOPOLIS,2182,2048,711,2958,21,2247,111
TO,73040,PALMEIRAS DO TOCANTINS,1446,2616,773,2905,21,2132,80
TO,73059,MAURILANDIA DO TOCANTINS,978,1918,533,2075,20,1542,74
TO,73067,CACHOEIRINHA,810,1014,307,1265,11,958,35
TO,73075,ANGICO,1058,1906,536,2087,12,1551,57
TO,73083,PALMEIRANTE,1128,1996,709,2354,9,1645,74
TO,73091,CAMPOS LINDOS,1372,2764,1066,3275,21,2209,120
TO,73105,SAO FELIX DO TOCANTINS,370,752,534,1123,6,589,22
TO,73113,LAGOA DO TOCANTINS,1114,1032,623,1777,16,1154,65
TO,73121,BOM JESUS DO TOCANTINS,1196,1092,553,1764,7,1211,60
TO,73130,SANTA MARIA DO TOCANTINS,1254,1004,483,1676,15,1193,49
TO,73148,NOVO ALEGRE,1258,870,521,1641,11,1120,45
TO,73156,SANDOLANDIA,1070,1854,786,2320,13,1534,59
TO,73164,TAIPAS DO TOCANTINS,796,664,547,1329,6,782,46
TO,73172,NOVO JARDIM,1184,798,474,1519,7,1045,47
TO,73180,SAO MIGUEL DO TOCANTINS,3158,2736,971,4101,33,3130,150
TO,73199,FORTALEZA DO TABOCAO,1524,1082,695,2064,12,1369,54
TO,73202,ITAPIRATINS,568,1716,1125,2351,18,1226,66
TO,73210,CENTENARIO,1176,752,581,1630,11,1049,74
TO,73229,RECURSOLANDIA,766,1986,665,2138,10,1473,87
TO,73237,TUPIRATINS,518,814,364,1083,9,719,44
TO,73245,BRASILANDIA DO TOCANTINS,990,1092,506,1606,9,1100,50
TO,73253,JUARINA,1194,866,445,1512,12,1067,25
TO,73261,PAU D'ARCO,1742,1774,950,2794,15,1844,71
TO,73270,MATEIROS,476,546,494,1051,5,557,41
TO,73288,SAO BENTO DO TOCANTINS,1182,2006,890,2579,22,1689,73
TO,73296,ESPERANTINA,3914,2052,1255,4432,38,3177,156
TO,73300,CARIRI DO TOCANTINS,1974,1340,672,2410,14,1738,67
TO,73318,ARAGUANA,1986,2048,1185,3300,16,2115,82
TO,73326,CARMOLANDIA,1398,1136,781,2129,12,1348,69
TO,73334,ARAGOMINAS,2104,3020,1497,4213,26,2716,128
TO,73342,MURICILANDIA,1388,1538,641,2208,9,1567,95
TO,73350,SANTA FE DO ARAGUAIA,2738,2570,1443,4236,25,2793,114
TO,73369,JAU DO TOCANTINS,1440,1882,755,2505,15,1750,74
TO,73377,SUCUPIRA,698,974,193,1073,10,880,34
TO,73385,LAGOA DA CONFUSAO,3158,1620,1011,3506,26,2495,80
TO,73393,SAO SALVADOR DO TOCANTINS,1098,962,581,1669,7,1088,51
TO,73407,LAGEADO,1496,954,898,2187,21,1289,43
TO,73415,RIO DOS BOIS,934,1074,495,1551,8,1056,44
TO,73423,CARRASCO BONITO,1228,1642,801,2336,9,1535,91
TO,73431,RIO DA CONCEICAO,928,496,293,1044,6,751,33
TO,73440,PALMAS,104816,48124,22402,101323,831,78921,1620
TO,73458,TUPIRAMA,530,828,361,1093,10,732,43
TO,73466,OLIVEIRA DE FATIMA,666,626,281,955,10,674,18
TO,73474,CHAPADA DE AREIA,914,920,602,1549,11,947,19
TO,73482,CHAPADA DA NATIVIDADE,1626,1404,661,2258,9,1597,73
TO,73504,TALISMA,1384,846,620,1794,15,1174,44
TO,73512,AGUIARNOPOLIS,1260,2394,420,2321,17,1901,57
TO,73520,LUZINOPOLIS,954,1294,336,1517,10,1181,47
TO,73539,SANTA TEREZINHA DO TOCANTINS,836,1626,320,1599,11,1279,37
TO,73547,SANTA RITA DO TOCANTINS,576,808,447,1166,5,719,22
TO,73555,CRIXAS DO TOCANTINS,860,898,549,1456,4,907,24
TO,73563,MONTE SANTO,1214,1340,394,1727,16,1333,40
TO,73571,PUGMIL,1060,924,412,1459,14,1047,41
TO,73580,BANDEIRANTE DO TOCANTINS,1390,1394,618,2060,5,1442,45
TO,73598,IPUEIRAS,606,868,307,1070,3,763,23
TO,73601,LAVANDEIRA,566,762,276,1001,14,725,47
TO,73610,BARRA DO OURO,924,2162,783,2390,12,1607,52
TO,92002,BERNARDO SAYAO,1358,2160,724,2573,20,1849,70
TO,92045,BURITI DO TOCANTINS,3280,3924,1261,5048,31,3787,154
TO,92070,ALMAS,3002,2982,1566,4757,34,3191,165
TO,92088,CASEARA,1808,1434,729,2416,5,1687,61
TO,92134,ALVORADA,3684,3782,2008,5939,50,3931,148
TO,92142,COMBINADO,2016,2180,903,3195,62,2292,132
TO,92185,DIVINOPOLIS DO TOCANTINS,3120,2328,1035,3890,42,2855,89
TO,92193,ANANAS,3792,4730,2124,6579,33,4455,161
TO,92240,GOIANORTE,1438,2988,1171,3477,20,2306,73
TO,92304,MARIANOPOLIS DO TOCANTINS,1452,1712,601,2258,21,1657,54
TO,92371,ARAGUACEMA,1678,2952,1213,3657,27,2444,102
TO,92398,ARAGUACU,3122,5348,2220,6665,66,4445,144
TO,92401,NOVA ROSALANDIA,1382,1670,539,2131,9,1592,57
TO,92410,ARAGUAINA,56898,43290,16628,68830,526,52202,1582
TO,92436,ARAGUATINS,8150,12278,3938,14688,125,10750,411
TO,92452,ARAPOEMA,3474,3120,1935,5385,40,3450,113
TO,92479,ARRAIAS,4496,2878,3274,7246,63,3972,222
TO,92487,PEQUIZEIRO,2018,2124,1024,3204,25,2180,84
TO,92509,PORTO ALEGRE DO TOCANTINS,1298,972,526,1729,13,1203,55
TO,92525,PRAIA NORTE,2946,2580,1358,4254,21,2896,112
TO,92533,AURORA DO TOCANTINS,1684,1566,879,2618,22,1739,92
TO,92541,SAMPAIO,1572,1342,580,2105,10,1525,58
TO,92576,AXIXA DO TOCANTINS,4536,5646,2199,7610,43,5411,277
TO,92584,SANTA ROSA DO TOCANTINS,1886,1840,758,2724,22,1966,81
TO,92592,BABACULANDIA,2308,5562,1611,5751,39,4140,166
TO,92606,SANTA TEREZA DO TOCANTINS,1322,950,486,1684,19,1198,43
TO,92681,SAO VALERIO DA NATIVIDADE,2424,1914,950,3224,25,2274,80
TO,92738,BREJINHO DE NAZARE,2654,2046,977,3456,28,2479,101
TO,93114,COLINAS DO TOCANTINS,12814,11642,4301,17106,141,12805,436
TO,93130,CONCEICAO DO TOCANTINS,1390,1522,1204,2751,20,1547,71
TO,93211,COUTO DE MAGALHAES,1994,1906,1226,3260,17,2034,67
TO,93238,CRISTALANDIA,4528,3066,1478,5463,42,3985,146
TO,93416,DIANOPOLIS,7674,4584,3334,9790,55,6456,272
TO,93459,DOIS IRMAOS DO TOCANTINS,2940,2430,1384,4214,30,2830,115
TO,93475,DUERE,2778,1526,872,3144,27,2272,93
TO,93556,FILADELFIA,2340,4714,1832,5568,44,3736,165
TO,93653,FORMOSO DO ARAGUAIA,8764,8002,4720,13503,123,8783,277
TO,93858,GURUPI,39642,24032,11918,45223,360,33305,1108
TO,94056,ITACAJA,1714,3618,1923,4726,24,2803,113
TO,94099,ITAGUATINS,3266,2500,1357,4414,20,3057,154
TO,94170,ITAPORA DO TOCANTINS,1106,1532,682,2070,22,1388,47
TO,94617,MIRACEMA DO TOCANTINS,10722,7792,4126,13908,140,9782,385
TO,94633,MIRANORTE,5766,6906,2669,9262,80,6593,177
TO,94692,MONTE DO CARMO,2840,2052,1145,3747,30,2602,126
TO,94811,NATIVIDADE,3444,4436,1697,5831,36,4134,158
TO,94838,NAZARE,1886,3138,891,3532,26,2641,103
TO,94994,NOVO ACORDO,1214,1848,965,2580,16,1615,68
TO,95192,PARAISO DO TOCANTINS,19152,17610,5469,24645,259,19176,536
TO,95214,PARANA,1854,3002,3147,5771,35,2624,161
TO,95257,PEDRO AFONSO,3914,3972,1726,5876,38,4150,169
TO,95273,PEIXE,3984,4042,1615,5863,44,4248,191
TO,95290,COLMEIA,3828,4944,2150,6774,60,4624,178
TO,95338,GOIATINS,2722,5088,2372,6556,38,4184,241
TO,95370,PINDORAMA DO TOCANTINS,1370,2614,955,3030,16,2075,67
TO,95478,PIUM,2412,2728,1266,4000,38,2734,126
TO,95516,PONTE ALTA DO BOM JESUS,1174,2812,1005,3172,25,2167,149
TO,95532,PONTE ALTA DO TOCANTINS,2442,3296,1123,4158,33,3035,133
TO,95591,PORTO NACIONAL,29796,10882,6610,27851,221,21241,681
TO,95699,LIZARDA,638,1760,1350,2604,11,1254,44
TO,96032,SAO SEBASTIAO DO TOCANTINS,1594,1708,817,2593,17,1776,108
TO,96130,SITIO NOVO DO TOCANTINS,5174,3584,1893,6537,40,4644,225
TO,96156,TAGUATINGA,4310,7272,2836,8996,66,6160,303
TO,96199,TOCANTINIA,2462,2080,1145,3530,25,2385,89
TO,96210,TOCANTINOPOLIS,11846,6462,2920,12587,107,9667,406
TO,96270,GUARAI,9408,10068,4033,14248,104,10215,373
TO,96296,PRESIDENTE KENNEDY,2280,1322,950,2871,36,1921,84
TO,96431,XAMBIOA,5398,5414,3005,8686,52,5681,223
TO,96490,PALMEIROPOLIS,2080,4352,1824,5182,36,3358,106
TO,96598,SILVANOPOLIS,2636,2050,1036,3503,22,2467,102
TO,96636,NOVA OLINDA,4020,3980,2601,6843,46,4242,196
TO,96652,WANDERLANDIA,4094,4472,2540,7072,50,4532,199
TO,96679,FIGUEIROPOLIS,2850,3074,1192,4281,27,3089,100
TO,96792,RIO SONO,2230,1750,1283,3375,24,2092,78
TO,96830,FATIMA,1708,2246,593,2654,35,2061,49
TO,96857,AUGUSTINOPOLIS,6302,5814,2812,9201,68,6389,263
TO,96954,ALIANCA DO TOCANTINS,3470,2476,1412,4546,32,3134,129
TO,96970,APARECIDA DO RIO NEGRO,1296,2188,744,2565,24,1821,55
TO,96997,BARROLANDIA,3176,2464,1352,4304,41,2952,91
