SG_UF,CD_MUNICIPIO,NM_MUNICIPIO,"('QT_VOTOS', 13, 'PARTIDO DOS TRABALHADORES')","('QT_VOTOS', 45, 'PARTIDO DA SOCIAL DEMOCRACIA BRASILEIRA')",QT_ABST,QT_APTOS,QT_BRANCOS,QT_COMPARECIMENTOS,QT_NULOS
AC,1007,BUJARI,1229,3224,863,5552,46,4689,190
AC,1015,CAPIXABA,847,3365,2064,6441,16,4377,149
AC,1023,PORTO ACRE,1460,5963,2765,10537,52,7772,297
AC,1031,SANTA ROSA DO PURUS,303,917,1039,2360,10,1321,91
AC,1040,MARECHAL THAUMATURGO,1698,2660,3219,7808,20,4589,211
AC,1058,BRASILÉIA,2992,7602,4276,15326,88,11050,368
AC,1066,PORTO WALTER,1301,1544,1845,4866,9,3021,167
AC,1074,CRUZEIRO DO SUL,10134,19070,17810,48422,277,30612,1131
AC,1082,RODRIGUES ALVES,1832,3183,3449,8695,27,5246,204
AC,1090,MÂNCIO LIMA,2395,3388,3598,9647,35,6049,231
AC,1104,JORDÃO,874,937,1741,3702,12,1961,138
AC,1112,EPITACIOLÂNDIA,1717,4830,2605,9422,60,6817,210
AC,1120,ACRELÂNDIA,1475,4451,2953,9111,65,6158,167
AC,1139,FEIJÓ,5711,4249,6512,17154,97,10642,585
AC,1392,RIO BRANCO,43426,119157,46267,217042,2280,170775,5912
AC,1457,SENA MADUREIRA,4369,9320,9603,24007,115,14404,600
AC,1473,TARAUACÁ,5177,5921,9470,21311,94,11841,649
AC,1490,XAPURI,2544,4697,3166,10790,59,7624,324
AC,1511,PLÁCIDO DE CASTRO,2110,6064,4097,12551,50,8454,230
AC,1538,SENADOR GUIOMARD,2930,8159,4302,15880,107,11578,382
AC,1554,MANOEL URBANO,1084,1830,1982,5077,19,3095,162
AC,1570,ASSIS BRASIL,1361,2235,691,4499,25,3808,187
AL,27006,PARIPUEIRA,2415,3285,1771,7928,143,6157,314
AL,27014,ÁGUA BRANCA,7531,1639,4749,14675,102,9926,654
AL,27022,PARICONHA,4476,650,2314,7856,47,5542,369
AL,27030,ANADIA,5019,3033,5123,13937,189,8814,573
AL,27049,ESTRELA DE ALAGOAS,5476,1593,4436,12250,130,7814,615
AL,27057,ARAPIRACA,42663,47437,29074,125965,1898,96891,4893
AL,27065,JEQUIÁ DA PRAIA,2902,1924,2922,8074,71,5152,255
AL,27073,ATALAIA,8967,9907,9219,29789,360,20570,1336
AL,27081,CAMPESTRE,2314,787,893,4287,65,3394,228
AL,27090,BARRA DE SANTO ANTÔNIO,3176,2840,987,7547,164,6560,380
AL,27111,BARRA DE SÃO MIGUEL,1666,2099,1203,5219,61,4016,190
AL,27138,BATALHA,5289,2203,3061,11076,76,8015,447
AL,27154,BELÉM,2072,951,1537,4863,68,3326,235
AL,27170,BELO MONTE,2444,604,1397,4675,21,3278,209
AL,27197,BOCA DA MATA,8753,4050,5918,19974,370,14056,883
AL,27219,BRANQUINHA,3082,1426,1099,6053,84,4954,362
AL,27235,CACIMBINHAS,3041,1741,1573,6823,63,5250,405
AL,27251,CAJUEIRO,4524,4436,4176,14012,176,9836,700
AL,27278,CAMPO ALEGRE,8527,4693,7666,22240,370,14574,984
AL,27294,CAMPO GRANDE,3998,1279,1854,7579,106,5725,342
AL,27316,CANAPI,6983,1142,4429,13218,93,8789,571
AL,27332,CAPELA,3340,4774,4209,13116,166,8907,627
AL,27359,CARNEIROS,2542,1175,1638,5687,48,4049,284
AL,27375,CHÃ PRETA,2729,1073,680,4861,76,4181,303
AL,27391,COITÉ DO NÓIA,3917,1286,862,6593,87,5731,441
AL,27413,COLÔNIA LEOPOLDINA,4719,4095,5100,14758,206,9658,638
AL,27430,COQUEIRO SECO,1691,1250,977,4184,107,3207,159
AL,27456,CORURIPE,8476,15642,10813,36868,569,26055,1368
AL,27472,DELMIRO GOUVEIA,19108,4071,10455,35345,342,24890,1369
AL,27499,DOIS RIACHOS,3829,1632,2848,8847,68,5999,470
AL,27510,FEIRA GRANDE,8129,2307,3847,15273,254,11426,736
AL,27537,FELIZ DESERTO,1152,944,956,3240,41,2284,147
AL,27553,FLEXEIRAS,2125,2892,2237,7782,135,5545,393
AL,27570,GIRAU DO PONCIANO,12158,2911,7329,23759,210,16430,1151
AL,27596,IBATEGUARA,4084,2608,3242,10679,160,7437,585
AL,27618,IGACI,8729,2770,2762,15562,248,12800,1053
AL,27634,IGREJA NOVA,7127,3903,4979,17110,295,12131,806
AL,27650,INHAPI,6677,891,4206,12619,105,8413,740
AL,27677,JACARÉ DOS HOMENS,2394,760,1376,4685,26,3309,129
AL,27693,JACUÍPE,2576,836,1679,5390,67,3711,232
AL,27715,JAPARATINGA,1750,1982,1926,5976,87,4050,231
AL,27731,JARAMATAIA,2056,964,482,3764,50,3282,212
AL,27758,JOAQUIM GOMES,4995,3402,5161,14401,168,9240,675
AL,27774,JUNDIÁ,1298,1132,1339,3921,40,2582,112
AL,27790,JUNQUEIRO,7628,4174,6060,18791,275,12731,654
AL,27812,LAGOA DA CANOA,6200,2492,3377,12916,184,9539,663
AL,27839,LIMOEIRO DE ANADIA,7712,2627,5248,16617,218,11369,812
AL,27855,MACEIÓ,152559,236597,113823,538534,11362,424711,24193
AL,27871,MAJOR ISIDORO,6243,2878,4971,14911,117,9940,702
AL,27898,MARAGOGI,5970,5434,4856,17433,391,12577,782
AL,27910,MARAVILHA,2562,2406,3039,8421,87,5382,327
AL,27936,MARECHAL DEODORO,7492,13225,8457,30890,517,22433,1199
AL,27952,MARIBONDO,3923,2826,1369,8844,160,7475,566
AL,27979,MAR VERMELHO,1340,903,813,3268,52,2455,160
AL,27995,MATA GRANDE,8985,1640,5822,17376,156,11554,773
AL,28010,MATRIZ DE CAMARAGIBE,4557,5976,5748,17159,241,11411,637
AL,28037,MESSIAS,3625,4099,3261,11697,211,8436,501
AL,28053,MINADOR DO NEGRÃO,1974,669,713,3591,41,2878,194
AL,28070,MONTEIRÓPOLIS,2383,946,1812,5410,44,3598,225
AL,28096,MURICI,5840,6281,5401,18904,314,13503,1068
AL,28118,NOVO LINO,2702,2659,2231,8099,146,5868,361
AL,28134,OLHO D'ÁGUA DAS FLORES,4560,4532,4309,14092,139,9783,552
AL,28150,OLHO D'ÁGUA DO CASADO,3455,567,1173,5541,51,4368,295
AL,28177,OLHO D'ÁGUA GRANDE,1899,691,1377,4177,50,2800,160
AL,28193,OLIVENÇA,3423,1953,2957,8788,66,5831,389
AL,28215,OURO BRANCO,4339,1167,2456,8338,65,5882,311
AL,28231,PALESTINA,1836,558,1324,3870,33,2546,119
AL,28258,PALMEIRA DOS ÍNDIOS,18403,14902,15296,51374,717,36078,2056
AL,28274,PÃO DE AÇÚCAR,8243,2789,6036,17744,130,11708,546
AL,28290,PASSO DE CAMARAGIBE,4256,2374,3472,10685,158,7213,425
AL,28312,PAULO JACINTO,3060,1136,1455,6010,81,4555,278
AL,28339,PENEDO,14156,11912,11408,39416,504,28008,1436
AL,28355,PIAÇABUÇU,4812,2951,4227,12669,153,8442,526
AL,28371,PILAR,5038,11431,7747,25578,471,17831,891
AL,28398,PINDOBA,1155,539,590,2417,17,1827,116
AL,28410,PIRANHAS,7944,1671,2927,13410,125,10483,743
AL,28436,POÇO DAS TRINCHEIRAS,4277,1685,971,7341,71,6370,337
AL,28452,PORTO CALVO,4550,7496,6783,20010,323,13227,858
AL,28479,PORTO DE PEDRAS,1799,1994,2332,6474,88,4142,261
AL,28495,PORTO REAL DO COLÉGIO,5203,4115,3776,13946,274,10170,578
AL,28517,QUEBRANGULO,4162,2039,1088,7855,100,6767,466
AL,28533,RIO LARGO,16980,15287,4248,39428,1088,35180,1825
AL,28550,ROTEIRO,986,1679,1859,4752,56,2893,172
AL,28576,SANTA LUZIA DO NORTE,2118,1707,1433,5541,65,4108,218
AL,28592,SANTANA DO IPANEMA,12344,8202,8590,30541,264,21951,1141
AL,28614,SANTANA DO MUNDAÚ,3470,1593,2393,8065,115,5672,494
AL,28630,SÃO BRÁS,2043,1369,1694,5422,128,3728,188
AL,28657,SÃO JOSÉ DA LAJE,7995,3184,3423,15822,247,12399,973
AL,28673,SÃO JOSÉ DA TAPERA,8425,3658,6857,20014,143,13157,931
AL,28690,SÃO LUÍS DO QUITUNDE,9426,5000,7016,22661,320,15645,899
AL,28711,SÃO MIGUEL DOS CAMPOS,8533,17058,8528,36312,647,27784,1546
AL,28738,SÃO MIGUEL DOS MILAGRES,1529,1918,718,4561,124,3843,272
AL,28754,SÃO SEBASTIÃO,10207,4831,7263,23657,406,16394,950
AL,28770,SATUBA,3023,3493,2245,9286,204,7041,321
AL,28797,TANQUE D'ARCA,2228,802,1026,4362,79,3336,227
AL,28819,TAQUARANA,5820,2650,4063,13448,162,9385,753
AL,28835,TRAIPU,7664,2954,7044,18630,131,11586,837
AL,28851,UNIÃO DOS PALMARES,16384,10719,12994,42896,632,29902,2167
AL,28878,VIÇOSA,8137,4751,5764,19810,273,14046,885
AL,28894,CRAÍBAS,8084,2598,4075,15703,185,11628,761
AL,28916,SENADOR RUI PALMEIRA,4180,1132,2509,8289,62,5780,406
AL,28932,TEOTÔNIO VILELA,8476,9430,9921,29262,445,19341,990
AM,2003,APUÍ,4150,1565,3148,9055,55,5907,137
AM,2011,NOVO AIRÃO,3718,781,1842,6463,41,4621,81
AM,2020,GUAJARÁ,2446,1509,3654,7818,25,4164,184
AM,2038,ANORI,4021,953,3365,8465,34,5100,92
AM,2046,CAREIRO DA VÁRZEA,8026,765,5040,14038,57,8998,150
AM,2054,ATALAIA DO NORTE,1877,1196,1852,5025,12,3173,88
AM,2070,AUTAZES,10132,1276,6606,18370,101,11764,255
AM,2097,BARCELOS,3275,1130,3456,8007,35,4551,111
AM,2119,BARREIRINHA,8627,795,5194,14907,51,9713,240
AM,2135,BENJAMIN CONSTANT,10297,1262,4292,16318,77,12026,390
AM,2151,BOCA DO ACRE,5674,5069,6321,17573,118,11252,391
AM,2178,BORBA,9273,977,6858,17422,53,10564,261
AM,2194,CANUTAMA,2240,1159,2831,6372,33,3541,109
AM,2216,CARAUARI,6475,1659,7862,16290,53,8428,241
AM,2232,CAREIRO,9548,888,7332,18083,80,10751,235
AM,2259,COARI,21146,3539,16376,41930,283,25554,586
AM,2275,CODAJÁS,6000,1322,5570,13119,53,7549,174
AM,2291,EIRUNEPÉ,8654,1023,8401,18476,68,10075,330
AM,2313,ENVIRA,3725,1316,4680,9869,23,5189,125
AM,2330,FONTE BOA,6337,950,4754,12308,30,7554,237
AM,2356,HUMAITÁ,12837,3212,7545,24068,122,16523,352
AM,2372,SANTA ISABEL DO RIO NEGRO,1933,1200,2570,5792,13,3222,76
AM,2399,IPIXUNA,2559,1396,4376,8604,34,4228,239
AM,2410,ITACOATIARA,30543,6727,18109,56335,382,38226,574
AM,2437,ITAPIRANGA,3124,570,2031,5802,25,3771,52
AM,2453,JAPURÁ,1545,262,1333,3192,8,1859,44
AM,2470,JURUÁ,1502,1491,2650,5760,14,3110,103
AM,2496,JUTAÍ,4201,998,4352,9744,24,5392,169
AM,2518,LÁBREA,9114,2019,8413,20007,71,11594,390
AM,2534,MANACAPURU,31024,5856,19912,58044,389,38132,863
AM,2550,MANAUS,679131,179371,215813,1123837,25969,908024,23553
AM,2577,MANICORÉ,10475,3844,8443,23151,51,14708,338
AM,2593,MARAÃ,2415,541,4361,7414,7,3053,90
AM,2615,MAUÉS,15469,1456,10119,27519,130,17400,345
AM,2631,NHAMUNDÁ,5594,1204,4259,11205,39,6946,109
AM,2658,NOVA OLINDA DO NORTE,7220,843,5174,13448,51,8274,160
AM,2674,NOVO ARIPUANÃ,5242,786,4487,10696,28,6209,153
AM,2690,PARINTINS,32747,7010,17066,57697,311,40631,563
AM,2712,PAUINI,3747,1109,3495,8552,25,5057,176
AM,2739,SANTO ANTÔNIO DO IÇÁ,5120,2213,3071,10763,85,7692,274
AM,2755,SÃO PAULO DE OLIVENÇA,7228,2109,2693,12411,64,9718,317
AM,2771,SILVES,3354,343,2152,5920,17,3768,54
AM,2798,TAPAUÁ,4185,1303,4950,10704,41,5754,225
AM,2810,TEFÉ,19223,2466,11203,33570,185,22367,493
AM,2836,SÃO GABRIEL DA CACHOEIRA,11396,2393,8546,22746,87,14200,324
AM,2852,URUCARÁ,5293,617,3648,9697,49,6049,90
AM,2879,URUCURITUBA,5209,690,4057,10144,49,6087,139
AM,2895,ALVARÃES,4369,413,3007,7944,25,4937,130
AM,2917,AMATURÁ,2705,510,1241,4597,21,3356,120
AM,2933,ANAMÃ,2768,632,2547,6034,15,3487,72
AM,2950,BERURI,3739,1015,3483,8367,19,4884,111
AM,2976,BOA VISTA DO RAMOS,5000,563,3296,8999,24,5703,116
AM,2992,CAAPIRANGA,3099,288,3065,6550,33,3485,65
AM,98353,IRANDUBA,15690,1636,6291,24149,170,17858,362
AM,98370,ITAMARATI,2129,424,2656,5305,12,2649,84
AM,98396,MANAQUIRI,5903,430,4302,10827,35,6525,157
AM,98418,PRESIDENTE FIGUEIREDO,9060,1578,3606,14625,126,11019,255
AM,98434,RIO PRETO DA EVA,6775,1292,3234,11557,99,8323,157
AM,98450,SÃO SEBASTIÃO DO UATUMÃ,2282,792,1748,4904,25,3156,57
AM,98477,TABATINGA,14205,3166,6391,24559,187,18168,610
AM,98493,UARINI,3131,381,2407,6030,17,3623,94
AM,98515,TONANTINS,3681,1050,2190,7062,9,4872,132
AP,6009,PRACUÚBA,1348,410,640,2508,16,1868,94
AP,6017,AMAPÁ,3099,879,1330,5548,33,4218,207
AP,6025,PORTO GRANDE,5563,1870,2145,10126,59,7981,489
AP,6033,CALÇOENE,3212,1214,1635,6371,39,4736,271
AP,6041,ITAUBAL,1906,728,967,3760,24,2793,135
AP,6050,MACAPÁ,112522,77412,40242,243110,2974,202868,9960
AP,6068,CUTIAS,1468,786,1078,3482,20,2404,130
AP,6076,MAZAGÃO,6140,2198,2817,11675,53,8858,467
AP,6084,ÁGUA BRANCA DO AMAPARI,2638,946,1328,5189,19,3861,258
AP,6092,OIAPOQUE,5934,2584,5990,15382,110,9392,764
AP,6106,SERRA DO NAVIO,1418,810,882,3226,21,2344,95
AP,6114,FERREIRA GOMES,1922,993,483,3599,27,3116,174
AP,6122,VITÓRIA DO JARI,4312,1728,3124,9584,43,6460,377
AP,6130,LARANJAL DO JARI,12452,5213,6989,25865,225,18876,986
AP,6157,SANTANA,31482,18942,10424,63994,746,53570,2400
AP,6173,TARTARUGALZINHO,3228,1647,1722,6930,34,5208,299
BA,30007,LUÍS EDUARDO MAGALHÃES,9773,9675,5894,26060,292,20166,426
BA,30058,EUNÁPOLIS,23291,22549,19931,68182,696,48251,1715
BA,30660,IUIU,4266,1071,2240,7836,59,5596,200
BA,30678,JABORANDI,3741,1248,1618,6884,71,5266,206
BA,30694,JUSSARI,1985,1168,1122,4430,35,3308,120
BA,30716,AMÉRICA DOURADA,5728,1848,3862,11801,78,7939,285
BA,30732,ARATACA,2678,1273,1565,5744,38,4179,190
BA,30759,BARRO ALTO,4950,1644,1684,8596,71,6912,247
BA,30775,BARROCAS,6789,1443,2403,11044,95,8641,314
BA,30791,BURITIRAMA,5500,3166,4814,14132,47,9318,605
BA,30813,CAPELA DO ALTO ALEGRE,4291,1666,1924,8400,168,6476,351
BA,30830,CAPIM GROSSO,8249,4933,5469,19556,324,14087,581
BA,30856,CANUDOS,6454,1027,3615,11538,81,7923,361
BA,30872,DIAS D'ÁVILA,22029,6009,8844,38857,794,30013,1181
BA,30899,FÁTIMA,7032,2281,3777,13594,119,9817,385
BA,30910,FILADÉLFIA,5693,3071,3792,13161,184,9369,421
BA,30937,GAVIÃO,1682,984,862,3743,39,2881,176
BA,30953,GUAJERU,3529,693,2812,7242,35,4430,173
BA,30970,HELIÓPOLIS,5342,1526,3444,10629,73,7185,244
BA,30996,JOÃO DOURADO,6981,4319,4576,16448,148,11872,424
BA,33014,ABAÍRA,2943,1740,1464,6504,81,5040,276
BA,33030,ABARÉ,7833,818,1700,10782,66,9082,365
BA,33057,ACAJUTIBA,4953,2167,2188,9735,134,7547,293
BA,33065,ADUSTINA,5700,2160,3132,11486,104,8354,390
BA,33073,ÁGUA FRIA,5623,1953,2445,10700,120,8255,559
BA,33090,ÉRICO CARDOSO,4056,1340,2933,8678,78,5745,271
BA,33111,AIQUARA,2079,549,1189,3991,44,2802,130
BA,33138,ALAGOINHAS,46823,23446,22711,97748,1962,75037,2806
BA,33154,ALCOBAÇA,7630,2215,5336,15772,139,10436,452
BA,33170,ALMADINA,2153,1099,1392,4831,47,3439,140
BA,33197,AMARGOSA,10402,6289,4491,22339,374,17848,783
BA,33219,AMÉLIA RODRIGUES,8550,3537,2800,15799,330,12999,582
BA,33235,ANAGÉ,7911,4085,4026,16746,118,12720,606
BA,33251,ANDARAÍ,5336,840,3252,9836,91,6584,317
BA,33260,ANDORINHA,7353,1128,2991,11840,92,8849,276
BA,33278,ANGICAL,6620,1834,2406,11236,62,8830,314
BA,33294,ANGUERA,4721,993,1873,7899,71,6026,241
BA,33316,ANTAS,5198,1580,2037,9180,95,7143,270
BA,33332,ANTÔNIO CARDOSO,5886,1394,1596,9298,111,7702,311
BA,33359,ANTÔNIO GONÇALVES,3354,1719,1491,6864,43,5373,257
BA,33375,APORÁ,5754,2578,3885,12760,129,8875,414
BA,33383,ARAÇÁS,4994,1518,2850,9707,98,6857,247
BA,33391,ARACATU,6079,1678,3142,11333,111,8191,323
BA,33405,APUAREMA,2115,1587,1551,5500,43,3949,204
BA,33413,ARACI,19338,3682,12492,36597,186,24105,899
BA,33430,ARAMARI,4445,1178,1323,7318,115,5995,257
BA,33456,ARATUÍPE,3497,1520,1636,6968,85,5332,230
BA,33472,AURELINO LEAL,4825,1210,4321,10670,85,6349,229
BA,33499,BAIANÓPOLIS,5959,1377,2295,9974,63,7679,280
BA,33510,BAIXA GRANDE,5720,4174,3456,14140,233,10684,557
BA,33529,BANZAÊ,4668,1531,2593,9106,65,6513,249
BA,33537,BARRA,15566,5076,10290,32370,208,22080,1230
BA,33553,BARRA DA ESTIVA,8514,3181,3396,15730,190,12334,449
BA,33570,BARRA DO CHOÇA,8894,6985,6889,24012,274,17123,970
BA,33596,BARRA DO MENDES,6011,1225,3340,10991,87,7651,328
BA,33618,BARRA DO ROCHA,1986,725,1349,4207,31,2858,116
BA,33634,BARREIRAS,42765,16310,19615,81282,934,61667,1658
BA,33650,BARRO PRETO,2249,1197,1070,4757,73,3687,168
BA,33677,BELMONTE,6143,2995,3918,13663,150,9745,457
BA,33693,BELO CAMPO,5365,3284,4721,13811,77,9090,364
BA,33715,BIRITINGA,6718,979,2196,10462,131,8266,438
BA,33731,BOA NOVA,5912,1223,4963,12712,115,7749,499
BA,33758,BOA VISTA DO TUPIM,6130,2367,2512,11615,118,9103,488
BA,33774,BOM JESUS DA LAPA,21021,6656,13637,42780,428,29143,1038
BA,33782,BOM JESUS DA SERRA,4233,671,2724,7942,51,5218,263
BA,33790,BONINAL,4336,1594,2474,8759,70,6285,285
BA,33804,BONITO,4281,2947,2801,10445,102,7644,314
BA,33812,BOQUIRA,8630,1398,3861,14411,113,10550,409
BA,33839,BOTUPORÃ,4569,1138,2741,8765,52,6024,265
BA,33855,BREJÕES,5238,1721,3933,11391,128,7458,371
BA,33871,BREJOLÂNDIA,3791,1228,1917,7206,62,5289,208
BA,33898,BROTAS DE MACAÚBAS,3875,2134,1826,8183,73,6357,275
BA,33910,BRUMADO,25707,7504,6423,41555,533,35132,1388
BA,33936,BUERAREMA,4083,5292,2788,12678,126,9890,389
BA,33952,CAATIBA,2951,1186,2405,6835,54,4430,239
BA,33960,CABACEIRAS DO PARAGUAÇU,5485,2593,3961,12558,107,8597,412
BA,33979,CACHOEIRA,12832,3475,4370,21658,352,17288,629
BA,33995,CACULÉ,6990,3822,2990,14538,205,11548,531
BA,34010,CAEM,4280,1168,2647,8592,75,5945,422
BA,34029,CAETANOS,4216,949,2987,8440,41,5453,247
BA,34037,CAETITÉ,18069,6949,6969,33644,333,26675,1324
BA,34053,CAFARNAUM,5096,2824,3809,12188,156,8379,303
BA,34070,CAIRU,4208,2330,2170,9045,130,6875,207
BA,34096,CALDEIRÃO GRANDE,3744,1111,1716,6927,65,5211,291
BA,34118,CAMACAN,8441,3674,4345,17365,212,13020,693
BA,34134,CAMAÇARI,67142,32656,25279,134109,3669,108830,5363
BA,34150,CAMAMU,6489,7774,8073,23298,218,15225,744
BA,34177,CAMPO ALEGRE DE LOURDES,9300,3070,6705,19843,85,13138,683
BA,34193,CAMPO FORMOSO,20615,10633,11045,44324,594,33279,1437
BA,34215,CANÁPOLIS,3911,1431,1281,6971,44,5690,304
BA,34231,CANARANA,8868,2647,3067,15163,119,12096,462
BA,34258,CANAVIEIRAS,9884,5398,9873,25998,192,16125,651
BA,34274,CANDEAL,3757,1099,1060,6227,73,5167,238
BA,34290,CANDEIAS,35241,5630,9800,54250,1700,44450,1879
BA,34312,CANDIBA,5910,1397,1599,9338,110,7739,322
BA,34339,CÂNDIDO SALES,8649,4121,7606,21010,145,13404,489
BA,34355,CANSANÇÃO,14085,1793,7833,24631,155,16798,765
BA,34363,CARAÍBAS,3213,1865,1841,7215,63,5374,233
BA,34371,CARAVELAS,6442,2195,2996,12322,134,9326,555
BA,34398,CARDEAL DA SILVA,3467,685,2021,6466,81,4445,212
BA,34410,CARINHANHA,7890,5412,5785,19657,131,13872,439
BA,34436,CASA NOVA,28341,5249,8738,44222,424,35484,1470
BA,34452,CASTRO ALVES,11397,2963,5515,20613,205,15098,533
BA,34479,CATOLÂNDIA,2155,237,680,3198,28,2518,98
BA,34495,CATU,23653,3755,5229,34989,998,29760,1354
BA,34509,CATURAMA,3701,741,1945,6668,72,4723,209
BA,34517,CENTRAL,6619,2277,2263,11604,110,9341,335
BA,34533,CHORROCHÓ,4618,989,2061,7973,40,5912,265
BA,34550,CÍCERO DANTAS,11857,4330,4904,22161,309,17257,761
BA,34576,CIPÓ,4824,3161,2817,11368,152,8551,414
BA,34592,COARACI,7620,3809,3437,15537,176,12100,495
BA,34614,COCOS,6026,2653,4863,14049,98,9186,409
BA,34630,CONCEIÇÃO DA FEIRA,6566,3656,1984,13022,375,11038,441
BA,34657,CONCEIÇÃO DO ALMEIDA,7348,1706,3990,13609,169,9619,396
BA,34673,CONCEIÇÃO DO COITÉ,21646,11876,7936,43226,559,35290,1209
BA,34690,CONCEIÇÃO DO JACUÍPE,9525,5503,3232,19273,379,16041,634
BA,34711,CONDE,7415,2556,4533,15090,162,10557,424
BA,34738,CONDEÚBA,6807,2375,3682,13493,121,9811,508
BA,34754,CONTENDAS DO SINCORÁ,1606,759,575,3039,24,2464,75
BA,34770,CORAÇÃO DE MARIA,10386,2952,3810,17966,256,14156,562
BA,34797,CORDEIROS,2327,1701,1349,5676,40,4327,259
BA,34819,CORIBE,6168,1723,4050,12361,104,8311,316
BA,34835,CORONEL JOÃO SÁ,5989,1953,3724,12165,100,8441,399
BA,34851,CORRENTINA,10984,5012,7708,24812,285,17104,823
BA,34878,COTEGIPE,5173,1125,3350,9975,49,6625,278
BA,34894,CRAVOLÂNDIA,2180,554,1051,4046,82,2995,179
BA,34916,CRISÓPOLIS,7943,1914,5238,15670,88,10432,487
BA,34932,CRISTÓPOLIS,6259,1288,2638,10594,62,7956,347
BA,34959,CRUZ DAS ALMAS,18625,11451,5222,36991,719,31769,974
BA,34975,CURAÇÁ,12963,3498,6003,23167,181,17164,522
BA,34991,DÁRIO MEIRA,3917,1079,3519,8914,90,5395,309
BA,35017,DOM BASÍLIO,5106,1779,1584,8849,110,7265,270
BA,35033,DOM MACEDO COSTA,1889,673,676,3425,42,2749,145
BA,35050,ELÍSIO MEDRADO,3067,1804,1954,7109,78,5155,206
BA,35076,ENCRUZILHADA,6324,3262,5837,16121,127,10284,571
BA,35092,ENTRE RIOS,13021,4501,8346,27157,519,18811,770
BA,35114,ESPLANADA,10310,4849,4715,20860,355,16145,631
BA,35130,EUCLIDES DA CUNHA,20896,5796,8393,36550,280,28157,1185
BA,35149,FEIRA DA MATA,2007,1059,1305,4472,27,3167,74
BA,35157,FEIRA DE SANTANA,158577,108974,71620,359325,6672,287705,13482
BA,35173,FIRMINO ALVES,1663,1136,854,3883,80,3029,150
BA,35190,FLORESTA AZUL,3230,1744,1601,6918,87,5317,256
BA,35211,FORMOSA DO RIO PRETO,7171,3293,4756,15655,72,10899,363
BA,35238,GANDU,8000,5475,3831,18264,299,14433,659
BA,35254,GENTIO DO OURO,4657,1112,1481,7583,57,6102,276
BA,35270,GLÓRIA,7187,1172,3005,11786,101,8781,321
BA,35297,GONGOGI,2336,852,3191,6557,42,3366,136
BA,35319,GOVERNADOR MANGABEIRA,8148,2506,3788,15070,224,11282,404
BA,35335,GUANAMBI,25508,15061,11717,54733,688,43016,1759
BA,35351,GUARATINGA,7553,1875,3908,13842,112,9934,394
BA,35378,IAÇU,9295,2491,8053,20718,239,12665,640
BA,35394,IBIASSUCÊ,3605,2244,2164,8367,57,6203,297
BA,35416,IBICARAÍ,6552,5446,3656,16367,185,12711,528
BA,35432,IBICOARA,5172,2740,2441,10868,123,8427,392
BA,35459,IBICUÍ,4972,2454,2547,10440,108,7893,359
BA,35475,IBIPEBA,7370,1157,3488,12460,108,8972,337
BA,35491,SANTA RITA DE CÁSSIA,9888,3609,6589,20763,154,14174,523
BA,35513,IBIPITANGA,5560,1173,3515,10616,90,7101,278
BA,35530,IBIQUERA,1834,352,823,3164,27,2341,128
BA,35556,IBIRAPITANGA,6042,2145,2825,11591,147,8766,432
BA,35572,IBIRAPUÃ,2507,1507,1234,5501,51,4267,202
BA,35599,IBIRATAIA,6316,3575,6732,17364,196,10632,545
BA,35610,IBITIARA,6037,1577,2412,10471,88,8059,357
BA,35637,IBITITÁ,7951,1456,2717,12533,107,9816,302
BA,35653,IBOTIRAMA,8892,3577,3664,16745,150,13081,462
BA,35670,ICHU,2622,976,685,4490,49,3805,158
BA,35696,IGAPORÃ,5930,1789,1877,10082,113,8205,373
BA,35700,IGRAPIÚNA,4077,1762,3219,9542,100,6323,384
BA,35718,IGUAÍ,8711,2836,7013,19388,145,12375,683
BA,35734,ILHÉUS,54528,32253,37362,129719,2122,92357,3454
BA,35750,INHAMBUPE,12767,4042,4330,22107,285,17777,683
BA,35777,IPECAETÁ,5976,2368,2429,11278,97,8849,408
BA,35793,IPIAÚ,15115,5281,5674,27402,439,21728,893
BA,35815,IPIRÁ,20365,7809,9462,39550,405,30088,1509
BA,35831,IPUPIARA,3473,1572,1785,7083,77,5298,176
BA,35858,IRAJUBA,2910,695,985,4792,37,3807,165
BA,35874,IRAMAIA,4247,1602,3143,9329,96,6186,241
BA,35890,IRAQUARA,8942,1690,2755,13845,105,11090,353
BA,35912,IRARÁ,10832,3560,4428,19734,282,15306,632
BA,35939,IRECÊ,19831,8893,11781,42275,559,30494,1211
BA,35947,ITABELA,7562,5508,7518,21417,238,13899,591
BA,35955,ITABERABA,19087,7162,7191,35553,671,28362,1442
BA,35971,ITABUNA,52855,50856,30571,139792,2094,109221,3416
BA,35998,ITACARÉ,5900,1991,1929,10336,154,8407,362
BA,36013,ITAETÉ,4576,1850,2297,9223,93,6926,407
BA,36030,ITAGI,4160,2835,2238,9677,87,7439,357
BA,36056,ITAGIBÁ,6005,1546,2539,10546,119,8007,337
BA,36072,ITAGIMIRIM,1936,1390,1563,5146,48,3583,209
BA,36080,ITAGUAÇU DA BAHIA,5373,671,2208,8569,54,6361,263
BA,36099,ITAJU DO COLÔNIA,2086,989,988,4221,34,3233,124
BA,36110,ITAJUÍPE,6873,4209,3552,15247,210,11695,403
BA,36137,ITAMARAJU,15046,12041,10302,38996,455,28694,1152
BA,36153,ITAMARI,2678,1569,1627,6119,54,4492,191
BA,36170,ITAMBÉ,7439,4788,6262,19129,142,12867,498
BA,36196,ITANAGRA,2086,631,1406,4304,40,2898,141
BA,36218,ITANHÉM,7485,2597,4239,15012,181,10773,510
BA,36234,ITAPARICA,8104,1915,4077,14725,236,10648,393
BA,36250,ITAPÉ,3503,2189,2648,8706,104,6058,262
BA,36277,ITAPEBI,2880,1389,2272,6781,43,4509,197
BA,36293,ITAPETINGA,15558,15629,7546,40329,554,32783,1042
BA,36315,ITAPICURU,11292,2019,6759,20964,155,14205,739
BA,36331,ITAPITANGA,3194,920,2718,7046,53,4328,161
BA,36358,ITAQUARA,2879,1272,1389,5812,75,4423,197
BA,36374,ITARANTIM,5740,2619,3097,11988,129,8891,403
BA,36382,ITATIM,4038,3224,2459,10174,106,7715,347
BA,36390,ITIRUÇU,3967,2504,2623,9536,142,6913,300
BA,36412,ITIÚBA,12399,5520,8281,27323,220,19042,903
BA,36439,ITORORÓ,5020,5450,4420,15532,142,11112,500
BA,36455,ITUAÇU,5029,5036,2669,13304,147,10635,423
BA,36471,ITUBERÁ,7340,4906,5843,18873,218,13030,566
BA,36498,JACARACI,5288,1555,3432,10756,88,7324,393
BA,36510,JACOBINA,27548,8266,11208,49465,618,38257,1825
BA,36536,JAGUAQUARA,15258,6364,10569,33801,489,23232,1121
BA,36552,JAGUARARI,10344,4821,3434,19448,234,16014,615
BA,36579,JAGUARIPE,6034,1317,2493,10380,178,7887,358
BA,36595,JANDAÍRA,3571,846,2501,7187,50,4686,219
BA,36617,JEQUIÉ,48342,18623,20795,93191,1985,72396,3446
BA,36633,JEREMOABO,14141,2766,5410,23301,149,17891,835
BA,36650,JIQUIRIÇÁ,3983,2911,2989,10403,146,7414,374
BA,36676,JITAÚNA,5492,2469,5279,13793,145,8514,408
BA,36692,JUAZEIRO,71389,22989,26563,125195,1418,98632,2836
BA,36706,JUCURUÇU,4018,958,2038,7324,39,5286,271
BA,36714,JUSSARA,6661,960,2532,10615,85,8083,377
BA,36730,JUSSIAPE,3418,1173,1491,6318,55,4827,181
BA,36757,LAFAIETE COUTINHO,2122,349,603,3215,40,2612,101
BA,36765,LAGOA REAL,5047,1655,2516,9595,65,7079,312
BA,36773,LAJE,9659,2426,4686,17635,203,12949,661
BA,36790,LAJEDÃO,1813,832,733,3512,22,2779,112
BA,36811,LAJEDINHO,1825,247,618,2838,13,2220,135
BA,36820,LAJEDO DO TABOCAL,3118,854,1222,5504,81,4282,229
BA,36838,LAMARÃO,3253,726,2694,6934,57,4240,204
BA,36854,LAURO DE FREITAS,50995,19139,21372,97521,2236,76149,3779
BA,36870,LENÇÓIS,3468,888,1972,6616,61,4644,227
BA,36897,LICÍNIO DE ALMEIDA,4132,2126,1869,8470,95,6601,248
BA,36919,LIVRAMENTO DE NOSSA SENHORA,16783,4937,8252,31195,360,22943,863
BA,36935,MACAJUBA,3574,2042,3123,9213,93,6090,381
BA,36951,MACARANI,5273,3234,3345,12529,156,9184,521
BA,36978,MACAÚBAS,16585,4483,9545,31802,254,22257,935
BA,36994,MACURURÉ,3255,832,1952,6269,40,4317,190
BA,37010,MAIQUINIQUE,2959,1464,1577,6289,66,4712,223
BA,37036,MAIRI,6269,2784,3361,13113,166,9752,533
BA,37052,MALHADA,6004,1878,3519,11791,107,8272,283
BA,37079,MALHADA DE PEDRAS,3607,1110,1227,6204,70,4977,190
BA,37095,MANOEL VITORINO,5568,1291,1663,8857,61,7194,274
BA,37117,MARACÁS,8544,3499,6564,19377,232,12813,538
BA,37133,MARAGOGIPE,14219,7046,5204,27737,417,22533,851
BA,37150,MARAÚ,5430,1726,4635,12288,123,7653,374
BA,37176,MARCIONÍLIO SOUZA,3774,1008,2018,7112,75,5094,237
BA,37192,MASCOTE,4060,1930,2638,8963,79,6325,256
BA,37214,MATA DE SÃO JOÃO,16615,5007,6399,29659,734,23260,904
BA,37222,MATINA,4932,709,2212,8216,57,6004,306
BA,37230,MEDEIROS NETO,8143,3498,4153,16552,155,12399,603
BA,37257,MIGUEL CALMON,10845,2934,6957,21755,191,14798,828
BA,37273,MILAGRES,4969,948,1987,8240,73,6253,263
BA,37290,MIRANGABA,4675,2356,3904,11364,81,7460,348
BA,37303,MIRANTE,3252,1380,2152,7051,40,4899,227
BA,37311,MONTE SANTO,21415,4055,12964,40013,270,27049,1309
BA,37338,MORPARÁ,3217,1409,1620,6495,36,4875,213
BA,37354,MORRO DO CHAPÉU,10995,4228,5470,21732,238,16262,801
BA,37370,MORTUGABA,4320,1601,2152,8441,70,6289,298
BA,37397,MUCUGÊ,3696,2142,1776,7985,76,6209,295
BA,37419,MUCURI,10222,4754,9632,25400,252,15768,540
BA,37427,MULUNGU DO MORRO,4375,1163,2792,8567,68,5775,169
BA,37435,MUNDO NOVO,7826,2034,3514,14124,190,10610,560
BA,37451,MUNIZ FERREIRA,3701,1099,1517,6523,47,5006,159
BA,37460,MUQUÉM DO SÃO FRANCISCO,4173,942,2058,7384,26,5326,185
BA,37478,MURITIBA,11044,3622,6405,22114,377,15709,666
BA,37494,MUTUÍPE,6359,5168,4808,17149,210,12341,604
BA,37516,NAZARÉ,11541,2731,4748,19890,335,15142,535
BA,37532,NILO PEÇANHA,3424,1925,1497,7241,128,5744,267
BA,37559,NOVA CANAÃ,5472,1662,2939,10676,96,7737,507
BA,37567,NOVA FÁTIMA,2988,1557,1246,6127,94,4881,242
BA,37575,NOVA ITARANA,2612,968,1246,5051,42,3805,183
BA,37583,NOVA REDENÇÃO,3204,647,1369,5525,75,4156,230
BA,37591,NOVA SOURE,10328,1810,3702,16605,165,12903,600
BA,37613,NOVA VIÇOSA,10475,5915,8383,25705,259,17322,673
BA,37621,NOVO TRIUNFO,2796,1881,2604,7543,26,4939,236
BA,37630,OLINDINA,10382,1934,6676,19767,161,13091,614
BA,37656,OLIVEIRA DOS BREJINHOS,8764,2156,3470,14976,131,11506,455
BA,37672,OURIÇANGAS,3021,1495,1483,6342,82,4859,261
BA,37680,OUROLÂNDIA,4652,2970,4491,12569,65,8078,391
BA,37699,PALMAS DE MONTE ALTO,9057,2074,3096,14915,123,11819,565
BA,37710,PALMEIRAS,3406,804,1122,5541,46,4419,163
BA,37737,PARAMIRIM,8423,1843,4768,15617,165,10849,418
BA,37753,PARATINGA,11024,3813,4248,19833,139,15585,609
BA,37770,PARIPIRANGA,10725,4331,6159,22105,246,15946,644
BA,37796,PAU BRASIL,3284,1637,1995,7198,71,5203,211
BA,37818,PAULO AFONSO,41813,9590,18633,72295,701,53662,1558
BA,37834,PEDRÃO,2942,785,1491,5410,58,3919,134
BA,37850,PEDRO ALEXANDRE,4478,1196,2819,8890,54,6071,343
BA,37877,PIATÃ,7438,1938,3730,13750,111,10020,533
BA,37893,PILÃO ARCADO,12472,2401,5550,21289,129,15739,737
BA,37915,PINDAÍ,5121,2866,2797,11338,139,8541,415
BA,37931,PINDOBAÇU,5962,3926,3048,13466,166,10418,364
BA,37940,PIRAÍ DO NORTE,2300,1565,1103,5206,42,4103,196
BA,37958,PIRIPÁ,3256,1717,3403,8642,32,5239,234
BA,37974,PIRITIBA,7024,1798,2568,12075,122,9507,563
BA,37990,PLANALTINO,3337,795,1122,5538,70,4416,214
BA,38016,PLANALTO,8198,3731,2691,15296,141,12605,535
BA,38032,POÇÕES,13463,6395,11213,32458,362,21245,1025
BA,38059,POJUCA,14567,3435,2530,22282,899,19752,851
BA,38067,PONTO NOVO,4533,2951,3523,11448,90,7925,351
BA,38075,PORTO SEGURO,29572,18138,21471,71961,926,50490,1854
BA,38091,POTIRAGUÁ,3581,1352,3334,8576,77,5242,232
BA,38113,PRADO,7298,4123,7385,19510,158,12125,546
BA,38130,PRESIDENTE DUTRA,6807,804,1755,9785,82,8030,337
BA,38156,PRESIDENTE JÂNIO QUADROS,4531,1299,4651,10911,48,6260,382
BA,38164,PRESIDENTE TANCREDO NEVES,5628,6748,4483,17694,160,13211,675
BA,38172,QUEIMADAS,9328,2959,4147,17165,195,13018,536
BA,38199,QUINJINGUE,9922,3177,4642,18535,115,13893,679
BA,38210,REMANSO,15999,3138,5514,25806,201,20292,954
BA,38237,RETIROLÂNDIA,5497,1925,1590,9473,153,7883,308
BA,38253,RIACHÃO DAS NEVES,9101,1893,4347,16030,112,11683,577
BA,38270,RIACHÃO DO JACUÍPE,12252,5415,3839,22555,280,18716,769
BA,38296,RIACHO DE SANTANA,11405,3742,4556,20641,224,16085,714
BA,38318,RIBEIRA DO AMPARO,5160,1871,3025,10489,89,7464,344
BA,38334,RIBEIRA DO POMBAL,17277,7183,11320,37116,363,25796,973
BA,38342,RIBEIRÃO DO LARGO,3336,1827,2988,8543,84,5555,308
BA,38350,RIO DE CONTAS,5883,1986,2872,11165,133,8293,291
BA,38377,RIO DO ANTÔNIO,5637,1351,3541,11030,119,7489,382
BA,38393,RIO DO PIRES,4403,1322,3060,9120,72,6060,263
BA,38415,RIO REAL,13600,4358,7660,26598,307,18938,673
BA,38431,RODELAS,3287,710,1159,5365,49,4206,160
BA,38458,RUY BARBOSA,10756,3740,7471,22914,226,15443,721
BA,38474,SALINAS DA MARGARIDA,5733,746,1662,8589,160,6927,288
BA,38490,SALVADOR,932949,339061,412098,1831572,48480,1419474,98984
BA,38512,SANTA BÁRBARA,8244,3162,3334,15381,159,12047,482
BA,38539,SANTA BRÍGIDA,6100,1166,3417,11164,78,7747,403
BA,38555,SANTA CRUZ CABRÁLIA,5110,4802,5147,15622,170,10475,393
BA,38571,SANTA CRUZ DA VITÓRIA,1771,757,1648,4350,48,2702,126
BA,38598,SANTA INÊS,3997,1012,2011,7316,78,5305,218
BA,38610,SANTALUZ,11619,6487,7130,26358,320,19228,802
BA,38636,SANTA MARIA DA VITÓRIA,12952,5806,8218,28037,258,19819,803
BA,38652,SANTANA,10184,3489,3495,17901,144,14406,589
BA,38679,SANTANÓPOLIS,4039,1264,1839,7490,108,5651,240
BA,38695,SANTA TEREZINHA,3731,1314,2288,7721,91,5433,297
BA,38717,SANTO AMARO,25443,4776,7322,39626,802,32304,1283
BA,38733,SANTO ANTÔNIO DE JESUS,30582,13549,14032,61442,1152,47410,2127
BA,38750,SANTO ESTEVÃO,16502,6164,9476,33466,323,23990,1001
BA,38776,SÃO DESIDÉRIO,9488,3436,3704,17378,113,13674,637
BA,38792,SÃO FÉLIX,5113,1819,1726,9047,143,7321,246
BA,38806,SÃO DOMINGOS,3349,1536,1172,6362,89,5190,216
BA,38814,SÃO FELIPE,7929,3075,3373,14973,199,11600,397
BA,38822,SÃO FÉLIX DO CORIBE,4415,2447,1785,8971,81,7186,243
BA,38830,SÃO FRANCISCO DO CONDE,16843,2926,3261,24346,610,21085,706
BA,38857,SÃO GONÇALO DOS CAMPOS,13350,3460,3048,20922,394,17874,670
BA,38865,SÃO JOSÉ DO JACUÍPE,3502,1434,1576,6905,123,5329,270
BA,38873,SÃO MIGUEL DAS MATAS,4465,1483,1413,7720,88,6307,271
BA,38890,SÃO SEBASTIÃO DO PASSÉ,18647,3493,4286,27961,555,23675,980
BA,38911,SAPEAÇU,7292,2299,2339,12415,154,10076,331
BA,38938,SÁTIRO DIAS,5693,1903,4489,12577,137,8088,355
BA,38946,SAUBARA,4835,1757,2133,9160,220,7027,215
BA,38954,SAÚDE,4539,1428,1965,8320,104,6355,284
BA,38970,SEABRA,16557,3622,5615,26781,260,21166,727
BA,38997,SEBASTIÃO LARANJEIRAS,3601,890,1661,6384,46,4723,186
BA,39012,SENHOR DO BONFIM,16755,17734,7104,43562,591,36458,1378
BA,39039,SENTO SÉ,11762,5301,9014,26714,140,17700,497
BA,39047,SERRA DO RAMALHO,11517,2590,8519,23386,167,14867,593
BA,39055,SERRA DOURADA,6576,3342,4180,14569,105,10389,366
BA,39071,SERRA PRETA,8623,1718,4223,15210,155,10987,491
BA,39098,SERRINHA,29042,8289,8576,48322,547,39746,1868
BA,39110,SERROLÂNDIA,3850,2284,2969,9606,134,6637,369
BA,39136,SIMÕES FILHO,42912,9710,15555,72833,1985,57278,2671
BA,39144,SÍTIO DO MATO,4487,1271,2898,8916,69,6018,191
BA,39152,SOUTO SOARES,5933,1675,2192,10099,58,7907,241
BA,39179,TABOCAS DO BREJO VELHO,5316,1133,2899,9676,48,6777,280
BA,39195,TANHAÇU,7977,3803,2723,15090,97,12367,490
BA,39217,TANQUINHO,3360,1137,846,5561,63,4715,155
BA,39233,TAPEROÁ,5588,2284,2544,10947,112,8403,419
BA,39250,TAPIRAMUTÁ,5099,1389,3545,10542,101,6997,408
BA,39276,TEODORO SAMPAIO,3421,809,1522,6018,108,4496,158
BA,39292,TEOFILÂNDIA,9305,1349,4344,15589,135,11245,456
BA,39314,TEOLÂNDIA,4231,2326,2011,9064,102,7053,394
BA,39330,TERRA NOVA,4919,1514,1800,8728,197,6928,298
BA,39357,TREMEDAL,6938,1945,4298,13767,85,9469,501
BA,39373,TUCANO,18186,4882,12643,37193,407,24550,1075
BA,39390,UAUÁ,10525,2766,5012,19112,253,14100,556
BA,39411,UBAÍRA,6602,3215,3024,13612,214,10588,557
BA,39438,UBAITABA,5840,4007,6370,16823,153,10453,453
BA,39454,UBATÃ,5107,3061,3656,12409,146,8753,439
BA,39470,UIBAÍ,5179,2069,2291,9935,107,7644,289
BA,39489,UMBURANAS,3167,2822,3154,9440,55,6286,242
BA,39497,UNA,6953,3577,7638,18812,166,11174,478
BA,39519,URANDI,6256,1642,2856,11227,135,8371,338
BA,39535,URUÇUCA,7486,3559,4150,15918,159,11768,564
BA,39551,UTINGA,6620,1668,2889,11698,102,8809,419
BA,39578,VALENÇA,23310,15723,14878,57681,1326,42803,2444
BA,39594,VALENTE,7666,5145,3021,16577,213,13556,532
BA,39616,VÁRZEA DO POÇO,3050,1548,1401,6298,101,4897,198
BA,39624,VARZEDO,3686,1330,1024,6329,56,5305,233
BA,39632,VERA CRUZ,15622,2853,7814,27354,436,19540,629
BA,39640,VEREDA,2793,904,1787,5694,28,3907,182
BA,39659,VITÓRIA DA CONQUISTA,65195,82688,48262,204932,2576,156670,6211
BA,39675,WAGNER,3202,1035,2297,6789,52,4492,203
BA,39691,WENCESLAU GUIMARÃES,6291,2764,2721,12389,135,9668,478
BA,39713,XIQUE-XIQUE,17336,4497,7658,30849,215,23191,1143
BA,39730,LAPÃO,10799,3165,5400,20004,164,14604,476
BA,39748,MADRE DE DEUS,7897,1780,2036,12222,235,10186,274
BA,39756,MAETINGA,2649,843,2609,6366,25,3757,240
BA,39772,MANSIDÃO,4069,1100,3643,9040,32,5397,196
BA,39799,NORDESTINA,5201,784,3005,9415,86,6410,339
BA,39810,PÉ DE SERRA,4906,2175,2091,9583,100,7492,311
BA,39837,PINTADAS,3181,2119,1873,7510,77,5637,260
BA,39845,QUIXABEIRA,3138,1665,1812,6953,113,5141,225
BA,39853,RAFAEL JAMBEIRO,7453,2999,3912,15049,126,11137,559
BA,39870,SANTA LUZIA,3144,2147,4255,9876,55,5621,275
BA,39896,SÃO GABRIEL,8266,1952,2615,13411,121,10796,457
BA,39900,SÍTIO DO QUINTO,4908,1257,2580,9063,50,6483,268
BA,39918,TANQUE NOVO,6408,1646,3148,11729,147,8581,380
BA,39926,SÃO JOSÉ DA VITÓRIA,2014,1297,1292,4778,26,3486,149
BA,39934,TEIXEIRA DE FREITAS,38982,21332,25553,88902,965,63349,2070
BA,39942,NOVO HORIZONTE,4390,1077,1361,7099,58,5738,213
BA,39950,VÁRZEA NOVA,3607,1874,3160,9110,114,5950,355
BA,39969,NOVA IBIÁ,2181,1211,1461,5075,64,3614,158
BA,39977,VÁRZEA DA ROÇA,5017,1503,2367,9499,198,7132,414
BA,39985,SOBRADINHO,8274,3108,2936,14871,151,11935,402
BA,39993,WANDERLEY,4609,1899,2530,9351,59,6821,254
CE,13005,JIJOCA DE JERICOACOARA,5987,1950,2977,11289,135,8312,240
CE,13013,ABAIARA,3831,672,1560,6400,91,4840,246
CE,13021,MADALENA,7721,929,3426,12420,75,8994,269
CE,13030,ACARAÚ,20817,4517,12313,39067,478,26754,942
CE,13048,PIRES FERREIRA,3922,837,1835,6799,51,4964,154
CE,13056,ACOPIARA,20465,5540,6188,33878,430,27690,1255
CE,13064,GRAÇA,6200,925,4614,12224,97,7610,388
CE,13072,AIUABA,6352,1053,3139,10967,64,7828,359
CE,13080,TURURU,7636,1397,2178,11623,125,9445,287
CE,13099,ALCÂNTARAS,4765,777,2473,8380,113,5907,252
CE,13102,QUITERIANÓPOLIS,7949,1923,5335,15803,119,10468,477
CE,13110,ALTANEIRA,3083,947,1331,5602,46,4271,195
CE,13129,BARREIRA,9177,2752,3500,16059,219,12559,411
CE,13137,ALTO SANTO,7485,898,3034,11793,87,8759,289
CE,13145,ACARAPE,5799,1953,2184,10389,185,8205,268
CE,13153,ANTONINA DO NORTE,3164,703,2274,6344,23,4070,180
CE,13161,CHOROZINHO,9640,2067,2731,15076,287,12345,351
CE,13170,APUIARÉS,6597,1293,3115,11352,74,8237,273
CE,13188,HORIZONTE,24896,5634,7138,39276,856,32138,752
CE,13196,AQUIRAZ,26102,6545,5328,39936,773,34608,1188
CE,13200,ERERÊ,2633,777,1272,4872,43,3600,147
CE,13218,ARACATI,29710,7661,10510,49788,886,39278,1021
CE,13226,EUSÉBIO,16734,4419,2223,24678,553,22455,749
CE,13234,ARACOIABA,12149,3500,4399,20770,187,16371,535
CE,13242,GUAIÚBA,10291,2921,3841,17558,148,13717,357
CE,13250,ARARIPE,9329,1620,4942,16579,105,11637,583
CE,13269,POTIRETAMA,3411,307,1049,4942,41,3893,134
CE,13277,ARATUBA,5609,1236,2262,9542,128,7280,307
CE,13285,PINDORETAMA,10111,1464,2522,14619,157,12097,365
CE,13293,ARNEIROZ,3320,874,1915,6328,42,4413,177
CE,13307,OCARA,11989,2715,3111,18485,194,15374,476
CE,13315,ASSARÉ,9943,1590,5348,17525,135,12177,509
CE,13323,TEJUÇUOCA,7661,1727,3356,13199,142,9843,313
CE,13331,AURORA,10335,3444,5654,20137,159,14483,545
CE,13340,IPAPORANGA,4872,1249,3372,9830,75,6458,262
CE,13358,BAIXIO,3149,328,1428,5042,33,3614,104
CE,13366,TARRAFAS,3944,689,2180,7079,47,4899,219
CE,13374,BARBALHA,18810,10103,8604,38919,461,30315,941
CE,13382,BANABUIÚ,7311,1532,3981,13247,135,9266,288
CE,13390,BARRO,9923,1273,4948,16720,127,11772,449
CE,13404,BARROQUINHA,6549,1453,2673,11093,77,8420,341
CE,13412,BATURITÉ,14242,3826,7175,26191,375,19016,573
CE,13420,ARARENDÁ,4764,1023,2365,8433,66,6068,215
CE,13439,BEBERIBE,21484,5827,9001,37909,668,28908,929
CE,13447,CATUNDA,4582,728,2357,7949,63,5592,219
CE,13455,BELA CRUZ,10883,3320,6258,21132,174,14874,497
CE,13463,CHORÓ,6219,912,3139,10626,85,7487,271
CE,13471,BOA VIAGEM,21904,3796,13144,40302,305,27158,1153
CE,13480,ITAITINGA,15679,3303,4538,24482,392,19944,570
CE,13498,BREJO SANTO,19482,4113,7878,32496,261,24618,762
CE,13501,FORTIM,7267,1187,2274,11150,137,8876,285
CE,13510,CAMOCIM,25278,5177,11079,43168,638,32089,996
CE,13536,CAMPOS SALES,10125,3194,5906,19977,178,14071,574
CE,13552,CANINDÉ,30479,5238,16105,53579,537,37474,1220
CE,13579,CAPISTRANO,8563,1354,3279,13675,144,10396,335
CE,13595,CARIDADE,7929,1984,3630,14021,134,10391,344
CE,13617,CARIRÉ,7692,2640,3718,14667,150,10949,467
CE,13633,CARIRIAÇU,9987,4060,7751,22588,175,14837,615
CE,13650,CARIÚS,8516,1590,5010,15711,139,10701,456
CE,13676,CARNAUBAL,6360,1287,4650,12750,81,8100,372
CE,13692,CASCAVEL,26920,8274,11056,48517,1012,37461,1255
CE,13714,CATARINA,4637,815,2662,8421,46,5759,261
CE,13730,CAUCAIA,114906,22349,32421,177996,2968,145575,5352
CE,13757,CEDRO,11282,3041,3903,19063,224,15160,613
CE,13773,CHAVAL,5896,1086,3015,10400,107,7385,296
CE,13811,COREAÚ,8767,2930,5039,17482,145,12443,601
CE,13838,CRATEÚS,28313,8378,17092,56398,695,39306,1920
CE,13854,CRATO,47870,13907,17348,82108,891,64760,2092
CE,13870,FARIAS BRITO,9106,2400,3569,15835,209,12266,551
CE,13897,FORTALEZA,846073,332200,283878,1557659,35577,1273781,59931
CE,13919,FRECHEIRINHA,5263,1688,2449,9843,94,7394,349
CE,13935,GENERAL SAMPAIO,3140,1082,1103,5565,67,4462,173
CE,13951,GRANJA,21916,3220,9034,35628,259,26594,1199
CE,13978,GRANJEIRO,2128,924,1591,4822,38,3231,141
CE,13994,GROAÍRAS,4511,1178,1786,7938,184,6152,279
CE,14010,GUARACIABA DO NORTE,13877,4792,10053,29828,285,19775,821
CE,14036,GUARAMIRANGA,3050,607,1158,5005,69,3847,121
CE,14052,HIDROLÂNDIA,8390,1584,4725,15283,165,10558,419
CE,14060,IBARETAMA,5947,1538,1968,9814,83,7846,278
CE,14079,IBIAPINA,8540,2903,5631,17691,187,12060,430
CE,14095,ICÓ,26905,5390,16706,50545,359,33839,1185
CE,14117,IGUATU,40832,7223,18016,68569,855,50553,1643
CE,14133,INDEPENDÊNCIA,9851,3652,6770,21140,208,14370,659
CE,14150,IPAUMIRIM,5382,755,2112,8706,91,6594,366
CE,14176,IPU,16128,4125,10812,32235,312,21423,858
CE,14192,IPUEIRAS,16487,2688,11442,31909,280,20467,1012
CE,14214,IRACEMA,6555,885,2576,10433,82,7857,335
CE,14230,IRAUÇUBA,10001,1711,4323,16596,147,12273,414
CE,14257,ITAIÇABA,3342,1221,1091,5860,95,4769,111
CE,14273,ITAPAGÉ,21694,4446,8095,35747,621,27652,891
CE,14290,ITAPIPOCA,48276,7765,18930,77680,890,58750,1819
CE,14311,ITAPIÚNA,8703,1808,4040,15119,143,11079,425
CE,14338,ITATIRA,8674,1502,4165,14877,98,10712,438
CE,14354,JAGUARETAMA,8539,1296,4458,14797,136,10339,368
CE,14370,JAGUARIBARA,5016,719,1948,7928,77,5980,168
CE,14397,JAGUARIBE,15530,3123,8540,28292,297,19752,802
CE,14419,JAGUARUANA,14067,4052,6629,25937,587,19308,602
CE,14435,JARDIM,9870,4377,6260,21300,175,15040,618
CE,14451,JATI,4146,370,1609,6304,45,4695,134
CE,14478,JUAZEIRO DO NORTE,76051,37257,37001,157143,2666,120142,4168
CE,14494,JUCÁS,8784,2918,5931,18456,237,12525,586
CE,14516,LAVRAS DA MANGABEIRA,12281,3091,8405,24692,177,16287,738
CE,14532,LIMOEIRO DO NORTE,26693,4696,8789,41957,716,33168,1063
CE,14559,MARANGUAPE,43911,8146,12728,67463,944,54735,1734
CE,14575,MARCO,10219,4059,2912,17770,183,14858,397
CE,14591,MARTINÓPOLE,4734,994,1751,7771,74,6020,218
CE,14613,MASSAPÊ,11860,6783,5882,25540,311,19658,704
CE,14630,MAURITI,16908,6217,8196,32467,242,24271,904
CE,14656,MERUOCA,6132,1331,1400,9339,179,7939,297
CE,14672,MILAGRES,13590,1604,6376,22248,183,15872,495
CE,14680,MIRAÍMA,6040,912,3359,10575,68,7216,196
CE,14699,MISSÃO VELHA,14851,3530,6933,26434,250,19501,870
CE,14710,MOMBAÇA,16946,3912,10681,32817,295,22136,983
CE,14737,MONSENHOR TABOSA,7459,1585,4442,13988,129,9546,373
CE,14753,MORADA NOVA,32785,5027,15212,54911,572,39699,1315
CE,14770,MORAÚJO,3695,773,1626,6320,54,4694,172
CE,14796,MORRINHOS,6194,3992,2584,13280,178,10696,332
CE,14818,MUCAMBO,5793,1681,3905,11875,177,7970,319
CE,14834,MULUNGU,4694,698,2165,7876,106,5711,213
CE,14850,NOVA OLINDA,5904,1963,2660,10936,125,8276,284
CE,14877,NOVA RUSSAS,12917,2375,6399,22525,229,16126,605
CE,14893,NOVO ORIENTE,9631,3487,7189,21192,204,14003,681
CE,14915,ORÓS,10016,1926,5093,17748,196,12655,517
CE,14931,PACAJUS,26061,5051,7332,40180,875,32848,861
CE,14958,PACATUBA,23490,6968,8188,40544,726,32356,1172
CE,14974,PACOTI,5657,1401,2234,9695,132,7461,271
CE,14990,PACUJÁ,3291,448,967,4917,57,3950,154
CE,15016,PALHANO,4071,1650,1261,7296,116,6035,198
CE,15032,PALMÁCIA,4774,839,1534,7451,83,5917,221
CE,15059,PARACURU,13537,4019,5837,24424,414,18587,617
CE,15075,PARAMBU,12179,4518,8973,26784,268,17811,846
CE,15091,PARAMOTI,5087,1555,2697,9654,66,6957,249
CE,15113,PEDRA BRANCA,19541,1826,11447,34034,207,22587,1013
CE,15130,PENAFORTE,4014,714,708,5645,58,4937,151
CE,15156,PENTECOSTE,17900,3269,6625,28685,265,22060,626
CE,15172,PEREIRO,6360,2332,4071,13234,119,9163,352
CE,15199,PIQUET CARNEIRO,6594,1181,1693,9932,113,8239,351
CE,15210,PORANGA,4528,1345,2982,9308,71,6326,382
CE,15237,PORTEIRAS,8366,628,3327,12776,98,9449,357
CE,15253,POTENGI,4177,851,1934,7274,64,5340,248
CE,15270,QUIXADÁ,23036,14989,13584,53401,611,39817,1181
CE,15296,QUIXERAMOBIM,28666,7316,13376,51129,526,37753,1245
CE,15318,QUIXERÉ,8897,2706,3093,15376,269,12283,411
CE,15334,REDENÇÃO,12935,3372,5223,22569,395,17346,644
CE,15350,RERIUTABA,8354,1427,5207,15580,146,10373,446
CE,15377,RUSSAS,28334,7647,9390,47491,864,38101,1256
CE,15393,SABOEIRO,6611,1309,4182,12652,89,8470,461
CE,15415,SANTANA DO ACARAÚ,14310,2448,4661,22252,278,17591,555
CE,15431,SANTANA DO CARIRI,6808,1840,3980,13142,84,9162,430
CE,15440,SALITRE,6770,1292,2918,11409,70,8491,359
CE,15458,SANTA QUITÉRIA,16979,4865,10770,33729,330,22959,785
CE,15474,SÃO BENEDITO,19350,3783,11788,36233,377,24445,935
CE,15490,SÃO GONÇALO DO AMARANTE,18160,6259,7680,33528,566,25848,863
CE,15512,SÃO JOÃO DO JAGUARIBE,4928,487,1626,7319,93,5693,185
CE,15539,SÃO LUÍS DO CURU,6598,1222,2167,10414,160,8247,267
CE,15555,SENADOR POMPEU,10245,4411,5249,20627,213,15378,509
CE,15571,SENADOR SÁ,3062,528,873,4641,36,3768,142
CE,15598,SOBRAL,78402,15933,22704,124040,3335,101336,3666
CE,15610,SOLONÓPOLE,7730,1465,4537,14196,95,9659,369
CE,15636,TABULEIRO DO NORTE,15024,2235,4729,23006,358,18277,660
CE,15652,TAMBORIL,10044,3926,5137,19808,132,14671,569
CE,15679,TAUÁ,21098,7535,11868,42364,483,30496,1380
CE,15695,TIANGUÁ,23722,10133,9891,45967,676,36076,1545
CE,15717,TRAIRI,19522,6241,10371,37429,449,27058,846
CE,15733,UBAJARA,12254,3923,6004,23309,373,17305,755
CE,15750,UMARI,3298,1064,1071,5635,47,4564,155
CE,15776,URUBURETAMA,9377,2828,2423,15310,250,12887,432
CE,15792,URUOCA,5179,2032,2915,10495,73,7580,296
CE,15814,VÁRZEA ALEGRE,16679,4196,7076,29318,386,22242,981
CE,15830,VIÇOSA DO CEARÁ,14565,15381,8884,40278,300,31394,1148
CE,15857,MARACANAÚ,85440,19271,23884,135489,2822,111605,4072
CE,15873,AMONTADA,14684,4948,8480,29020,252,20540,656
CE,15881,CROATÁ,6918,1453,5006,13909,148,8903,384
CE,15890,CRUZ,9042,3457,5595,18664,149,13069,421
CE,15911,FORQUILHA,9954,1740,3629,16167,350,12538,494
CE,15920,IBICUITINGA,6123,1576,1844,9906,112,8062,251
CE,15938,ICAPUÍ,6614,4663,3266,14962,162,11696,257
CE,15954,ITAREMA,12988,4445,8076,26325,217,18249,599
CE,15970,MILHÃ,6633,905,2976,10873,91,7897,268
CE,15989,DEPUTADO IRAPUAN PINHEIRO,3559,1415,1093,6348,61,5255,220
CE,15997,PARAIPABA,12914,2970,4447,20996,229,16549,436
CE,98531,QUIXELÔ,8202,1337,1752,11855,147,10103,417
CE,98558,UMIRIM,7907,1801,4155,14305,122,10150,320
CE,98574,VARJOTA,7604,1646,4072,13865,181,9793,362
DF,97012,BRASÍLIA,708674,633299,354146,1834135,45821,1479989,92195
ES,56006,SÃO DOMINGOS DO NORTE,3112,2296,1281,6898,84,5617,125
ES,56014,AFONSO CLÁUDIO,7226,10241,6336,24770,367,18434,600
ES,56022,ÁGUA DOCE DO NORTE,4171,2622,2801,9942,129,7141,219
ES,56030,ALEGRE,7334,9851,6773,24899,381,18126,560
ES,56049,IRUPI,2396,3791,2195,8721,119,6526,220
ES,56057,ALFREDO CHAVES,3315,5080,2045,10928,235,8883,253
ES,56065,ALTO RIO NOVO,2429,1768,1198,5588,67,4390,126
ES,56073,ANCHIETA,6567,7723,3392,18424,362,15032,380
ES,56081,VILA PAVÃO,3417,2266,1070,6950,87,5880,110
ES,56090,APIACÁ,2261,2068,1856,6414,74,4558,155
ES,56103,MARECHAL FLORIANO,3863,5298,2792,12492,277,9700,262
ES,56111,ARACRUZ,22590,21178,11775,58421,1342,46646,1536
ES,56120,MARATAÍZES,7703,9801,6542,24940,446,18398,448
ES,56138,ATÍLIO VIVÁCQUA,3398,2953,1347,7974,116,6627,160
ES,56146,BREJETUBA,3127,2877,2631,8938,103,6307,200
ES,56154,BAIXO GUANDU,7133,9985,6161,24101,354,17940,468
ES,56162,SÃO ROQUE DO CANAÃ,3657,3142,1959,9139,170,7180,211
ES,56170,BARRA DE SÃO FRANCISCO,11890,10552,8684,32006,325,23322,555
ES,56189,SOORETAMA,6931,4875,4617,17099,307,12482,369
ES,56197,BOA ESPERANÇA,4535,3448,3636,11976,119,8340,238
ES,56200,PONTO BELO,2507,1637,1534,5890,57,4356,155
ES,56219,BOM JESUS DO NORTE,2996,2799,2045,8232,119,6187,273
ES,56227,VILA VALÉRIO,6197,2664,2306,11565,192,9259,206
ES,56235,CACHOEIRO DE ITAPEMIRIM,38398,58971,24902,127750,2925,102848,2554
ES,56251,CARIACICA,106110,77978,41693,237231,5727,195538,5723
ES,56278,CASTELO,6844,14324,3024,25260,526,22236,542
ES,56294,COLATINA,21369,40834,16680,82176,1493,65496,1800
ES,56308,GOVERNADOR LINDENBERG,3853,2637,1929,8706,122,6777,165
ES,56316,CONCEIÇÃO DA BARRA,8842,4937,6781,21442,310,14661,572
ES,56332,CONCEIÇÃO DO CASTELO,1812,4716,1656,8587,156,6931,247
ES,56359,DIVINO DE SÃO LOURENÇO,1002,1649,1152,3947,54,2795,90
ES,56375,DOMINGOS MARTINS,7308,12936,5300,26573,482,21273,547
ES,56391,DORES DO RIO PRETO,2229,2081,1612,6139,65,4527,152
ES,56413,ECOPORANGA,6785,5416,3521,16312,177,12791,413
ES,56430,FUNDÃO,5501,4180,2391,12654,243,10263,339
ES,56456,GUAÇUÍ,5884,9034,5395,21067,298,15672,456
ES,56472,GUARAPARI,22532,34644,17595,78441,1613,60846,2057
ES,56499,IBIRAÇU,3070,3500,2003,9053,198,7050,282
ES,56502,IBITIRAMA,1743,3083,2182,7281,105,5099,168
ES,56510,ICONHA,4007,4267,1039,9699,177,8660,209
ES,56537,ITAGUAÇU,4719,4066,3147,12486,233,9339,321
ES,56553,ITAPEMIRIM,8657,9375,6314,25307,462,18993,499
ES,56570,ITARANA,3230,3980,1971,9545,149,7574,215
ES,56596,IÚNA,5071,9645,5296,20740,282,15444,446
ES,56618,JERÔNIMO MONTEIRO,3138,3615,1278,8461,144,7183,286
ES,56626,JOÃO NEIVA,4445,5254,2612,13022,296,10410,415
ES,56634,LINHARES,30792,40830,22520,98565,1958,76045,2465
ES,56650,MANTENÓPOLIS,3375,4000,1998,9692,98,7694,221
ES,56677,MIMOSO DO SUL,7795,7669,5233,21556,331,16323,528
ES,56693,MONTANHA,4612,4382,2969,12388,177,9419,248
ES,56715,MUCURICI,2038,1314,1457,4927,33,3470,85
ES,56731,MUNIZ FREIRE,5174,5006,3911,14753,281,10842,381
ES,56758,MUQUI,3025,5390,1306,10126,167,8820,238
ES,56774,NOVA VENÉCIA,13219,11386,8104,34005,607,25901,689
ES,56790,PANCAS,5973,4913,4369,15674,146,11305,273
ES,56812,PINHEIROS,6847,4721,3399,15493,203,12094,323
ES,56839,PIÚMA,3556,5287,3104,12511,269,9407,295
ES,56855,PRESIDENTE KENNEDY,3426,3258,1679,8654,100,6975,191
ES,56871,RIO NOVO DO SUL,3139,4298,2086,9911,193,7825,195
ES,56898,SANTA LEOPOLDINA,4140,3317,2244,10153,202,7909,250
ES,56910,SANTA TERESA,4458,9086,3971,18337,335,14366,487
ES,56936,SÃO GABRIEL DA PALHA,8552,9066,5046,23587,454,18541,469
ES,56952,SÃO JOSÉ DO CALÇADO,3756,2578,1512,8342,205,6830,291
ES,56979,SÃO MATEUS,33232,17812,17344,71065,1201,53721,1476
ES,56995,SERRA,118657,75963,49933,259240,7245,209307,7442
ES,57010,VIANA,17674,12397,3170,34911,923,31741,747
ES,57037,VILA VELHA,99455,112663,55022,283005,7294,227983,8571
ES,57053,VITÓRIA,82228,103254,52459,250740,5726,198281,7073
ES,57070,MARILÂNDIA,3665,3829,1582,9489,194,7907,219
ES,57096,IBATIBA,4806,7476,4097,16941,222,12844,340
ES,57118,RIO BANANAL,6040,4257,3214,14001,213,10787,277
ES,57134,JAGUARÉ,9024,4641,4267,18619,347,14352,340
ES,57150,PEDRO CANÁRIO,7349,4162,5270,17432,229,12162,422
ES,57916,LARANJA DA TERRA,2885,4234,1757,9183,113,7426,194
ES,57932,SANTA MARIA DE JETIBÁ,8881,11245,3185,24280,455,21095,514
ES,57959,VARGEM ALTA,3828,6663,2817,13809,237,10992,264
ES,57975,VENDA NOVA DO IMIGRANTE,2980,8584,3039,15208,271,12169,334
ES,57991,ÁGUIA BRANCA,4161,1705,1232,7289,75,6057,116
GO,92010,ABADIÂNIA,2697,4148,2437,9705,156,7268,267
GO,92029,BONFINÓPOLIS,2263,1985,835,5383,75,4548,225
GO,92037,ÁGUA LIMPA,743,842,334,1995,16,1661,60
GO,92053,ALEXÂNIA,3869,7642,1907,14333,285,12426,630
GO,92061,CAMPOS VERDES,2071,875,1473,4637,24,3164,194
GO,92096,ALOÂNDIA,817,736,230,1867,26,1637,58
GO,92100,CEZARINA,2777,2397,1866,7403,73,5537,290
GO,92118,ALTO PARAÍSO DE GOIÁS,1460,1576,1719,5024,76,3305,193
GO,92126,COLINAS DO SUL,1372,516,1009,3066,26,2057,143
GO,92150,ALVORADA DO NORTE,1631,2372,1511,5835,66,4324,255
GO,92169,MORRO AGUDO DE GOIÁS,909,921,271,2181,18,1910,62
GO,92177,AMORINÓPOLIS,1381,1315,675,3534,33,2859,130
GO,92207,EDEALINA,1312,1215,667,3360,42,2693,124
GO,92215,ANÁPOLIS,68316,99738,48471,230085,4258,181614,9302
GO,92223,FAINA,2512,1636,1777,6113,41,4336,147
GO,92231,ANHANGÜERA,373,366,137,929,12,792,41
GO,92258,ANICUNS,6231,5505,3887,16381,183,12494,575
GO,92266,GOUVELÂNDIA,1436,1255,593,3487,54,2894,149
GO,92274,APARECIDA DE GOIÂNIA,101877,80697,52844,251182,4243,198338,11521
GO,92282,ITAGUARI,1980,993,811,4010,71,3199,155
GO,92290,APORÉ,770,1120,1140,3158,29,2018,99
GO,92312,ARAÇU,1414,1680,706,3980,42,3274,138
GO,92320,MATRINCHÃ,1247,1340,1067,3799,20,2732,125
GO,92339,ARAGARÇAS,5253,3811,3894,13509,161,9615,390
GO,92347,MIMOSO DE GOIÁS,780,907,580,2349,19,1769,63
GO,92355,ARAGOIÂNIA,2722,2140,1172,6335,69,5163,232
GO,92363,MONTIVIDIU,1932,3625,1841,7734,72,5893,264
GO,92444,NOVO PLANALTO,1321,720,699,2876,36,2177,100
GO,92460,PALESTINA DE GOIÁS,1278,1085,974,3455,19,2481,99
GO,92495,ARUANÃ,1807,1533,1121,4646,33,3525,152
GO,92517,AURILÂNDIA,1532,846,532,3059,36,2527,113
GO,92550,AVELINÓPOLIS,864,1294,695,2960,20,2265,87
GO,92568,SANTA FÉ DE GOIÁS,1454,1278,1332,4288,44,2956,180
GO,92614,BALIZA,1175,550,706,2556,15,1850,110
GO,92622,SÃO JOÃO DA PARAÚNA,610,751,454,1880,15,1426,50
GO,92630,BARRO ALTO,2810,1669,1261,6077,84,4816,253
GO,92649,SÃO LUIZ DO NORTE,1460,1333,1035,4000,39,2965,133
GO,92657,BELA VISTA DE GOIÁS,5420,7166,3929,17474,218,13545,741
GO,92665,SÃO MIGUEL DO PASSA QUATRO,1239,1346,646,3361,23,2715,107
GO,92673,BOM JARDIM DE GOIÁS,2882,2004,1291,6452,61,5161,214
GO,92690,BOM JESUS DE GOIÁS,5201,5166,3588,14730,245,11142,530
GO,92703,SENADOR CANEDO,20514,16408,11277,51420,984,40143,2237
GO,92711,BRAZABRANTES,1046,905,407,2493,42,2086,93
GO,92720,SIMOLÂNDIA,1582,1942,1681,5496,48,3815,243
GO,92754,BRITÂNIA,1544,1609,1145,4478,31,3333,149
GO,92762,TERESINA DE GOIÁS,891,584,834,2447,15,1613,123
GO,92770,BURITI ALEGRE,2197,3152,1184,6905,89,5721,283
GO,92789,TROMBAS,1089,864,783,2889,16,2106,137
GO,92797,CABECEIRAS,2335,1713,1088,5364,77,4276,151
GO,92800,TURVELÂNDIA,1512,1264,1274,4207,30,2933,127
GO,92819,CACHOEIRA ALTA,2247,2262,1739,6616,102,4877,266
GO,92827,RIO QUENTE,856,1144,710,2853,31,2143,112
GO,92835,CACHOEIRA DE GOIÁS,420,654,393,1518,15,1125,36
GO,92851,CAÇU,3010,3444,1406,8282,94,6876,328
GO,92860,GUARINOS,871,587,352,1889,19,1537,60
GO,92878,CAIAPÔNIA,4493,3612,2917,11702,139,8785,541
GO,92886,COCALZINHO DE GOIÁS,4308,3881,3006,11993,276,8987,522
GO,92894,CALDAS NOVAS,15552,18456,11589,48201,687,36612,1917
GO,92908,SANTO ANTÔNIO DE GOIÁS,1677,1021,656,3560,51,2904,155
GO,92916,CAMPESTRE DE GOIÁS,1080,1271,814,3281,32,2467,84
GO,92924,CHAPADÃO DO CÉU,1707,1819,1205,4927,46,3722,150
GO,92932,CAMPINORTE,3130,2309,2259,8061,83,5802,280
GO,92940,ALTO HORIZONTE,1230,1598,683,3627,18,2944,98
GO,92959,CAMPO ALEGRE DE GOIÁS,1693,1663,731,4247,46,3516,114
GO,92967,CASTELÂNDIA,1272,1050,1167,3613,28,2446,96
GO,92975,CAMPOS BELOS,5590,3566,4593,14538,125,9945,664
GO,92983,JESÚPOLIS,751,817,504,2177,24,1673,81
GO,92991,CARMO DO RIO VERDE,2213,2691,1191,6395,79,5204,221
GO,93009,APARECIDA DO RIO DOCE,1016,732,516,2401,32,1885,105
GO,93017,CATALÃO,22760,22113,10767,59344,1078,48577,2626
GO,93025,CIDADE OCIDENTAL,14026,7781,6504,30151,736,23647,1104
GO,93033,CATURAÍ,1495,1105,576,3382,57,2806,149
GO,93041,PROFESSOR JAMIL,1178,1019,899,3218,20,2319,102
GO,93050,CAVALCANTE,2789,881,2926,7064,61,4138,407
GO,93068,PEROLÂNDIA,1178,767,742,2781,10,2039,84
GO,93076,CERES,5064,6343,2315,14423,203,12108,498
GO,93084,NOVA IGUAÇU DE GOIÁS,1055,657,738,2532,13,1794,69
GO,93092,DIVINÓPOLIS DE GOIÁS,1609,1196,1426,4570,49,3144,290
GO,93106,BURITI DE GOIÁS,1081,917,592,2702,39,2110,73
GO,93122,CALDAZINHA,1031,977,651,2789,38,2138,92
GO,93149,GUARAÍTA,998,776,363,2244,36,1881,71
GO,93157,CÓRREGO DO OURO,883,1026,373,2388,22,2015,84
GO,93165,INACIOLÂNDIA,1728,1487,990,4431,49,3441,177
GO,93173,CORUMBÁ DE GOIÁS,1712,3170,1989,7305,145,5316,289
GO,93181,MONTIVIDIU DO NORTE,1227,896,1003,3296,30,2293,140
GO,93190,CORUMBAÍBA,2187,2392,903,5775,77,4872,216
GO,93203,SANTO ANTÔNIO DA BARRA,1547,1202,562,3473,30,2911,132
GO,93220,TEREZÓPOLIS DE GOIÁS,2240,1702,1144,5375,66,4231,223
GO,93246,UIRAPURU,1245,511,605,2451,16,1846,74
GO,93254,CRISTALINA,7786,11935,7151,28223,475,21072,876
GO,93262,BURITINÓPOLIS,652,1280,1067,3107,25,2040,83
GO,93270,CRISTIANÓPOLIS,911,1328,463,2823,32,2360,89
GO,93289,VILA BOA,1236,828,1226,3445,28,2219,127
GO,93297,CRIXÁS,5500,2599,2631,11199,100,8568,369
GO,93300,VALPARAÍSO DE GOIÁS,25826,15118,11891,56668,1450,44777,2383
GO,93319,CROMÍNIA,1262,1365,377,3148,42,2771,102
GO,93327,NOVO GAMA,17767,12848,9835,43413,1136,33578,1827
GO,93335,CUMARI,1039,829,474,2475,41,2001,92
GO,93343,ÁGUAS LINDAS DE GOIÁS,28100,13787,14334,60218,1588,45884,2409
GO,93351,DAMIANÓPOLIS,799,1329,1063,3322,39,2259,92
GO,93360,ABADIA DE GOIÁS,2043,2089,1217,5591,52,4374,190
GO,93378,DAMOLÂNDIA,981,1221,308,2638,36,2330,92
GO,93386,AMARALINA,1208,762,759,2829,20,2070,80
GO,93394,DAVINÓPOLIS,1020,798,360,2283,27,1923,78
GO,93408,BONÓPOLIS,1086,592,685,2462,12,1777,87
GO,93424,PORTEIRÃO,1199,549,805,2629,23,1824,53
GO,93432,DIORAMA,906,710,331,2050,22,1719,81
GO,93440,SANTA RITA DO NOVO DESTINO,1388,648,510,2678,25,2168,107
GO,93483,SÃO PATRÍCIO,622,782,259,1755,25,1496,67
GO,93491,EDÉIA,2808,3619,1683,8461,97,6778,254
GO,93505,VILA PROPÍCIO,1507,1155,757,3623,42,2866,162
GO,93513,ESTRELA DO NORTE,1209,877,494,2686,25,2192,81
GO,93530,FAZENDA NOVA,2150,1661,1381,5458,61,4077,205
GO,93548,IPIRANGA DE GOIÁS,1141,839,646,2736,29,2090,81
GO,93564,GAMELEIRA DE GOIÁS,833,894,416,2259,20,1843,96
GO,93572,FIRMINÓPOLIS,2710,3117,1542,7728,93,6186,266
GO,93580,CAMPO LIMPO DE GOIÁS,1719,1941,1005,4913,61,3908,187
GO,93599,FLORES DE GOIÁS,2303,1393,2002,6012,52,4010,262
GO,93602,LAGOA SANTA,341,504,280,1178,9,898,44
GO,93610,FORMOSA,23078,22173,14085,63035,1165,48950,2534
GO,93637,FORMOSO,1724,1100,1359,4352,33,2993,136
GO,93670,GOIANÁPOLIS,2541,3908,2319,9155,128,6836,259
GO,93696,GOIANDIRA,1630,1477,552,3905,66,3353,180
GO,93718,GOIANÉSIA,17620,13623,9332,43100,744,33768,1781
GO,93734,GOIÂNIA,279578,379262,190400,902008,14061,711608,38707
GO,93750,GOIANIRA,7090,6608,4599,19306,282,14707,727
GO,93777,GOIÁS,7843,6246,5720,20690,204,14970,677
GO,93793,GOIATUBA,8164,10318,5963,25811,383,19848,983
GO,93815,GUAPÓ,3659,3851,2302,10301,110,7999,379
GO,93831,GUARANI DE GOIÁS,1322,1169,1106,3773,14,2667,162
GO,93874,HEITORAÍ,1273,1239,574,3253,36,2679,131
GO,93890,HIDROLÂNDIA,4578,4687,1264,11260,152,9996,579
GO,93912,HIDROLINA,1454,1374,724,3733,52,3009,129
GO,93939,IACIARA,2659,2542,2660,8292,41,5632,390
GO,93955,INHUMAS,13116,14808,8145,38188,630,30043,1489
GO,93971,IPAMERI,6614,7065,4668,19392,277,14724,768
GO,93998,IPORÁ,8924,8116,6118,24195,271,18077,766
GO,94013,ISRAELÂNDIA,937,985,710,2749,30,2039,87
GO,94030,ITABERAÍ,10304,8992,5734,26297,325,20563,942
GO,94072,ITAGUARU,2249,1532,809,4843,70,4034,183
GO,94110,ITAJÁ,1305,1571,1126,4204,38,3078,164
GO,94137,ITAPACI,5468,3886,3484,13508,165,10024,505
GO,94153,ITAPIRAPUÃ,2216,2605,1955,7036,53,5081,207
GO,94196,ITAPURANGA,8906,6189,3421,19654,363,16233,775
GO,94218,ITARUMÃ,1376,1767,1244,4559,25,3315,147
GO,94234,ITAUÇU,2641,2486,1029,6491,95,5462,240
GO,94250,ITUMBIARA,21024,30198,14617,68693,974,54076,1880
GO,94277,IVOLÂNDIA,1045,784,745,2690,24,1945,92
GO,94293,JANDAIA,2564,2354,927,6125,79,5198,201
GO,94315,JARAGUÁ,9716,11335,6362,28978,498,22616,1067
GO,94331,JATAÍ,23386,21654,14215,62562,939,48347,2368
GO,94358,JAUPACI,1304,796,402,2594,18,2192,74
GO,94374,JOVIÂNIA,1919,2455,1202,5851,63,4649,212
GO,94390,JUSSARA,4379,5840,2976,13889,114,10913,580
GO,94439,LEOPOLDO DE BULHÕES,2152,2218,1407,6131,94,4724,260
GO,94455,LUZIÂNIA,37153,38868,22334,104940,2291,82606,4294
GO,94471,MAIRIPOTABA,657,1000,403,2146,27,1743,59
GO,94498,MAMBAÍ,1020,2498,1577,5311,43,3734,173
GO,94510,MARA ROSA,3282,2353,2461,8495,75,6034,324
GO,94536,MARZAGÃO,718,719,428,1953,18,1525,70
GO,94552,PARANAIGUARA,3188,2027,1101,6651,71,5550,264
GO,94579,MAURILÂNDIA,3573,2454,2232,8630,96,6398,275
GO,94595,MINEIROS,13419,11768,7723,34821,501,27098,1410
GO,94650,MOIPORÁ,567,887,522,2066,24,1544,66
GO,94676,MONTE ALEGRE DE GOIÁS,1986,1370,1516,5157,32,3641,253
GO,94714,MONTES CLAROS DE GOIÁS,2552,1771,1625,6189,50,4564,191
GO,94730,MORRINHOS,12114,11584,6582,31934,461,25352,1193
GO,94757,MOSSÂMEDES,1923,1245,864,4224,51,3360,141
GO,94773,MOZARLÂNDIA,3537,3649,2188,9842,83,7654,385
GO,94790,MUTUNÓPOLIS,1389,1132,633,3278,28,2645,96
GO,94854,NAZÁRIO,2323,2617,1105,6351,72,5246,234
GO,94870,NERÓPOLIS,6746,6555,4494,18889,298,14395,796
GO,94897,NIQUELÂNDIA,12577,7247,5574,26754,312,21180,1044
GO,94919,NOVA AMÉRICA,678,815,268,1867,19,1599,87
GO,94935,NOVA AURORA,700,813,222,1813,19,1591,59
GO,94951,NOVA ROMA,1045,828,829,2810,18,1981,90
GO,94978,NOVA VENEZA,2407,2584,1148,6463,84,5315,240
GO,95010,NOVO BRASIL,1307,1207,620,3269,26,2649,109
GO,95036,ORIZONA,3801,4439,1321,10154,174,8833,419
GO,95052,OURO VERDE DE GOIÁS,909,1792,851,3748,51,2897,145
GO,95079,OUVIDOR,2261,1625,511,4635,66,4124,172
GO,95095,PADRE BERNARDO,4668,5333,4752,15665,251,10913,661
GO,95117,PALMEIRAS DE GOIÁS,4788,8204,2461,16011,157,13550,401
GO,95133,PALMELO,708,796,409,1996,13,1587,70
GO,95150,PALMINÓPOLIS,1099,1767,595,3547,15,2952,71
GO,95176,PANAMÁ,870,936,444,2364,27,1920,87
GO,95230,PARAÚNA,3305,2896,2166,8757,76,6591,314
GO,95311,PETROLINA DE GOIÁS,2484,3064,1995,7953,92,5958,318
GO,95354,PILAR DE GOIÁS,993,833,480,2415,27,1935,82
GO,95397,PIRACANJUBA,7446,6468,4205,18959,212,14754,628
GO,95419,PIRANHAS,4125,2722,2223,9518,90,7295,358
GO,95435,PIRENÓPOLIS,5021,8377,2815,17075,259,14260,603
GO,95451,PIRES DO RIO,6722,9075,4729,21775,296,17046,953
GO,95494,PONTALINA,5695,4830,3023,14200,170,11177,482
GO,95559,PORANGATU,13457,6966,8526,30189,261,21663,979
GO,95575,PORTELÂNDIA,1300,1058,682,3208,47,2526,121
GO,95613,POSSE,6816,8551,5855,22118,203,16263,693
GO,95630,QUIRINÓPOLIS,11227,12248,6347,31303,449,24956,1032
GO,95656,RIALMA,2941,3202,2049,8630,114,6581,324
GO,95672,RIANÁPOLIS,1210,1441,810,3696,47,2886,188
GO,95710,RIO VERDE,32460,44006,22001,103492,1352,81491,3673
GO,95737,RUBIATABA,4552,6227,3287,14866,209,11579,591
GO,95753,SANCLERLÂNDIA,2850,2187,1489,6814,79,5325,209
GO,95770,SANTA BÁRBARA DE GOIÁS,1614,1908,992,4693,41,3701,138
GO,95796,SANTA CRUZ DE GOIÁS,883,1285,833,3126,29,2293,96
GO,95818,SANTA HELENA DE GOIÁS,12053,9567,3936,27032,413,23096,1063
GO,95834,SANTA RITA DO ARAGUAIA,1096,1626,957,3846,46,2889,121
GO,95850,SANTA ROSA DE GOIÁS,1114,1059,516,2925,109,2409,127
GO,95877,SANTA TEREZA DE GOIÁS,1183,1009,1094,3448,55,2354,107
GO,95893,SANTA TEREZINHA DE GOIÁS,3440,2191,1755,7733,73,5978,274
GO,95915,SÃO DOMINGOS,2695,1735,2614,7512,59,4898,409
GO,95931,SÃO FRANCISCO DE GOIÁS,1518,1746,1168,4697,70,3529,195
GO,95958,PLANALTINA,20414,12775,11539,47720,1162,36181,1830
GO,95974,SÃO JOÃO D'ALIANÇA,2051,2007,1974,6368,112,4394,224
GO,95990,SÃO LUÍS DE MONTES BELOS,6843,9382,5215,22686,340,17471,906
GO,96016,SÃO MIGUEL DO ARAGUAIA,5230,6456,5835,18291,128,12456,642
GO,96059,SÃO SIMÃO,5841,2932,2250,11633,153,9383,457
GO,96075,SERRANÓPOLIS,2092,1644,800,4780,54,3980,190
GO,96091,SILVÂNIA,5005,5625,2756,14032,177,11276,469
GO,96113,SÍTIO D'ABADIA,769,721,829,2409,6,1580,84
GO,96172,TAQUARAL DE GOIÁS,1196,1327,648,3334,44,2686,119
GO,96237,TRÊS RANCHOS,1279,1154,666,3230,33,2564,98
GO,96253,TRINDADE,26736,24505,14970,69828,945,54858,2672
GO,96318,TURVÂNIA,1569,1818,780,4366,48,3586,151
GO,96334,URUAÇU,10462,6614,6797,24928,257,18131,798
GO,96350,URUANA,3803,4168,2823,11350,153,8527,403
GO,96377,URUTAÍ,977,959,639,2731,46,2092,110
GO,96393,VARJÃO,1017,1670,761,3618,44,2857,126
GO,96415,VIANÓPOLIS,2177,4548,1853,9083,133,7230,372
GO,96458,ACREÚNA,5084,5804,3921,15498,165,11577,524
GO,96474,MINAÇU,11700,4755,9243,26738,245,17495,795
GO,96512,MUNDO NOVO,1659,1386,1752,5005,33,3253,175
GO,96539,NOVA CRIXÁS,3206,2063,2636,8304,66,5668,333
GO,96555,NOVA GLÓRIA,2816,1993,2101,7300,112,5199,278
GO,96571,VICENTINÓPOLIS,2151,2162,979,5493,64,4514,137
GO,96610,AMERICANO DO BRASIL,1773,1800,696,4443,34,3747,140
GO,96695,ARAGUAPAZ,1941,2210,1643,6053,44,4410,215
GO,96717,ARENÓPOLIS,1365,908,763,3170,18,2407,116
GO,96733,CACHOEIRA DOURADA,2742,2427,2081,7593,83,5512,260
GO,96750,DOVERLÂNDIA,2745,1670,1000,5665,43,4665,207
GO,96776,SANTO ANTÔNIO DO DESCOBERTO,14049,10368,8374,35227,805,26853,1631
GO,96814,INDIARA,4610,2610,2587,10397,155,7810,435
GO,96873,CAMPINAÇU,1483,689,866,3172,27,2306,107
GO,96890,SANTA ISABEL,1163,1038,576,2948,43,2372,128
GO,96911,ADELÂNDIA,1004,927,366,2421,25,2055,99
GO,96938,ÁGUA FRIA DE GOIÁS,1194,1453,1369,4186,52,2817,118
MA,7005,ÁGUA DOCE DO MARANHÃO,4138,1903,3434,9770,79,6336,216
MA,7013,AFONSO CUNHA,3348,247,1120,4899,26,3779,158
MA,7021,ALTO ALEGRE DO MARANHÃO,8753,1041,4000,14341,81,10341,466
MA,7030,ALCÂNTARA,8912,974,5909,16263,141,10354,327
MA,7048,ALTO ALEGRE DO PINDARÉ,11630,1190,6116,19689,130,13573,623
MA,7056,ALDEIAS ALTAS,9455,1206,4298,15713,124,11415,630
MA,7064,APICUM-AÇU,4597,1531,2664,8964,24,6300,148
MA,7072,ALTAMIRA DO MARANHÃO,2478,726,1320,4747,50,3427,173
MA,7080,AMAPÁ DO MARANHÃO,2181,737,1530,4622,27,3092,147
MA,7099,ALTO PARNAÍBA,3138,1494,2520,7415,41,4895,222
MA,7102,ARAGUANÃ,3891,369,2305,6738,26,4433,147
MA,7110,AMARANTE DO MARANHÃO,11051,4519,6384,22750,184,16366,612
MA,7129,BACABEIRA,7193,651,1775,9965,108,8190,238
MA,7137,ANAJATUBA,10590,931,6261,18420,155,12159,483
MA,7145,BACURITUBA,2273,409,2014,4803,21,2789,86
MA,7153,ANAPURUS,6763,865,1469,9458,67,7989,294
MA,7161,BELÁGUA,3007,239,969,4388,27,3419,146
MA,7170,ARAIOSES,14477,4764,9229,29540,309,20311,761
MA,7188,BELA VISTA DO MARANHÃO,4111,897,2500,7674,34,5174,132
MA,7196,ARARI,11284,2271,6474,20760,209,14286,522
MA,7200,BERNARDO DO MEARIM,2642,501,1362,4635,36,3273,94
MA,7218,AXIXÁ,5264,715,2703,8909,73,6206,154
MA,7226,CACHOEIRA GRANDE,3613,255,2228,6282,29,4054,157
MA,7234,BACABAL,32879,9176,19316,63421,620,44105,1430
MA,7242,DAVINÓPOLIS,4559,1585,2692,9063,80,6371,147
MA,7250,BACURI,6528,1172,4041,12047,56,8006,250
MA,7269,BOM JESUS DAS SELVAS,7093,2492,4414,14382,81,9968,302
MA,7277,BALSAS,22287,13250,13458,50270,398,36812,877
MA,7285,BOM LUGAR,5533,822,2924,9535,43,6611,213
MA,7293,BARÃO DE GRAJAÚ,7128,1379,3390,12336,97,8946,342
MA,7307,BREJO DE AREIA,3461,788,1864,6403,50,4539,240
MA,7315,BARRA DO CORDA,26845,8647,17335,54586,445,37251,1314
MA,7323,BOA VISTA DO GURUPI,2147,875,1267,4369,15,3102,65
MA,7331,BARREIRINHAS,21974,2276,10308,35422,160,25114,704
MA,7340,BURITICUPU,21448,4954,12176,39652,272,27476,802
MA,7358,BENEDITO LEITE,1758,852,1535,4320,30,2785,145
MA,7366,BURITIRANA,4847,1677,2960,9824,107,6864,233
MA,7374,BEQUIMÃO,7079,2650,4450,14579,121,10129,279
MA,7382,CAMPESTRE DO MARANHÃO,5239,1018,2553,9018,75,6465,133
MA,7390,BREJO,12204,3017,6491,22347,136,15856,499
MA,7404,CAPINZAL DO NORTE,4317,938,1795,7326,60,5531,216
MA,7412,BURITI,10535,1710,5677,18794,144,13117,728
MA,7420,CENTRAL DO MARANHÃO,3347,145,2475,6175,31,3700,177
MA,7439,BURITI BRAVO,8422,1542,4780,15434,120,10654,570
MA,7447,CENTRO DO GUILHERME,3554,382,1545,5636,23,4091,132
MA,7455,CAJAPIÓ,4269,687,3031,8267,75,5236,205
MA,7463,CENTRO NOVO DO MARANHÃO,5212,922,2346,8761,55,6415,226
MA,7471,CAJARI,7635,487,2533,11020,68,8487,297
MA,7480,CIDELÂNDIA,4859,1395,2908,9396,68,6488,166
MA,7498,CÂNDIDO MENDES,5678,1924,5190,13112,46,7922,274
MA,7501,CONCEIÇÃO DO LAGO-AÇU,5417,842,2175,8767,50,6592,283
MA,7510,CANTANHEDE,6315,1029,3386,11096,78,7710,288
MA,7528,FEIRA NOVA DO MARANHÃO,2473,1269,1569,5515,57,3946,147
MA,7536,CAROLINA,8049,2824,5322,16796,149,11474,452
MA,7544,FERNANDO FALCÃO,3393,796,1369,5727,21,4358,148
MA,7552,CARUTAPERA,6157,3283,4860,14659,80,9799,279
MA,7560,FORMOSA DA SERRA NEGRA,3999,3245,2696,10272,51,7576,281
MA,7579,CAXIAS,56961,11559,30259,102299,1035,72040,2485
MA,7595,CEDRAL,4480,401,2640,7730,64,5090,145
MA,7609,GOVERNADOR EDISON LOBÃO,4770,2254,2397,9738,110,7341,207
MA,7617,CHAPADINHA,27567,5132,13499,47810,386,34311,1226
MA,7625,GOVERNADOR LUIZ ROCHA,2371,1503,1208,5292,41,4084,169
MA,7633,CODÓ,36291,8571,30382,77922,699,47540,1979
MA,7641,GOVERNADOR NEWTON BELLO,3890,600,2625,7328,41,4703,172
MA,7650,COELHO NETO,19064,2847,11462,34445,232,22983,840
MA,7668,GOVERNADOR NUNES FREIRE,7816,1756,4004,13942,67,9938,299
MA,7676,COLINAS,12751,2656,8347,24595,144,16248,697
MA,7684,IGARAPÉ DO MEIO,5144,830,3485,9762,57,6277,246
MA,7692,COROATÁ,23395,5041,13965,44078,378,30113,1299
MA,7706,ITAIPAVA DO GRAJAÚ,4954,964,2613,8770,30,6157,209
MA,7714,CURURUPU,12296,1752,9414,23981,140,14567,379
MA,7722,ITINGA DO MARANHÃO,6502,4701,5809,17352,85,11543,255
MA,7730,DOM PEDRO,8485,2747,4323,15995,129,11672,311
MA,7749,JATOBÁ,3129,618,1301,5199,24,3898,127
MA,7757,DUQUE BACELAR,4712,716,2478,8222,55,5744,261
MA,7765,JENIPAPO DOS VIEIRAS,5717,1376,3401,10781,50,7380,237
MA,7773,ESPERANTINÓPOLIS,8058,1319,3885,13785,107,9900,416
MA,7781,JUNCO DO MARANHÃO,2531,485,1204,4353,37,3149,96
MA,7790,FORTALEZA DOS NOGUEIRAS,5052,1041,2472,8828,70,6356,193
MA,7803,LAGO DOS RODRIGUES,3904,1082,1351,6518,33,5167,148
MA,7811,FORTUNA,6740,808,2784,10785,119,8001,334
MA,7820,LAGOA DO MATO,4312,497,2186,7328,45,5142,288
MA,7838,GODOFREDO VIANA,2500,1238,2189,6040,19,3851,94
MA,7846,LAGOA GRANDE DO MARANHÃO,4455,842,1672,7188,35,5516,184
MA,7854,GONÇALVES DIAS,6534,1120,3347,11369,70,8022,298
MA,7862,LAJEADO NOVO,2753,996,1543,5442,35,3899,115
MA,7870,GOVERNADOR ARCHER,4059,706,2278,7293,37,5015,213
MA,7889,MARACAÇUMÉ,6167,1716,4110,12354,77,8244,284
MA,7897,GOVERNADOR EUGÊNIO BARROS,6274,1186,3102,10920,71,7818,287
MA,7900,MARAJÁ DO SENA,3164,556,1583,5536,30,3953,203
MA,7919,GRAÇA ARANHA,3158,437,1554,5280,21,3726,110
MA,7927,MARANHÃOZINHO,3794,694,1504,6166,31,4662,143
MA,7935,GRAJAÚ,20367,5789,10884,38024,191,27140,793
MA,7943,MATÕES DO NORTE,3704,295,2512,6711,32,4199,168
MA,7951,GUIMARÃES,5661,507,3440,9915,82,6475,225
MA,7960,MILAGRES DO MARANHÃO,2408,507,1494,4523,15,3029,99
MA,7978,HUMBERTO DE CAMPOS,10177,897,7263,18891,83,11628,471
MA,7986,NOVA COLINAS,2172,595,995,3900,37,2905,101
MA,7994,ICATU,10812,703,6948,18933,77,11985,393
MA,8001,NOVA OLINDA DO MARANHÃO,6230,1230,3559,11387,90,7828,278
MA,8010,IGARAPÉ GRANDE,4156,1356,1543,7342,81,5799,206
MA,8028,OLINDA NOVA DO MARANHÃO,4800,429,2974,8540,69,5566,268
MA,8036,IMPERATRIZ,59841,54665,37422,156733,2051,119311,2754
MA,8044,PAULINO NEVES,6052,920,3318,10657,80,7339,287
MA,8052,SÃO LUÍS GONZAGA DO MARANHÃO,10220,878,6173,17865,95,11692,499
MA,8060,PEDRO DO ROSÁRIO,8389,661,4799,14358,81,9559,428
MA,8079,ITAPECURU MIRIM,22039,3089,11244,37785,360,26541,1053
MA,8087,PERITORÓ,8985,998,4304,14883,151,10579,445
MA,8095,JOÃO LISBOA,8056,3661,5558,17851,188,12293,388
MA,8109,PORTO RICO DO MARANHÃO,2796,644,1920,5511,50,3591,101
MA,8117,JOSELÂNDIA,6498,1210,3290,11409,94,8119,317
MA,8125,PRESIDENTE MÉDICI,2800,435,1294,4645,20,3351,96
MA,8133,LAGO DA PEDRA,14721,6200,10891,32799,240,21908,747
MA,8141,PRESIDENTE SARNEY,6315,677,4055,11399,47,7344,305
MA,8150,LAGO DO JUNCO,4271,859,1915,7276,58,5361,173
MA,8168,RAPOSA,9132,1380,1749,12633,148,10884,224
MA,8176,LAGO VERDE,6527,639,3212,10743,79,7531,286
MA,8184,RIBAMAR FIQUENE,2833,1245,1973,6195,36,4222,108
MA,8192,LIMA CAMPOS,4388,1741,2046,8567,89,6521,303
MA,8206,SANTA FILOMENA DO MARANHÃO,3113,518,1252,5044,32,3792,129
MA,8214,LORETO,4090,922,2337,7581,35,5244,197
MA,8222,SANTANA DO MARANHÃO,3307,541,2428,6472,32,4044,164
MA,8230,LUÍS DOMINGUES,1881,1238,1667,4893,26,3226,81
MA,8249,SANTO AMARO DO MARANHÃO,4556,487,2484,7748,48,5264,173
MA,8257,MAGALHÃES DE ALMEIDA,5353,2089,3728,11591,82,7863,339
MA,8265,SÃO DOMINGOS DO AZEITÃO,2989,428,1602,5180,17,3578,144
MA,8273,MATA ROMA,6704,1442,2686,11221,79,8535,310
MA,8281,SÃO FRANCISCO DO BREJÃO,3129,1347,1549,6162,40,4613,97
MA,8290,MATINHA,9740,1387,5028,16746,172,11718,419
MA,8303,SÃO JOÃO DO CARÚ,5351,701,2796,9168,37,6372,283
MA,8311,MATÕES,11637,1776,6984,21167,112,14183,658
MA,8320,SÃO JOÃO DO PARAÍSO,3657,1945,2224,8079,62,5855,191
MA,8338,MIRADOR,7179,1250,4952,13852,60,8900,411
MA,8346,SÃO JOÃO DO SOTER,6204,565,2588,9769,53,7181,359
MA,8354,MIRINZAL,5758,701,3498,10237,71,6739,209
MA,8362,SÃO JOSÉ DOS BASÍLIOS,3937,434,2376,6943,36,4567,160
MA,8370,MONÇÃO,10713,1380,5688,18424,118,12736,525
MA,8389,SÃO PEDRO DA ÁGUA BRANCA,4326,914,2814,8230,31,5416,145
MA,8397,MONTES ALTOS,3593,1370,2006,7220,60,5214,191
MA,8400,SÃO PEDRO DOS CRENTES,1462,1020,935,3529,29,2594,83
MA,8419,MORROS,6879,771,4422,12560,97,8138,391
MA,8427,SÃO RAIMUNDO DO DOCA BEZERRA,2472,555,1558,4727,32,3169,110
MA,8435,NINA RODRIGUES,4449,673,2860,8283,44,5423,257
MA,8443,SÃO ROBERTO,2423,381,1152,4068,16,2916,96
MA,8451,NOVA IORQUE,1628,608,1217,3587,17,2370,117
MA,8460,SATUBINHA,2771,455,1637,5000,29,3363,108
MA,8478,OLHO D'ÁGUA DAS CUNHÃS,7009,1612,4636,13691,88,9055,346
MA,8486,SENADOR ALEXANDRE COSTA,3706,759,1582,6265,36,4683,182
MA,8494,PAÇO DO LUMIAR,27889,5260,4226,39021,799,34795,847
MA,8508,SENADOR LA ROCQUE,7889,2140,4655,15195,125,10540,386
MA,8516,PALMEIRÂNDIA,7732,912,5206,14300,79,9094,371
MA,8524,SERRANO DO MARANHÃO,3884,339,2253,6721,40,4468,205
MA,8532,PARAIBANO,6952,1720,5511,14703,86,9192,434
MA,8540,SUCUPIRA DO RIACHÃO,2151,391,1046,3763,21,2717,154
MA,8559,PARNARAMA,12706,1980,8901,24487,151,15586,749
MA,8567,TRIZIDELA DO VALE,7534,2140,2446,12614,153,10168,341
MA,8575,PASSAGEM FRANCA,6355,1900,2752,11553,104,8801,442
MA,8583,TUFILÂNDIA,3025,299,1828,5320,25,3492,143
MA,8591,PASTOS BONS,6818,1529,4024,12771,57,8747,343
MA,8605,TURILÂNDIA,6504,841,4947,12672,63,7725,317
MA,8613,PEDREIRAS,15165,4572,8715,29396,339,20681,605
MA,8621,VILA NOVA DOS MARTÍRIOS,2616,1511,1683,5979,49,4296,120
MA,8630,PENALVA,13041,1303,9344,24406,124,15062,594
MA,8656,PERI MIRIM,4833,978,4015,10069,69,6054,174
MA,8672,PINDARÉ-MIRIM,12033,2100,6716,21538,182,14822,507
MA,8699,PINHEIRO,23869,9510,17454,52230,398,34776,999
MA,8710,PIO XII,9292,2135,5582,17576,91,11994,476
MA,8737,PIRAPEMAS,6568,664,4100,11764,79,7664,353
MA,8753,POÇÃO DE PEDRAS,8652,1811,4614,15528,93,10914,358
MA,8770,PORTO FRANCO,5451,4758,4059,14562,93,10503,201
MA,8796,PRESIDENTE DUTRA,15789,4000,8916,29495,272,20579,518
MA,8818,PRESIDENTE JUSCELINO,4993,286,3032,8518,36,5486,171
MA,8834,PRESIDENTE VARGAS,5149,478,2656,8583,62,5927,238
MA,8850,PRIMEIRA CRUZ,4492,433,3873,9020,32,5147,190
MA,8877,RIACHÃO,7239,1709,4285,13728,81,9443,414
MA,8893,SÃO JOSÉ DE RIBAMAR,46070,8120,18975,75408,990,56433,1253
MA,8915,ROSÁRIO,16555,1615,7978,26982,278,19004,556
MA,8931,SAMBAÍBA,2347,696,1419,4594,22,3175,110
MA,8958,SANTA HELENA,10489,2113,8331,21527,152,13196,442
MA,8974,SANTA LUZIA,24069,4660,14739,45002,314,30263,1220
MA,8990,SANTA QUITÉRIA DO MARANHÃO,10399,1795,5139,17845,107,12706,405
MA,9016,SANTA RITA,11033,2003,6034,19693,153,13659,470
MA,9032,SANTO ANTÔNIO DOS LOPES,6616,1003,2909,10896,69,7987,299
MA,9059,SÃO BENEDITO DO RIO PRETO,7130,965,3359,11859,78,8500,327
MA,9075,SÃO BENTO,11499,3604,10206,25986,184,15780,493
MA,9091,SÃO BERNARDO,9507,2916,5837,18988,128,13151,600
MA,9113,SÃO DOMINGOS DO MARANHÃO,12168,4886,8342,26254,199,17912,659
MA,9130,SÃO FÉLIX DE BALSAS,2094,303,1112,3639,13,2527,117
MA,9156,SÃO FRANCISCO DO MARANHÃO,4784,1006,2781,8935,66,6154,298
MA,9172,SÃO JOÃO BATISTA,9890,1202,5303,16830,74,11527,361
MA,9199,SÃO JOÃO DOS PATOS,8541,2809,6281,18282,179,12001,472
MA,9210,SÃO LUÍS,365814,111129,163871,668253,12140,504382,15299
MA,9237,SÃO MATEUS DO MARANHÃO,13324,3771,10195,28179,188,17984,701
MA,9253,SÃO RAIMUNDO DAS MANGABEIRAS,6456,1933,4000,12762,73,8762,300
MA,9270,SÃO VICENTE FERRER,8381,932,6689,16529,120,9840,407
MA,9296,SÍTIO NOVO,5895,2497,3593,12382,64,8789,333
MA,9318,SUCUPIRA DO NORTE,4785,613,2284,7989,46,5705,261
MA,9334,TASSO FRAGOSO,2646,997,1508,5302,32,3794,119
MA,9350,TIMBIRAS,10045,1283,6463,18438,103,11975,544
MA,9377,TIMON,57703,14872,24028,100147,1023,76119,2521
MA,9393,TUNTUM,13255,4485,8714,27470,258,18756,758
MA,9415,TURIAÇU,10861,3066,8737,23350,121,14613,565
MA,9431,TUTÓIA,15194,5865,11129,33237,280,22108,769
MA,9458,URBANO SANTOS,10312,1177,3694,15857,124,12163,550
MA,9474,VARGEM GRANDE,14716,2548,9328,27806,188,18478,1026
MA,9490,VIANA,17935,4379,10989,34288,280,23299,705
MA,9512,VITÓRIA DO MEARIM,11449,2425,8858,23486,199,14628,555
MA,9539,VITORINO FREIRE,11373,3270,6907,22370,172,15463,648
MA,9555,BOM JARDIM,13371,2768,8561,25585,177,17024,708
MA,9571,SANTA INÊS,26887,11068,15285,54909,585,39624,1084
MA,9598,PAULO RAMOS,8073,1729,4039,14365,104,10326,420
MA,9610,AÇAILÂNDIA,32731,16612,19106,70193,710,51087,1034
MA,9636,ESTREITO,9553,4266,5149,19572,159,14423,445
MA,9652,SANTA LUZIA DO PARUÁ,8484,1898,4366,15195,121,10829,326
MA,9679,ARAME,9164,3546,6461,19724,76,13263,477
MA,9695,MIRANDA DO NORTE,7344,880,4201,12776,88,8575,263
MA,9717,ZÉ DOCA,17038,3334,10541,31799,192,21258,694
MG,40002,ALFREDO VASCONCELOS,2688,1166,635,4732,71,4097,172
MG,40010,ABADIA DOS DOURADOS,2678,1613,717,5268,91,4551,169
MG,40029,ARAPORÃ,2437,1959,1120,5688,60,4568,112
MG,40037,ABAETÉ,5868,7384,4318,18262,328,13944,364
MG,40045,BRASILÂNDIA DE MINAS,5148,1757,2358,9489,98,7131,128
MG,40053,ABRE CAMPO,4836,2886,2987,11139,164,8152,266
MG,40061,CAPITÃO ANDRADE,1572,1205,722,3679,64,2957,116
MG,40070,ACAIACA,1538,849,925,3440,39,2515,89
MG,40088,CARNEIRINHO,3839,1927,1292,7264,71,5972,135
MG,40096,AÇUCENA,3941,1353,3069,8719,124,5650,232
MG,40100,CATUJI,3320,1106,1675,6339,50,4664,188
MG,40118,ÁGUA BOA,5247,1575,4526,11822,86,7296,388
MG,40126,DIVISA ALEGRE,1763,1198,1314,4416,29,3102,112
MG,40134,ÁGUA COMPRIDA,782,732,457,2055,32,1598,52
MG,40142,DIVISÓPOLIS,2702,1353,1024,5294,48,4270,167
MG,40150,AGUANIL,1854,693,735,3451,65,2716,104
MG,40169,DURANDÉ,2700,1534,1392,5819,59,4427,134
MG,40177,ÁGUAS FORMOSAS,6197,3002,4640,14352,127,9712,386
MG,40185,ENTRE FOLHAS,2400,1235,1215,5062,82,3847,130
MG,40193,ÁGUAS VERMELHAS,3798,1981,3694,9839,82,6145,284
MG,40207,FERVEDOURO,4066,1696,1820,7908,123,6088,203
MG,40215,AIMORÉS,7223,6229,3302,17473,242,14171,477
MG,40223,FRANCISCÓPOLIS,2093,537,1694,4513,39,2819,150
MG,40231,AIURUOCA,1801,1698,1252,5053,81,3801,221
MG,40240,ICARAÍ DE MINAS,3824,926,1551,6471,28,4920,142
MG,40258,ALAGOA,669,980,471,2227,34,1756,73
MG,40266,IPABA,6912,2077,2778,12135,169,9357,199
MG,40274,ALBERTINA,679,1006,384,2134,19,1750,46
MG,40282,JAÍBA,11721,3558,5435,21376,139,15941,523
MG,40290,ALÉM PARAÍBA,13815,6919,6467,28467,471,22000,795
MG,40304,JAMPRUCA,2050,616,883,3733,54,2850,130
MG,40312,ALFENAS,18473,22827,10903,54369,902,43466,1264
MG,40320,JUATUBA,7678,3597,2794,15071,414,12277,588
MG,40339,ALMENARA,14070,4209,9339,28681,262,19342,801
MG,40347,LAGOA GRANDE,3023,1781,1341,6297,71,4956,81
MG,40355,ALPERCATA,2770,1461,1379,5872,96,4493,166
MG,40363,LIMEIRA DO OESTE,2889,1027,662,4689,31,4027,80
MG,40371,ALPINÓPOLIS,7347,3548,2818,14276,239,11458,324
MG,40380,LONTRA,3811,811,2449,7296,52,4847,173
MG,40398,ALTEROSA,4028,4506,1884,10773,158,8889,197
MG,40401,MAMONAS,2648,1216,887,4955,44,4068,160
MG,40410,ALTO RIO DOCE,4033,2903,2583,9964,149,7381,296
MG,40428,MATA VERDE,2810,1592,1939,6610,35,4671,234
MG,40436,ALVARENGA,1755,1177,637,3706,46,3069,91
MG,40444,MATIAS CARDOSO,2963,1189,1364,5731,36,4367,179
MG,40452,ALVINÓPOLIS,6862,2195,3151,13035,228,9884,599
MG,40460,MONTEZUMA,2342,1024,1632,5251,46,3619,207
MG,40479,ALVORADA DE MINAS,1731,315,1237,3433,41,2196,109
MG,40487,NAQUE,2388,930,1276,4763,77,3487,92
MG,40495,AMPARO DO SERRA,2264,849,1000,4293,53,3293,127
MG,40509,NOVO ORIENTE DE MINAS,3644,1094,3352,8605,92,5253,423
MG,40517,ANDRADAS,8009,13259,4183,26881,525,22698,905
MG,40525,PALMÓPOLIS,2654,816,2451,6160,39,3709,200
MG,40533,CACHOEIRA DE PAJEÚ,2944,1506,1608,6309,53,4701,198
MG,40541,PEDRAS DE MARIA DA CRUZ,4068,610,2604,7497,35,4893,180
MG,40550,ANDRELÂNDIA,3371,3522,2179,9618,191,7439,355
MG,40568,PERIQUITO,2284,1765,1646,5887,54,4241,138
MG,40576,ANTÔNIO CARLOS,4830,1973,1719,9017,191,7298,304
MG,40584,PONTO DOS VOLANTES,3704,1512,2347,7939,66,5592,310
MG,40592,ANTÔNIO DIAS,3533,2388,2121,8426,100,6305,284
MG,40606,RIACHINHO,2786,714,1561,5218,36,3657,121
MG,40614,ANTÔNIO PRADO DE MINAS,727,538,302,1617,22,1315,28
MG,40622,ROSÁRIO DA LIMEIRA,2424,1269,914,4788,74,3874,107
MG,40630,ARAÇAÍ,799,860,743,2519,36,1776,81
MG,40649,SANTA BÁRBARA DO LESTE,2963,2043,1507,6823,123,5316,187
MG,40657,ARACITABA,934,432,401,1906,65,1505,74
MG,40665,SANTA RITA DE MINAS,2250,1579,1106,5139,77,4033,127
MG,40673,ARAÇUAÍ,10804,6689,9588,27865,202,18277,582
MG,40681,SANTANA DO PARAÍSO,6892,3894,2986,14404,303,11418,329
MG,40690,ARAGUARI,34878,28108,16249,83308,1451,67059,2622
MG,40703,SÃO JOÃO DA LAGOA,2002,799,1269,4189,33,2920,86
MG,40711,ARANTINA,1426,411,642,2644,55,2002,110
MG,40720,SÃO JOÃO DO MANHUAÇU,3627,1957,1336,7140,79,5804,141
MG,40738,ARAPONGA,3610,690,1654,6227,69,4573,204
MG,40746,SÃO JOÃO DO MANTENINHA,2262,1254,890,4536,51,3646,79
MG,40754,ARAPUÁ,705,1336,507,2680,59,2173,73
MG,40762,SÃO JOÃO DO PACUÍ,1956,366,839,3346,32,2507,153
MG,40770,ARAÚJOS,1554,2999,956,5713,105,4757,99
MG,40789,SÃO JOSÉ DA LAPA,7606,4046,2617,15245,447,12628,529
MG,40797,ARAXÁ,26279,26409,12675,68705,1174,56030,2168
MG,40800,SARZEDO,7700,4077,2282,15194,556,12912,579
MG,40819,ARCEBURGO,2032,3239,914,6538,111,5624,242
MG,40827,SEM PEIXE,1354,619,1141,3249,43,2108,92
MG,40835,ARCOS,12847,9035,4387,28074,838,23687,967
MG,40843,SENADOR AMARAL,2453,1136,643,4364,49,3721,83
MG,40851,AREADO,2802,5796,2010,11049,192,9039,249
MG,40860,UBAPORANGA,3649,2870,2504,9319,102,6815,194
MG,40878,ARGIRITA,1450,642,505,2707,39,2202,71
MG,40886,URUCUIA,3238,930,2010,6345,47,4335,120
MG,40894,ARINOS,5927,2658,4464,13449,113,8985,287
MG,40908,VARGEM ALEGRE,2675,1275,1877,6052,72,4175,153
MG,40916,ASTOLFO DUTRA,5607,2667,1726,10395,169,8669,226
MG,40924,JOSENÓPOLIS,1873,277,1220,3499,8,2279,121
MG,40932,ATALÉIA,5740,1431,4314,11921,112,7607,324
MG,40940,JUVENÍLIA,2308,973,1755,5157,29,3402,92
MG,40959,AUGUSTO DE LIMA,1973,859,1293,4281,51,2988,105
MG,40967,LEME DO PRADO,1753,641,1343,3828,24,2485,67
MG,40975,BAEPENDI,5657,5933,2842,15118,252,12276,434
MG,40983,LUISBURGO,1705,2146,936,4939,58,4003,94
MG,40991,BALDIM,3441,1254,1255,6250,137,4995,163
MG,41009,LUISLÂNDIA,2975,436,1820,5354,27,3534,96
MG,41017,BAMBUÍ,7910,5341,4274,18281,263,14007,493
MG,41025,MÁRIO CAMPOS,4105,2585,1656,8924,258,7268,320
MG,41033,BANDEIRA,1940,593,1277,3993,33,2716,150
MG,41041,MARTINS SOARES,2736,1519,1178,5624,70,4446,121
MG,41050,BANDEIRA DO SUL,1967,1750,820,4722,81,3902,104
MG,41068,MIRAVÂNIA,1848,455,1306,3694,12,2388,73
MG,41076,BARÃO DE COCAIS,10329,5377,3988,21081,568,17093,819
MG,41084,MONTE FORMOSO,1579,713,1300,3713,17,2413,104
MG,41092,BARÃO DE MONTE ALTO,2136,1621,722,4655,60,3933,116
MG,41106,NATALÂNDIA,1573,376,738,2746,27,2008,32
MG,41114,BARBACENA,47108,22956,16264,92794,2079,76530,4387
MG,41122,NINHEIRA,3121,1347,2571,7363,52,4792,272
MG,41130,BARRA LONGA,2294,1408,1537,5447,64,3910,144
MG,41149,NOVA BELÉM,1512,777,1020,3432,30,2412,93
MG,41157,TRÊS MARIAS,8595,6594,5008,21184,439,16176,548
MG,41165,NOVA PORTEIRINHA,3496,1037,1315,6073,80,4758,145
MG,41173,BARROSO,7852,4235,2867,16107,521,13240,632
MG,41181,NOVORIZONTE,1987,906,819,3913,57,3094,144
MG,41190,BELA VISTA DE MINAS,4153,1409,1100,7055,168,5955,225
MG,41203,OLHOS D'ÁGUA,2682,425,1397,4633,33,3236,96
MG,41211,BELMIRO BRAGA,1504,685,472,2796,37,2324,98
MG,41220,ORATÓRIOS,2248,661,987,4036,61,3049,79
MG,41238,BELO HORIZONTE,651989,662232,358058,1828692,51846,1470634,104567
MG,41246,ORIZÂNIA,2895,1301,1417,5767,45,4350,109
MG,41254,BELO ORIENTE,8847,3695,4139,17465,399,13326,385
MG,41262,PADRE CARVALHO,2381,488,1459,4473,24,3014,121
MG,41270,BELO VALE,3181,2174,1496,7264,199,5768,214
MG,41289,PAI PEDRO,2519,538,889,4141,31,3252,164
MG,41297,BERILO,4476,1189,3680,9662,77,5982,240
MG,41300,PATIS,2268,582,1043,4003,20,2960,90
MG,41319,BERTÓPOLIS,1739,645,888,3417,21,2529,124
MG,41327,PEDRA BONITA,2362,1567,1011,5124,40,4113,144
MG,41335,BETIM,119740,64704,38989,240927,7226,201938,10268
MG,41343,PIEDADE DE CARATINGA,2546,1662,1044,5424,54,4380,118
MG,41351,BIAS FORTES,1742,728,949,3610,54,2661,137
MG,41360,PINGO D'ÁGUA,2014,574,831,3529,27,2698,83
MG,41378,BICAS,4849,3213,2440,11172,168,8732,502
MG,41386,PINTÓPOLIS,2879,679,2283,5988,50,3705,97
MG,41394,BIQUINHAS,980,821,529,2434,31,1905,73
MG,41408,PONTO CHIQUE,1631,595,1241,3570,15,2329,88
MG,41416,BOA ESPERANÇA,11229,10775,6788,29869,467,23081,610
MG,41424,REDUTO,2054,1594,1154,4976,60,3822,114
MG,41432,BOCAINA DE MINAS,1640,1542,910,4283,54,3373,137
MG,41440,SANTA BÁRBARA DO MONTE VERDE,1457,697,663,2953,35,2290,101
MG,41459,BOCAIÚVA,18665,4903,8952,33770,437,24818,813
MG,41467,SANTA CRUZ DE MINAS,2375,2445,827,6023,158,5196,218
MG,41475,BOM DESPACHO,11612,14906,6701,34939,753,28238,967
MG,41483,SANTA CRUZ DE SALINAS,2353,357,1312,4193,29,2881,142
MG,41491,BOM JARDIM DE MINAS,2612,1412,1175,5464,81,4289,184
MG,41505,SANTA HELENA DE MINAS,1971,1040,1096,4257,25,3161,125
MG,41513,BOM JESUS DA PENHA,1302,1074,560,3055,49,2495,70
MG,41521,SANTO ANTÔNIO DO RETIRO,3034,596,1565,5528,53,3963,280
MG,41530,BOM JESUS DO AMPARO,2374,1092,988,4708,86,3720,168
MG,41548,SÃO DOMINGOS DAS DORES,2625,1206,1000,4956,47,3956,78
MG,41556,BOM JESUS DO GALHO,5093,3086,1891,10540,134,8649,336
MG,41564,SÃO FÉLIX DE MINAS,1235,809,819,2979,37,2160,79
MG,41572,BOM REPOUSO,3850,2531,1117,7799,118,6682,183
MG,41580,SÃO GERALDO DO BAIXIO,1308,680,492,2574,42,2082,52
MG,41599,BOM SUCESSO,4741,5878,3312,14619,284,11307,404
MG,41602,SÃO JOÃO DAS MISSÕES,4127,874,1969,7339,48,5370,321
MG,41610,BONFIM,2911,1730,1027,6177,230,5150,279
MG,41629,SÃO JOAQUIM DE BICAS,8863,2889,3356,15913,333,12557,472
MG,41637,BONFINÓPOLIS DE MINAS,2150,1134,1689,5146,71,3457,102
MG,41645,SÃO JOSÉ DA BARRA,2739,1393,1410,5742,75,4332,125
MG,41653,BORDA DA MATA,4620,5138,2300,12627,199,10327,370
MG,41661,ALTO CAPARAÓ,893,1935,409,3381,50,2972,94
MG,41670,BOTELHOS,5122,4219,2668,12512,210,9844,293
MG,41688,ANGELÂNDIA,2282,1464,2286,6274,55,3988,187
MG,41696,BOTUMIRIM,2521,687,1761,5135,35,3374,131
MG,41700,ARICANDUVA,1879,833,1288,4181,39,2893,142
MG,41718,BRASÍLIA DE MINAS,13550,3125,7790,25365,277,17575,623
MG,41726,BERIZAL,1677,903,604,3310,29,2706,97
MG,41734,BRÁS PIRES,1767,884,1003,3793,47,2790,92
MG,41742,BONITO DE MINAS,3504,478,2241,6468,22,4227,223
MG,41750,BRAÚNAS,1915,825,735,3702,75,2967,152
MG,41769,BUGRE,1635,1158,882,3797,41,2915,81
MG,41777,BRAZÓPOLIS,3695,5754,2656,12547,172,9891,270
MG,41785,CABECEIRA GRANDE,2249,1319,1385,5088,38,3703,97
MG,41793,BRUMADINHO,10491,6982,3673,22704,592,19031,966
MG,41807,CAMPO AZUL,1775,372,1064,3304,17,2240,76
MG,41815,BUENO BRANDÃO,2526,3941,1659,8582,168,6923,288
MG,41823,CANTAGALO,1391,786,654,3010,63,2356,116
MG,41831,BUENÓPOLIS,3036,1622,3326,8315,121,4989,210
MG,41840,CATAS ALTAS,1810,1234,707,3999,119,3292,129
MG,41858,BURITIS,6001,5248,4710,16486,188,11776,339
MG,41866,CATUTI,2336,560,1077,4167,42,3090,152
MG,41874,BURITIZEIRO,9056,3820,5852,19476,259,13624,489
MG,41882,CHAPADA GAÚCHA,3403,1001,2040,6694,41,4654,209
MG,41890,CABO VERDE,4133,3191,2096,9773,132,7677,221
MG,41904,CÔNEGO MARINHO,3028,553,1213,4970,24,3757,152
MG,41912,CACHOEIRA DA PRATA,1388,1124,456,3179,101,2723,110
MG,41920,CONFINS,2398,1452,589,4736,131,4147,166
MG,41939,CACHOEIRA DE MINAS,2582,4212,1464,8627,134,7163,235
MG,41947,CÓRREGO FUNDO,2350,1413,563,4629,144,4066,159
MG,41955,CACHOEIRA DOURADA,1194,488,852,2585,17,1733,34
MG,41963,CRISÓLITA,2120,717,1126,4134,35,3008,136
MG,41971,CAETANÓPOLIS,3251,2303,1365,7364,175,5999,270
MG,41980,CUPARAQUE,1359,1407,922,3779,25,2857,66
MG,41998,CAETÉ,14357,9042,6022,31420,711,25398,1288
MG,42005,CURRAL DE DENTRO,2278,1546,1659,5687,24,4028,180
MG,42013,CAIANA,1691,1033,505,3356,44,2851,83
MG,42021,DELTA,2519,815,910,4412,68,3502,100
MG,42030,CAJURI,2121,794,686,3792,74,3106,117
MG,42048,DOM BOSCO,1499,763,706,3048,27,2342,53
MG,42056,CALDAS,3559,4575,1674,10249,141,8575,300
MG,42064,FREI LAGONEGRO,1543,488,742,2866,21,2124,72
MG,42072,CAMACHO,1366,1028,640,3184,66,2544,84
MG,42080,FRUTA DE LEITE,2562,381,1870,5008,21,3138,174
MG,42099,CAMANDUCAIA,6278,5755,2963,15639,237,12676,406
MG,42102,GAMELEIRAS,1937,827,967,3881,18,2914,132
MG,42110,CAMBUÍ,6720,8244,3700,19687,347,15987,676
MG,42129,GLAUCILÂNDIA,1771,519,673,3052,28,2379,61
MG,42137,CAMBUQUIRA,2428,4961,2011,9770,111,7759,259
MG,42145,GOIABEIRA,1153,794,469,2504,21,2035,67
MG,42153,CAMPANÁRIO,1630,514,779,3036,34,2257,79
MG,42161,GOIANÁ,1544,906,734,3374,58,2640,132
MG,42170,CAMPANHA,2747,6045,2322,11565,171,9243,280
MG,42188,GUARACIAMA,3331,417,1269,5177,54,3908,106
MG,42196,CAMPESTRE,3961,8258,2978,15873,309,12895,367
MG,42200,IBIRACATU,2553,888,1803,5447,24,3644,179
MG,42218,CAMPINA VERDE,6147,5034,2770,14442,181,11672,310
MG,42226,IMBÉ DE MINAS,2436,1106,1459,5136,35,3677,100
MG,42234,CAMPO BELO,17646,11136,7993,38702,840,30709,1087
MG,42242,INDAIABIRA,2425,1167,1790,5621,29,3831,210
MG,42250,CAMPO DO MEIO,4215,2667,2278,9577,222,7299,195
MG,42269,JAPONVAR,3959,673,2503,7370,52,4867,183
MG,42277,CAMPO FLORIDO,1787,1444,679,4015,41,3336,64
MG,42285,JENIPAPO DE MINAS,2249,758,2218,5382,41,3164,116
MG,42293,CAMPOS ALTOS,3476,3784,2524,10150,161,7626,205
MG,42307,JOSÉ GONÇALVES DE MINAS,1431,874,1103,3558,39,2455,111
MG,42315,CAMPOS GERAIS,6835,7857,4661,20180,353,15519,474
MG,42323,JOSÉ RAYDAN,1909,449,1174,3652,20,2478,100
MG,42331,CANAÃ,2327,701,532,3756,57,3224,139
MG,42340,SÃO SEBASTIÃO DA VARGEM ALEGRE,1250,733,496,2599,42,2103,78
MG,42358,CANÁPOLIS,4203,2586,2077,9126,93,7049,167
MG,42366,SÃO SEBASTIÃO DO ANTA,1970,1152,1318,4550,39,3232,71
MG,42374,CANA VERDE,2149,1385,566,4303,96,3737,107
MG,42382,SERRANÓPOLIS DE MINAS,1983,683,751,3572,28,2821,127
MG,42390,CANDEIAS,5036,3940,2199,11771,242,9572,354
MG,42404,SETUBINHA,3390,834,3093,7710,55,4617,338
MG,42412,CAPARAÓ,1219,1726,912,3995,52,3083,86
MG,42420,TAPARUBA,1194,991,868,3147,31,2279,63
MG,42439,CAPELA NOVA,1716,1273,658,3910,140,3252,123
MG,42447,UNIÃO DE MINAS,1751,806,1124,3736,17,2612,38
MG,42455,CAPELINHA,9240,6143,7115,23537,314,16422,725
MG,42463,URUANA DE MINAS,1533,519,837,2979,27,2142,63
MG,42471,CAPETINGA,2099,2193,1511,5994,69,4483,122
MG,42480,VARGEM GRANDE DO RIO PARDO,1632,950,773,3484,20,2711,109
MG,42498,CAPIM BRANCO,2923,2404,1129,6777,147,5648,174
MG,42501,VARJÃO DE MINAS,1575,1825,880,4432,65,3552,87
MG,42510,CAPINÓPOLIS,5420,3246,1778,10723,112,8945,167
MG,42528,VERDELÂNDIA,3309,755,1699,5965,34,4266,168
MG,42536,CAPITÃO ENÉAS,5790,1910,3354,11470,109,8116,307
MG,42544,VEREDINHA,2383,743,1310,4604,31,3294,137
MG,42552,CAPITÓLIO,3044,2012,1386,6729,111,5343,176
MG,42560,VERMELHO NOVO,1769,1508,820,4267,76,3447,94
MG,42579,CAPUTIRA,3110,2246,1725,7378,141,5653,156
MG,42587,TOCOS DO MOJI,1643,1269,339,3368,46,3029,71
MG,42595,CARAÍ,7137,1249,5334,14333,100,8999,513
MG,42617,CARANAÍBA,1219,992,458,2873,94,2415,110
MG,42633,CARANDAÍ,8606,5577,2591,18256,741,15665,741
MG,42650,CARANGOLA,10513,7224,5824,24598,370,18774,667
MG,42676,CARATINGA,22053,20828,14025,59869,1120,45844,1843
MG,42692,CARBONITA,3023,2010,2224,7486,49,5262,180
MG,42714,CAREAÇU,1867,1740,989,4722,40,3733,86
MG,42730,CARLOS CHAGAS,6100,4232,6034,16964,207,10930,391
MG,42757,CARMÉSIA,1045,395,580,2110,20,1530,70
MG,42773,CARMO DA CACHOEIRA,3849,2880,2104,9300,177,7196,290
MG,42790,CARMO DA MATA,4104,2963,1301,8812,171,7511,273
MG,42811,CARMO DE MINAS,2796,4254,1718,9223,153,7505,302
MG,42838,CARMO DO CAJURU,6602,5674,2411,15548,395,13137,466
MG,42854,CARMO DO PARANAÍBA,6857,8486,5228,21639,508,16411,560
MG,42870,CARMO DO RIO CLARO,6572,4912,3102,15161,233,12059,342
MG,42897,CARMÓPOLIS DE MINAS,5546,3839,1927,11981,263,10054,406
MG,42919,CARRANCAS,1234,1169,456,2989,36,2533,94
MG,42935,CARVALHÓPOLIS,1118,1132,511,2872,34,2361,77
MG,42951,CARVALHOS,1458,1350,840,3896,87,3056,161
MG,42978,CASA GRANDE,885,731,404,2213,87,1809,106
MG,42994,CASCALHO RICO,1096,926,558,2674,31,2116,63
MG,43010,CÁSSIA,5048,5137,2967,13771,212,10804,407
MG,43036,CONCEIÇÃO DA BARRA DE MINAS,1325,1344,399,3205,54,2806,83
MG,43052,CATAGUASES,28407,11052,10147,52518,1043,42371,1869
MG,43079,CATAS ALTAS DA NORUEGA,1619,635,725,3113,48,2388,86
MG,43095,CAXAMBU,5924,6978,4125,17880,324,13755,529
MG,43117,CEDRO DO ABAETÉ,269,573,415,1312,27,897,28
MG,43133,CENTRAL DE MINAS,2066,2094,1222,5573,64,4351,127
MG,43150,CENTRALINA,3559,1625,1079,6510,93,5431,154
MG,43176,CHÁCARA,1275,608,377,2388,35,2011,93
MG,43192,CHALÉ,1866,1490,707,4249,78,3542,108
MG,43214,CHAPADA DO NORTE,4785,869,3970,10004,83,6034,297
MG,43230,CHIADOR,1362,762,486,2738,33,2252,95
MG,43257,CIPOTÂNEA,2325,958,1788,5334,119,3546,144
MG,43273,CLARAVAL,1294,2027,706,4117,29,3411,61
MG,43290,CLARO DOS POÇÕES,3548,1318,2071,7217,95,5146,185
MG,43311,CLÁUDIO,7184,7802,2610,18498,462,15888,440
MG,43338,COIMBRA,2817,1892,1054,6095,130,5041,202
MG,43354,COLUNA,3045,1131,2383,6840,54,4457,227
MG,43370,COMENDADOR GOMES,814,973,592,2418,17,1826,22
MG,43397,COMERCINHO,3368,1022,2257,6935,56,4678,232
MG,43419,CONCEIÇÃO DA APARECIDA,3101,2559,1870,7819,141,5949,148
MG,43435,CONCEIÇÃO DAS PEDRAS,956,940,439,2448,50,2009,63
MG,43451,CONCEIÇÃO DAS ALAGOAS,7970,4128,3918,16484,174,12566,294
MG,43478,CONCEIÇÃO DE IPANEMA,1860,1072,521,3574,32,3053,89
MG,43494,CONCEIÇÃO DO MATO DENTRO,6517,2127,5031,14386,208,9355,503
MG,43516,CONCEIÇÃO DO PARÁ,1807,1550,778,4368,106,3590,127
MG,43532,CONCEIÇÃO DO RIO VERDE,2560,4591,2188,9722,170,7534,213
MG,43559,CONCEIÇÃO DOS OUROS,2632,3644,1345,7972,143,6627,208
MG,43575,CONGONHAL,2210,3726,953,7129,104,6176,136
MG,43591,CONGONHAS,16009,12189,5014,36261,1142,31247,1907
MG,43613,CONGONHAS DO NORTE,1911,366,1321,3824,43,2503,183
MG,43630,CONQUISTA,1820,2022,562,4612,74,4050,134
MG,43656,CONSELHEIRO LAFAIETE,44384,22247,12251,85425,2413,73174,4130
MG,43672,CONSELHEIRO PENA,6035,5492,4262,16401,205,12139,407
MG,43699,CONSOLAÇÃO,552,671,297,1592,26,1295,46
MG,43710,CONTAGEM,197480,111855,74556,418498,12240,343942,22367
MG,43737,COQUEIRAL,2190,3162,1821,7457,104,5636,180
MG,43753,CORAÇÃO DE JESUS,11470,2291,6584,20986,194,14402,447
MG,43770,CORDISBURGO,3137,1657,1802,6868,94,5066,178
MG,43796,CORDISLÂNDIA,1104,1046,848,3077,34,2229,45
MG,43818,CORINTO,9808,3213,5831,19485,216,13654,417
MG,43834,COROACI,3492,2117,2827,8804,109,5977,259
MG,43850,COROMANDEL,8494,7664,5035,22131,359,17096,579
MG,43877,CORONEL FABRICIANO,34724,21773,16480,76678,1608,60198,2093
MG,43893,CORONEL MURTA,3352,1354,1718,6652,68,4934,160
MG,43915,CORONEL PACHECO,1311,516,256,2243,55,1987,105
MG,43931,CORONEL XAVIER CHAVES,1152,943,430,2680,66,2250,89
MG,43958,CÓRREGO DANTA,1049,1034,771,2956,29,2185,73
MG,43974,CÓRREGO DO BOM JESUS,1241,1385,447,3213,41,2766,99
MG,43990,CÓRREGO NOVO,1587,544,1122,3349,31,2227,65
MG,44016,COUTO DE MAGALHÃES DE MINAS,1901,484,1104,3649,48,2545,112
MG,44032,CRISTAIS,4003,2009,1539,7994,151,6455,292
MG,44059,CRISTÁLIA,2306,568,1339,4349,36,3010,100
MG,44075,CRISTIANO OTONI,1718,1424,571,4059,157,3488,189
MG,44091,CRISTINA,2110,3688,1811,7983,105,6172,269
MG,44113,CRUCILÂNDIA,1769,1553,844,4398,102,3554,130
MG,44130,CRUZEIRO DA FORTALEZA,1364,1201,832,3525,52,2693,76
MG,44156,CRUZÍLIA,4401,4496,2275,11609,170,9334,267
MG,44172,CURVELO,24263,16587,7099,50454,1049,43355,1456
MG,44199,DATAS,2429,561,1311,4488,73,3177,114
MG,44210,DELFIM MOREIRA,1908,3004,1313,6477,80,5164,172
MG,44237,DELFINÓPOLIS,2267,1833,1307,5633,88,4326,138
MG,44253,DESCOBERTO,1480,1885,647,4220,65,3573,143
MG,44270,DESTERRO DE ENTRE RIOS,1953,2244,721,5323,225,4602,180
MG,44296,DESTERRO DO MELO,1286,976,391,2810,58,2419,99
MG,44318,DIAMANTINA,16084,6985,9784,34405,535,24621,1017
MG,44334,DIOGO DE VASCONCELOS,1919,458,700,3232,31,2532,124
MG,44350,DIONÍSIO,3244,1468,2431,7462,118,5031,201
MG,44377,DIVINÉSIA,1747,816,496,3180,38,2684,83
MG,44393,DIVINO,6760,3519,3578,14321,164,10743,300
MG,44415,DIVINO DAS LARANJEIRAS,1557,1235,952,3920,55,2968,121
MG,44431,DIVINOLÂNDIA DE MINAS,2484,1218,1697,5622,74,3925,149
MG,44458,DIVINÓPOLIS,77205,43769,23070,154378,3982,131308,6352
MG,44474,DIVISA NOVA,1687,1788,917,4565,65,3648,108
MG,44490,DOM CAVATI,1868,1671,836,4535,53,3699,107
MG,44512,DOM JOAQUIM,1795,516,1099,3568,44,2469,114
MG,44539,DOM SILVÉRIO,1862,1329,673,4150,95,3477,191
MG,44555,DOM VIÇOSO,935,1125,356,2521,44,2165,61
MG,44571,DONA EUSÉBIA,2841,1024,650,4678,61,4028,102
MG,44598,DORES DE CAMPOS,2385,3087,840,7070,365,6230,393
MG,44610,DORES DE GUANHÃES,2440,589,1418,4647,59,3229,141
MG,44636,DORES DO INDAIÁ,3635,4573,2589,11189,145,8600,247
MG,44652,DORES DO TURVO,1953,1086,1197,4396,50,3199,110
MG,44679,DORESÓPOLIS,505,539,401,1511,29,1110,37
MG,44695,DOURADOQUARA,897,497,247,1719,40,1472,38
MG,44717,ELÓI MENDES,5762,8660,2960,18138,290,15178,466
MG,44733,ENGENHEIRO CALDAS,2946,2276,1645,7170,123,5525,180
MG,44750,ENGENHEIRO NAVARRO,3148,782,1383,5562,82,4179,167
MG,44776,ENTRE RIOS DE MINAS,4994,3583,1331,10573,278,9242,387
MG,44792,ERVÁLIA,7551,3578,2596,14665,390,12069,550
MG,44814,ESMERALDAS,18523,8069,7298,35716,775,28418,1051
MG,44830,ESPERA FELIZ,6442,4977,2270,14337,259,12067,389
MG,44857,ESPINOSA,10255,4878,9310,25239,200,15929,596
MG,44873,ESPÍRITO SANTO DO DOURADO,1539,1650,418,3800,51,3382,142
MG,44890,ESTIVA,2983,3581,1373,8353,170,6980,246
MG,44911,ESTRELA DALVA,1181,500,568,2348,31,1780,68
MG,44938,ESTRELA DO INDAIÁ,895,1209,734,2958,37,2224,83
MG,44954,ESTRELA DO SUL,2795,1342,1173,5524,103,4351,111
MG,44970,EUGENÓPOLIS,3851,2383,1569,8115,122,6546,190
MG,44997,EWBANK DA CÂMARA,2009,634,661,3473,66,2812,103
MG,45012,EXTREMA,8236,8089,3762,20988,378,17226,523
MG,45039,FAMA,981,940,502,2522,40,2020,59
MG,45055,FARIA LEMOS,1436,852,721,3157,38,2436,110
MG,45071,FELÍCIO DOS SANTOS,1724,791,1846,4525,51,2679,113
MG,45098,SÃO GONÇALO DO RIO PRETO,1341,525,859,2851,44,1992,82
MG,45110,FELISBURGO,1929,1161,1864,5137,37,3273,146
MG,45136,FELIXLÂNDIA,4862,3088,2781,11108,156,8327,221
MG,45152,FERNANDES TOURINHO,1139,824,450,2499,26,2049,60
MG,45179,FERROS,4208,1639,1839,8089,104,6250,299
MG,45195,FLORESTAL,2712,1332,1040,5433,133,4393,216
MG,45217,FORMIGA,18858,21027,9126,52132,1253,43006,1868
MG,45233,FORMOSO,2493,1208,1161,5012,26,3851,124
MG,45250,FORTALEZA DE MINAS,1182,1224,694,3290,87,2596,103
MG,45276,FORTUNA DE MINAS,1188,631,519,2443,39,1924,66
MG,45292,FRANCISCO BADARÓ,2920,1264,2978,7398,60,4420,176
MG,45314,FRANCISCO DUMONT,1759,855,1474,4248,58,2774,102
MG,45330,FRANCISCO SÁ,10930,2074,3856,17575,154,13719,561
MG,45357,FREI GASPAR,2492,617,1196,4517,43,3321,169
MG,45373,FREI INOCÊNCIO,3306,1353,1900,6805,75,4905,171
MG,45390,FRONTEIRA,4845,2696,2714,10597,123,7883,219
MG,45411,FRUTAL,14772,14094,8019,38142,508,30123,749
MG,45438,FUNILÂNDIA,1531,1059,917,3661,43,2744,111
MG,45454,GALILÉIA,2179,1508,1550,5412,58,3862,117
MG,45470,GONÇALVES,923,1775,682,3522,41,2840,101
MG,45497,GONZAGA,1374,1509,941,3988,50,3047,114
MG,45519,GOUVEIA,4999,1305,2703,9452,160,6749,285
MG,45535,GOVERNADOR VALADARES,65926,71709,47873,193961,3732,146088,4721
MG,45551,GRÃO MOGOL,5364,1488,3377,10645,104,7268,312
MG,45578,GRUPIARA,558,518,322,1468,28,1146,42
MG,45594,GUANHÃES,8443,6788,6284,22670,384,16386,771
MG,45616,GUAPÉ,3435,4229,2069,10091,151,8022,207
MG,45632,GUARACIABA,3589,2100,2128,8104,74,5976,213
MG,45659,GUARANÉSIA,7524,3517,2639,14294,222,11655,392
MG,45675,GUARANI,2926,2321,1195,6845,132,5650,271
MG,45691,GUARARÁ,1388,1085,717,3392,62,2675,140
MG,45713,GUARDA-MOR,2001,1572,1479,5212,47,3733,113
MG,45730,GUAXUPÉ,15334,12284,7085,36857,720,29772,1434
MG,45756,GUIDOVAL,3331,1635,1183,6439,123,5256,167
MG,45772,GUIMARÂNIA,2519,1981,1295,6097,107,4802,195
MG,45799,GUIRICEMA,3338,2005,718,6460,160,5742,239
MG,45810,GURINHATÃ,1853,2000,1882,5891,43,4009,113
MG,45837,HELIODORA,1920,1938,757,4802,70,4045,117
MG,45853,IAPU,3140,2568,1871,7880,110,6009,191
MG,45870,IBERTIOGA,2547,940,820,4488,74,3668,107
MG,45896,IBIÁ,6460,5981,4239,17396,262,13157,454
MG,45918,IBIAÍ,3267,677,1928,6029,40,4101,117
MG,45934,IBIRACI,2337,4195,1455,8263,88,6808,188
MG,45950,IBIRITÉ,52310,20315,15938,95284,2926,79346,3795
MG,45977,IBITIÚRA DE MINAS,1238,1185,493,3095,73,2602,106
MG,45993,IBITURUNA,842,1009,435,2369,36,1934,47
MG,46019,IGARAPÉ,12503,4769,4534,23263,622,18729,835
MG,46035,IGARATINGA,3894,1123,970,6291,170,5321,134
MG,46051,IGUATAMA,2687,2413,961,6335,117,5374,157
MG,46078,IJACI,1872,1924,461,4468,95,4007,116
MG,46094,ILICÍNEA,3897,2801,1641,8615,118,6974,158
MG,46116,INCONFIDENTES,2307,2386,888,5796,85,4908,130
MG,46132,INDIANÓPOLIS,2302,1159,1089,4717,63,3628,104
MG,46159,INGAÍ,933,991,470,2500,33,2030,73
MG,46175,INHAPIM,8885,5174,4612,19327,254,14715,402
MG,46191,INHAÚMA,2486,1206,971,4905,95,3934,147
MG,46213,INIMUTABA,2714,1145,1251,5333,99,4082,124
MG,46230,IPANEMA,5207,5136,2704,13515,157,10811,311
MG,46256,IPATINGA,66124,62396,36442,174452,4013,138010,5477
MG,46272,IPIAÇU,1522,1031,1116,3763,35,2647,59
MG,46299,IPUIÚNA,3140,2791,1165,7320,70,6155,154
MG,46310,IRAÍ DE MINAS,2799,1378,1027,5416,66,4389,146
MG,46337,ITABIRA,40318,23782,14753,84917,1990,70164,4074
MG,46353,ITABIRINHA,3309,2179,1982,7865,154,5883,241
MG,46370,ITABIRITO,14659,12412,5481,35123,1011,29642,1560
MG,46396,ITACAMBIRA,2264,382,1516,4316,28,2800,126
MG,46418,ITACARAMBI,6707,1773,4077,13031,107,8954,367
MG,46434,ITAGUARA,4044,3370,1826,10033,348,8207,445
MG,46450,ITAIPÉ,3199,1747,2729,8032,98,5303,259
MG,46477,ITAJUBÁ,19489,32240,13325,68475,1139,55150,2282
MG,46493,ITAMARANDIBA,8643,6435,6398,22505,379,16107,650
MG,46515,ITAMARATI DE MINAS,1920,766,487,3339,49,2852,117
MG,46531,ITAMBACURI,8335,2770,6424,18290,165,11866,596
MG,46558,ITAMBÉ DO MATO DENTRO,1108,380,567,2201,42,1634,104
MG,46574,ITAMOGI,3409,3058,2100,8983,136,6883,280
MG,46590,ITAMONTE,3169,4897,1803,10472,221,8669,382
MG,46612,ITANHANDU,3660,5283,1904,11302,176,9398,279
MG,46639,ITANHOMI,3756,3024,1705,8857,103,7152,269
MG,46655,ITAOBIM,5044,5420,5345,16455,202,11110,444
MG,46671,ITAPAGIPE,3725,3463,2242,9749,143,7507,176
MG,46698,ITAPECERICA,6096,6860,2844,16759,375,13915,584
MG,46710,ITAPEVA,2738,2395,1456,6843,96,5387,158
MG,46736,ITATIAIUÇU,3819,2048,1404,7687,205,6283,211
MG,46752,ITAÚNA,20402,29099,9208,63230,1635,54022,2886
MG,46779,ITAVERAVA,2781,1263,1103,5434,130,4331,157
MG,46795,ITINGA,4597,2218,3700,10842,78,7142,249
MG,46817,ITUETA,2063,1836,1052,5108,69,4056,88
MG,46833,ITUIUTABA,34637,19606,17182,73710,839,56528,1446
MG,46850,ITUMIRIM,2221,1967,1008,5502,118,4494,188
MG,46876,ITURAMA,14125,5788,6137,26701,233,20564,418
MG,46892,ITUTINGA,1383,1208,762,3482,47,2720,82
MG,46914,JABOTICATUBAS,6120,3088,1977,11749,184,9772,380
MG,46930,JACINTO,3691,2118,2237,8401,84,6164,271
MG,46957,JACUÍ,1100,3251,1445,6046,103,4601,147
MG,46973,JACUTINGA,4357,8280,2379,15633,214,13254,403
MG,46990,JAGUARAÇU,1351,633,452,2565,74,2113,55
MG,47015,JANAÚBA,22989,10604,11846,47147,576,35301,1132
MG,47031,JANUÁRIA,24794,5620,15322,47250,406,31928,1108
MG,47058,JAPARAÍBA,1164,1271,390,2965,69,2575,71
MG,47074,JECEABA,2090,1616,1012,4991,141,3979,132
MG,47090,JEQUERI,4811,1916,2123,9408,195,7285,363
MG,47112,JEQUITAÍ,3277,809,2457,6774,65,4317,166
MG,47139,JEQUITIBÁ,1983,1593,1236,5021,71,3785,138
MG,47155,JEQUITINHONHA,7828,2823,6353,17701,138,11348,559
MG,47171,JESUÂNIA,1623,1576,815,4186,60,3371,112
MG,47198,JOAÍMA,5004,1987,3835,11333,124,7498,383
MG,47210,JOANÉSIA,2227,910,1290,4683,90,3393,166
MG,47236,JOÃO MONLEVADE,22938,19004,11313,56750,1341,45437,2154
MG,47252,JOÃO PINHEIRO,14721,9498,9356,34809,551,25453,683
MG,47279,JOAQUIM FELÍCIO,1333,833,1256,3550,46,2294,82
MG,47295,JORDÂNIA,3314,1543,2746,7891,68,5145,220
MG,47317,NOVA UNIÃO,2736,975,1180,5107,71,3927,145
MG,47333,JUIZ DE FORA,189310,85697,70793,378061,9234,307268,23027
MG,47350,JURAMENTO,2094,738,861,3869,69,3008,107
MG,47376,JURUAIA,2721,2442,1241,6741,147,5500,190
MG,47392,LADAINHA,5633,1461,4083,11747,90,7664,480
MG,47414,LAGAMAR,2591,2172,1346,6275,77,4929,89
MG,47430,LAGOA DA PRATA,10446,14414,5248,31591,653,26343,830
MG,47457,LAGOA DOS PATOS,1812,611,1331,3874,35,2543,85
MG,47473,LAGOA DOURADA,3598,3520,1269,9126,382,7857,357
MG,47490,LAGOA FORMOSA,4510,5399,1641,12162,357,10521,255
MG,47511,LAGOA SANTA,13062,13221,6573,35601,1192,29028,1553
MG,47538,LAJINHA,5402,5331,3072,14415,207,11343,403
MG,47554,LAMBARI,4736,7015,3072,15571,254,12499,494
MG,47570,LAMIM,1637,705,524,3031,76,2507,89
MG,47597,LARANJAL,2681,1539,880,5361,83,4481,178
MG,47619,LASSANCE,2559,782,1577,5093,63,3516,112
MG,47635,LAVRAS,24520,25515,11951,66201,1490,54250,2725
MG,47651,LEANDRO FERREIRA,1234,971,519,2835,52,2316,59
MG,47678,LEOPOLDINA,19608,9590,8150,39080,664,30930,1068
MG,47694,LIBERDADE,1822,1408,841,4275,67,3434,137
MG,47716,LIMA DUARTE,6476,2974,3042,13248,274,10206,482
MG,47732,LUMINÁRIAS,1735,1478,692,4096,79,3404,112
MG,47759,LUZ,4781,5568,3124,14003,221,10879,309
MG,47775,MACHACALIS,2770,876,1173,5023,46,3850,158
MG,47791,MACHADO,7093,14422,5277,27937,427,22660,718
MG,47813,MADRE DE DEUS DE MINAS,1884,1233,973,4280,64,3307,126
MG,47830,MALACACHETA,6286,2583,6045,15646,160,9601,572
MG,47856,MANGA,8096,1939,4869,15377,81,10508,392
MG,47872,MANHUAÇU,19876,19671,11154,53045,937,41891,1407
MG,47899,MANHUMIRIM,4955,6628,3819,16086,237,12267,447
MG,47910,MANTENA,7522,6062,3684,17962,234,14278,460
MG,47937,MARAVILHAS,2382,2035,1054,5701,97,4647,133
MG,47953,MAR DE ESPANHA,3875,2903,1776,9062,158,7286,350
MG,47970,MARIA DA FÉ,3996,5328,2038,11828,155,9790,311
MG,47996,MARIANA,19904,10413,8073,41321,1066,33248,1865
MG,48011,MARILAC,1661,804,910,3557,59,2647,123
MG,48038,MARIPÁ DE MINAS,1342,710,583,2775,41,2192,99
MG,48054,MARLIÉRIA,1697,988,667,3557,91,2890,114
MG,48070,MARMELÓPOLIS,1308,771,746,2961,61,2215,75
MG,48097,MARTINHO CAMPOS,3721,3411,2478,10093,207,7615,276
MG,48119,MATERLÂNDIA,1911,528,1641,4227,43,2586,104
MG,48135,MATEUS LEME,8948,5483,3636,19408,568,15772,773
MG,48151,MATIAS BARBOSA,5403,2583,1854,10593,260,8739,493
MG,48178,MATIPÓ,5963,3602,3407,13537,205,10130,360
MG,48194,MATO VERDE,5455,2056,2521,10398,109,7877,257
MG,48216,MATOZINHOS,12831,7336,4726,26820,827,22094,1100
MG,48232,MATUTINA,1002,1402,717,3278,56,2561,101
MG,48259,MEDEIROS,869,1131,706,2811,30,2105,75
MG,48275,MEDINA,7301,3044,4004,15029,210,11025,470
MG,48291,MENDES PIMENTEL,2077,1450,989,4755,84,3766,155
MG,48313,MERCÊS,3704,1933,1322,7376,133,6054,284
MG,48330,MESQUITA,2156,1309,1576,5254,95,3678,118
MG,48356,MINAS NOVAS,9222,2742,9311,22091,203,12780,613
MG,48372,MINDURI,1346,985,662,3098,34,2436,71
MG,48399,MIRABELA,5944,1156,3152,10521,80,7369,189
MG,48410,MIRADOURO,3975,2398,1912,8706,167,6794,254
MG,48437,MIRAÍ,3644,3598,2311,10086,197,7775,336
MG,48453,MOEDA,1944,1349,894,4471,92,3577,192
MG,48470,MOEMA,2342,2261,1269,6049,73,4780,104
MG,48496,MONJOLOS,803,553,668,2110,25,1442,61
MG,48518,MONSENHOR PAULO,2317,2300,985,5925,120,4940,203
MG,48534,MONTALVÂNIA,5433,2742,4444,13055,92,8611,344
MG,48550,MONTE ALEGRE DE MINAS,6466,4044,3470,14575,232,11105,363
MG,48577,MONTE AZUL,9228,3308,3323,16525,175,13202,491
MG,48593,MONTE BELO,3872,3898,2163,10408,216,8245,259
MG,48615,MONTE CARMELO,18306,7993,7415,35488,620,28073,882
MG,48631,MONTE SANTO DE MINAS,4287,8105,3636,16732,249,13096,455
MG,48658,MONTES CLAROS,120444,58681,45019,238231,4716,193212,9371
MG,48674,MONTE SIÃO,3932,8235,3242,15980,210,12738,361
MG,48690,MORADA NOVA DE MINAS,2718,2103,1578,6658,93,5080,166
MG,48712,MORRO DA GARÇA,1089,685,730,2586,36,1856,46
MG,48739,MORRO DO PILAR,1562,512,730,2972,36,2242,132
MG,48755,MUNHOZ,2151,1805,1196,5367,76,4171,139
MG,48771,MURIAÉ,34698,20178,14976,73533,1227,58557,2454
MG,48798,MUTUM,8062,7163,3460,19483,272,16023,526
MG,48810,MUZAMBINHO,6283,6362,3358,16679,266,13321,410
MG,48836,NACIP RAYDAN,1311,389,721,2510,20,1789,69
MG,48852,NANUQUE,11551,9071,9962,31729,419,21767,726
MG,48879,NATÉRCIA,1016,2163,685,4048,68,3363,116
MG,48895,NAZARENO,2909,1632,1285,6101,135,4816,140
MG,48917,NEPOMUCENO,6702,8108,4024,19771,384,15747,553
MG,48933,NOVA ERA,6878,3593,3501,14792,308,11291,512
MG,48950,NOVA LIMA,23193,19379,8752,56280,1818,47528,3138
MG,48976,NOVA MÓDICA,1472,674,872,3191,29,2319,144
MG,48992,NOVA PONTE,4651,2522,1771,9228,116,7457,168
MG,49018,NOVA RESENDE,4254,4392,1998,11215,256,9217,315
MG,49034,NOVA SERRANA,13746,17656,7318,40907,1152,33589,1035
MG,49050,NOVO CRUZEIRO,9910,2681,9231,22875,284,13644,769
MG,49077,OLARIA,1061,503,371,2034,40,1663,59
MG,49093,OLÍMPIO NORONHA,739,974,352,2175,32,1823,78
MG,49115,OLIVEIRA,11542,11841,5409,30589,701,25180,1096
MG,49131,OLIVEIRA FORTES,1131,342,298,1906,48,1608,87
MG,49158,ONÇA DE PITANGUI,1025,1045,450,2617,36,2167,61
MG,49174,OURO BRANCO,11628,8481,4746,26365,590,21619,920
MG,49190,OURO FINO,6615,11912,4593,24047,339,19454,588
MG,49212,OURO PRETO,26607,14854,9997,55276,1312,45279,2506
MG,49239,OURO VERDE DE MINAS,2787,1149,1783,5950,45,4167,186
MG,49255,PADRE PARAÍSO,6183,2459,5359,14618,177,9259,440
MG,49271,PAINEIRAS,1830,1196,1013,4205,74,3192,92
MG,49298,PAINS,2488,2808,1056,6561,90,5505,119
MG,49310,PAIVA,735,354,326,1544,50,1218,79
MG,49336,PALMA,2443,1346,827,4814,66,3987,132
MG,49352,FRONTEIRA DOS VALES,1918,776,1024,3879,34,2855,127
MG,49379,PAPAGAIOS,5564,2768,1789,10501,131,8712,249
MG,49395,PARACATU,22085,21820,11858,58246,1162,46388,1321
MG,49417,PARÁ DE MINAS,22923,22492,4398,54088,1673,49690,2602
MG,49433,PARAGUAÇU,5335,7112,2942,16022,265,13080,368
MG,49450,PARAISÓPOLIS,4374,7553,2752,15395,229,12643,487
MG,49476,PARAOPEBA,8540,4668,3259,17424,432,14165,525
MG,49492,PASSABÉM,816,401,424,1743,29,1319,73
MG,49514,PASSA QUATRO,4055,5734,2108,12519,198,10411,424
MG,49530,PASSA TEMPO,3230,1783,1585,7077,196,5492,283
MG,49557,PASSA VINTE,788,681,340,1918,35,1578,74
MG,49573,PASSOS,37154,21429,13830,75588,1312,61758,1863
MG,49590,PATOS DE MINAS,35935,39731,20790,101308,2110,80518,2742
MG,49611,PATROCÍNIO,24026,19927,11700,58913,1368,47213,1892
MG,49638,PATROCÍNIO DO MURIAÉ,2018,1524,903,4629,67,3726,117
MG,49654,PAULA CÂNDIDO,3793,1480,1695,7298,100,5603,230
MG,49670,PAULISTAS,1809,800,1416,4208,46,2792,137
MG,49697,PAVÃO,2740,1513,1204,5730,58,4526,215
MG,49719,PEÇANHA,5043,2403,5266,13179,123,7913,344
MG,49735,PEDRA AZUL,7279,4109,6901,19069,194,12168,586
MG,49751,PEDRA DO ANTA,1829,569,696,3286,65,2590,127
MG,49778,PEDRA DO INDAIÁ,1415,1354,532,3467,75,2935,91
MG,49794,PEDRA DOURADA,896,596,370,1935,22,1565,51
MG,49816,PEDRALVA,2330,4739,1782,9206,110,7424,245
MG,49832,PEDRINÓPOLIS,1226,1029,528,2900,51,2372,66
MG,49859,PEDRO LEOPOLDO,19222,14119,6771,43313,1385,36542,1816
MG,49875,PEDRO TEIXEIRA,1082,335,279,1763,22,1484,45
MG,49891,PEQUERI,1191,853,582,2754,49,2172,79
MG,49913,PEQUI,1532,1059,642,3390,67,2748,90
MG,49930,PERDIGÃO,2065,2705,994,6045,122,5051,159
MG,49956,PERDIZES,3086,4458,2697,10517,109,7820,167
MG,49972,PERDÕES,6564,5440,2808,15713,342,12905,559
MG,49999,PESCADOR,1253,913,749,3021,41,2272,65
MG,50016,PIAU,1395,728,580,2879,67,2299,109
MG,50032,PIEDADE DE PONTE NOVA,1733,873,744,3512,49,2768,113
MG,50059,PIEDADE DO RIO GRANDE,1489,1278,970,3996,74,3026,185
MG,50075,PIEDADE DOS GERAIS,1888,1155,714,3997,116,3283,124
MG,50091,PIMENTA,2694,2060,1182,6315,190,5133,189
MG,50113,PIRACEMA,2855,1346,850,5526,161,4676,314
MG,50130,PIRAJUBA,1380,1029,846,3345,34,2499,56
MG,50156,PIRANGA,5793,2901,4424,13772,213,9348,441
MG,50172,PIRANGUÇU,1203,2147,834,4352,54,3518,114
MG,50199,PIRANGUINHO,2491,2682,1099,6509,78,5410,159
MG,50210,PIRAPETINGA,4876,2065,1110,8510,186,7400,273
MG,50237,PIRAPORA,15625,11246,9453,38196,722,28743,1150
MG,50253,PIRAÚBA,4195,2701,1705,9009,159,7304,249
MG,50270,PITANGUI,6415,8395,3449,19276,435,15827,582
MG,50296,PIUMHI,9312,8394,5405,24330,538,18925,681
MG,50318,PLANURA,3522,2319,2113,8200,114,6087,132
MG,50334,POÇO FUNDO,4872,4951,1969,12304,254,10335,258
MG,50350,POÇOS DE CALDAS,36488,43969,21775,107742,1831,85967,3679
MG,50377,POCRANE,3152,2199,1748,7354,78,5606,177
MG,50393,POMPÉU,10555,5274,4278,21072,394,16794,571
MG,50415,PONTE NOVA,21848,10559,5759,40126,779,34367,1181
MG,50431,PORTEIRINHA,16086,4840,7932,29924,294,21992,772
MG,50458,PORTO FIRME,3753,1565,1885,7503,118,5618,182
MG,50474,POTÉ,5019,2695,3598,11852,112,8254,428
MG,50490,POUSO ALEGRE,30315,39311,16398,90633,1644,74235,2965
MG,50512,POUSO ALTO,1375,2609,958,5206,93,4248,171
MG,50539,PRADOS,2553,2637,842,6499,217,5657,250
MG,50555,PRATA,9002,5406,3609,18548,180,14939,351
MG,50571,PRATÁPOLIS,2561,2882,1356,7194,154,5838,241
MG,50598,PRATINHA,907,1040,632,2685,49,2053,57
MG,50610,PRESIDENTE BERNARDES,2283,1185,1199,4829,45,3630,117
MG,50636,PRESIDENTE JUSCELINO,1953,553,1276,3951,32,2675,137
MG,50652,PRESIDENTE KUBITSCHEK,1547,252,503,2392,14,1889,76
MG,50679,PRESIDENTE OLEGÁRIO,7148,3862,3902,15549,238,11647,399
MG,50695,ALTO JEQUITIBÁ,1911,3279,1352,6779,74,5427,163
MG,50717,PRUDENTE DE MORAIS,3120,2351,1283,7295,214,6012,327
MG,50733,QUARTEL GERAL,1036,1028,721,2904,42,2183,77
MG,50750,QUELUZITO,1147,412,335,2017,38,1682,85
MG,50776,RAPOSOS,6549,2454,1090,11039,373,9949,573
MG,50792,RAUL SOARES,7671,4773,3492,16739,257,13247,546
MG,50814,RECREIO,3545,2182,1496,7535,113,6039,199
MG,50830,RESENDE COSTA,3736,2891,1467,8474,167,7007,213
MG,50857,RESPLENDOR,3871,5415,2855,12552,171,9697,240
MG,50873,RESSAQUINHA,2109,1042,329,3669,58,3340,131
MG,50890,RIACHO DOS MACHADOS,3952,894,2143,7272,61,5129,222
MG,50911,RIBEIRÃO DAS NEVES,86922,37932,30734,167412,5096,136678,6728
MG,50938,RIBEIRÃO VERMELHO,1305,1116,445,3094,77,2649,151
MG,50954,RIO ACIMA,2925,2320,683,6466,207,5783,331
MG,50970,RIO CASCA,4930,2991,3176,11688,249,8512,342
MG,50997,RIO DOCE,893,760,315,2055,34,1740,53
MG,51012,RIO DO PRADO,2207,596,753,3724,43,2971,125
MG,51039,RIO ESPERA,1820,1506,1085,4713,124,3628,178
MG,51055,RIO MANSO,2168,968,646,3959,71,3313,106
MG,51071,RIO NOVO,2896,2324,1105,6728,132,5623,271
MG,51098,RIO PARANAÍBA,3812,2419,2071,8745,203,6674,240
MG,51110,RIO PARDO DE MINAS,9893,3623,4909,19403,285,14494,693
MG,51136,RIO PIRACICABA,5730,2842,2747,12033,281,9286,433
MG,51152,RIO POMBA,5397,4464,2804,13521,352,10717,504
MG,51179,RIO PRETO,2471,1229,934,4837,61,3903,142
MG,51195,RIO VERMELHO,4380,1541,4949,11318,104,6369,344
MG,51217,RITÁPOLIS,1638,1643,717,4232,91,3515,143
MG,51233,ROCHEDO DE MINAS,893,631,373,1983,26,1610,60
MG,51250,RODEIRO,2748,1359,650,5010,111,4360,142
MG,51276,ROMARIA,1762,694,651,3188,28,2537,53
MG,51292,RUBELITA,3135,1126,2839,7361,52,4522,209
MG,51314,RUBIM,2359,2045,1600,6306,70,4706,232
MG,51330,SABARÁ,35936,24979,13889,82444,2995,68555,4645
MG,51357,SABINÓPOLIS,5736,1789,4045,12134,160,8089,404
MG,51373,SACRAMENTO,5960,7679,3898,18153,191,14255,425
MG,51390,SALINAS,13115,7334,7622,29312,394,21690,847
MG,51411,SALTO DA DIVISA,2029,1227,1150,4595,20,3445,169
MG,51438,SANTA BÁRBARA,10973,4878,4342,21327,461,16985,673
MG,51454,SANTA BÁRBARA DO TUGÚRIO,2188,896,523,3825,63,3302,155
MG,51470,SANTA CRUZ DO ESCALVADO,2485,697,1064,4397,46,3333,105
MG,51497,SANTA EFIGÊNIA DE MINAS,1392,952,1355,3929,58,2574,172
MG,51519,SANTA FÉ DE MINAS,1564,308,1496,3444,13,1948,63
MG,51535,SANTA JULIANA,3644,2298,955,7109,101,6154,111
MG,51551,SANTA LUZIA,65253,39889,24763,140953,4600,116190,6448
MG,51578,SANTA MARGARIDA,4985,3791,2188,11427,154,9239,309
MG,51594,SANTA MARIA DE ITABIRA,3728,2027,1946,8108,141,6162,266
MG,51616,SANTA MARIA DO SALTO,1839,868,1599,4477,39,2878,132
MG,51632,SANTA MARIA DO SUAÇUÍ,5220,1638,4745,12017,82,7272,332
MG,51659,SANTANA DA VARGEM,2827,1762,714,5483,90,4769,90
MG,51675,SANTANA DE CATAGUASES,1341,1066,415,2955,36,2540,97
MG,51691,SANTANA DE PIRAPAMA,3529,1456,2137,7410,106,5273,182
MG,51713,SANTANA DO DESERTO,1793,640,586,3142,55,2556,68
MG,51730,SANTANA DO GARAMBÉU,797,713,303,1922,34,1619,75
MG,51756,SANTANA DO JACARÉ,1684,1099,843,3850,106,3007,118
MG,51772,SANTANA DO MANHUAÇU,3089,1653,1809,6731,58,4922,122
MG,51799,SANTANA DO RIACHO,2013,759,1306,4285,69,2979,138
MG,51810,SANTANA DOS MONTES,1221,1377,659,3419,76,2760,86
MG,51837,SANTA RITA DE CALDAS,2902,2852,1321,7387,83,6066,229
MG,51853,SANTA RITA DE JACUTINGA,1983,1424,869,4462,55,3593,131
MG,51870,SANTA RITA DE IBITIPOCA,1379,775,748,3033,41,2285,90
MG,51896,SANTA RITA DO ITUETO,1967,1575,1382,5061,70,3679,67
MG,51918,SANTA RITA DO SAPUCAÍ,4911,16256,5182,27349,365,22167,635
MG,51934,SANTA ROSA DA SERRA,1239,676,868,2873,39,2005,51
MG,51950,SANTA VITÓRIA,7430,3125,3040,14015,176,10975,244
MG,51977,SANTO ANTÔNIO DO AMPARO,7081,2805,2349,12794,234,10445,325
MG,51993,SANTO ANTÔNIO DO AVENTUREIRO,1353,1039,438,2997,70,2559,97
MG,52019,SANTO ANTÔNIO DO GRAMA,1559,1017,678,3407,57,2729,96
MG,52035,SANTO ANTÔNIO DO ITAMBÉ,1627,465,1453,3699,27,2246,127
MG,52051,SANTO ANTÔNIO DO JACINTO,3609,2169,2184,8368,63,6184,343
MG,52078,SANTO ANTÔNIO DO MONTE,5342,8519,3128,17922,447,14794,486
MG,52094,SANTO ANTÔNIO DO RIO ABAIXO,860,273,580,1817,42,1237,62
MG,52116,SANTO HIPÓLITO,1333,560,1152,3183,31,2031,107
MG,52132,SANTOS DUMONT,19205,9482,7235,38375,903,31140,1550
MG,52159,SÃO BENTO ABADE,1238,1623,745,3749,59,3004,84
MG,52175,SÃO BRÁS DO SUAÇUÍ,1240,986,420,2859,86,2439,127
MG,52191,SÃO DOMINGOS DO PRATA,6751,3294,2073,12809,192,10736,499
MG,52213,SÃO FRANCISCO,18675,4927,12911,37532,279,24621,740
MG,52230,SÃO FRANCISCO DE PAULA,2751,1479,1094,5567,103,4473,140
MG,52256,SÃO FRANCISCO DE SALES,2372,998,693,4180,39,3487,78
MG,52272,SÃO FRANCISCO DO GLÓRIA,2153,903,578,3789,51,3211,104
MG,52299,SÃO GERALDO,3222,1566,1126,6243,115,5117,214
MG,52310,SÃO GERALDO DA PIEDADE,1716,623,1005,3492,54,2487,94
MG,52337,SÃO GONÇALO DO ABAETÉ,1678,1575,1038,4430,54,3392,85
MG,52353,SÃO GONÇALO DO PARÁ,3245,2474,1234,7386,196,6152,237
MG,52370,SÃO GONÇALO DO RIO ABAIXO,3793,2345,1038,7608,188,6570,244
MG,52396,SÃO GONÇALO DO SAPUCAÍ,5785,7620,3833,17814,210,13981,366
MG,52418,SÃO GOTARDO,6150,10605,5380,23152,430,17772,587
MG,52434,SÃO JOÃO BATISTA DO GLÓRIA,2743,1646,897,5527,113,4630,128
MG,52450,SÃO JOÃO DA MATA,944,1044,483,2595,48,2112,76
MG,52477,SÃO JOÃO DA PONTE,10628,2471,7959,21794,125,13835,611
MG,52493,SÃO JOÃO DEL REI,24144,25728,6848,61298,1732,54450,2846
MG,52515,SÃO JOÃO DO ORIENTE,3122,1747,1229,6434,140,5205,196
MG,52531,SÃO JOÃO DO PARAÍSO,7037,4017,4904,16904,242,12000,704
MG,52558,SÃO JOÃO EVANGELISTA,4986,2560,2549,10554,140,8005,319
MG,52574,SÃO JOÃO NEPOMUCENO,8448,6107,3763,19529,395,15766,816
MG,52590,SÃO JOSÉ DA SAFIRA,1567,597,1183,3451,24,2268,80
MG,52612,SÃO JOSÉ DA VARGINHA,1431,1066,636,3303,77,2667,93
MG,52639,SÃO JOSÉ DO ALEGRE,919,1693,608,3373,62,2765,91
MG,52655,SÃO JOSÉ DO DIVINO,1221,969,790,3106,31,2316,95
MG,52671,SÃO JOSÉ DO GOIABAL,2214,1066,1208,4780,77,3572,215
MG,52698,SÃO JOSÉ DO JACURI,2275,984,1220,4707,53,3487,175
MG,52710,SÃO JOSÉ DO MANTIMENTO,830,822,397,2166,50,1769,67
MG,52736,SÃO LOURENÇO,7575,16077,6068,31468,645,25400,1103
MG,52752,SÃO MIGUEL DO ANTA,3071,1228,935,5532,118,4597,180
MG,52779,SÃO PEDRO DA UNIÃO,1958,1084,963,4227,105,3264,117
MG,52795,SÃO PEDRO DOS FERROS,3082,1469,1930,6821,121,4891,219
MG,52817,SÃO PEDRO DO SUAÇUÍ,1994,900,978,4072,53,3094,147
MG,52833,SÃO ROMÃO,3300,465,2648,6579,44,3931,122
MG,52850,SÃO ROQUE DE MINAS,1329,2487,1270,5288,80,4018,122
MG,52876,SÃO SEBASTIÃO DA BELA VISTA,1721,1412,643,3917,47,3274,94
MG,52892,SÃO SEBASTIÃO DO MARANHÃO,3043,1374,3822,8525,54,4703,232
MG,52914,SÃO SEBASTIÃO DO OESTE,2244,1484,686,4597,49,3911,134
MG,52930,SÃO SEBASTIÃO DO PARAÍSO,17104,18030,9570,46767,760,37197,1303
MG,52957,SÃO SEBASTIÃO DO RIO PRETO,575,395,381,1432,33,1051,48
MG,52973,SÃO SEBASTIÃO DO RIO VERDE,633,874,260,1848,38,1588,43
MG,52990,SÃO TIAGO,2905,3512,1464,8373,257,6909,235
MG,53015,SÃO TOMÁS DE AQUINO,2057,2134,1196,5598,89,4402,122
MG,53031,SÃO THOMÉ DAS LETRAS,2171,1651,1361,5395,73,4034,139
MG,53058,SÃO VICENTE DE MINAS,1623,2420,901,5199,86,4298,169
MG,53074,SAPUCAÍ-MIRIM,1658,1833,946,4603,54,3657,112
MG,53090,SARDOÁ,1608,1097,1158,4066,49,2908,154
MG,53112,SENADOR CORTES,1058,573,445,2179,30,1734,73
MG,53139,SENADOR FIRMINO,3421,1417,1091,6202,103,5111,170
MG,53155,SENADOR JOSÉ BENTO,772,785,510,2180,40,1670,73
MG,53171,SENADOR MODESTINO GONÇALVES,1607,932,1815,4507,44,2692,109
MG,53198,SENHORA DE OLIVEIRA,2569,978,1365,5158,94,3793,152
MG,53210,SENHORA DO PORTO,1206,805,759,2914,38,2155,106
MG,53236,SENHORA DOS REMÉDIOS,3210,2384,1120,7039,85,5919,240
MG,53252,SERICITA,2724,1561,1455,5987,99,4532,148
MG,53279,SERITINGA,764,538,359,1760,30,1401,69
MG,53295,SERRA AZUL DE MINAS,1510,503,1295,3484,34,2189,142
MG,53317,SERRA DA SAUDADE,217,426,366,1034,9,668,16
MG,53333,SERRA DOS AIMORÉS,2677,1290,1526,5715,62,4189,160
MG,53350,SERRA DO SALITRE,3068,2722,1843,7860,114,6017,113
MG,53376,SERRANIA,2177,2333,1380,6095,104,4715,101
MG,53392,SERRANOS,685,637,464,1862,25,1398,51
MG,53414,SERRO,7271,2303,5331,15615,173,10284,537
MG,53430,SETE LAGOAS,68249,45930,24348,149980,4644,125632,6809
MG,53457,SILVEIRÂNIA,1180,590,424,2279,32,1855,53
MG,53473,SILVIANÓPOLIS,1524,2103,774,4588,63,3814,124
MG,53490,SIMÃO PEREIRA,1279,792,631,2808,45,2177,61
MG,53511,SIMONÉSIA,5529,4544,3187,13823,215,10636,348
MG,53538,SOBRÁLIA,1989,1168,1063,4388,62,3325,106
MG,53554,SOLEDADE DE MINAS,1433,2219,756,4619,80,3863,131
MG,53570,TABULEIRO,1690,1222,902,3996,75,3094,107
MG,53597,TAIOBEIRAS,7957,8839,6288,23958,258,17670,616
MG,53619,TAPIRA,1377,1372,899,3774,53,2875,73
MG,53635,TAPIRAÍ,941,570,852,2414,22,1562,29
MG,53651,TAQUARAÇU DE MINAS,1365,1362,1020,3907,56,2887,104
MG,53678,TARUMIRIM,4349,3496,1766,9972,134,8206,227
MG,53694,TEIXEIRAS,4855,2283,1908,9600,208,7692,346
MG,53716,TEÓFILO OTONI,36889,29697,29299,100947,1976,71648,3086
MG,53732,TIMÓTEO,26426,16889,11123,58008,1500,46885,2070
MG,53759,TIRADENTES,1898,2331,618,5193,122,4575,224
MG,53775,TIROS,1380,2373,1247,5241,110,3994,131
MG,53791,TOCANTINS,5399,4426,2146,12638,301,10492,366
MG,53813,TOLEDO,2070,1605,1055,4919,64,3864,125
MG,53830,TOMBOS,2769,2603,1681,7305,75,5624,177
MG,53856,TRÊS CORAÇÕES,15801,24650,9678,52690,995,43012,1566
MG,53872,TRÊS PONTAS,16381,14766,7435,40273,731,32838,960
MG,53899,TUMIRITINGA,1903,1538,1254,4828,46,3574,87
MG,53910,TUPACIGUARA,9264,5266,4156,19417,305,15261,426
MG,53937,TURMALINA,7305,1908,3485,13189,207,9704,284
MG,53953,TURVOLÂNDIA,1321,1363,801,3687,93,2886,109
MG,53970,UBÁ,35316,15992,10942,65840,1456,54898,2134
MG,53996,UBAÍ,4565,1206,1981,8013,38,6032,223
MG,54011,UBERABA,94946,62790,41055,209257,3295,168202,7171
MG,54038,UBERLÂNDIA,214681,105897,77140,423172,8189,346032,17265
MG,54054,UMBURATIBA,1222,421,756,2488,26,1732,63
MG,54070,UNAÍ,19231,21393,13931,56499,853,42568,1091
MG,54097,URUCÂNIA,2664,3217,1926,8150,105,6224,238
MG,54119,VARGEM BONITA,771,683,401,1932,34,1531,43
MG,54135,VARGINHA,26031,45606,14831,91386,2011,76555,2907
MG,54151,VÁRZEA DA PALMA,12599,5974,6976,26522,459,19546,514
MG,54178,VARZELÂNDIA,6196,2862,5194,14811,139,9617,420
MG,54194,VAZANTE,7910,3214,2896,14646,256,11750,370
MG,54216,WENCESLAU BRAZ,801,1063,284,2243,32,1959,63
MG,54232,VERÍSSIMO,1023,675,399,2137,12,1738,28
MG,54259,VESPASIANO,32203,15906,12659,65343,2018,52684,2557
MG,54275,VIÇOSA,27719,11522,10092,52323,1354,42231,1636
MG,54291,VIEIRAS,1893,894,694,3601,42,2907,78
MG,54313,MATHIAS LOBATO,1224,711,728,2773,44,2045,66
MG,54330,VIRGEM DA LAPA,4155,1847,3861,10230,78,6369,289
MG,54356,VIRGÍNIA,2638,2555,1366,6783,58,5417,166
MG,54372,VIRGINÓPOLIS,3428,1952,1799,7563,143,5764,241
MG,54399,VIRGOLÂNDIA,2301,663,901,4025,42,3124,118
MG,54410,VISCONDE DO RIO BRANCO,13548,8859,4445,28252,633,23807,767
MG,54437,VOLTA GRANDE,1915,1077,1037,4219,71,3182,119
MG,54453,ITAÚ DE MINAS,3872,5059,2323,11978,247,9655,477
MS,55000,NOVA ALVORADA DO SUL,4132,3529,3208,11077,80,7869,128
MS,55018,ALCINÓPOLIS,1026,1383,830,3313,22,2483,52
MS,55026,LAGUNA CARAPÃ,1405,1658,1153,4319,27,3166,76
MS,55034,JAPORÃ,1771,1396,1450,4763,39,3313,107
MS,55042,NOVO HORIZONTE DO SUL,1135,1516,800,3552,28,2752,73
MS,55050,PARAÍSO DAS ÁGUAS,699,1469,1129,3360,13,2231,50
MS,55069,FIGUEIRÃO,566,1068,492,2171,11,1679,34
MS,90034,ÁGUA CLARA,2870,2812,3413,9321,82,5908,144
MS,90115,AMAMBAI,8031,8112,6503,23271,202,16768,423
MS,90131,ANASTÁCIO,6383,5342,5159,17253,136,12094,233
MS,90158,ANAURILÂNDIA,2009,2366,1731,6247,34,4516,107
MS,90174,ANTÔNIO JOÃO,2057,2430,1626,6310,46,4684,151
MS,90190,APARECIDA DO TABOADO,4828,6428,3795,15604,185,11809,368
MS,90212,AQUIDAUANA,11706,10770,10359,33651,316,23292,500
MS,90298,BANDEIRANTES,1883,1680,1620,5332,36,3712,113
MS,90379,BATAGUASSU,4511,6073,4011,15018,148,11007,275
MS,90395,BATAYPORÃ,3106,3010,2252,8591,80,6339,143
MS,90417,BELA VISTA,5459,6014,4720,16524,114,11804,217
MS,90433,BONITO,5203,4805,4843,15191,112,10348,228
MS,90450,BRASILÂNDIA,2691,3144,3095,9205,89,6110,186
MS,90492,CAMAPUÃ,3606,4151,3590,11579,66,7989,166
MS,90514,CAMPO GRANDE,164917,244903,111423,541184,7533,429761,12408
MS,90530,CARACOL,1405,1559,1211,4263,32,3052,56
MS,90557,CAARAPÓ,6160,6352,3654,16678,198,13024,314
MS,90573,CASSILÂNDIA,3560,7612,4359,16059,150,11700,378
MS,90611,CORGUINHO,877,1358,962,3251,19,2289,35
MS,90638,CORUMBÁ,27894,20740,17180,67454,576,50274,1064
MS,90654,COXIM,7106,9264,7694,24736,211,17042,461
MS,90735,DOURADOS,39899,65268,29673,139806,1693,110133,3273
MS,90751,FÁTIMA DO SUL,4310,7259,2397,14416,165,12019,285
MS,90794,GLÓRIA DE DOURADOS,2483,3021,1380,7154,113,5774,157
MS,90816,GUIA LOPES DA LAGUNA,2529,2786,2104,7674,82,5570,173
MS,90859,IGUATEMI,3078,4253,3244,10808,62,7564,171
MS,90875,INOCÊNCIA,1388,2392,2083,6033,36,3950,134
MS,90891,ITAPORÃ,4166,5340,2744,12644,154,9900,240
MS,90930,IVINHEMA,5735,6754,2400,15512,264,13112,359
MS,90972,JARAGUARI,1539,1538,1864,5055,30,3191,84
MS,90999,JARDIM,6100,6406,4756,17718,170,12962,286
MS,91014,JATEÍ,1044,1429,915,3451,14,2536,49
MS,91030,LADÁRIO,4911,3495,3036,11797,141,8761,214
MS,91073,MARACAJU,9005,8684,5706,24024,207,18318,422
MS,91111,MIRANDA,7055,5885,4846,18209,114,13363,309
MS,91138,NAVIRAÍ,11483,12915,8313,33684,390,25371,583
MS,91154,NIOAQUE,3499,3338,3277,10351,70,7074,167
MS,91235,NOVA ANDRADINA,10164,12288,8177,31404,326,23227,449
MS,91251,PARANAÍBA,8651,12792,7413,29775,350,22362,569
MS,91278,PEDRO GOMES,1794,2558,1889,6374,35,4485,98
MS,91316,PONTA PORÃ,18341,20216,13584,53476,460,39892,875
MS,91375,PORTO MURTINHO,2893,2671,2942,8680,51,5738,123
MS,91413,RIBAS DO RIO PARDO,4230,4031,3887,12443,111,8556,184
MS,91430,RIO BRILHANTE,7440,7871,4425,20218,192,15793,290
MS,91456,RIO NEGRO,1185,1751,998,4051,30,3053,87
MS,91472,RIO VERDE DE MATO GROSSO,4946,4704,3972,13903,78,9931,203
MS,91499,ROCHEDO,776,1642,748,3260,32,2512,62
MS,91570,SIDROLÂNDIA,10121,8072,7686,26475,250,18789,346
MS,91596,TERENOS,3920,3947,2872,11033,107,8161,187
MS,91650,TRÊS LAGOAS,26110,22528,14895,66289,1207,51394,1549
MS,91693,ANGÉLICA,2201,2578,1304,6277,77,4973,117
MS,91715,ARAL MOREIRA,2472,1868,1571,6083,36,4512,136
MS,91731,ELDORADO,1977,4297,2731,9293,97,6562,191
MS,91758,DEODÁPOLIS,2987,3785,1588,8668,122,7080,186
MS,91782,CHAPADÃO DO SUL,3476,5188,3217,12171,98,8954,192
MS,91790,MUNDO NOVO,4512,4990,2348,12285,160,9937,275
MS,91804,DOIS IRMÃOS DO BURITI,2909,2098,2452,7619,52,5167,108
MS,91820,JUTI,1771,1358,991,4251,38,3260,93
MS,91847,PARANHOS,2494,2315,2144,7207,50,5063,204
MS,91863,SANTA RITA DO PARDO,1203,1745,1671,4734,36,3063,79
MS,91880,SONORA,3574,3535,2518,9836,64,7318,145
MS,91901,VICENTINA,1447,2259,728,4572,46,3844,92
MS,98019,BODOQUENA,2323,1871,2276,6625,47,4349,108
MS,98035,COSTA RICA,3906,5407,2917,12575,109,9658,236
MS,98051,DOURADINA,1142,1850,526,3641,32,3115,91
MS,98078,ITAQUIRAÍ,4280,4278,4075,12950,112,8875,205
MS,98094,SÃO GABRIEL DO OESTE,4952,6384,4438,16127,146,11689,207
MS,98116,SELVÍRIA,2091,1384,1308,4920,39,3612,98
MS,98132,SETE QUEDAS,2457,2852,1574,7130,60,5556,187
MS,98159,TACURU,2877,1564,2077,6690,51,4613,121
MS,98175,TAQUARUSSU,831,1286,564,2760,44,2196,35
MS,98590,CORONEL SAPUCAIA,3610,2635,3040,9571,45,6531,241
MT,89788,COLNIZA,5472,5864,4815,16591,179,11776,261
MT,89796,COLÍDER,3885,11954,5786,22123,168,16337,330
MT,89800,CURVELÂNDIA,1171,1777,754,3809,37,3055,70
MT,89818,NOVA BRASILÂNDIA,1322,1196,874,3485,14,2611,79
MT,89826,NOVA SANTA HELENA,875,1052,880,2877,22,1997,48
MT,89834,PARANATINGA,3411,5390,3445,12576,106,9131,224
MT,89843,SANTO ANTÔNIO DO LESTE,625,885,957,2507,17,1550,23
MT,89850,SINOP,21913,32183,19649,75640,806,55991,1089
MT,89877,ALTA FLORESTA,9701,16268,9338,36033,251,26695,475
MT,89893,ARAPUTANGA,3313,5027,2895,11547,106,8652,206
MT,89915,JAURU,2304,3262,2557,8359,73,5802,163
MT,89931,SÃO JOSÉ DOS QUATRO MARCOS,4944,5097,4120,14647,218,10527,268
MT,89958,RIO BRANCO,1219,1747,787,3890,47,3103,90
MT,89960,RONDOLÂNDIA,877,734,1161,2848,16,1687,60
MT,89974,SALTO DO CÉU,829,1231,459,2604,28,2145,57
MT,89990,PONTES E LACERDA,7360,12292,8762,29150,259,20388,477
MT,90018,ACORIZAL,2865,953,1005,4929,20,3924,86
MT,90026,SÃO JOSÉ DO POVO,1044,1022,629,2784,41,2155,48
MT,90042,ALTO BOA VISTA,682,1555,1330,3616,8,2286,41
MT,90050,ALTO ARAGUAIA,2901,5330,2758,11323,102,8565,232
MT,90069,QUERÊNCIA,2908,2550,2870,8492,50,5622,114
MT,90077,ALTO GARÇAS,2142,2814,1514,6674,71,5160,133
MT,90085,CANABRAVA DO NORTE,838,1503,1218,3626,11,2408,56
MT,90093,ALTO PARAGUAI,2379,1714,1293,5548,49,4255,113
MT,90107,SANTA CARMEM,880,1221,917,3086,19,2169,49
MT,90123,NOVA MARINGÁ,1051,1505,972,3605,16,2633,61
MT,90140,NOVA GUARITA,1448,1240,951,3721,31,2770,51
MT,90166,NOVA MARILÂNDIA,754,825,739,2367,12,1628,37
MT,90182,PORTO ESTRELA,1512,610,661,2910,23,2249,104
MT,90204,GLÓRIA D'OESTE,848,944,508,2369,31,1861,38
MT,90220,TABAPORÃ,1597,2763,2006,6489,43,4483,80
MT,90239,ARAGUAINHA,363,260,290,933,8,643,12
MT,90247,SÃO JOSÉ DO XINGU,965,1340,1492,3894,23,2402,74
MT,90255,ARENÁPOLIS,2116,3045,2244,7598,54,5354,139
MT,90263,APIACÁS,1715,2209,1058,5142,49,4084,111
MT,90271,ARIPUANÃ,3668,4576,4335,12835,90,8500,166
MT,90280,CONFRESA,5330,5094,5161,15916,111,10755,220
MT,90301,LAMBARI D'OESTE,1186,1642,1400,4329,34,2929,67
MT,90310,BARÃO DE MELGAÇO,3046,906,1885,5969,35,4084,97
MT,90328,SANTO AFONSO,724,816,540,2120,14,1580,26
MT,90336,BARRA DO BUGRES,9804,5838,6516,22695,186,16179,351
MT,90344,PLANALTO DA SERRA,957,618,605,2254,11,1649,63
MT,90352,BARRA DO GARÇAS,14574,13188,11710,40734,492,29024,770
MT,90360,NOVA MONTE VERDE,1769,2022,1617,5532,44,3915,80
MT,90387,NOVA BANDEIRANTES,2471,3570,2672,8951,87,6279,151
MT,90409,SÃO PEDRO DA CIPA,1115,1316,720,3253,40,2533,62
MT,90425,COTRIGUAÇU,3484,2790,2609,9128,89,6519,156
MT,90441,RIBEIRÃOZINHO,682,485,472,1676,12,1204,25
MT,90468,BRASNORTE,2838,3427,2744,9175,50,6431,116
MT,90476,CÁCERES,24589,17790,16987,60745,465,43758,914
MT,90484,CAMPO NOVO DO PARECIS,5909,5456,5711,17398,128,11687,194
MT,90506,CAMPO VERDE,8888,8043,6462,23988,242,17526,353
MT,90522,CLÁUDIA,1839,3290,1995,7331,75,5336,132
MT,90549,CASTANHEIRA,1910,2107,1116,5280,48,4164,99
MT,90565,JANGADA,2697,1477,2042,6385,28,4343,141
MT,90581,JURUENA,1866,2263,1412,5687,49,4275,97
MT,90590,CHAPADA DOS GUIMARÃES,5846,3709,3738,13687,109,9949,285
MT,90603,LUCAS DO RIO VERDE,9125,10678,7254,27732,317,20478,358
MT,90620,MATUPÁ,3244,3778,2310,9561,82,7251,147
MT,90646,NOVA MUTUM,5580,7295,4821,18114,204,13293,214
MT,90662,RIBEIRÃO CASCALHEIRA,1549,2527,1643,5870,28,4227,123
MT,90670,CUIABÁ,148633,144087,81236,386601,4659,305365,7986
MT,90689,TAPURAH,1740,2506,1942,6289,31,4347,70
MT,90697,DIAMANTINO,5309,5162,3874,14663,115,10789,203
MT,90700,PONTAL DO ARAGUAIA,1636,1130,664,3531,30,2867,71
MT,90719,DOM AQUINO,2071,2412,1332,5975,45,4643,115
MT,90727,SAPEZAL,3198,3637,3572,10663,95,7091,161
MT,90743,CAMPOS DE JÚLIO,1089,1467,1763,4388,33,2625,36
MT,90760,CARLINDA,2405,3052,1563,7190,51,5627,119
MT,90778,GENERAL CARNEIRO,1356,1013,701,3133,23,2432,40
MT,90786,FELIZ NATAL,1589,2181,2215,6073,37,3858,51
MT,90808,NOVO MUNDO,1741,1698,1572,5125,32,3553,82
MT,90824,GAÚCHA DO NORTE,964,1468,1416,3939,17,2523,74
MT,90832,GUIRATINGA,2475,3917,2052,8719,87,6667,188
MT,90840,UNIÃO DO SUL,873,762,910,2585,10,1675,30
MT,90867,NOVA LACERDA,1606,992,1316,3987,23,2671,50
MT,90883,NOVA UBIRATÃ,2085,1502,1683,5382,35,3699,77
MT,90905,BOM JESUS DO ARAGUAIA,863,1199,1373,3477,13,2104,29
MT,90913,ITIQUIRA,2452,2573,2110,7301,66,5191,100
MT,90921,SERRA NOVA DOURADA,238,395,521,1167,4,646,9
MT,90948,NOVO SANTO ANTÔNIO,399,529,672,1636,4,964,32
MT,90956,JACIARA,5573,8392,4852,19303,176,14451,310
MT,90964,NOVA NAZARÉ,498,616,677,1824,8,1147,25
MT,90980,SANTA CRUZ DO XINGU,341,624,490,1483,12,993,16
MT,91006,CONQUISTA D'OESTE,709,1020,612,2391,20,1779,30
MT,91022,VALE DE SÃO DOMINGOS,808,1198,806,2871,20,2065,39
MT,91049,SANTA RITA DO TRIVELATO,420,655,609,1702,8,1093,10
MT,91057,LUCIARA,678,569,583,1884,9,1301,45
MT,91081,IPIRANGA DO NORTE,982,1351,748,3153,39,2405,33
MT,91090,VILA BELA DA SANTÍSSIMA TRINDADE,2578,3205,3190,9130,35,5940,122
MT,91103,ITANHANGÁ,1104,1564,1172,3917,25,2745,52
MT,91170,NOBRES,3274,4340,2714,10584,68,7870,188
MT,91197,NORTELÂNDIA,1801,1695,1064,4695,42,3631,93
MT,91219,NOSSA SENHORA DO LIVRAMENTO,5519,2188,2921,10909,58,7988,223
MT,91294,POCONÉ,10971,5626,6210,23320,110,17110,403
MT,91332,PONTE BRANCA,608,573,426,1639,4,1213,28
MT,91359,PORTO DOS GAÚCHOS,808,1958,1172,4010,26,2838,46
MT,91391,POXORÉU,4929,4006,4678,14048,127,9370,308
MT,91510,RONDONÓPOLIS,51765,44839,30383,131238,1737,100855,2514
MT,91537,ROSÁRIO OESTE,5262,3761,4736,14096,92,9360,245
MT,91553,SANTO ANTÔNIO DO LEVERGER,7122,3435,3150,14064,108,10914,249
MT,91618,TESOURO,640,784,821,2307,24,1486,38
MT,91634,TORIXORÉU,1283,1207,714,3297,32,2583,61
MT,91677,VÁRZEA GRANDE,74019,52273,36789,168186,1937,131397,3168
MT,91774,MIRASSOL D'OESTE,5734,7324,4956,18529,211,13573,304
MT,91812,PEDRA PRETA,4041,4416,3178,11990,142,8812,213
MT,91839,SÃO FÉLIX DO ARAGUAIA,2012,2091,2627,6884,39,4257,115
MT,91855,TANGARÁ DA SERRA,17044,23837,15032,57349,517,42317,919
MT,91898,JUSCIMEIRA,3543,3012,2565,9341,64,6776,157
MT,91910,ÁGUA BOA,3633,5837,3633,13430,127,9797,200
MT,91936,CANARANA,3343,5151,4513,13340,111,8827,222
MT,91952,NOVA XAVANTINA,4306,5423,4598,14631,81,10033,223
MT,91979,SANTA TEREZINHA,1910,912,1714,4642,23,2928,83
MT,91995,SÃO JOSÉ DO RIO CLARO,2846,4542,3062,10686,70,7624,166
MT,98191,JUARA,5194,10889,6642,23252,195,16610,332
MT,98310,JUÍNA,8033,12111,7955,28699,234,20744,366
MT,98337,DENISE,2449,1955,1442,5979,48,4537,85
MT,98612,ALTO TAQUARI,1371,2358,1400,5233,37,3833,67
MT,98639,ARAGUAIANA,974,752,917,2709,15,1792,51
MT,98655,CAMPINÁPOLIS,2550,3244,2570,8556,49,5986,143
MT,98671,COCALINHO,1694,885,1960,4628,19,2668,70
MT,98698,ITAÚBA,1062,1417,1361,3919,30,2558,49
MT,98710,MARCELÂNDIA,1472,4604,3253,9531,63,6278,139
MT,98736,NOVA OLÍMPIA,5787,3096,3252,12478,151,9226,192
MT,98752,NOVA CANAÃ DO NORTE,2003,4640,2345,9231,97,6886,146
MT,98779,NOVO SÃO JOAQUIM,1362,1903,1910,5262,17,3352,70
MT,98795,NOVO HORIZONTE DO NORTE,830,1479,565,2915,11,2350,30
MT,98817,PEIXOTO DE AZEVEDO,6600,6037,4379,17494,153,13115,325
MT,98833,PARANAÍTA,2052,3307,1634,7155,52,5521,110
MT,98850,PORTO ALEGRE DO NORTE,1851,2206,2386,6596,34,4210,119
MT,98876,PORTO ESPERIDIÃO,2967,2142,2372,7674,46,5302,147
MT,98892,PRIMAVERA DO LESTE,10378,14533,9234,34870,279,25636,446
MT,98914,RESERVA DO CABAÇAL,613,789,418,1879,15,1461,44
MT,98930,SORRISO,15286,14662,10837,41783,444,30946,554
MT,98957,TERRA NOVA DO NORTE,3754,2611,2582,9125,62,6543,116
MT,98973,VERA,1940,2501,2106,6674,47,4568,80
MT,98990,VILA RICA,4074,4932,4527,13826,111,9299,182
MT,99015,COMODORO,3121,5378,4262,13003,66,8741,176
MT,99031,FIGUEIRÓPOLIS D'OESTE,694,1732,745,3256,28,2511,57
MT,99058,GUARANTÃ DO NORTE,5032,7974,6092,19597,175,13505,324
MT,99074,INDIAVAÍ,859,599,447,1947,14,1500,28
PA,4006,GOIANÉSIA DO PARÁ,7295,6307,8600,22663,155,14063,306
PA,4014,ABAETETUBA,45863,23557,17163,88319,479,71156,1257
PA,4022,TAILÂNDIA,7844,15728,12894,37186,201,24292,519
PA,4030,ACARÁ,13916,7906,9852,32389,140,22537,575
PA,4049,BOM JESUS DO TOCANTINS,3320,2503,3361,9435,67,6074,184
PA,4057,AFUÁ,7041,5597,5654,18661,36,13007,333
PA,4065,SÃO JOÃO DE PIRABAS,6370,2853,4068,13521,64,9453,166
PA,4073,ALENQUER,10559,12506,7564,31104,111,23540,364
PA,4081,TUCUMÃ,8009,6648,5698,20826,205,15128,266
PA,4090,ALMEIRIM,9014,5106,5925,20477,126,14552,306
PA,4103,MÃE DO RIO,6695,8475,6671,22287,146,15616,300
PA,4111,ALTAMIRA,15668,27523,16963,61588,455,44625,979
PA,4120,ELDORADO DOS CARAJÁS,6139,4284,5099,15895,134,10796,239
PA,4138,ANAJÁS,3800,5465,4955,14538,23,9583,295
PA,4146,SANTA LUZIA DO PARÁ,5878,4210,4138,14559,85,10421,248
PA,4154,ANANINDEUA,103642,94666,51615,259051,3722,207436,5406
PA,4162,PALESTINA DO PARÁ,1892,1660,1934,5618,24,3684,108
PA,4170,AUGUSTO CORRÊA,12019,7093,9431,29242,107,19811,592
PA,4189,IPIXUNA DO PARÁ,6067,5279,5031,16702,55,11671,270
PA,4197,AVEIRO,3336,2333,3523,9358,37,5835,129
PA,4200,JACAREACANGA,1985,2389,2778,7418,40,4640,226
PA,4219,BAGRE,3512,1819,4593,10070,21,5477,125
PA,4227,BRASIL NOVO,3176,5525,2954,11853,63,8899,135
PA,4235,BAIÃO,9490,4838,5181,19861,75,14680,277
PA,4243,SANTA BÁRBARA DO PARÁ,4936,4160,2405,11772,109,9367,162
PA,4251,BARCARENA,27605,18173,14199,61340,547,47141,816
PA,4260,ÁGUA AZUL DO NORTE,2893,2984,2833,8907,67,6074,130
PA,4278,BELÉM,371634,384400,204534,995993,12937,791459,22488
PA,4286,TRAIRÃO,2789,2783,2836,8583,58,5747,117
PA,4294,BENEVIDES,12354,11119,6072,30278,280,24206,453
PA,4308,PAU D'ARCO,2064,1464,2039,5713,53,3674,93
PA,4316,BONITO,3932,2499,1962,8634,78,6672,163
PA,4324,ULIANÓPOLIS,5489,3739,5054,14632,109,9578,241
PA,4332,BRAGANÇA,27450,21013,21015,70782,347,49767,957
PA,4340,AURORA DO PARÁ,5383,4803,5011,15556,72,10545,287
PA,4359,BREVES,15136,13461,20488,50029,161,29541,783
PA,4367,TERRA SANTA,3862,2967,3493,10449,51,6956,76
PA,4375,BUJARU,7356,4090,3773,15519,74,11746,226
PA,4383,NOVO PROGRESSO,5503,4457,6763,17013,122,10250,168
PA,4391,CACHOEIRA DO ARARI,7160,2281,5526,15175,48,9649,160
PA,4405,VITÓRIA DO XINGU,2277,3089,2805,8294,28,5489,95
PA,4413,CAMETÁ,38001,19590,15233,73955,217,58722,914
PA,4421,NOVO REPARTIMENTO,12673,11519,13837,38893,258,25056,606
PA,4430,CAPANEMA,20879,13153,6507,41873,641,35366,693
PA,4448,BREU BRANCO,8607,8645,8991,26852,164,17861,445
PA,4456,CAPITÃO POÇO,10964,12251,9942,33966,230,24024,579
PA,4464,SÃO DOMINGOS DO ARAGUAIA,5845,3775,5463,15522,131,10059,308
PA,4472,CASTANHAL,32780,47501,21568,104595,1177,83027,1569
PA,4480,NOVA ESPERANÇA DO PIRIÁ,4713,3926,3776,12658,47,8882,196
PA,4499,CHAVES,3537,2541,4693,10985,25,6292,189
PA,4502,ABEL FIGUEIREDO,2110,1382,1861,5477,43,3616,81
PA,4510,COLARES,4120,1795,2370,8456,60,6086,111
PA,4529,CUMARU DO NORTE,1727,1382,2470,5674,17,3204,78
PA,4537,CONCEIÇÃO DO ARAGUAIA,10638,9615,9626,30658,267,21032,512
PA,4545,TERRA ALTA,3842,2417,2188,8615,58,6427,110
PA,4553,CURRALINHO,7430,2655,5309,15695,43,10386,258
PA,4561,FLORESTA DO ARAGUAIA,4434,2792,3671,11124,69,7453,158
PA,4570,CURUÇÁ,12878,5836,6346,25572,127,19226,385
PA,4588,BANNACH,872,1016,977,2955,15,1978,75
PA,4596,FARO,2952,910,1833,5753,15,3920,43
PA,4600,NOVA IPIXUNA,3217,3416,3754,10665,69,6911,209
PA,4618,GURUPÁ,6284,4026,3654,14197,25,10543,208
PA,4626,PLACAS,3041,4311,2738,10271,54,7533,127
PA,4634,IGARAPÉ-AÇU,11175,7413,5421,24717,251,19296,457
PA,4642,MARITUBA,24761,17940,12038,56269,675,44231,855
PA,4650,IGARAPÉ-MIRI,17958,10791,11958,41598,200,29640,691
PA,4669,TRACUATEUA,10549,3488,5034,19518,102,14484,345
PA,4677,INHANGAPI,2280,3121,1618,7171,43,5553,109
PA,4685,QUATIPURU,3357,2107,3114,8724,33,5610,113
PA,4693,IRITUIA,9663,5917,6060,22087,141,16027,306
PA,4707,CANAÃ DOS CARAJÁS,6816,5556,6449,19329,259,12880,249
PA,4715,ITAITUBA,17747,22976,24559,66333,301,41774,750
PA,4723,ANAPU,2884,5316,2867,11312,62,8445,183
PA,4731,ITUPIRANGA,12593,6415,12334,32089,192,19755,555
PA,4740,CURUÁ,3822,2174,2284,8414,15,6130,119
PA,4758,JACUNDÁ,10650,11174,12186,34780,224,22594,546
PA,4766,CACHOEIRA DO PIRIÁ,4293,2351,3809,10737,45,6928,239
PA,4774,JURUTI,10516,7443,5896,24222,81,18326,286
PA,4782,PIÇARRA,2871,2461,3238,8751,44,5513,137
PA,4790,LIMOEIRO DO AJURU,7879,4245,3005,15424,71,12419,224
PA,4804,BELTERRA,4580,4514,3461,12794,53,9333,186
PA,4812,MAGALHÃES BARATA,3513,1272,1289,6178,22,4889,82
PA,4820,SÃO JOÃO DA PONTA,2117,1464,1031,4685,19,3654,54
PA,4839,MARABÁ,54808,38308,36906,133435,1321,96529,2092
PA,4847,SAPUCAIA,1139,1403,1019,3631,21,2612,49
PA,4855,MARACANÃ,9047,5646,5314,20419,128,15105,284
PA,4863,MOJUÍ DOS CAMPOS,3196,7154,4274,14911,55,10637,232
PA,4871,MARAPANIM,8436,5736,5982,20505,77,14523,274
PA,4898,MELGAÇO,2601,3269,5889,12019,21,6130,239
PA,4910,MOCAJUBA,10130,3727,4608,18800,101,14192,234
PA,4936,MOJU,17429,9620,12683,40419,170,27736,517
PA,4952,MONTE ALEGRE,11101,17580,11183,40508,157,29325,487
PA,4979,MUANÁ,9770,3505,5392,19053,75,13661,311
PA,4995,NOVA TIMBOTEUA,4491,2897,3077,10759,125,7682,169
PA,5010,ÓBIDOS,14506,6558,9828,31395,147,21567,356
PA,5037,OEIRAS DO PARÁ,7972,3928,3975,16245,44,12270,326
PA,5053,ORIXIMINÁ,14302,11266,13372,39581,229,26209,412
PA,5070,OURÉM,4521,4098,4022,12945,67,8923,237
PA,5096,PARAGOMINAS,16607,22564,19967,60337,352,40370,847
PA,5118,PEIXE-BOI,2880,1856,1877,6797,56,4920,128
PA,5134,PONTA DE PEDRAS,7314,3739,4281,15627,67,11346,226
PA,5150,PORTEL,7511,7775,12336,28185,92,15849,471
PA,5177,PORTO DE MOZ,5271,5034,4914,15481,49,10567,213
PA,5193,PRAINHA,5779,6720,5861,18682,70,12821,252
PA,5215,PRIMAVERA,3028,2765,2775,8757,54,5982,135
PA,5231,SALINÓPOLIS,8793,9480,7243,25897,139,18654,242
PA,5258,SALVATERRA,6538,3909,4490,15232,113,10742,182
PA,5274,SANTA CRUZ DO ARARI,2528,1147,1969,5727,17,3758,66
PA,5290,SANTA ISABEL DO PARÁ,13145,13424,7283,34793,391,27510,550
PA,5312,SANTA MARIA DO PARÁ,6262,6358,4597,17652,151,13055,284
PA,5339,SANTANA DO ARAGUAIA,6299,5609,7166,19464,107,12298,283
PA,5355,SANTARÉM,51275,83378,46483,184812,1338,138329,2338
PA,5371,SANTARÉM NOVO,2967,999,1139,5204,21,4065,78
PA,5398,SANTO ANTÔNIO DO TAUÁ,8514,5953,4485,19333,113,14848,268
PA,5410,SÃO CAETANO DE ODIVELAS,4741,4381,3716,13045,70,9329,137
PA,5436,SÃO DOMINGOS DO CAPIM,7488,7051,5382,20423,94,15041,408
PA,5452,SÃO FÉLIX DO XINGU,9959,10552,11089,32434,239,21345,595
PA,5479,SÃO FRANCISCO DO PARÁ,4604,3921,2448,11228,91,8780,164
PA,5495,SÃO JOÃO DO ARAGUAIA,3795,1869,3710,9573,46,5863,153
PA,5517,SÃO MIGUEL DO GUAMÁ,10098,12536,8726,32038,227,23312,451
PA,5533,SÃO SEBASTIÃO DA BOA VISTA,7641,3554,4658,16114,54,11456,207
PA,5550,SENADOR JOSÉ PORFÍRIO,2242,2314,2990,7693,27,4703,120
PA,5576,SOURE,8734,2561,5519,17117,102,11598,201
PA,5592,TOMÉ-AÇU,15950,8279,10840,35807,231,24967,507
PA,5614,TUCURUÍ,28392,18662,20495,69042,592,48547,901
PA,5630,VIGIA,13462,8923,9113,32238,314,23125,426
PA,5657,VISEU,19060,4179,12038,36075,103,24037,695
PA,5673,REDENÇÃO,16417,18763,16479,52699,397,36220,643
PA,5690,RIO MARIA,4838,3987,2991,12067,91,9076,160
PA,5711,XINGUARA,9044,9786,8149,27537,198,19388,360
PA,5738,RONDON DO PARÁ,10682,7554,11542,30523,183,18981,562
PA,5754,URUARÁ,4935,12966,6824,25293,173,18469,395
PA,5770,MEDICILÂNDIA,4477,6885,4096,15837,137,11741,242
PA,5797,SÃO GERALDO DO ARAGUAIA,6769,5401,8032,20710,167,12678,341
PA,5819,CONCÓRDIA DO PARÁ,6869,5587,4122,16861,44,12739,239
PA,5835,PARAUAPEBAS,34447,28384,26302,92215,1689,65913,1393
PA,5851,CURIONÓPOLIS,5434,3472,3754,12978,117,9224,201
PA,5878,GARRAFÃO DO NORTE,7726,4283,5785,18267,91,12482,382
PA,5894,RURÓPOLIS,5083,5619,4395,15464,111,11069,256
PA,5916,PACAJÁ,5765,8744,7171,22202,129,15031,393
PA,5932,BREJO GRANDE DO ARAGUAIA,2184,1266,2080,5648,34,3568,84
PA,5959,OURILÂNDIA DO NORTE,6562,4339,5356,16579,117,11223,205
PA,5975,DOM ELISEU,10428,7552,9180,27870,326,18690,384
PA,5991,SANTA MARIA DAS BARREIRAS,3536,3035,3708,10556,53,6848,224
PB,19003,RIACHÃO DO POÇO,1459,1164,720,3670,80,2950,247
PB,19011,ÁGUA BRANCA,3330,1053,1788,6768,114,4980,483
PB,19020,SOBRADO,2496,1922,1504,6385,110,4881,353
PB,19038,AGUIAR,2689,576,881,4473,37,3592,290
PB,19046,SÃO JOSÉ DOS RAMOS,2057,1062,856,4273,74,3417,224
PB,19054,ALAGOA GRANDE,9838,4858,6214,22710,388,16496,1412
PB,19062,CAPIM,1976,1043,554,3933,75,3379,285
PB,19070,ALAGOA NOVA,5184,4849,3603,15028,304,11425,1088
PB,19089,CUITÉ DE MAMANGUAPE,2796,1392,769,5343,66,4574,320
PB,19097,ALAGOINHA,4678,2409,2616,10548,183,7932,662
PB,19100,CURRAL DE CIMA,1633,1487,1084,4686,94,3602,388
PB,19119,ALHANDRA,7273,3979,2243,14749,318,12506,936
PB,19127,RIACHÃO DO BACAMARTE,1464,1007,774,3650,92,2876,313
PB,19135,SÃO JOÃO DO RIO DO PEIXE,8078,1860,3223,14230,225,11007,844
PB,19143,MATINHAS,1369,1315,531,3511,60,2980,236
PB,19151,ARAÇAGI,6167,2610,4387,14244,270,9857,810
PB,19160,LOGRADOURO,1417,924,333,2893,35,2560,184
PB,19178,ARARA,4094,1755,2318,8949,137,6631,645
PB,19186,SERTÃOZINHO,1349,1315,590,3508,58,2918,196
PB,19194,ARARUNA,4927,4236,3188,13342,225,10154,766
PB,19208,RIACHÃO,1426,874,460,2963,38,2503,165
PB,19216,AREIA,8217,4151,4365,18637,548,14272,1356
PB,19224,SÃO DOMINGOS DO CARIRI,927,739,263,2063,23,1800,111
PB,19232,AREIAL,1750,1991,1079,5276,139,4197,317
PB,19240,CARAÚBAS,1996,522,557,3336,45,2779,216
PB,19259,AROEIRAS,6436,4066,3630,15337,264,11707,941
PB,19267,SANTO ANDRÉ,1253,560,352,2330,23,1978,142
PB,19275,DAMIÃO,1789,957,851,3815,39,2964,179
PB,19283,SOSSÊGO,1382,643,416,2621,38,2205,142
PB,19291,BAÍA DA TRAIÇÃO,2808,1139,1022,5372,82,4350,321
PB,19305,BARAÚNA,1686,878,580,3441,71,2861,226
PB,19313,BANANEIRAS,6943,4395,4191,17021,359,12830,1133
PB,19321,ASSUNÇÃO,1421,940,515,3124,59,2609,189
PB,19330,BARRA DE SANTA ROSA,4826,2566,2246,10336,101,8090,597
PB,19348,ZABELÊ,997,329,268,1758,34,1490,130
PB,19356,BARRA DE SÃO MIGUEL,2483,937,533,4289,80,3756,256
PB,19364,CACIMBAS,1899,1044,1009,4476,89,3467,435
PB,19372,BAYEUX,33746,17433,11654,68758,1773,57104,4152
PB,19380,CAJAZEIRINHAS,2047,459,621,3372,31,2751,214
PB,19399,BELÉM,5809,3696,2844,13187,196,10343,642
PB,19402,SÃO BENTINHO,1606,582,789,3194,32,2405,185
PB,19410,BELÉM DO BREJO DO CRUZ,2667,1177,960,5188,72,4228,312
PB,19429,SÃO DOMINGOS DE POMBAL,1611,497,556,2854,30,2298,160
PB,19437,BOA VENTURA,2386,797,1494,5080,54,3586,349
PB,19445,SÃO JOSÉ DE PRINCESA,1979,344,903,3519,30,2616,263
PB,19453,BOM JESUS,1526,179,391,2302,40,1911,166
PB,19461,MARIZÓPOLIS,3026,589,671,4661,70,3990,305
PB,19470,BOM SUCESSO,2496,492,687,3951,46,3264,230
PB,19488,MATO GROSSO,1284,108,481,1966,8,1485,85
PB,19496,BONITO DE SANTA FÉ,3933,1190,2050,7702,71,5652,458
PB,19500,BERNARDINO BATISTA,1243,266,456,2171,22,1715,184
PB,19518,BOQUEIRÃO,5304,4268,1354,11834,213,10480,695
PB,19526,POÇO DE JOSÉ DE MOURA,2171,498,558,3517,43,2959,247
PB,19534,IGARACY,2484,890,1656,5452,64,3796,358
PB,19542,SÃO JOSÉ DO BREJO DO CRUZ,929,307,289,1624,31,1335,68
PB,19550,BORBOREMA,1580,1258,1201,4396,69,3195,288
PB,19569,SANTA INÊS,1825,483,1033,3639,19,2606,279
PB,19577,BREJO DO CRUZ,3775,2444,1975,8937,156,6962,587
PB,19585,AMPARO,1325,195,309,1987,29,1678,129
PB,19593,BREJO DOS SANTOS,2606,1120,755,4813,98,4058,234
PB,19607,CASSERENGUE,2618,1010,1487,5546,67,4059,364
PB,19615,CAAPORÃ,8413,3104,3236,16048,409,12812,886
PB,19623,GADO BRAVO,2666,1947,972,6157,126,5185,446
PB,19631,CABACEIRAS,1909,1231,526,4084,108,3558,310
PB,19640,POÇO DANTAS,1825,409,883,3375,39,2492,219
PB,19658,CABEDELO,15702,9541,2954,31074,872,28120,2005
PB,19666,SANTARÉM,1371,396,524,2423,15,1899,117
PB,19674,CACHOEIRA DOS ÍNDIOS,4151,704,1196,6575,89,5379,435
PB,19682,TENÓRIO,925,804,433,2336,29,1903,145
PB,19690,CACIMBA DE AREIA,1597,631,543,2996,31,2453,194
PB,19704,COXIXOLA,799,361,224,1532,47,1308,101
PB,19712,CACIMBA DE DENTRO,5835,3006,2416,12288,156,9872,875
PB,19720,PARARI,872,405,201,1623,23,1422,122
PB,19739,CAIÇARA,2521,1865,687,5527,82,4840,372
PB,19747,PEDRO RÉGIS,1517,1289,1147,4286,77,3139,256
PB,19755,CAJAZEIRAS,23730,6465,9652,42692,692,33040,2153
PB,19763,ALCANTIL,1751,1500,605,4171,87,3566,228
PB,19771,CALDAS BRANDÃO,2456,1116,861,4753,81,3892,239
PB,19780,BARRA DE SANTANA,2581,2413,1419,7080,166,5661,501
PB,19798,CAMALAÚ,2844,585,947,4746,66,3799,304
PB,19801,CATURITÉ,1866,1274,571,4017,66,3446,240
PB,19810,CAMPINA GRANDE,84611,128010,39840,276486,6501,236646,17524
PB,19828,RIACHO DE SANTO ANTÔNIO,792,485,138,1532,26,1394,91
PB,19836,CARRAPATEIRA,1279,91,501,2005,12,1504,122
PB,19844,APARECIDA,3504,969,1085,6052,104,4967,390
PB,19852,CATINGUEIRA,1548,1158,883,3908,56,3025,263
PB,19860,SÃO FRANCISCO,1915,597,420,3150,50,2730,168
PB,19879,CATOLÉ DO ROCHA,10060,5609,3794,20771,423,16977,885
PB,19887,VIEIRÓPOLIS,2873,474,1052,4724,53,3672,272
PB,19895,CONCEIÇÃO,7002,2449,3087,13602,142,10515,922
PB,19909,AREIA DE BARAÚNAS,722,570,391,1801,18,1410,100
PB,19917,CONDADO,2650,1131,993,5209,54,4216,381
PB,19925,ALGODÃO DE JANDAÍRA,1380,450,381,2374,36,1993,127
PB,19933,CONDE,7303,3122,1792,13555,319,11763,1019
PB,19941,BOA VISTA,2070,2017,514,5005,122,4491,282
PB,19950,CONGO,2639,506,781,4168,47,3387,195
PB,19968,MARCAÇÃO,2493,1235,1237,5456,99,4219,392
PB,19976,COREMAS,6311,1789,3038,11793,90,8755,565
PB,19984,MATURÉIA,2313,1118,969,4752,79,3783,273
PB,19992,CRUZ DO ESPÍRITO SANTO,7476,2228,2248,13182,360,10934,870
PB,20001,SANTA CECÍLIA,2265,1727,1464,5812,66,4348,290
PB,20010,CUBATI,2508,2044,612,5550,77,4938,309
PB,20036,CUITÉ,6750,3950,3943,15786,255,11843,888
PB,20052,CUITEGI,1726,1897,1376,5451,118,4075,334
PB,20079,CURRAL VELHO,787,499,616,2067,25,1451,140
PB,20095,DESTERRO,2913,1581,1648,6591,95,4943,354
PB,20117,VISTA SERRANA,1253,492,644,2615,65,1971,161
PB,20133,DIAMANTE,2851,697,1506,5473,48,3967,371
PB,20150,DONA INÊS,4068,1974,2141,8778,87,6637,508
PB,20176,DUAS ESTRADAS,1183,1116,512,3064,60,2552,193
PB,20192,EMAS,1231,884,389,2688,31,2299,153
PB,20214,ESPERANÇA,8427,7879,5417,23831,546,18414,1562
PB,20230,FAGUNDES,3894,2672,1444,8781,101,7337,670
PB,20257,FREI MARTINHO,1174,790,473,2629,34,2156,158
PB,20273,GUARABIRA,14645,13817,7001,37985,873,30984,1649
PB,20290,GURINHÉM,4597,3103,2590,11102,205,8512,607
PB,20311,GURJÃO,1184,922,483,2802,37,2319,176
PB,20338,IBIARA,2647,735,957,4686,57,3729,290
PB,20354,IMACULADA,3611,1528,2408,8203,92,5795,564
PB,20370,INGÁ,5524,3809,2068,12494,236,10426,857
PB,20397,ITABAIANA,10233,4222,3277,19162,343,15885,1087
PB,20419,ITAPORANGA,8658,2759,4121,16648,174,12527,936
PB,20435,ITAPOROROCA,5115,3414,2453,11848,191,9395,675
PB,20451,ITATUBA,3660,2013,959,7228,129,6269,467
PB,20478,JACARAÚ,4613,2914,3237,11764,186,8527,814
PB,20494,JERICÓ,3278,1030,1062,5765,68,4703,327
PB,20516,JOÃO PESSOA,210207,149331,68894,467267,11188,398373,27647
PB,20532,JUAREZ TÁVORA,3420,1083,1328,6376,143,5048,402
PB,20559,JUAZEIRINHO,4869,3867,2123,11790,181,9667,750
PB,20575,JUNCO DO SERIDÓ,2060,1587,899,4945,97,4046,302
PB,20591,JURIPIRANGA,4559,1654,1407,8283,130,6876,533
PB,20613,JURU,4212,671,1563,7056,92,5493,518
PB,20630,LAGOA,2467,452,776,3993,46,3217,252
PB,20656,LAGOA DE DENTRO,2506,1576,887,5454,114,4567,371
PB,20672,LAGOA SECA,6414,7348,2721,18305,569,15584,1253
PB,20699,LASTRO,2054,239,367,2865,26,2498,179
PB,20710,LIVRAMENTO,2239,1527,1282,5480,100,4198,332
PB,20737,LUCENA,4563,1956,2157,9510,216,7353,618
PB,20753,MÃE D'ÁGUA,1605,878,625,3347,30,2722,209
PB,20770,MALTA,2087,951,903,4230,82,3327,207
PB,20796,MAMANGUAPE,13626,7240,7153,30454,596,23301,1839
PB,20818,MANAÍRA,4814,670,2458,8577,68,6119,567
PB,20834,MARI,6974,3967,3576,15805,289,12229,999
PB,20850,MASSARANDUBA,3815,2875,1322,8982,224,7660,746
PB,20877,MATARACA,2816,1516,783,5597,121,4814,361
PB,20893,MOGEIRO,4528,2582,2853,10646,142,7793,541
PB,20915,MONTADAS,1280,1438,403,3452,61,3049,270
PB,20931,MONTE HOREBE,2063,337,800,3464,22,2664,242
PB,20958,MONTEIRO,12242,3832,4924,22847,409,17923,1440
PB,20974,MULUNGU,4117,1950,1126,7757,135,6631,429
PB,20990,NATUBA,2822,1313,1867,6707,149,4840,556
PB,21016,NAZAREZINHO,3957,507,768,5645,49,4877,364
PB,21032,NOVA FLORESTA,2833,2510,1366,7291,104,5925,478
PB,21059,NOVA OLINDA,2226,939,1460,5002,69,3542,308
PB,21075,NOVA PALMEIRA,1597,727,486,3080,67,2594,203
PB,21091,OLHO D'ÁGUA,2514,1825,1512,6333,63,4821,419
PB,21113,OLIVEDOS,1340,976,303,2887,87,2584,181
PB,21130,OURO VELHO,1268,753,287,2466,34,2179,124
PB,21156,PASSAGEM,966,514,470,2057,20,1587,87
PB,21172,PATOS,28354,20699,13358,66468,1086,53110,2971
PB,21199,PAULISTA,4387,2322,2325,9626,139,7301,453
PB,21210,PEDRA BRANCA,1796,643,531,3208,42,2677,196
PB,21237,PEDRA LAVRADA,2246,2117,697,5507,83,4810,364
PB,21253,PEDRAS DE FOGO,10210,4009,1369,17074,329,15705,1157
PB,21270,PIANCÓ,5166,3493,2056,11600,150,9544,735
PB,21296,PICUÍ,6108,4219,2798,14258,231,11460,902
PB,21318,PILAR,4855,1563,1700,8854,184,7154,552
PB,21334,PILÕES,2727,1562,1666,6497,108,4831,434
PB,21350,PILÕEZINHOS,1847,1390,1285,4965,131,3680,312
PB,21377,PIRPIRITUBA,2940,2124,1907,7529,135,5622,423
PB,21393,PITIMBU,4606,2240,2015,9715,193,7700,661
PB,21415,POCINHOS,4446,4871,2426,12889,349,10463,797
PB,21431,POMBAL,12500,4656,5247,23980,364,18733,1213
PB,21458,PRATA,1684,967,356,3253,68,2897,178
PB,21474,PRINCESA ISABEL,6693,3579,3499,14927,239,11428,917
PB,21490,PUXINANÃ,3944,3793,1368,10038,240,8670,693
PB,21512,QUEIMADAS,10899,10384,6300,30347,757,24047,2007
PB,21539,QUIXABA,888,444,162,1612,21,1450,97
PB,21555,REMÍGIO,6200,2737,3204,13089,226,9885,722
PB,21571,RIACHO DOS CAVALOS,3731,1088,986,6236,120,5250,311
PB,21598,RIO TINTO,8073,4257,4161,17846,301,13685,1054
PB,21610,SALGADINHO,990,887,585,2617,34,2032,121
PB,21636,SALGADO DE SÃO FÉLIX,4947,1615,3121,10364,118,7243,563
PB,21652,SANTA CRUZ,3438,515,715,4985,52,4270,265
PB,21679,SANTA HELENA,3049,530,1214,5154,45,3940,316
PB,21695,SANTA LUZIA,3922,4564,2116,11443,227,9327,614
PB,21717,SANTANA DE MANGUEIRA,2834,285,867,4302,30,3435,286
PB,21733,SANTANA DOS GARROTES,2699,1175,1837,6221,54,4384,456
PB,21750,SANTA RITA,40631,21060,15665,85237,2134,69572,5747
PB,21776,SANTA TERESINHA,1797,1370,575,4025,57,3450,226
PB,21792,SÃO BENTO,7182,8636,5591,22710,334,17119,967
PB,21814,SÃO JOÃO DO CARIRI,1740,1064,803,3880,49,3077,224
PB,21830,SÃO JOÃO DO TIGRE,1711,568,763,3378,55,2615,281
PB,21857,SÃO JOSÉ DA LAGOA TAPADA,3304,1152,1222,6279,94,5057,507
PB,21873,SÃO JOSÉ DE CAIANA,2528,555,1502,4894,28,3392,281
PB,21890,SÃO JOSÉ DE ESPINHARAS,1981,996,517,3752,43,3235,215
PB,21911,SÃO JOSÉ DE PIRANHAS,8917,1005,3501,14394,126,10893,845
PB,21938,SÃO JOSÉ DO BONFIM,1581,843,465,3108,56,2643,163
PB,21954,SÃO JOSÉ DO SABUGI,1512,1145,321,3304,80,2983,246
PB,21970,SÃO JOSÉ DOS CORDEIROS,1528,585,552,2918,54,2366,199
PB,21997,SÃO MAMEDE,2597,2308,839,6088,66,5249,278
PB,22012,SÃO MIGUEL DE TAIPU,2509,1146,887,4985,67,4098,376
PB,22039,SÃO SEBASTIÃO DE LAGOA DE ROÇA,2433,3435,1928,8530,197,6602,537
PB,22055,SÃO SEBASTIÃO DO UMBUZEIRO,1738,363,369,2699,35,2330,194
PB,22071,SAPÉ,15235,8258,10708,37457,889,26749,2367
PB,22098,SÃO VICENTE DO SERIDÓ,3055,2231,1772,7558,111,5786,389
PB,22110,SERRA BRANCA,4446,2312,2168,9690,170,7522,594
PB,22136,SERRA DA RAIZ,861,972,339,2359,48,2020,139
PB,22152,SERRA GRANDE,1308,339,597,2434,26,1837,164
PB,22179,SERRA REDONDA,2995,1257,1533,6310,104,4777,421
PB,22195,SERRARIA,1798,1285,830,4394,79,3564,402
PB,22217,SOLÂNEA,6965,6595,7069,22429,410,15360,1390
PB,22233,SOLEDADE,4122,3614,1772,10306,188,8534,610
PB,22250,SOUSA,25918,7849,9439,46277,757,36838,2314
PB,22276,SUMÉ,6856,1848,2740,12349,174,9609,731
PB,22292,CAMPO DE SANTANA,3063,1941,1653,7194,103,5541,434
PB,22314,TAPEROÁ,4304,2998,2465,10561,179,8096,615
PB,22330,TAVARES,5726,1095,2992,10676,134,7684,729
PB,22357,TEIXEIRA,4655,2419,2127,10003,180,7876,622
PB,22373,TRIUNFO,3730,780,2443,7444,76,5001,415
PB,22390,UIRAÚNA,5945,2013,2399,11088,115,8689,616
PB,22411,UMBUZEIRO,2851,1552,1118,6154,125,5036,508
PB,22438,VÁRZEA,1074,660,236,2122,33,1886,119
PE,23000,QUIXABA,3619,250,1395,5446,41,4051,141
PE,23019,AFOGADOS DA INGAZEIRA,12593,5195,8253,26908,334,18655,533
PE,23027,LAGOA DO CARRO,6300,2928,2593,12295,206,9702,268
PE,23035,AFRÂNIO,8867,1893,2711,14207,196,11496,540
PE,23043,SANTA CRUZ DA BAIXA VERDE,6359,492,1601,8834,78,7233,304
PE,23051,AGRESTINA,10247,2954,3467,17485,298,14018,519
PE,23060,XEXÉU,5265,1334,4307,11399,209,7092,284
PE,23078,ÁGUA PRETA,11143,2502,6972,21479,384,14507,478
PE,23086,VERTENTE DO LÉRIO,3556,1279,1722,6871,112,5149,202
PE,23094,ÁGUAS BELAS,13591,6098,4992,25917,232,20925,1004
PE,23108,SANTA CRUZ,6749,712,1798,9669,58,7871,352
PE,23116,ALAGOINHA,6432,1410,1980,10232,121,8252,289
PE,23124,JUCATI,5165,671,2679,8821,93,6142,213
PE,23132,ALIANÇA,14139,4425,8950,28680,526,19730,640
PE,23140,DORMENTES,8227,1672,3043,13544,172,10501,430
PE,23159,ALTINHO,9095,2817,4387,17092,338,12705,455
PE,23167,CARNAUBEIRA DA PENHA,6098,371,2985,9807,58,6822,295
PE,23175,AMARAJI,9483,1707,5302,17367,444,12065,431
PE,23183,LAGOA GRANDE,10450,1836,4398,17223,126,12825,413
PE,23191,ANGELIM,3504,2100,2053,7974,88,5921,229
PE,23205,ARAÇOIABA,8496,2188,3078,14274,218,11196,294
PE,23213,ARARIPINA,29386,7426,14667,53641,602,38974,1560
PE,23221,CASINHAS,5658,2027,3774,11997,190,8223,348
PE,23230,ARCOVERDE,26972,5708,11281,45841,728,34560,1152
PE,23248,MANARI,5852,1235,2842,10354,80,7512,345
PE,23256,BARRA DE GUABIRABA,4979,1534,2739,9618,184,6879,182
PE,23264,JATOBÁ,6809,729,2985,10810,70,7825,217
PE,23272,BARREIROS,16818,3428,10158,31605,576,21447,625
PE,23280,TAMANDARÉ,8767,2085,1412,12823,252,11411,307
PE,23299,BELÉM DE MARIA,5104,905,1973,8370,112,6397,276
PE,23302,JAQUEIRA,4537,1112,2885,8865,114,5980,217
PE,23310,BELÉM DE SÃO FRANCISCO,9377,1138,2842,13898,121,11056,420
PE,23329,SANTA FILOMENA,5820,1020,2723,9898,50,7175,285
PE,23337,BELO JARDIM,25659,11967,14320,54965,1350,40645,1669
PE,23353,BETÂNIA,6044,285,2807,9538,85,6731,317
PE,23370,BEZERROS,24119,7804,10078,44709,1279,34631,1429
PE,23396,BODOCÓ,14230,2491,5302,23108,265,17806,820
PE,23418,BOM CONSELHO,17144,3739,9901,32230,367,22329,1079
PE,23434,BOM JARDIM,15207,4928,9381,30705,469,21324,720
PE,23450,BONITO,16098,3543,8158,29228,578,21070,851
PE,23477,BREJÃO,4912,1410,1663,8410,100,6747,325
PE,23493,BREJINHO,3956,759,1484,6476,91,4992,186
PE,23515,BREJO DA MADRE DE DEUS,14654,5131,6890,27971,529,21081,767
PE,23531,BUENOS AIRES,6205,1364,2420,10398,172,7978,237
PE,23558,BUÍQUE,20447,1669,10947,34825,344,23878,1418
PE,23574,CABO DE SANTO AGOSTINHO,90105,17233,24474,139465,4185,114991,3468
PE,23590,CABROBÓ,14477,1483,5452,22096,188,16644,496
PE,23612,CACHOEIRINHA,7550,2252,4828,15297,299,10469,368
PE,23639,CAETÉS,9562,1889,5530,17757,225,12227,551
PE,23655,CALÇADO,4172,793,2128,7367,95,5239,179
PE,23671,CALUMBI,4142,150,1330,5784,29,4454,133
PE,23698,CAMOCIM DE SÃO FÉLIX,7691,1534,3586,13469,280,9883,378
PE,23710,CAMUTANGA,3308,1756,1456,6862,157,5406,185
PE,23736,CANHOTINHO,6759,4451,6311,18229,213,11918,495
PE,23752,CAPOEIRAS,8035,1509,5138,15347,258,10209,407
PE,23779,CARNAÍBA,8445,1583,3435,14009,145,10574,401
PE,23795,CARPINA,24301,13928,10037,50713,1278,40676,1169
PE,23817,CARUARU,100290,51466,33499,196569,5991,163070,5323
PE,23833,CATENDE,14524,2375,8226,25985,326,17759,534
PE,23850,CEDRO,5313,560,2584,8775,69,6191,249
PE,23876,CHÃ DE ALEGRIA,5614,1983,1751,9830,189,8079,293
PE,23892,CHÃ GRANDE,7554,4060,3152,15587,359,12435,462
PE,23914,CONDADO,9357,3018,5014,18189,370,13175,430
PE,23930,CORRENTES,7131,857,4160,12611,129,8451,334
PE,23957,CORTÊS,6280,1721,2214,10696,198,8482,283
PE,23973,CUMARU,7958,2176,4480,15162,197,10682,351
PE,23990,CUPIRA,10240,2118,5795,18948,307,13153,488
PE,24015,CUSTÓDIA,15762,1611,7779,26035,191,18256,692
PE,24031,ESCADA,29016,4693,11152,46562,747,35410,954
PE,24058,EXU,14942,2248,9353,27488,184,18135,761
PE,24074,FEIRA NOVA,8179,2944,2636,14557,352,11921,446
PE,24090,FERREIROS,3907,2386,1424,8327,294,6903,316
PE,24112,FLORES,10266,765,3339,14998,150,11659,478
PE,24139,FLORESTA,12882,2032,5320,20903,147,15583,522
PE,24155,FREI MIGUELINHO,6002,2307,1763,10554,190,8791,292
PE,24171,GAMELEIRA,9144,1792,5008,16503,209,11495,350
PE,24198,GARANHUNS,52924,8988,19628,85555,1803,65927,2212
PE,24210,GLÓRIA DO GOITÁ,10401,4600,5922,21981,374,16059,684
PE,24236,GOIANA,33702,7874,12005,55879,1266,43874,1032
PE,24252,GRANITO,3567,230,1011,4985,34,3974,143
PE,24279,GRAVATÁ,27417,13758,11888,55860,1343,43972,1454
PE,24295,IATI,8264,1079,4999,14917,131,9918,444
PE,24317,IBIMIRIM,11230,1303,3886,17056,125,13170,512
PE,24333,IBIRAJUBA,3315,829,1697,6098,78,4401,179
PE,24350,IGARASSU,39458,10903,11331,64659,1446,53328,1521
PE,24376,IGUARACI,4877,1344,3100,9695,91,6595,283
PE,24392,INAJÁ,6888,678,2593,10558,75,7965,324
PE,24414,INGAZEIRA,2235,373,729,3455,37,2726,81
PE,24430,IPOJUCA,36805,6474,12529,58257,1335,45728,1114
PE,24457,IPUBI,10863,2516,5464,19758,214,14294,701
PE,24473,ITACURUBA,2647,149,961,3867,17,2906,93
PE,24490,ITAÍBA,9473,2359,6198,18823,156,12625,637
PE,24511,ILHA DE ITAMARACÁ,8176,1901,1047,11593,230,10546,239
PE,24538,ITAPETIM,6447,1312,2107,10370,146,8263,358
PE,24554,ITAQUITINGA,7324,1398,3325,12530,230,9205,253
PE,24570,JABOATÃO DOS GUARARAPES,220271,81781,73113,400344,12137,327231,13042
PE,24597,JATAÚBA,6104,2712,3320,12566,110,9246,320
PE,24619,JOÃO ALFREDO,11628,3894,4064,20599,397,16535,616
PE,24635,JOAQUIM NABUCO,6696,1728,2859,11809,259,8950,267
PE,24651,JUPI,6824,823,2249,10307,141,8058,270
PE,24678,JUREMA,5735,1103,3340,10613,106,7273,329
PE,24694,LAGOA DE ITAENGA,8226,4417,2912,16422,412,13510,455
PE,24716,LAGOA DO OURO,6418,776,2051,9711,116,7660,350
PE,24732,LAGOA DOS GATOS,6466,1348,3781,12082,125,8301,362
PE,24759,LAJEDO,12456,5865,4709,24410,572,19701,808
PE,24775,LIMOEIRO,24450,7994,11823,46358,994,34535,1097
PE,24791,MACAPARANA,9589,2804,4815,18223,361,13408,654
PE,24813,MACHADOS,4828,1701,2317,9295,181,6978,268
PE,24830,MARAIAL,4882,1041,3634,9989,141,6355,291
PE,24856,MIRANDIBA,6493,1130,2591,10611,105,8020,292
PE,24872,MORENO,24460,6198,7921,41245,1399,33324,1267
PE,24899,NAZARÉ DA MATA,13761,4433,5875,25275,617,19400,589
PE,24910,OLINDA,170240,62283,50963,300693,7853,249730,9354
PE,24937,OROBÓ,8221,3294,6470,18858,308,12388,565
PE,24953,OROCÓ,5764,1828,2771,10695,103,7924,229
PE,24970,OURICURI,24948,3497,11764,41731,303,29967,1219
PE,24996,PALMARES,25168,4030,13305,44233,808,30928,922
PE,25011,PALMEIRINA,3905,494,2117,6819,74,4702,229
PE,25038,PANELAS,10171,2228,7535,20732,181,13197,617
PE,25054,PARANATAMA,5740,510,1461,8118,100,6657,307
PE,25070,PARNAMIRIM,10619,999,3831,15873,74,12042,350
PE,25097,PASSIRA,12640,3704,7291,24578,330,17287,613
PE,25119,PAUDALHO,15304,11435,6195,34666,947,28471,785
PE,25135,PAULISTA,110172,34667,31863,187229,4986,155366,5541
PE,25151,PEDRA,9366,1722,5165,16983,256,11818,474
PE,25178,PESQUEIRA,27941,4554,12673,46782,567,34109,1047
PE,25194,PETROLÂNDIA,14445,2089,5729,22967,214,17238,490
PE,25216,PETROLINA,103427,22184,32604,164886,2360,132282,4311
PE,25232,POÇÃO,5139,1152,2005,8775,147,6770,332
PE,25259,POMBOS,9905,3553,2915,17441,556,14526,512
PE,25275,PRIMAVERA,5771,1047,2459,9723,180,7264,266
PE,25291,QUIPAPÁ,8448,1566,6559,17256,214,10697,469
PE,25313,RECIFE,573663,290946,207951,1142380,32059,934429,37761
PE,25330,RIACHO DAS ALMAS,9696,2368,2685,15710,439,13025,522
PE,25356,RIBEIRÃO,17017,3365,9579,31109,520,21530,628
PE,25372,RIO FORMOSO,9175,2126,1517,13382,223,11865,341
PE,25399,SAIRÉ,6376,1458,1901,10371,242,8470,394
PE,25410,SALGADINHO,2958,1039,1539,5797,86,4258,175
PE,25437,SALGUEIRO,23007,5040,8105,37145,320,29040,673
PE,25453,SALOÁ,6986,939,4097,12642,169,8545,451
PE,25470,SANHARÓ,8506,2005,2914,14051,195,11137,431
PE,25496,SANTA CRUZ DO CAPIBARIBE,21357,15458,10848,50031,1358,39183,1010
PE,25518,SANTA MARIA DA BOA VISTA,15514,3622,6626,26440,159,19814,519
PE,25534,SANTA MARIA DO CAMBUCÁ,4546,2524,2147,9694,180,7547,297
PE,25550,SANTA TEREZINHA,4207,1128,2611,8203,77,5592,180
PE,25577,SÃO BENEDITO DO SUL,3544,887,3040,7878,118,4838,289
PE,25593,SÃO BENTO DO UNA,17557,4427,9833,33142,493,23309,832
PE,25615,SÃO CAITANO,15359,4341,6696,27885,601,21189,888
PE,25631,SÃO JOÃO,9969,1217,4774,16525,167,11751,398
PE,25658,SÃO JOAQUIM DO MONTE,8143,3175,4667,16899,283,12232,631
PE,25674,SÃO JOSÉ DA COROA GRANDE,6170,2556,2939,12098,177,9159,256
PE,25690,SÃO JOSÉ DO BELMONTE,14230,1748,8625,25417,175,16792,639
PE,25712,SÃO JOSÉ DO EGITO,13224,3052,6938,24073,255,17135,604
PE,25739,SÃO LOURENÇO DA MATA,42003,12438,13432,71746,2027,58314,1846
PE,25755,SÃO VICENTE FERRÉR,7257,1850,4339,14034,184,9695,404
PE,25771,SERRA TALHADA,35586,3604,14678,55769,500,41091,1401
PE,25798,SERRITA,8155,1494,4253,14301,75,10048,324
PE,25810,SERTÂNIA,13959,3145,4481,22451,231,17970,635
PE,25836,SIRINHAÉM,15796,3178,3630,23584,480,19954,500
PE,25852,MOREILÂNDIA,5637,590,1529,8045,60,6516,229
PE,25879,SOLIDÃO,3067,421,1323,4985,42,3662,132
PE,25895,SURUBIM,20186,9479,9677,41218,972,31541,904
PE,25917,TABIRA,11663,1862,5455,19622,187,14167,455
PE,25933,TACAIMBÓ,5280,1610,2950,10338,204,7388,294
PE,25950,TACARATU,6945,1291,4001,12674,128,8673,309
PE,25976,ITAMBÉ,12920,4485,6508,24889,348,18381,628
PE,25992,TAQUARITINGA DO NORTE,7872,5254,3597,17521,352,13924,446
PE,26018,TEREZINHA,3471,610,894,5270,73,4376,222
PE,26034,TERRA NOVA,5315,378,939,6832,39,5893,161
PE,26050,TIMBAÚBA,23152,7299,13078,45311,731,32233,1051
PE,26077,TORITAMA,11944,4041,4471,21241,439,16770,346
PE,26093,TRACUNHAÉM,5552,1935,1556,9435,178,7879,214
PE,26115,TRINDADE,10120,2017,5331,18117,167,12786,482
PE,26131,TRIUNFO,7339,857,3080,11705,155,8625,274
PE,26158,TUPANATINGA,7901,1598,5659,15801,123,10142,520
PE,26174,TUPARETAMA,4773,561,1756,7324,76,5568,158
PE,26190,VENTUROSA,7553,1188,2381,11637,158,9256,357
PE,26212,VERDEJANTE,4449,714,1211,6671,79,5460,218
PE,26239,VERTENTES,6090,3920,2816,13413,240,10597,347
PE,26255,VICÊNCIA,10881,3717,7248,22946,451,15698,649
PE,26271,VITÓRIA DE SANTO ANTÃO,52416,18027,18621,93569,2120,74948,2385
PE,26298,CAMARAGIBE,60647,23774,17181,107948,3096,90767,3250
PE,26310,ABREU E LIMA,45161,12988,13833,76155,2100,62322,2073
PE,26336,ITAPISSUMA,9080,2500,1171,13588,486,12417,351
PE,30015,FERNANDO DE NORONHA,905,393,711,2098,39,1387,50
PI,10006,BRASILEIRA,3133,1004,1517,6155,84,4638,417
PI,10014,AGRICOLÂNDIA,2439,644,1167,4563,60,3396,253
PI,10022,ALEGRETE DO PIAUÍ,2177,500,990,3950,28,2960,255
PI,10030,ÁGUA BRANCA,6097,2196,2831,11989,154,9158,711
PI,10049,BAIXA GRANDE DO RIBEIRO,3543,1179,1468,6703,36,5235,477
PI,10057,ALTO LONGÁ,5758,1776,2658,10977,65,8319,720
PI,10065,BOM PRINCÍPIO DO PIAUÍ,2333,1190,1098,5057,47,3959,389
PI,10073,ALTOS,15402,5118,6321,28851,288,22530,1722
PI,10081,BONFIM DO PIAUÍ,2437,364,966,4105,41,3139,297
PI,10090,AMARANTE,7005,1947,3873,13796,139,9923,832
PI,10103,BURITI DOS MONTES,2864,1142,1298,5660,59,4362,297
PI,10111,ANGICAL DO PIAUÍ,3439,1014,1434,6296,82,4862,327
PI,10120,CABECEIRAS DO PIAUÍ,4004,904,1866,7293,62,5427,457
PI,10138,ANÍSIO DE ABREU,3355,945,1420,6154,49,4734,385
PI,10146,CALDEIRÃO GRANDE DO PIAUÍ,2399,563,878,4132,35,3254,257
PI,10154,ANTÔNIO ALMEIDA,991,825,750,2731,43,1981,122
PI,10162,CANAVIEIRA,1523,423,979,3188,32,2209,231
PI,10170,AROAZES,2876,563,1211,5024,40,3813,334
PI,10189,COIVARAS,2216,769,734,3976,25,3242,232
PI,10197,ARRAIAL,2155,365,1117,3898,37,2781,224
PI,10200,COLÔNIA DO GURGUÉIA,2664,486,1272,4769,48,3497,299
PI,10219,AVELINO LOPES,4104,1102,2249,8114,87,5865,572
PI,10227,COLÔNIA DO PIAUÍ,3046,511,1943,5932,43,3989,389
PI,10235,BARRAS,12085,8287,8353,30957,315,22604,1917
PI,10243,CORONEL JOSÉ DIAS,2549,612,927,4363,42,3436,233
PI,10251,BARREIRAS DO PIAUÍ,1347,401,997,2902,22,1905,135
PI,10260,FARTURA DO PIAUÍ,2324,372,1231,4220,21,2989,272
PI,10278,BARRO DURO,2727,980,1640,5699,56,4059,296
PI,10286,JACOBINA DO PIAUÍ,2695,411,1007,4395,69,3388,213
PI,10294,BATALHA,8295,4264,6372,20393,208,14021,1254
PI,10308,JARDIM DO MULATO,1936,621,655,3443,38,2788,193
PI,10316,BENEDITINOS,4038,1612,2017,8365,89,6348,609
PI,10324,LAGOA ALEGRE,4001,791,1636,6855,44,5219,383
PI,10332,BERTOLÍNIA,2114,567,987,3979,39,2992,272
PI,10340,LAGOA DO BARRO DO PIAUÍ,2112,320,920,3636,47,2716,237
PI,10359,BOCAINA,2416,1483,827,5020,67,4193,227
PI,10367,MARCOLÂNDIA,3240,921,1018,5827,94,4809,554
PI,10375,BOM JESUS,6342,3563,3042,13897,144,10855,806
PI,10383,PATOS DO PIAUÍ,2730,774,1247,5307,79,4060,477
PI,10391,BURITI DOS LOPES,6450,3819,3365,14764,145,11399,985
PI,10405,PASSAGEM FRANCA DO PIAUÍ,1727,423,889,3277,30,2388,208
PI,10413,CAMPINAS DO PIAUÍ,2712,383,998,4468,59,3470,316
PI,10421,QUEIMADA NOVA,3873,518,1536,6404,62,4868,415
PI,10430,CAMPO MAIOR,17181,7629,7372,34394,389,27022,1823
PI,10448,SANTA CRUZ DOS MILAGRES,1489,410,852,2942,20,2090,171
PI,10456,CANTO DO BURITI,7435,2623,3912,14919,139,11007,810
PI,10464,SANTA ROSA DO PIAUÍ,1977,644,1227,4183,34,2956,301
PI,10472,CAPITÃO DE CAMPOS,3998,1473,2119,8331,127,6212,614
PI,10480,SANTANA DO PIAUÍ,1999,626,682,3680,49,2998,324
PI,10499,CARACOL,4284,813,1568,7208,66,5640,477
PI,10502,SÃO BRAZ DO PIAUÍ,2141,389,871,3644,27,2773,216
PI,10510,CASTELO DO PIAUÍ,6371,3461,4779,15574,138,10795,825
PI,10529,SÃO JOSÉ DO DIVINO,2193,1041,1116,4627,39,3511,238
PI,10537,COCAL,6185,5873,5899,19420,361,13521,1102
PI,10545,SIGEFREDO PACHECO,3964,1272,1798,7546,64,5748,448
PI,10553,CONCEIÇÃO DO CANINDÉ,2343,352,1086,4148,63,3062,304
PI,10561,SÃO LOURENÇO DO PIAUÍ,2417,462,976,4159,42,3183,262
PI,10570,CORRENTE,8412,3063,4355,17138,174,12783,1134
PI,10588,VÁRZEA BRANCA,1937,416,992,3624,20,2632,259
PI,10596,CRISTALÂNDIA DO PIAUÍ,2312,1374,1309,5261,26,3952,240
PI,10600,BARRA D'ALCÂNTARA,1464,528,680,2919,16,2239,231
PI,10618,CRISTINO CASTRO,3413,998,2106,7015,72,4909,426
PI,10626,BELA VISTA DO PIAUÍ,1864,252,287,2646,44,2359,199
PI,10634,CURIMATÁ,3606,1755,2248,8055,86,5807,360
PI,10642,BREJO DO PIAUÍ,2041,230,876,3456,35,2580,274
PI,10650,DEMERVAL LOBÃO,4690,2036,1232,8546,94,7314,494
PI,10669,BOA HORA,2504,905,1380,5071,30,3691,252
PI,10677,DOM EXPEDITO LOPES,3548,1138,970,6063,64,5093,343
PI,10685,DOM INOCÊNCIO,4455,475,1600,7070,50,5470,490
PI,10693,ELESBÃO VELOSO,6379,1714,3369,12426,101,9057,863
PI,10707,CAPITÃO GERVÁSIO OLIVEIRA,1868,335,785,3253,41,2468,224
PI,10715,ELISEU MARTINS,1921,557,995,3773,64,2778,236
PI,10723,CAMPO GRANDE DO PIAUÍ,2717,543,740,4317,54,3577,263
PI,10731,ESPERANTINA,10105,7731,7960,27528,279,19568,1453
PI,10740,CAMPO LARGO DO PIAUÍ,2250,745,1448,4736,33,3288,260
PI,10758,FLORES DO PIAUÍ,1781,727,831,3657,37,2826,281
PI,10766,CURRAIS,2513,496,913,4211,29,3298,260
PI,10774,FLORIANO,20241,8052,9381,40066,500,30685,1892
PI,10782,GEMINIANO,2511,762,839,4630,64,3791,454
PI,10790,FRANCINÓPOLIS,2092,768,1253,4420,46,3167,261
PI,10804,GUARIBAS,2085,215,1183,3663,18,2480,162
PI,10812,FRANCISCO AYRES,2008,560,1323,4174,45,2851,238
PI,10820,ILHA GRANDE,3627,1162,1488,6879,113,5391,489
PI,10839,FRANCISCO SANTOS,3742,980,1925,7138,127,5213,364
PI,10847,JUREMA,2199,630,805,3936,38,3131,264
PI,10855,FRONTEIRAS,4564,1251,2141,8590,129,6449,505
PI,10863,LAGOA DE SÃO FRANCISCO,2612,559,1215,4695,51,3480,258
PI,10871,GILBUÉS,3415,1025,2451,7415,55,4964,469
PI,10880,MORRO CABEÇA NO TEMPO,1377,543,1182,3393,35,2211,256
PI,10898,GUADALUPE,3750,1393,2302,7877,63,5575,369
PI,10901,NOVO SANTO ANTÔNIO,1811,347,819,3199,27,2380,195
PI,10910,HUGO NAPOLEÃO,1897,559,872,3559,38,2687,193
PI,10928,NOSSA SENHORA DE NAZARÉ,2757,546,976,4551,28,3575,244
PI,10936,INHUMA,5937,1692,3261,11920,154,8659,876
PI,10944,PAQUETÁ,2112,398,726,3562,27,2836,299
PI,10952,IPIRANGA DO PIAUÍ,3769,932,1619,6911,89,5292,502
PI,10960,NOVA SANTA RITA,2054,432,917,3659,27,2742,229
PI,10979,ISAÍAS COELHO,3191,751,1795,6274,82,4479,455
PI,10987,SÃO JOÃO DO ARRAIAL,2415,1478,1400,5696,43,4296,360
PI,10995,ITAINÓPOLIS,4926,1127,1803,8710,148,6907,706
PI,11010,ITAUEIRA,3981,1868,1732,8196,115,6464,500
PI,11037,JAICÓS,5167,1735,3794,11739,134,7945,909
PI,11053,JERUMENHA,1948,808,952,3983,48,3031,227
PI,11070,JOAQUIM PIRES,4467,2460,2663,10437,110,7774,737
PI,11088,SÃO JOÃO DA CANABRAVA,2068,933,877,4123,32,3246,213
PI,11096,JOSÉ DE FREITAS,16136,4875,5741,28525,307,22784,1466
PI,11118,LANDRI SALES,2055,534,1578,4438,36,2860,235
PI,11134,LUIS CORREIA,9652,5840,5600,22642,209,17042,1341
PI,11150,LUZILÂNDIA,8212,4205,4975,18523,181,13548,950
PI,11177,MANOEL EMÍDIO,2376,449,1180,4340,35,3160,300
PI,11193,MARCOS PARENTE,1490,939,1196,3857,45,2661,187
PI,11215,MATIAS OLÍMPIO,2924,2265,2331,8029,52,5698,457
PI,11231,MIGUEL ALVES,10077,4316,6923,23137,244,16214,1577
PI,11258,MIGUEL LEÃO,564,225,248,1114,8,866,69
PI,11274,MONSENHOR GIL,5064,1530,1853,8996,63,7143,486
PI,11290,MONSENHOR HIPÓLITO,3301,1095,1124,6007,70,4883,417
PI,11312,MONTE ALEGRE DO PIAUÍ,3782,925,2322,7530,37,5208,464
PI,11339,NAZARÉ DO PIAUÍ,3367,626,1721,6160,44,4439,402
PI,11355,NOSSA SENHORA DOS REMÉDIOS,2858,1396,1820,6553,71,4733,408
PI,11371,NOVO ORIENTE DO PIAUÍ,3048,536,1446,5410,32,3964,348
PI,11398,OEIRAS,13378,5128,5974,26360,262,20386,1618
PI,11410,DOMINGOS MOURÃO,1788,610,938,3519,22,2581,161
PI,11436,PADRE MARCOS,2579,1227,1406,5638,73,4232,353
PI,11452,PAES LANDIM,1186,1027,851,3304,46,2453,194
PI,11479,PALMEIRA DO PIAUÍ,1981,711,1104,4125,44,3021,285
PI,11495,PALMEIRAIS,5846,1574,2169,10359,94,8190,676
PI,11517,PARNAGUÁ,3737,614,1864,6703,44,4839,444
PI,11533,PARNAÍBA,36686,29084,21051,92323,1175,71272,4327
PI,11550,PAULISTANA,8791,926,3465,14279,138,10814,959
PI,11576,PEDRO II,14073,4235,7650,27845,332,20195,1555
PI,11592,PICOS,24056,10667,8659,47072,674,38413,3016
PI,11614,PIMENTEIRAS,4185,1878,1920,8441,46,6521,412
PI,11630,PIO IX,6879,2337,2672,12809,192,10137,729
PI,11657,PIRACURUCA,9063,5657,1995,17845,181,15850,949
PI,11673,PIRIPIRI,19146,10621,4905,38029,655,33124,2702
PI,11690,PORTO,4109,989,2580,8299,69,5719,552
PI,11711,PRATA DO PIAUÍ,1586,341,1019,3166,21,2147,199
PI,11738,REDENÇÃO DO GURGUÉIA,2604,1476,1620,6061,44,4441,317
PI,11754,REGENERAÇÃO,7200,1559,3707,13394,136,9687,792
PI,11770,RIBEIRO GONÇALVES,2294,1067,969,4657,42,3688,285
PI,11797,RIO GRANDE DO PIAUÍ,2483,1271,1593,5668,33,4075,288
PI,11819,SANTA CRUZ DO PIAUÍ,2934,868,919,5052,44,4133,287
PI,11835,SANTA FILOMENA,2036,747,1221,4333,33,3112,296
PI,11851,SANTA LUZ,1955,1026,931,4237,67,3306,258
PI,11878,SANTO ANTÔNIO DE LISBOA,2629,945,901,4824,90,3923,259
PI,11894,SANTO INÁCIO DO PIAUÍ,1454,484,868,3038,24,2170,208
PI,11916,SÃO FÉLIX DO PIAUÍ,1764,421,853,3250,25,2397,187
PI,11932,SÃO FRANCISCO DO PIAUÍ,2781,683,1404,5220,33,3816,319
PI,11959,SÃO GONÇALO DO PIAUÍ,2354,660,819,4161,67,3342,261
PI,11975,SÃO JOÃO DA SERRA,2548,1389,1766,6048,53,4282,292
PI,11991,SÃO JOÃO DO PIAUÍ,6322,2377,3193,12883,152,9690,839
PI,12009,SÃO JOÃO DA FRONTEIRA,2287,714,1103,4425,40,3322,281
PI,12017,SÃO JOSÉ DO PEIXE,1506,397,910,3062,27,2152,222
PI,12025,SÃO JOÃO DA VARJOTA,2046,454,856,3640,31,2784,253
PI,12033,SÃO JOSÉ DO PIAUÍ,3168,749,1313,5629,67,4316,332
PI,12041,SEBASTIÃO BARROS,1965,632,1063,3928,20,2865,248
PI,12050,SÃO JULIÃO,2938,597,1095,4997,28,3902,339
PI,12068,SEBASTIÃO LEAL,1685,686,544,3172,69,2628,188
PI,12076,SÃO MIGUEL DO TAPUIO,5574,3746,4717,15035,121,10318,877
PI,12084,ALVORADA DO GURGUÉIA,2174,314,889,3592,31,2703,184
PI,12092,SÃO PEDRO DO PIAUÍ,4654,2220,2797,10526,131,7729,724
PI,12106,ASSUNÇÃO DO PIAUÍ,1974,1452,1865,5748,97,3883,360
PI,12114,SÃO RAIMUNDO NONATO,10124,4634,4120,20185,202,16065,1105
PI,12122,BETÂNIA DO PIAUÍ,3029,313,1028,4759,50,3731,339
PI,12130,SIMÕES,5376,1043,2747,10052,142,7305,744
PI,12149,BOQUEIRÃO DO PIAUÍ,2399,413,1216,4340,35,3124,277
PI,12157,SIMPLÍCIO MENDES,3867,2505,2267,9191,120,6924,432
PI,12165,CARIDADE DO PIAUÍ,2278,456,1030,4032,22,3002,246
PI,12173,SOCORRO DO PIAUÍ,1782,718,1142,3937,26,2795,269
PI,12181,CURRAL NOVO DO PIAUÍ,1987,283,839,3379,62,2540,208
PI,12190,TERESINA,251422,142192,93025,517510,7991,424485,22880
PI,12203,JÚLIO BORGES,2358,317,1228,4153,30,2925,220
PI,12211,UNIÃO,15549,6957,7011,32039,279,25028,2243
PI,12220,LAGOA DO SÍTIO,2757,357,1149,4572,28,3423,281
PI,12238,URUÇUÍ,3615,6086,3673,14208,153,10535,681
PI,12246,MILTON BRANDÃO,2710,807,1409,5259,43,3850,290
PI,12254,VALENÇA DO PIAUÍ,8162,2241,4152,15704,200,11552,949
PI,12262,PAJEÚ DO PIAUÍ,1269,482,895,2858,16,1963,196
PI,12270,VÁRZEA GRANDE,1594,862,1164,3903,27,2739,256
PI,12289,PAVUSSU,1946,413,973,3541,30,2568,179
PI,12297,DIRCEU ARCOVERDE,2809,625,1797,5538,49,3741,258
PI,12300,RIACHO FRIO,2161,357,956,3825,19,2869,332
PI,12319,ALAGOINHA DO PIAUÍ,2829,1559,1282,6120,61,4838,389
PI,12327,ACAUÃ,3449,413,731,4911,61,4180,257
PI,12335,BELÉM DO PIAUÍ,1579,324,425,2533,38,2108,167
PI,12343,CAJAZEIRAS DO PIAUÍ,1591,243,723,2779,33,2056,189
PI,12351,CAMPO ALEGRE DO FIDALGO,2327,429,1009,4052,37,3043,250
PI,12360,COCAL DE TELHA,2237,369,1265,4164,44,2899,249
PI,12378,FRANCISCO MACEDO,1447,178,417,2220,20,1803,158
PI,12386,JOÃO COSTA,1715,253,633,2839,21,2206,217
PI,12394,JATOBÁ DO PIAUÍ,2679,1005,1081,5069,39,3988,265
PI,12408,JOCA MARQUES,1926,771,1078,4095,31,3017,289
PI,12416,JUAZEIRO DO PIAUÍ,2660,1128,1314,5425,60,4111,263
PI,12424,LAGOA DO PIAUÍ,1789,577,391,2962,23,2571,182
PI,12432,LAGOINHA DO PIAUÍ,1207,388,490,2251,38,1761,128
PI,12440,MADEIRO,2291,1448,1695,5773,27,4078,312
PI,12459,MORRO DO CHAPÉU DO PIAUÍ,2258,1247,1950,5836,54,3886,327
PI,12467,MASSAPÊ DO PIAUÍ,2818,748,1439,5521,89,4082,427
PI,12475,MURICI DOS PORTELAS,2632,1199,1533,5903,59,4370,480
PI,12483,OLHO D'ÁGUA DO PIAUÍ,1172,287,452,2051,20,1599,120
PI,12491,PEDRO LAURENTINO,1413,261,647,2494,17,1847,156
PI,12505,SÃO FRANCISCO DE ASSIS DO PIAUÍ,2336,495,777,3946,32,3169,306
PI,12513,SUSSUAPARA,2845,1077,716,5008,57,4292,313
PI,12521,TANQUE DO PIAUÍ,1161,312,545,2187,36,1642,133
PI,12530,TAMBORIL DO PIAUÍ,907,925,689,2639,12,1950,106
PI,12548,VILA NOVA DO PIAUÍ,1514,308,453,2481,31,2028,175
PI,12556,VERA MENDES,1426,356,706,2781,71,2075,222
PI,12564,WALL FERRAZ,2185,385,671,3487,32,2816,214
PI,12572,CAJUEIRO DA PRAIA,3132,754,1251,5525,48,4274,340
PI,12580,CURRALINHOS,2181,588,764,3793,26,3029,234
PI,12599,PORTO ALEGRE DO PIAUÍ,940,349,484,1909,6,1425,130
PI,12602,RIBEIRA DO PIAUÍ,2005,247,861,3441,29,2580,299
PI,12610,SÃO GONÇALO DO GURGUÉIA,1085,279,620,2096,4,1476,108
PI,12629,SÃO LUIS DO PIAUÍ,1152,517,491,2343,39,1852,144
PI,12637,FLORESTA DO PIAUÍ,1188,352,650,2352,16,1702,146
PI,12653,SANTO ANTÔNIO DOS MILAGRES,1045,149,338,1667,17,1329,118
PI,12661,SÃO MIGUEL DA BAIXA GRANDE,1154,330,521,2156,20,1635,131
PI,12670,CARAÚBAS DO PIAUÍ,1685,1618,1119,4771,41,3652,308
PI,12688,CAXINGÓ,1718,1384,898,4304,41,3406,263
PI,12696,COCAL DOS ALVES,2295,807,1255,4682,73,3427,252
PI,12700,SÃO MIGUEL DO FIDALGO,1034,527,705,2487,45,1782,176
PI,12718,PAU D'ARCO DO PIAUÍ,2078,598,908,3790,24,2882,182
PI,12726,NAZÁRIA,5003,1276,1977,8799,54,6822,489
PI,12734,AROEIRAS DO ITAIM,1641,551,543,2928,41,2385,152
PR,74004,GODOY MOREIRA,1143,948,554,2728,22,2174,61
PR,74012,ABATIÁ,1966,2519,890,5561,87,4671,99
PR,74020,IBEMA,2058,1394,912,4492,51,3580,77
PR,74039,ADRIANÓPOLIS,2322,1067,1039,4592,34,3553,130
PR,74047,LINDOESTE,2211,1206,1083,4594,30,3511,64
PR,74055,AGUDOS DO SUL,2662,2388,912,6147,67,5235,118
PR,74063,OURO VERDE DO OESTE,1825,1610,471,4029,39,3558,84
PR,74071,ALMIRANTE TAMANDARÉ,24986,22389,9726,59800,1257,50074,1442
PR,74080,SANTA TEREZA DO OESTE,2886,2755,1284,7102,69,5818,108
PR,74098,ALTO PARANÁ,4175,3500,1737,9697,90,7960,195
PR,74101,ANAHY,959,957,304,2275,13,1971,42
PR,74110,ALTO PIQUIRI,3133,2384,1064,6806,75,5742,150
PR,74128,ÂNGULO,818,1036,535,2473,23,1938,61
PR,74136,ALVORADA DO SUL,2749,2305,976,6201,69,5225,102
PR,74144,BOA ESPERANÇA DO IGUAÇU,1321,600,407,2371,20,1964,23
PR,74152,AMAPORÃ,1327,1512,557,3495,32,2938,67
PR,74160,BOM SUCESSO DO SUL,1245,1051,322,2671,19,2349,34
PR,74179,AMPÉRE,7125,2782,2066,12286,92,10220,221
PR,74187,BRASILÂNDIA DO SUL,1230,862,453,2620,33,2167,42
PR,74195,ANDIRÁ,6702,5931,4063,17452,292,13389,464
PR,74209,CAFEZAL DO SUL,1282,1394,483,3249,42,2766,48
PR,74217,ANTONINA,3756,7506,4113,15809,182,11696,252
PR,74225,CANDÓI,5027,3130,2867,11314,100,8447,190
PR,74233,ANTONIO OLINTO,2433,2423,962,6031,76,5069,137
PR,74241,CRUZEIRO DO IGUAÇU,1887,647,589,3191,16,2602,52
PR,74250,APUCARANA,21089,48183,17295,90070,1254,72775,2249
PR,74268,DIAMANTE DO SUL,1291,781,659,2782,16,2123,35
PR,74276,ARAPONGAS,18075,39725,14617,76131,1387,61514,2327
PR,74284,ENTRE RIOS DO OESTE,1448,1132,313,2946,26,2633,27
PR,74292,ARAPOTI,5220,8757,3789,18239,186,14450,287
PR,74306,FAROL,914,1188,461,2718,72,2257,83
PR,74314,ARARUNA,4104,3869,2133,10442,145,8309,191
PR,74322,FAZENDA RIO GRANDE,25065,14838,10566,52626,1042,42060,1115
PR,74330,MARILÂNDIA DO SUL,2120,3299,1362,7042,118,5680,143
PR,74349,FLOR DA SERRA DO SUL,2018,1222,869,4188,32,3319,47
PR,74357,ARAUCÁRIA,42379,24517,15277,85986,1707,70709,2106
PR,74365,HONÓRIO SERPA,2276,1117,1312,4794,33,3482,56
PR,74373,ASSAÍ,3146,6761,2022,12367,173,10345,265
PR,74381,IGUATU,797,724,209,1769,19,1560,20
PR,74390,ASTORGA,5865,9564,3947,20019,276,16072,367
PR,74403,IRACEMA DO OESTE,1075,758,457,2368,18,1911,60
PR,74411,ATALAIA,1352,1307,484,3232,38,2748,51
PR,74420,NOVO ITACOLOMI,846,1130,274,2339,33,2065,56
PR,74438,BALSA NOVA,3864,3194,669,8121,176,7452,218
PR,74446,ITAPERUÇU,9435,3849,2962,16769,238,13807,285
PR,74454,BANDEIRANTES,8414,10491,5295,25051,320,19756,531
PR,74462,IVATÉ,2548,1688,758,5160,58,4402,108
PR,74470,BARBOSA FERRAZ,2784,3739,1769,8628,122,6859,214
PR,74489,LIDIANÓPOLIS,1306,1296,932,3651,37,2719,80
PR,74497,BARRACÃO,2963,2094,1257,6458,61,5201,83
PR,74500,MARIPÁ,1262,2499,717,4605,48,3888,79
PR,74519,BARRA DO JACARÉ,882,874,304,2162,42,1858,60
PR,74527,MATO RICO,1318,972,550,2941,20,2391,81
PR,74535,BELA VISTA DO PARAÍSO,3847,5736,1644,11670,157,10026,286
PR,74543,MAUÁ DA SERRA,1731,2840,1364,6142,74,4778,133
PR,74551,BITURUNA,5526,3796,2589,12258,113,9669,234
PR,74560,MERCEDES,1547,1863,536,4079,53,3543,80
PR,74578,BOA ESPERANÇA,1028,1901,664,3743,57,3079,93
PR,74586,NOVA LARANJEIRAS,3174,2409,2243,7983,42,5740,115
PR,74594,BOCAIÚVA DO SUL,3081,2866,1349,7567,118,6218,153
PR,74608,NOVA SANTA BÁRBARA,1177,1067,517,2867,33,2350,73
PR,74616,BOM SUCESSO,1865,1937,648,4625,59,3977,116
PR,74624,PATO BRAGADO,1661,1652,457,3879,50,3422,59
PR,74632,BORRAZÓPOLIS,2017,3114,1534,6861,76,5327,120
PR,74640,PINHAL DE SÃO BENTO,1382,306,327,2057,12,1730,30
PR,74659,CAFEARA,1095,505,256,1936,28,1680,52
PR,74667,PITANGUEIRAS,717,1164,234,2189,26,1955,48
PR,74675,CALIFÓRNIA,1730,3357,1253,6580,99,5327,141
PR,74683,QUATRO PONTES,1103,1522,435,3139,20,2704,59
PR,74691,CAMBARÁ,4562,9631,3756,18727,255,14971,523
PR,74705,RAMILÂNDIA,1314,1180,775,3349,26,2574,54
PR,74713,CAMBÉ,23951,29921,12149,69665,1319,57516,2325
PR,74721,RANCHO ALEGRE D'OESTE,1017,847,490,2407,26,1917,27
PR,74730,CAMBIRA,2313,2534,968,6049,93,5081,141
PR,74748,RIO BONITO DO IGUAÇU,4794,2139,2570,9681,61,7111,117
PR,74756,CAMPINA DA LAGOA,3969,4812,2962,12113,150,9151,220
PR,74764,SANTA LÚCIA,1405,1013,569,3068,29,2499,52
PR,74772,CAMPINA GRANDE DO SUL,11159,10100,6005,28335,490,22330,581
PR,74780,CAMPO BONITO,1617,1165,964,3834,38,2870,50
PR,74799,CAMPO DO TENENTE,1424,2665,817,5064,64,4247,94
PR,74802,SANTA MARIA DO OESTE,4039,1995,2849,9091,58,6242,150
PR,74810,CAMPO LARGO,29151,32004,12529,77251,1584,64722,1983
PR,74829,SANTA MÔNICA,1096,1001,338,2509,27,2171,47
PR,74837,CAMPO MOURÃO,22357,25168,13901,63285,721,49384,1138
PR,74845,SÃO MANOEL DO PARANÁ,464,949,260,1730,20,1470,37
PR,74853,CÂNDIDO DE ABREU,4368,4633,3105,12493,126,9388,261
PR,74861,SÃO PEDRO DO IGUAÇU,2160,1832,705,4879,62,4174,120
PR,74870,CAPANEMA,6687,4589,2433,14039,124,11606,206
PR,74888,TUNAS DO PARANÁ,1756,1402,866,4145,34,3279,87
PR,74896,CAPITÃO LEÔNIDAS MARQUES,5388,3298,2778,11744,96,8966,184
PR,74900,VENTANIA,2450,2646,1642,6989,98,5347,153
PR,74918,CARLÓPOLIS,3837,4174,2324,10675,101,8351,239
PR,74926,ALTO PARAÍSO,995,867,510,2442,34,1932,36
PR,74934,CASCAVEL,70184,78224,38940,193820,2295,154880,4177
PR,74942,DOUTOR ULYSSES,2309,1165,878,4512,47,3634,113
PR,74950,CASTRO,14068,23898,9102,48705,704,39603,933
PR,74969,VIRMOND,1224,1390,674,3378,38,2704,52
PR,74977,CATANDUVAS,2513,2861,1811,7357,38,5546,134
PR,74985,LARANJAL,2178,1002,1582,4886,31,3304,93
PR,74993,CENTENÁRIO DO SUL,4290,2367,1714,8652,83,6938,198
PR,75000,ITAIPULÂNDIA,3628,2122,1484,7406,88,5922,84
PR,75019,CERRO AZUL,5822,3464,2401,12162,178,9761,297
PR,75027,NOVA ESPERANÇA DO SUDOESTE,2234,982,534,3840,39,3306,51
PR,75035,CHOPINZINHO,6624,4735,3465,15381,250,11916,307
PR,75043,PINHAIS,31706,31186,16302,82958,1648,66656,2116
PR,75051,CIANORTE,14323,23776,10232,50379,878,40147,1170
PR,75060,SAUDADE DO IGUAÇU,1836,1019,893,3851,37,2958,66
PR,75078,CIDADE GAÚCHA,3787,2813,1587,8439,88,6852,164
PR,75086,ARIRANHA DO IVAÍ,928,667,515,2165,18,1650,37
PR,75094,CLEVELÂNDIA,5456,4135,3670,13601,136,9931,204
PR,75108,ARAPUÃ,1373,1178,475,3078,15,2603,37
PR,75116,MANGUEIRINHA,6130,3671,3594,13725,113,10131,217
PR,75124,BELA VISTA DA CAROBA,1534,1016,591,3208,23,2617,44
PR,75132,COLOMBO,56839,47293,23448,133380,2733,109932,3067
PR,75140,BOA VENTURA DE SÃO ROQUE,2292,1310,918,4645,32,3727,93
PR,75159,COLORADO,7509,6048,3791,18187,322,14396,517
PR,75167,BOM JESUS DO SUL,1623,926,631,3252,18,2621,54
PR,75175,CONGONHINHAS,2801,1941,1537,6506,62,4969,165
PR,75183,CAMPINA DO SIMÃO,1608,775,835,3292,24,2457,50
PR,75191,CONSELHEIRO MAIRINCK,1010,1239,450,2805,44,2355,62
PR,75205,CAMPO MAGRO,6727,5866,2360,15620,321,13260,346
PR,75213,CONTENDA,4760,3877,1617,10657,192,9040,211
PR,75221,CARAMBEÍ,3440,7129,2150,13120,191,10970,210
PR,75230,CORBÉLIA,4195,6233,2007,12726,117,10719,174
PR,75248,CORONEL DOMINGOS SOARES,2266,1208,1322,4893,24,3571,73
PR,75256,CORNÉLIO PROCÓPIO,10428,17681,8054,37550,515,29496,872
PR,75264,CRUZMALTINA,802,1240,689,2829,23,2140,75
PR,75272,CORONEL VIVIDA,7529,5301,2350,15623,164,13273,279
PR,75280,CORUMBATAÍ DO SUL,1316,1183,669,3299,32,2630,99
PR,75299,CRUZEIRO DO OESTE,6678,4935,2327,14382,156,12055,286
PR,75302,ESPERANÇA NOVA,735,647,250,1675,19,1425,24
PR,75310,CRUZEIRO DO SUL,1772,1386,541,3766,23,3225,44
PR,75329,ESPIGÃO ALTO DO IGUAÇU,1602,1215,1071,4020,41,2949,91
PR,75337,CRUZ MACHADO,4405,6320,2329,13488,146,11159,288
PR,75345,FERNANDES PINHEIRO,1949,1988,1046,5097,38,4051,76
PR,75353,CURITIBA,359869,629755,254327,1309149,24395,1054822,40803
PR,75361,FOZ DO JORDÃO,1944,735,1255,4028,34,2773,60
PR,75370,CURIÚVA,3392,4382,2959,11090,147,8131,210
PR,75388,GOIOXIM,2694,1126,1412,5350,37,3938,81
PR,75396,DIAMANTE DO NORTE,1768,1610,1182,4702,57,3520,85
PR,75400,DIAMANTE D'OESTE,1630,1174,725,3661,48,2936,84
PR,75418,DOIS VIZINHOS,13316,7827,5089,26869,248,21780,389
PR,75426,GUAMIRANGA,2882,2181,965,6244,111,5279,105
PR,75434,DOUTOR CAMARGO,1504,2385,755,4797,60,4042,93
PR,75442,IMBAÚ,3267,2450,1790,7759,112,5969,140
PR,75450,ENÉAS MARQUES,2557,1501,485,4698,64,4213,91
PR,75469,MANFRINÓPOLIS,1532,599,587,2774,9,2187,47
PR,75477,ENGENHEIRO BELTRÃO,3890,4439,2173,10819,140,8646,177
PR,75485,MARQUINHO,1560,1249,1089,3983,21,2894,64
PR,75493,FAXINAL,3565,5100,1806,10792,125,8986,196
PR,75507,PEROBAL,1700,1927,706,4504,74,3798,97
PR,75515,FÊNIX,1356,1577,874,3919,32,3045,80
PR,75523,PONTAL DO PARANÁ,4287,5676,4136,14580,213,10444,268
PR,75531,FLORAÍ,1660,1747,484,4072,81,3588,100
PR,75540,PORTO BARREIRO,1315,988,627,3002,24,2375,48
PR,75558,FLORESTA,1484,2356,524,4523,57,3999,102
PR,75566,PRADO FERREIRA,1455,845,366,2767,36,2401,65
PR,75574,FLORESTÓPOLIS,4289,3183,2184,9906,110,7722,140
PR,75582,QUARTO CENTENÁRIO,1666,1370,810,3946,39,3136,61
PR,75590,FLÓRIDA,1026,620,374,2116,29,1742,67
PR,75604,RESERVA DO IGUAÇU,2481,1141,1620,5365,38,3745,85
PR,75612,FORMOSA DO OESTE,1888,2852,906,5869,92,4963,131
PR,75620,RIO BRANCO DO IVAÍ,920,1166,990,3176,38,2186,62
PR,75639,FOZ DO IGUAÇU,66532,65969,45903,183796,2262,137893,3130
PR,75647,SERRANÓPOLIS DO IGUAÇU,1600,1616,518,3827,35,3309,58
PR,75655,FRANCISCO BELTRÃO,25698,18124,10631,55999,649,45368,897
PR,75663,TAMARANA,2450,3627,2089,8420,92,6331,162
PR,75671,GENERAL CARNEIRO,3595,3572,2560,10009,133,7449,149
PR,75698,GOIOERÊ,7649,8664,4820,21770,256,16950,381
PR,75710,GUAÍRA,8640,7618,4574,21459,273,16885,354
PR,75736,GUAIRAÇÁ,1591,1990,868,4608,48,3740,111
PR,75744,ROSÁRIO DO IVAÍ,1431,1912,1429,4931,41,3502,118
PR,75752,GUAPIRAMA,1024,1496,936,3569,43,2633,70
PR,75760,NOVA TEBAS,2467,1734,1141,5487,32,4346,113
PR,75779,GUAPOREMA,729,692,358,1830,18,1472,33
PR,75787,SULINA,1419,824,497,2812,24,2315,48
PR,75795,GUARACI,1357,1921,479,3874,51,3395,66
PR,75809,LUIZIANA,2485,1859,966,5498,55,4532,133
PR,75817,GUARANIAÇU,4180,4674,2181,11354,101,9173,218
PR,75833,GUARAPUAVA,46043,42980,24217,116861,1545,92644,2076
PR,75850,GUARAQUEÇABA,1903,2434,2107,6601,36,4494,121
PR,75876,GUARATUBA,6127,10734,6824,24370,281,17546,404
PR,75892,IBAITI,7135,9353,4946,22116,275,17170,407
PR,75914,IBIPORÃ,9263,18150,6847,35949,712,29102,977
PR,75930,ICARAÍMA,2284,2885,1435,6782,68,5347,110
PR,75957,IGUARAÇU,1136,1394,514,3149,53,2635,52
PR,75973,IMBITUVA,6425,9969,3117,20147,296,17030,340
PR,75990,INÁCIO MARTINS,3522,2698,1421,7852,66,6431,145
PR,76015,INAJÁ,1134,714,539,2459,24,1920,48
PR,76031,IPIRANGA,4274,3983,1775,10370,162,8595,176
PR,76058,IPORÃ,4072,4764,1836,11046,154,9210,220
PR,76074,IRATI,14478,18591,7484,42203,642,34719,1008
PR,76090,IRETAMA,3136,2716,1501,7633,83,6132,197
PR,76112,ITAGUAJÉ,1479,1290,792,3676,51,2884,64
PR,76139,ITAMBARACÁ,1797,2128,848,4942,58,4094,111
PR,76155,ITAMBÉ,1624,2095,803,4646,44,3843,80
PR,76171,ITAPEJARA D'OESTE,4347,2189,1340,8078,93,6738,109
PR,76198,ITAÚNA DO SUL,1350,822,856,3134,43,2278,63
PR,76210,IVAÍ,3023,4607,1022,8922,89,7900,181
PR,76236,IVAIPORÃ,7964,9557,4869,23030,239,18161,401
PR,76252,IVATUBA,840,861,738,2495,16,1757,40
PR,76279,JABOTI,1187,1670,666,3678,60,3012,95
PR,76295,JACAREZINHO,10079,12679,7260,30974,373,23714,583
PR,76317,JAGUAPITÃ,2924,4209,1981,9476,142,7495,220
PR,76333,JAGUARIAÍVA,6999,11523,5303,24490,277,19187,388
PR,76350,JANDAIA DO SUL,5282,7377,2736,16012,230,13276,387
PR,76376,JANIÓPOLIS,2313,1836,1590,5935,63,4345,133
PR,76392,JAPIRA,1538,1327,930,3922,44,2992,83
PR,76414,JAPURÁ,2153,3303,724,6430,106,5706,144
PR,76430,JARDIM ALEGRE,3197,3741,2185,9391,111,7206,157
PR,76457,JARDIM OLINDA,583,429,347,1386,9,1039,18
PR,76473,JATAIZINHO,2617,4364,1892,9210,130,7318,207
PR,76490,JOAQUIM TÁVORA,3067,3261,1327,7953,109,6626,189
PR,76511,JUNDIAÍ DO SUL,1080,822,449,2442,28,1993,63
PR,76538,JUSSARA,2090,2017,971,5250,82,4279,90
PR,76554,KALORÉ,1267,1764,509,3659,35,3150,84
PR,76570,LAPA,12981,14479,5864,34625,562,28761,739
PR,76597,LARANJEIRAS DO SUL,8880,7478,5874,22830,208,16956,390
PR,76619,LEÓPOLIS,1256,1347,742,3468,43,2726,80
PR,76635,LOANDA,5036,6492,3439,15421,189,11982,265
PR,76651,LOBATO,1731,1108,522,3474,44,2952,69
PR,76678,LONDRINA,65777,203132,66598,352517,5454,285919,11556
PR,76694,LUPIONÓPOLIS,1711,1161,748,3765,51,3017,94
PR,76716,MALLET,3973,4002,1833,10230,170,8397,252
PR,76732,MAMBORÊ,3332,5234,2323,11206,124,8883,193
PR,76759,MANDAGUAÇU,6051,5518,2814,15040,255,12226,402
PR,76775,MANDAGUARI,8905,10849,5067,25902,426,20835,655
PR,76791,MANDIRITUBA,7156,5404,2999,16185,327,13186,299
PR,76813,MANOEL RIBAS,2425,5274,2212,10173,90,7961,172
PR,76830,MARECHAL CÂNDIDO RONDON,13587,14227,5928,34894,480,28966,672
PR,76856,MARIA HELENA,1941,1568,593,4202,37,3609,63
PR,76872,MARIALVA,8169,11505,4638,25248,436,20610,500
PR,76899,MARILUZ,3540,2380,1850,8015,92,6165,153
PR,76910,MARINGÁ,72694,116774,49276,248364,3691,199088,5929
PR,76937,MARIÓPOLIS,2273,1702,765,4923,57,4158,126
PR,76953,MARMELEIRO,5131,2769,2141,10275,95,8134,139
PR,76970,MARUMBI,1186,1634,396,3341,43,2945,82
PR,76996,MATELÂNDIA,3614,5620,2562,12164,136,9602,232
PR,77011,MEDIANEIRA,12235,11355,6250,30799,369,24549,590
PR,77038,MIRADOR,873,573,462,1951,14,1489,29
PR,77054,MIRASELVA,751,756,245,1792,9,1547,31
PR,77070,MOREIRA SALES,3016,4087,1504,8854,86,7350,161
PR,77097,MORRETES,3871,6328,3608,14258,179,10650,272
PR,77119,MUNHOZ DE MELO,1206,1203,486,3004,42,2518,67
PR,77135,NOSSA SENHORA DAS GRAÇAS,1499,928,646,3194,52,2548,69
PR,77151,NOVA ALIANÇA DO IVAÍ,493,557,283,1363,12,1080,18
PR,77178,NOVA AMÉRICA DA COLINA,1160,1001,431,2694,47,2263,55
PR,77194,NOVA CANTU,2554,1855,2072,6636,39,4564,116
PR,77216,NOVA ESPERANÇA,7123,8465,4831,21110,278,16279,413
PR,77232,NOVA FÁTIMA,2120,2352,1557,6272,110,4715,133
PR,77259,NOVA LONDRINA,3440,3534,2819,10081,98,7262,190
PR,77275,ORTIGUEIRA,7567,4307,3703,16153,165,12450,411
PR,77291,OURIZONA,1429,918,357,2809,26,2452,79
PR,77313,PAIÇANDU,11170,7860,4612,24642,464,20030,536
PR,77330,PALMAS,10417,9535,6733,27322,280,20589,357
PR,77356,PALMEIRA,7661,12148,4307,24926,374,20619,436
PR,77372,PALMITAL,5070,3102,3935,12434,88,8499,239
PR,77399,PALOTINA,7374,9250,4417,21632,209,17215,382
PR,77410,PARAÍSO DO NORTE,3832,3090,964,8135,75,7171,174
PR,77437,PARANACITY,2944,2668,1722,7531,61,5809,136
PR,77453,PARANAGUÁ,27091,50440,17243,97973,1421,80730,1778
PR,77470,PARANAPOEMA,975,616,301,1950,23,1649,35
PR,77496,PARANAVAÍ,16323,28677,13166,60232,833,47066,1233
PR,77518,PATO BRANCO,21918,18362,10003,51758,569,41755,906
PR,77534,PAULA FREITAS,1487,1839,640,4103,73,3463,64
PR,77550,PAULO FRONTIN,2186,2110,874,5373,100,4499,103
PR,77577,PEABIRU,3845,3933,2426,10480,110,8054,166
PR,77593,PÉROLA D'OESTE,2332,1898,684,5068,52,4384,102
PR,77615,PIÊN,3179,3655,976,8087,115,7111,162
PR,77631,PINHALÃO,2123,2008,1207,5544,62,4337,144
PR,77658,PINHÃO,10491,5652,5829,22592,205,16763,415
PR,77674,PIRAÍ DO SUL,4954,9291,3740,18599,269,14859,345
PR,77690,PIRAQUARA,23029,17135,10563,52937,1107,42374,1103
PR,77712,PITANGA,9536,8806,7053,26023,210,18970,418
PR,77739,PLANALTINA DO PARANÁ,1454,1102,646,3318,62,2672,54
PR,77755,PLANALTO,5438,2773,2119,10546,95,8427,121
PR,77771,PONTA GROSSA,54280,118173,39011,219736,3383,180725,4889
PR,77798,PORECATU,4860,3445,2295,11002,184,8707,218
PR,77810,PORTO AMAZONAS,902,1820,656,3526,55,2870,93
PR,77836,PORTO RICO,942,772,375,2136,16,1761,31
PR,77852,PORTO VITÓRIA,1091,1348,617,3162,49,2545,57
PR,77879,PRESIDENTE CASTELO BRANCO,2060,997,762,3949,49,3187,81
PR,77895,PRIMEIRO DE MAIO,2522,3987,1040,7822,105,6782,168
PR,77917,PRUDENTÓPOLIS,10654,17834,5348,35129,435,29781,858
PR,77933,QUATIGUÁ,1852,3097,934,6070,79,5136,108
PR,77950,QUATRO BARRAS,4430,5487,1876,12345,239,10469,313
PR,77976,QUERÊNCIA DO NORTE,3681,2577,1992,8467,67,6475,150
PR,77992,QUINTA DO SOL,1885,1409,997,4444,62,3447,91
PR,78018,QUITANDINHA,4419,5351,1497,11753,239,10256,247
PR,78034,RANCHO ALEGRE,1054,1448,452,3068,50,2616,64
PR,78050,REALEZA,6100,3863,2327,12612,135,10285,187
PR,78077,REBOUÇAS,4042,5084,2294,11777,159,9483,198
PR,78093,RENASCENÇA,2503,1478,808,4944,48,4136,107
PR,78115,RESERVA,8200,6010,3640,18481,204,14841,427
PR,78131,RIBEIRÃO CLARO,2956,3855,1433,8690,158,7257,288
PR,78158,RIBEIRÃO DO PINHAL,4565,3381,3202,11427,90,8225,189
PR,78174,RIO AZUL,4321,4071,1587,10501,202,8914,320
PR,78190,RIO BOM,722,1373,394,2627,51,2233,87
PR,78212,RIO BRANCO DO SUL,10675,7724,3995,23179,364,19184,421
PR,78239,RIO NEGRO,5679,12176,4076,22653,299,18577,423
PR,78255,ROLÂNDIA,10764,23235,7763,43542,721,35779,1059
PR,78271,RONCADOR,3287,3249,1616,8438,82,6822,204
PR,78298,RONDON,2435,3248,1189,7059,67,5870,120
PR,78310,SABÁUDIA,1450,2400,652,4704,109,4052,93
PR,78336,SALGADO FILHO,1709,1014,779,3613,63,2834,48
PR,78352,SALTO DO ITARARÉ,1648,1352,705,3873,53,3168,115
PR,78379,SALTO DO LONTRA,5144,2276,2230,9905,94,7675,161
PR,78395,SANTA AMÉLIA,989,1357,513,2959,35,2446,65
PR,78417,SANTA CECÍLIA DO PAVÃO,832,1389,489,2813,44,2324,59
PR,78433,SANTA CRUZ DE MONTE CASTELO,2663,2288,1196,6346,71,5150,128
PR,78450,SANTA FÉ,2970,2978,1009,7190,107,6181,126
PR,78476,SANTA INÊS,596,732,381,1749,12,1368,28
PR,78492,SANTA ISABEL DO IVAÍ,2140,3152,1465,6972,64,5507,151
PR,78514,SANTA IZABEL DO OESTE,3970,2342,1471,7994,78,6523,133
PR,78530,SANTA MARIANA,3713,3751,2468,10342,168,7874,242
PR,78557,SANTANA DO ITARARÉ,1903,1378,963,4396,68,3433,84
PR,78573,SANTO ANTÔNIO DO SUDOESTE,6397,4201,2444,13335,109,10891,184
PR,78590,SANTO ANTÔNIO DA PLATINA,8311,15427,5452,30289,514,24837,585
PR,78611,SANTO ANTONIO DO CAIUÁ,1006,803,492,2374,24,1882,49
PR,78638,SANTO ANTÔNIO DO PARAÍSO,726,896,505,2187,28,1682,32
PR,78654,SANTO INÁCIO,1765,1548,745,4191,52,3446,81
PR,78670,SÃO CARLOS DO IVAÍ,1476,2318,909,4826,57,3917,66
PR,78697,SÃO JERÔNIMO DA SERRA,3508,2635,2521,8937,66,6416,207
PR,78719,SÃO JOÃO,3662,2576,1036,7511,77,6475,160
PR,78735,SÃO JOÃO DO CAIUÁ,2031,1473,1243,4910,53,3667,110
PR,78751,SÃO JOÃO DO IVAÍ,3449,3607,1551,8908,106,7357,195
PR,78778,SÃO JOÃO DO TRIUNFO,4840,3533,1702,10448,187,8746,186
PR,78794,SÃO JORGE DO IVAÍ,1583,1989,573,4279,35,3706,99
PR,78816,SÃO JORGE D'OESTE,3377,2282,892,6772,98,5880,123
PR,78832,SÃO JOSÉ DA BOA VISTA,1264,2278,997,4683,40,3686,104
PR,78859,SÃO JOSÉ DOS PINHAIS,61542,64887,28731,162877,3441,134146,4276
PR,78875,SÃO MATEUS DO SUL,11923,12218,4720,29939,412,25219,666
PR,78891,SÃO MIGUEL DO IGUAÇU,8730,6731,4834,20833,203,15999,335
PR,78913,SÃO PEDRO DO IVAÍ,3031,2645,1246,7146,72,5900,152
PR,78930,SÃO PEDRO DO PARANÁ,740,1004,336,2146,25,1810,41
PR,78956,SÃO SEBASTIÃO DA AMOREIRA,2775,2359,1542,6916,87,5374,153
PR,78972,SÃO TOMÉ,1319,2038,499,3971,40,3472,75
PR,78999,SAPOPEMA,2154,1565,1250,5159,63,3909,127
PR,79014,SENGÉS,4475,6140,3572,14676,160,11104,329
PR,79030,SERTANEJA,1448,2335,1050,4988,60,3938,95
PR,79057,SERTANÓPOLIS,3569,6289,2721,13055,217,10334,259
PR,79073,SIQUEIRA CAMPOS,5489,5684,3048,14780,210,11732,349
PR,79090,TAMBOARA,1179,1752,434,3513,45,3079,103
PR,79111,TAPEJARA,4959,3632,2079,11017,149,8938,198
PR,79138,TEIXEIRA SOARES,2825,2796,1495,7342,89,5847,137
PR,79154,TELÊMACO BORBA,17421,19656,10551,49254,781,38703,845
PR,79170,TERRA BOA,3811,5713,2213,12162,193,9949,232
PR,79197,TERRA RICA,3989,4696,2200,11271,146,9071,240
PR,79219,TERRA ROXA,4366,5292,1752,11790,141,10038,239
PR,79235,TIBAGI,4668,5822,3331,14191,134,10860,236
PR,79251,TIJUCAS DO SUL,3964,3769,2130,10193,160,8063,170
PR,79278,TOLEDO,32492,34919,15671,85789,1066,70118,1641
PR,79294,TOMAZINA,2059,2909,1346,6563,83,5217,166
PR,79316,TUNEIRAS DO OESTE,2520,2426,1009,6137,73,5128,109
PR,79332,UBIRATÃ,5923,6750,2265,15356,169,13091,249
PR,79359,UMUARAMA,25265,29512,16932,74163,1083,57231,1371
PR,79375,UNIÃO DA VITÓRIA,10683,19566,8707,40158,496,31451,706
PR,79391,UNIFLOR,889,682,197,1818,17,1621,33
PR,79413,URAÍ,3057,3490,1140,7980,111,6840,182
PR,79430,WENCESLAU BRAZ,3457,7496,3081,14497,167,11416,296
PR,79456,VERÊ,3559,2001,705,6416,60,5711,91
PR,79472,VITORINO,1898,1809,922,4740,39,3818,72
PR,79499,XAMBRÊ,2238,1628,840,4859,51,4019,102
PR,79510,ALTÔNIA,5168,6200,1956,13828,221,11872,283
PR,79537,ASSIS CHATEAUBRIAND,8377,10871,3573,23665,309,20092,535
PR,79553,QUEDAS DO IGUAÇU,8866,7239,6547,23232,203,16685,377
PR,79570,CÉU AZUL,2697,3832,1592,8383,104,6791,158
PR,79596,GRANDES RIOS,1397,2338,1551,5460,49,3909,125
PR,79618,INDIANÓPOLIS,1135,1522,543,3308,49,2765,59
PR,79634,MATINHOS,6970,8627,6738,22990,299,16252,356
PR,79650,NOVA AURORA,3548,4097,1819,9758,107,7939,187
PR,79677,NOVA OLÍMPIA,1939,1451,613,4144,58,3531,83
PR,79693,PÉROLA,3279,2584,948,7062,116,6114,135
PR,79715,SANTA HELENA,8924,5744,3305,18529,220,15224,336
PR,79731,TAPIRA,1639,1883,640,4305,56,3665,87
PR,79758,MARILENA,2564,1470,1408,5600,58,4192,100
PR,79774,FRANCISCO ALVES,1899,1922,679,4658,72,3979,86
PR,79790,NOVA SANTA ROSA,1624,3366,927,6071,69,5144,85
PR,79812,BOA VISTA DA APARECIDA,2816,1760,1644,6403,74,4759,109
PR,79839,BRAGANEY,2082,1432,603,4233,40,3630,76
PR,79855,CAFELÂNDIA,3982,3963,1679,9876,94,8197,158
PR,79871,TRÊS BARRAS DO PARANÁ,3313,3474,1178,8214,89,7036,160
PR,79898,VERA CRUZ DO OESTE,2145,3027,1378,6728,55,5350,123
PR,79910,PRANCHITA,2101,1636,740,4594,48,3854,69
PR,79936,TUPÃSSI,2062,2985,848,6120,89,5272,136
PR,79952,NOVA PRATA DO IGUAÇU,3800,2220,1110,7283,65,6173,88
PR,79979,JESUÍTAS,2365,3085,796,6538,96,5742,196
PR,79995,SÃO JORGE DO PATROCÍNIO,2074,1687,594,4471,48,3877,68
PR,84514,CANTAGALO,3905,2587,2960,9660,73,6700,135
PR,84530,TURVO,5093,3166,2306,10867,111,8561,191
PR,84557,ALTAMIRA DO PARANÁ,1420,1228,1552,4288,16,2736,72
PR,84573,FIGUEIRA,2743,2105,1615,6675,66,5060,146
PR,84590,LUNARDELLI,1239,1930,662,3983,48,3321,104
PR,84611,SARANDI,25226,17700,11296,56260,1010,44964,1028
PR,84638,JURANDA,1836,2761,874,5622,69,4748,82
PR,84654,DOURADINA,2151,2178,659,5136,42,4477,106
PR,84670,SANTA TEREZINHA DE ITAIPU,5316,6600,3445,15807,167,12362,279
PR,84697,MISSAL,3981,2734,934,7836,81,6902,106
PR,84719,SÃO JOSÉ DAS PALMEIRAS,1528,943,403,2954,32,2551,48
RJ,58009,QUISSAMÃ,5897,5080,2696,14464,316,11768,475
RJ,58017,ANGRA DOS REIS,46400,35162,24752,112569,2575,87817,3680
RJ,58025,QUATIS,4529,2725,1637,9384,163,7747,330
RJ,58033,ARARUAMA,24381,31912,20726,82432,1956,61706,3457
RJ,58041,BELFORD ROXO,166042,51941,61612,302637,8672,241025,14370
RJ,58050,BARRA DO PIRAÍ,31029,20833,13350,69781,1680,56431,2889
RJ,58068,CARDOSO MOREIRA,3951,3525,2744,10711,169,7967,322
RJ,58076,BARRA MANSA,58817,38618,21765,127731,3180,105966,5351
RJ,58084,VARRE-SAI,2213,3212,1375,7141,101,5766,240
RJ,58092,BOM JARDIM,6578,8104,4513,20704,476,16191,1033
RJ,58106,GUAPIMIRIM,15983,8443,8411,34820,751,26409,1232
RJ,58114,BOM JESUS DO ITABAPOANA,8759,11270,6211,27536,427,21325,869
RJ,58122,QUEIMADOS,51248,17348,18827,94116,2766,75289,3927
RJ,58130,CABO FRIO,37615,49667,31379,126954,3240,95575,5053
RJ,58149,JAPERI,34515,12090,13867,64222,1544,50355,2206
RJ,58157,CACHOEIRAS DE MACACU,17339,11750,9415,41278,1035,31863,1739
RJ,58165,COMENDADOR LEVY GASPARIAN,3620,1548,932,6478,135,5546,243
RJ,58173,CAMBUCI,3820,4085,2258,10757,194,8499,400
RJ,58181,APERIBÉ,2708,3217,1432,7829,189,6397,283
RJ,58190,CAMPOS DOS GOYTACAZES,110731,124141,76279,334487,8581,258208,14755
RJ,58203,RIO DAS OSTRAS,22113,19463,16620,62636,1661,46016,2779
RJ,58211,CANTAGALO,4856,6885,3631,16335,289,12704,674
RJ,58220,AREAL,2575,4285,1400,8741,180,7341,301
RJ,58238,CARMO,6251,3896,2137,13015,227,10878,504
RJ,58246,PINHEIRAL,8044,3765,2647,15286,287,12639,543
RJ,58254,CASIMIRO DE ABREU,8130,9314,5833,24831,543,18998,1011
RJ,58262,IGUABA GRANDE,5919,6645,4559,18224,408,13665,693
RJ,58270,CONCEIÇÃO DE MACABU,5541,5774,3955,16136,309,12181,557
RJ,58289,SÃO FRANCISCO DE ITABAPOANA,8242,13693,11153,34488,575,23335,825
RJ,58297,CORDEIRO,5111,5996,3557,15850,381,12293,805
RJ,58300,CARAPEBUS,4402,2750,1919,9631,244,7712,316
RJ,58319,DUAS BARRAS,3055,3311,1600,8485,162,6885,357
RJ,58327,PORTO REAL,5901,3978,2048,12742,318,10694,497
RJ,58335,DUQUE DE CAXIAS,314471,114676,113693,590214,16606,476521,30768
RJ,58343,SÃO JOSÉ DE UBÁ,2694,2307,1091,6299,49,5208,158
RJ,58351,ENGENHEIRO PAULO DE FRONTIN,3453,3615,1099,8837,226,7738,444
RJ,58360,TANGUÁ,11235,4523,4428,21386,515,16958,685
RJ,58378,ITABORAÍ,77459,30701,29979,149470,4660,119491,6671
RJ,58386,MACUCO,2536,1942,913,5747,109,4834,247
RJ,58394,ITAGUAÍ,35816,21471,16491,79122,2447,62631,2897
RJ,58408,ARMAÇÃO DOS BÚZIOS,6682,8122,3249,19230,463,15981,714
RJ,58416,ITAOCARA,4833,8644,3933,18527,396,14594,721
RJ,58424,SEROPÉDICA,24256,11768,9955,49544,1391,39589,2174
RJ,58432,ITAPERUNA,22317,29458,18131,73504,1433,55373,2165
RJ,58440,ITATIAIA,9218,6805,4415,21492,411,17077,643
RJ,58459,LAJE DO MURIAÉ,2381,2283,1854,6810,100,4956,192
RJ,58467,MESQUITA,63015,28569,24609,127523,3776,102914,7554
RJ,58475,MACAÉ,55952,34195,33945,133675,3725,99730,5858
RJ,58491,MAGÉ,82974,33167,33266,161109,4752,127843,6950
RJ,58513,MANGARATIBA,11127,7615,5164,25782,685,20618,1191
RJ,58530,MARICÁ,31126,22709,17842,77312,1878,59470,3757
RJ,58556,MENDES,5425,5280,2603,14359,383,11756,668
RJ,58572,MIGUEL PEREIRA,7018,8385,4306,21031,388,16725,934
RJ,58599,MIRACEMA,8000,6752,5921,21914,451,15993,790
RJ,58610,NATIVIDADE,3742,4464,2016,10920,196,8904,502
RJ,58637,NILÓPOLIS,62968,28314,18763,122048,3966,103285,8037
RJ,58653,NITERÓI,140931,126789,67827,371183,9274,303356,26362
RJ,58670,NOVA FRIBURGO,41460,60498,30292,145145,4304,114853,8591
RJ,58696,NOVA IGUAÇU,253028,134036,111694,545670,16639,433976,30273
RJ,58718,PARACAMBI,12927,10730,5107,31251,908,26144,1579
RJ,58734,PARAÍBA DO SUL,9846,13608,6892,32509,761,25617,1402
RJ,58750,PARATY,6719,10877,5412,24197,482,18785,707
RJ,58777,PETRÓPOLIS,69082,99308,49226,238098,6735,188872,13747
RJ,58793,PIRAÍ,9321,5387,3063,18840,382,15777,687
RJ,58815,PORCIÚNCULA,4992,4415,3636,13719,237,10083,439
RJ,58831,RESENDE,29516,31172,18054,83704,1951,65650,3011
RJ,58858,RIO BONITO,15001,15454,9158,42873,1222,33715,2038
RJ,58874,RIO CLARO,7054,3338,3146,14249,247,11103,464
RJ,58890,RIO DAS FLORES,2845,2501,1294,6991,104,5697,247
RJ,58912,SANTA MARIA MADALENA,2687,3057,1880,8104,136,6224,344
RJ,58939,SANTO ANTÔNIO DE PÁDUA,9624,12590,7734,31667,629,23933,1090
RJ,58955,SÃO FIDÉLIS,6281,13877,8289,29706,467,21417,792
RJ,58971,SÃO GONÇALO,320701,136315,131069,652786,20767,521717,43934
RJ,58998,SÃO JOÃO DA BARRA,8781,12045,5337,27652,600,22315,889
RJ,59013,SÃO JOÃO DE MERITI,181795,66593,71009,351287,10526,280278,21364
RJ,59030,SÃO PEDRO DA ALDEIA,17862,18858,13062,53737,1669,40675,2286
RJ,59056,SÃO SEBASTIÃO DO ALTO,2379,2655,2022,7469,114,5447,299
RJ,59072,SAPUCAIA,6536,4837,3268,15497,282,12229,574
RJ,59099,SAQUAREMA,19339,17900,15613,56167,1040,40554,2275
RJ,59110,SILVA JARDIM,5828,5210,4117,15996,329,11879,512
RJ,59137,SUMIDOURO,4210,5454,2800,13100,257,10300,379
RJ,59153,TERESÓPOLIS,27208,60264,24125,118944,2419,94819,4928
RJ,59170,TRAJANO DE MORAIS,3576,2324,1878,8342,176,6464,388
RJ,59196,TRÊS RIOS,27094,16145,10935,58150,1600,47215,2376
RJ,59218,VALENÇA,25239,15935,12158,56866,1145,44708,2389
RJ,59234,VASSOURAS,9660,10637,6438,28221,521,21783,965
RJ,59250,VOLTA REDONDA,97277,60285,38547,212395,5804,173848,10482
RJ,59277,ARRAIAL DO CABO,7169,8943,6243,23823,494,17580,974
RJ,59293,ITALVA,3626,3908,2094,10174,209,8080,337
RJ,59315,PATY DO ALFERES,7846,6952,4922,20832,384,15910,728
RJ,59331,SÃO JOSÉ DO VALE DO RIO PRETO,3087,7985,3163,14956,268,11793,453
RJ,60011,RIO DE JANEIRO,1958537,1252818,1001848,4671849,127675,3670001,330971
RN,16004,TENENTE LAURENTINO CRUZ,2404,802,911,4329,69,3418,143
RN,16012,ACARI,3959,2650,2260,9387,179,7127,339
RN,16020,SERRA DO MEL,4148,1962,2125,8536,96,6411,205
RN,16039,ASSÚ,22159,6600,8569,38860,561,30291,971
RN,16047,CAIÇARA DO NORTE,1783,1546,1288,4763,38,3475,108
RN,16055,AFONSO BEZERRA,4131,1746,2921,9118,105,6197,215
RN,16063,SÃO MIGUEL DO GOSTOSO,3257,1487,1608,6611,74,5003,185
RN,16071,ÁGUA NOVA,1579,125,541,2329,16,1788,68
RN,16080,ITAJÁ,3624,1067,1617,6546,48,4929,190
RN,16098,ALEXANDRIA,6032,1213,1661,9308,94,7647,308
RN,16101,BODÓ,1399,604,618,2728,35,2110,72
RN,16110,ALMINO AFONSO,2722,679,1186,4784,59,3598,138
RN,16128,TRIUNFO POTIGUAR,1613,934,974,3670,43,2696,106
RN,16136,ALTO DO RODRIGUES,5798,1722,1543,9412,129,7869,220
RN,16144,FERNANDO PEDROZA,1056,927,961,3053,33,2092,76
RN,16152,ANGICOS,3976,2488,2376,9334,207,6958,287
RN,16160,MAJOR SALES,1852,236,482,2673,24,2191,79
RN,16179,ANTÔNIO MARTINS,3259,858,969,5368,96,4399,186
RN,16187,VENHA-VER,1486,600,1143,3386,33,2243,124
RN,16195,APODI,16511,3864,5501,27125,480,21624,769
RN,16209,SERRINHA DOS PINTOS,1966,796,818,3780,75,2962,125
RN,16217,AREIA BRANCA,8347,5928,3095,18570,438,15475,762
RN,16225,TIBAU,1870,732,842,3614,66,2772,104
RN,16233,ARÊS,4466,3010,1465,9559,243,8094,375
RN,16241,SANTA MARIA,1814,1215,1115,4290,44,3175,102
RN,16250,CAMPO GRANDE,4143,1399,2183,8025,104,5842,196
RN,16268,RIO DO FOGO,2630,3386,3410,9686,93,6276,167
RN,16276,BAÍA FORMOSA,2533,2080,2053,6891,90,4838,135
RN,16284,PORTO DO MANGUE,2161,996,1056,4388,65,3332,110
RN,16292,BARCELONA,1263,1574,830,3817,44,2987,106
RN,16306,JUNDIÁ,1405,833,669,3090,60,2421,123
RN,16314,BENTO FERNANDES,2091,960,1070,4299,49,3229,129
RN,16330,BOM JESUS,2819,2396,2134,7633,77,5499,207
RN,16357,BREJINHO,3075,3338,2226,9089,158,6863,292
RN,16373,CAIÇARA DO RIO DO VENTO,1159,1160,746,3179,41,2433,73
RN,16390,CAICÓ,23175,9272,8935,43800,1001,34865,1417
RN,16411,CAMPO REDONDO,4301,1236,1350,7284,118,5934,279
RN,16438,CANGUARETAMA,10826,4916,5950,22588,358,16638,538
RN,16454,CARAÚBAS,10254,2230,2133,15450,314,13317,519
RN,16470,CARNAÚBA DOS DANTAS,2294,2039,950,5657,166,4707,208
RN,16497,CARNAUBAIS,3966,1939,2010,8229,110,6219,204
RN,16519,CEARÁ-MIRIM,22430,12523,10834,48092,971,37258,1334
RN,16535,CERRO CORÁ,3418,2281,2218,8264,75,6046,272
RN,16551,CORONEL EZEQUIEL,2199,903,729,4040,59,3311,150
RN,16578,CORONEL JOÃO PESSOA,2099,472,756,3519,26,2763,166
RN,16594,CRUZETA,3334,1701,1483,6815,127,5332,170
RN,16616,CURRAIS NOVOS,13138,9629,8036,32545,635,24509,1107
RN,16632,DOUTOR SEVERIANO,3105,619,1036,5014,54,3978,200
RN,16659,ENCANTO,2824,328,615,3950,45,3335,138
RN,16675,EQUADOR,2272,971,1127,4644,97,3517,177
RN,16691,ESPÍRITO SANTO,2252,2387,2044,6980,106,4936,191
RN,16713,EXTREMOZ,6180,5400,1626,13850,232,12224,412
RN,16730,FELIPE GUERRA,3841,760,947,5800,120,4853,132
RN,16756,FLORÂNIA,3654,1959,1422,7344,111,5922,198
RN,16772,FRANCISCO DANTAS,1517,454,517,2613,27,2096,98
RN,16799,GALINHOS,617,758,687,2132,18,1445,52
RN,16810,GOIANINHA,5972,7283,2641,16792,343,14151,553
RN,16837,GOVERNADOR DIX-SEPT ROSADO,5987,2058,2447,11093,239,8646,362
RN,16853,GROSSOS,3707,1865,1318,7382,299,6064,193
RN,16870,GUAMARÉ,5562,2385,1899,10267,152,8368,269
RN,16896,IELMO MARINHO,3874,2872,3119,10237,134,7118,238
RN,16918,IPANGUAÇU,6924,1753,2243,11324,124,9081,280
RN,16934,IPUEIRA,1001,360,334,1798,49,1464,54
RN,16950,ITAÚ,2978,448,1200,4821,70,3621,125
RN,16977,JAÇANÃ,2138,2396,1403,6228,74,4825,217
RN,16993,JANDAÍRA,2460,1350,1536,5522,49,3986,127
RN,17019,JANDUÍS,2411,762,846,4208,80,3362,109
RN,17035,BOA SAÚDE,2367,2591,2092,7359,92,5267,217
RN,17051,JAPI,2149,1577,1082,5002,49,3920,145
RN,17078,JARDIM DE ANGICOS,1174,591,617,2477,27,1860,68
RN,17094,JARDIM DE PIRANHAS,5717,1678,2617,10425,153,7808,260
RN,17116,JARDIM DO SERIDÓ,4572,2935,1973,10242,288,8269,474
RN,17132,JOÃO CÂMARA,10722,5615,6640,23972,398,17332,597
RN,17159,JOÃO DIAS,1416,322,447,2305,19,1858,101
RN,17175,JOSÉ DA PENHA,3385,314,923,4835,45,3912,168
RN,17191,JUCURUTU,6833,3660,4002,15170,256,11168,419
RN,17213,MESSIAS TARGINO,2190,587,865,3818,80,2953,96
RN,17230,LAGOA D'ANTA,2249,1230,909,4608,57,3699,163
RN,17256,LAGOA DE PEDRAS,2465,1738,1442,5915,99,4473,171
RN,17272,LAGOA DE VELHOS,1217,934,664,2926,27,2262,84
RN,17299,LAGOA NOVA,4415,3274,3001,11169,193,8168,286
RN,17310,LAGOA SALGADA,3506,2222,1579,7746,156,6167,283
RN,17337,LAJES,3848,2153,2207,8584,127,6377,249
RN,17353,LAJES PINTADAS,2330,906,852,4315,66,3463,161
RN,17370,LUCRÉCIA,2048,288,549,3002,42,2453,75
RN,17396,LUÍS GOMES,4537,792,2499,8145,69,5646,248
RN,17418,MACAÍBA,17168,16458,9000,44894,874,35894,1394
RN,17434,MACAU,10235,4834,2761,18697,365,15936,502
RN,17450,MARCELINO VIEIRA,3955,547,1419,6199,74,4780,204
RN,17477,MARTINS,2866,1854,1512,6518,91,5006,195
RN,17493,MAXARANGUAPE,2904,2824,2053,8042,92,5989,169
RN,17515,FRUTUOSO GOMES,2315,440,1208,4105,45,2897,97
RN,17531,MONTANHAS,4471,1324,2762,8956,141,6194,258
RN,17558,MONTE ALEGRE,4796,6076,3516,15057,242,11541,427
RN,17574,MONTE DAS GAMELEIRAS,1292,515,820,2735,26,1915,82
RN,17590,MOSSORÓ,73046,46701,29469,158925,3762,129456,5947
RN,17612,NATAL,188558,202019,101153,523964,10441,422811,21793
RN,17639,NÍSIA FLORESTA,6620,5023,1589,14041,364,12452,445
RN,17655,NOVA CRUZ,9607,8223,9095,28214,476,19119,813
RN,17671,OLHO D'ÁGUA DO BORGES,2343,455,1161,4123,62,2962,102
RN,17698,OURO BRANCO,1925,1050,559,3769,88,3210,147
RN,17710,PARANÁ,2134,225,754,3245,22,2491,110
RN,17736,PARAÚ,2012,602,960,3761,70,2801,117
RN,17752,PARAZINHO,1918,892,1165,4110,39,2945,96
RN,17779,PARELHAS,6058,5731,3365,16268,470,12903,644
RN,17795,PARNAMIRIM,31042,42380,17405,96334,2028,78929,3479
RN,17817,PASSA E FICA,2332,2922,2066,7670,86,5604,264
RN,17833,PASSAGEM,1466,975,772,3346,46,2574,87
RN,17850,PATU,4496,1668,1835,8452,153,6617,300
RN,17876,PAU DOS FERROS,10908,3174,4326,19156,279,14830,469
RN,17892,PEDRA GRANDE,1366,982,1310,3796,38,2486,100
RN,17914,PEDRA PRETA,1170,692,721,2682,30,1961,69
RN,17930,PEDRO AVELINO,1886,1867,1417,5365,61,3948,134
RN,17957,PEDRO VELHO,5762,2033,3629,11962,210,8333,328
RN,17973,PENDÊNCIAS,5384,1905,3009,10633,118,7624,217
RN,17990,PILÕES,2105,216,498,2928,33,2430,76
RN,18015,POÇO BRANCO,4542,2662,2193,9837,171,7644,269
RN,18031,PORTALEGRE,2863,1371,1239,5801,102,4562,226
RN,18058,SERRA CAIADA,3189,1817,1787,7083,81,5296,209
RN,18074,PUREZA,3295,1430,1866,6865,108,4999,166
RN,18090,RAFAEL FERNANDES,2767,414,781,4141,55,3360,124
RN,18112,RIACHO DA CRUZ,1257,636,484,2503,31,2019,95
RN,18139,RIACHO DE SANTANA,2122,278,968,3497,32,2529,97
RN,18155,RIACHUELO,2552,1546,1209,5511,62,4302,142
RN,18171,RODOLFO FERNANDES,2303,762,894,4137,43,3243,135
RN,18198,RUY BARBOSA,963,1288,1084,3461,25,2377,101
RN,18210,SÃO FRANCISCO DO OESTE,1775,829,596,3352,45,2756,107
RN,18236,SANTA CRUZ,9696,8436,5541,24840,434,19299,733
RN,18252,SANTANA DO SERIDÓ,1116,537,368,2186,64,1818,101
RN,18279,SANTANA DO MATOS,4876,2868,3541,11757,156,8216,316
RN,18295,SANTO ANTÔNIO,9383,2498,4808,17606,326,12798,591
RN,18317,SÃO BENTO DO NORTE,1413,652,870,3030,21,2160,74
RN,18333,SÃO BENTO DO TRAIRÍ,1260,1343,737,3492,45,2755,107
RN,18350,SÃO FERNANDO,1754,751,280,2926,51,2646,90
RN,18376,SÃO GONÇALO DO AMARANTE,21557,22266,13440,60072,1088,46632,1721
RN,18392,SÃO JOÃO DO SABUGI,3261,681,891,5091,110,4200,148
RN,18414,SÃO JOSÉ DE MIPIBU,11623,8115,2513,23628,483,21115,894
RN,18430,SÃO JOSÉ DO CAMPESTRE,4198,2694,2699,10135,224,7436,320
RN,18457,SÃO JOSÉ DO SERIDÓ,1819,1072,568,3745,118,3177,168
RN,18473,SÃO MIGUEL,9222,2362,5493,18038,284,12545,677
RN,18490,SÃO PAULO DO POTENGI,4707,4586,3375,13274,203,9899,403
RN,18511,SÃO PEDRO,2381,1913,1169,5714,82,4545,169
RN,18538,SÃO RAFAEL,3443,1465,1790,7019,103,5229,218
RN,18554,SÃO TOMÉ,4340,1854,1773,8314,81,6541,266
RN,18570,SÃO VICENTE,2270,1228,1107,4872,76,3765,191
RN,18597,SENADOR ELÓI DE SOUZA,2097,1289,1366,4936,49,3570,135
RN,18619,SENADOR GEORGINO AVELINO,1186,1296,822,3481,74,2659,103
RN,18635,SERRA DE SÃO BENTO,1586,1779,1246,4882,87,3636,184
RN,18651,SERRA NEGRA DO NORTE,2999,1231,1705,6201,99,4496,167
RN,18678,SERRINHA,3195,1175,1625,6311,96,4686,220
RN,18694,SEVERIANO MELO,3627,984,2289,7160,71,4871,189
RN,18716,SÍTIO NOVO,2197,861,1057,4270,55,3213,100
RN,18732,TABOLEIRO GRANDE,1027,522,395,2032,21,1637,67
RN,18759,TAIPU,3786,2924,2031,9185,156,7154,288
RN,18775,TANGARÁ,4264,3707,2964,11422,156,8458,331
RN,18791,TENENTE ANANIAS,4184,1107,1674,7278,37,5604,276
RN,18813,TIBAU DO SUL,3217,2987,1903,8538,183,6635,248
RN,18830,TIMBAÚBA DOS BATISTAS,974,593,393,2089,57,1696,72
RN,18856,TOUROS,8494,6404,5630,21414,320,15784,566
RN,18872,UMARIZAL,5084,1282,2281,9050,135,6769,268
RN,18899,UPANEMA,5132,2049,2218,9933,201,7715,333
RN,18910,VÁRZEA,1880,1442,1081,4600,65,3519,132
RN,18937,RAFAEL GODEIRO,1641,518,770,3077,57,2307,91
RN,18953,VERA CRUZ,3102,3468,1257,8281,165,7024,289
RN,18970,VIÇOSA,798,269,355,1500,21,1145,57
RN,18996,VILA FLOR,1153,584,389,2241,46,1852,69
RN,30031,BARAÚNA,7722,4665,2768,15892,266,13124,471
RO,19,GUAJARÁ-MIRIM,10134,7963,7762,27365,217,19603,1289
RO,35,PORTO VELHO,114498,87387,53963,275972,4178,222009,15946
RO,51,JI-PARANÁ,22679,31353,21759,80702,1029,58943,3882
RO,78,ARIQUEMES,16226,24651,16089,60485,797,44396,2722
RO,94,CACOAL,14986,23190,14734,56328,700,41594,2718
RO,116,PIMENTA BUENO,6717,9611,7027,25057,316,18030,1386
RO,132,VILHENA,13392,19333,12781,48649,729,35868,2414
RO,159,JARU,9894,15556,12139,39872,398,27733,1885
RO,175,OURO PRETO DO OESTE,8052,11243,9393,30447,274,21054,1485
RO,191,PRESIDENTE MÉDICI,5194,5634,5595,17543,241,11948,879
RO,213,COSTA MARQUES,3028,2275,2603,8365,60,5762,399
RO,230,COLORADO DO OESTE,4661,4746,2527,12892,211,10365,747
RO,256,ESPIGÃO DO OESTE,6102,8141,5332,20849,268,15517,1006
RO,272,CEREJEIRAS,2956,5985,3967,13683,130,9716,645
RO,299,ROLIM DE MOURA,10906,13372,9377,35901,443,26524,1803
RO,310,ALTA FLORESTA DO OESTE,6262,6385,5696,19456,190,13760,923
RO,337,ALVORADA DO OESTE,4016,4277,3734,12841,116,9107,698
RO,353,SANTA LUZIA DO OESTE,2373,2633,2219,7688,87,5469,376
RO,370,NOVA BRASILÂNDIA DO OESTE,4033,5900,3638,14463,122,10825,770
RO,396,MACHADINHO DO OESTE,6130,7363,6983,21702,168,14719,1058
RO,418,SÃO MIGUEL DO GUAPORÉ,4622,5228,3584,14331,134,10747,763
RO,434,NOVA MAMORÉ,3612,5642,3930,14174,116,10244,874
RO,450,CABIXI,1698,1757,1468,5268,67,3800,278
RO,477,CANDEIAS DO JAMARI,5697,3234,3282,13250,150,9968,887
RO,493,ITAPUÃ DO OESTE,2162,1512,1593,5607,43,4014,297
RO,515,NOVO HORIZONTE DO OESTE,2979,2256,2108,7811,75,5703,393
RO,531,CASTANHEIRAS,1327,965,980,3458,22,2478,164
RO,558,VALE DO PARAÍSO,1963,2342,2004,6675,46,4671,320
RO,566,URUPÁ,2675,3761,2739,9827,108,7088,544
RO,574,MIRANTE DA SERRA,2816,3396,2754,9554,87,6800,501
RO,582,SERINGUEIRAS,3059,2821,2364,8821,85,6457,492
RO,590,THEOBROMA,2196,3139,2457,8261,54,5804,415
RO,604,MINISTRO ANDREAZZA,2222,2540,1941,7072,56,5131,313
RO,612,GOVERNADOR JORGE TEIXEIRA,2131,3218,2027,7852,58,5825,418
RO,620,CACAULÂNDIA,1241,1603,922,4031,54,3109,211
RO,639,ALTO PARAÍSO,3726,3850,3044,11344,115,8300,609
RO,647,RIO CRESPO,722,1105,808,2808,26,2000,147
RO,655,CORUMBIARA,1904,1964,1578,5802,65,4224,291
RO,663,MONTE NEGRO,2708,4007,3466,10873,107,7407,585
RO,671,CAMPO NOVO DE RONDÔNIA,2135,2615,2359,7549,58,5190,382
RO,680,CUJUBIM,2173,3662,2528,8902,97,6374,442
RO,698,VALE DO ANARI,1720,2402,1826,6310,56,4484,306
RO,701,PARECIS,1059,972,662,2848,21,2186,134
RO,710,SÃO FELIPE DO OESTE,1422,2144,1355,5210,52,3855,237
RO,728,PRIMAVERA DE RONDÔNIA,938,1213,952,3299,34,2347,162
RO,736,ALTO ALEGRE DOS PARECIS,2446,3152,2128,8311,78,6183,507
RO,744,NOVA UNIÃO,1956,1853,1328,5465,53,4137,275
RO,752,TEIXEIRÓPOLIS,1125,1682,1207,4228,41,3021,173
RO,779,BURITIS,5589,8710,6154,21707,204,15553,1050
RO,787,PIMENTEIRAS DO OESTE,543,663,791,2094,14,1303,83
RO,795,SÃO FRANCISCO DO GUAPORÉ,2922,3694,3028,10264,98,7236,522
RO,809,CHUPINGUAIA,1411,1635,1765,5136,49,3371,276
RR,3000,CAROEBE,1935,2346,1012,5524,36,4512,195
RR,3018,BOA VISTA,42090,98338,30988,176911,1837,145923,3658
RR,3026,IRACEMA,1764,2018,1015,4968,34,3953,137
RR,3034,CARACARAÍ,2731,5084,2614,10765,67,8151,269
RR,3042,AMAJARI,898,2546,861,4418,26,3557,87
RR,3050,ALTO ALEGRE,2330,4034,1274,7885,48,6611,199
RR,3069,CANTÁ,2289,4533,1732,8820,58,7088,208
RR,3077,BONFIM,1403,3277,1278,6136,33,4858,145
RR,3085,RORAINÓPOLIS,4623,4816,2589,12420,116,9831,276
RR,3093,MUCAJAÍ,3107,4405,1953,9738,84,7785,189
RR,3107,UIRAMUTÃ,1733,1239,730,3929,21,3199,206
RR,3115,NORMANDIA,1761,2082,725,4687,11,3962,108
RR,3123,PACARAIMA,1307,3252,1293,6026,29,4733,145
RR,3131,SÃO JOÃO DA BALIZA,1702,1870,826,4524,50,3698,76
RR,3158,SÃO LUIZ,1607,2056,1034,4852,57,3818,98
RS,84735,ÁUREA,1018,1501,335,2987,59,2652,74
RS,84743,TRÊS ARROIOS,1152,968,257,2472,42,2215,53
RS,84751,NOVA ROMA DO SUL,1063,1307,261,2753,54,2492,68
RS,84760,PROGRESSO,2459,1623,802,5101,95,4299,122
RS,84778,PIRAPÓ,1042,765,604,2487,27,1883,49
RS,84786,JABOTICABA,1366,1021,739,3225,27,2486,72
RS,84794,SÃO JORGE,1083,1031,277,2473,39,2196,43
RS,84808,ALTO ALEGRE,724,629,187,1588,19,1401,29
RS,84816,NOVA HARTZ,6357,4507,1932,13228,216,11296,216
RS,84824,DOIS LAJEADOS,1157,1179,340,2790,50,2450,64
RS,84832,SÃO DOMINGOS DO SUL,1160,912,278,2462,61,2184,51
RS,84840,TUNAS,2070,780,630,3594,39,2964,75
RS,84859,SÃO JOÃO DA URTIGA,1851,1503,440,4016,132,3576,90
RS,84867,GUABIJU,471,662,234,1435,38,1201,30
RS,84875,QUINZE DE NOVEMBRO,1320,1330,326,3048,21,2722,51
RS,84883,DOUTOR MAURÍCIO CARDOSO,1858,1892,655,4520,44,3865,71
RS,84891,CAPELA DE SANTANA,3475,2800,1261,7801,116,6540,149
RS,84905,JAQUIRANA,1224,1432,1170,3954,62,2784,66
RS,84913,VANINI,747,660,197,1680,44,1483,32
RS,84921,BOQUEIRÃO DO LEÃO,3262,1505,1146,6146,105,5000,128
RS,84930,FAGUNDES VARELA,847,977,224,2132,36,1908,48
RS,84948,ÁGUA SANTA,1216,1206,439,2991,66,2552,64
RS,84956,SILVEIRA MARTINS,1026,877,286,2277,46,1991,42
RS,84964,IBIRAPUITÃ,1428,1276,582,3374,39,2792,49
RS,84972,IBARAMA,2054,875,317,3379,51,3062,82
RS,84980,PANTANO GRANDE,3575,2677,1980,8501,142,6521,127
RS,84999,IPÊ,1616,2589,659,5009,73,4350,72
RS,85006,TRINDADE DO SUL,2183,1432,603,4359,63,3756,78
RS,85014,AGUDO,6165,4501,2001,13111,229,11110,215
RS,85022,ERNESTINA,1167,1072,248,2559,36,2311,36
RS,85030,AJURICABA,2320,2655,928,6040,65,5112,72
RS,85049,DEZESSEIS DE NOVEMBRO,965,896,458,2395,27,1937,49
RS,85057,ALECRIM,2775,2112,829,5904,76,5075,112
RS,85065,BROCHIER,2057,1151,456,3795,52,3339,79
RS,85073,ALEGRETE,22188,22788,14976,61269,636,46293,681
RS,85081,EREBANGO,911,955,301,2272,44,1971,61
RS,85090,ALPESTRE,3325,1621,1013,6205,121,5192,125
RS,85103,ENTRE-IJUÍS,3673,2096,1204,7204,110,6000,121
RS,85111,ALVORADA,49381,55491,23217,133960,2919,110743,2952
RS,85120,NOVA ESPERANÇA DO SUL,1406,1683,453,3706,89,3253,75
RS,85138,ANTA GORDA,1894,2147,909,5185,133,4276,102
RS,85146,PAVERAMA,2901,1795,985,5870,78,4885,111
RS,85154,ANTÔNIO PRADO,3236,5260,1717,10670,172,8953,285
RS,85162,TERRA DE AREIA,2765,2667,1562,7172,91,5610,87
RS,85170,ARATIBA,2478,2256,574,5495,76,4921,111
RS,85189,HARMONIA,1603,1436,412,3607,73,3195,83
RS,85197,ARROIO DO MEIO,6977,5421,2160,15234,320,13074,356
RS,85200,CAMPOS BORGES,1264,1005,442,2846,69,2404,66
RS,85219,ARROIO DOS RATOS,3303,4534,2346,10564,216,8218,165
RS,85227,CERRO GRANDE,1068,594,352,2075,18,1723,43
RS,85235,ARROIO DO TIGRE,5563,2661,1541,10135,183,8594,187
RS,85243,IPIRANGA DO SUL,496,1001,191,1773,36,1582,49
RS,85251,ARROIO GRANDE,4961,6869,3312,15655,291,12343,222
RS,85260,LAGOÃO,2277,1283,1068,4859,70,3791,161
RS,85278,ARVOREZINHA,3631,2742,1531,8304,220,6773,180
RS,85286,ESTAÇÃO,1721,2473,739,5120,91,4381,96
RS,85294,AUGUSTO PESTANA,2696,2308,705,5891,77,5186,105
RS,85308,ARROIO DO SAL,2071,2494,1411,6149,77,4738,96
RS,85316,BAGÉ,28410,38857,16812,87220,1681,70408,1460
RS,85324,SÃO JOSÉ DO HORTÊNCIO,1559,1252,377,3333,86,2956,59
RS,85332,BARÃO DE COTEGIPE,2064,2292,704,5256,91,4552,105
RS,85340,PINHAL,924,625,254,1846,14,1592,29
RS,85359,BARRACÃO,1773,1482,754,4168,85,3414,74
RS,85367,TRÊS CACHOEIRAS,3628,2715,1298,7843,86,6545,116
RS,85375,BARRA DO RIBEIRO,3001,4632,2061,10035,177,7974,164
RS,85383,SÃO VENDELINO,851,771,163,1854,44,1691,25
RS,85391,BARROS CASSAL,3873,2845,2032,9075,144,7043,181
RS,85405,PROTÁSIO ALVES,482,1122,228,1903,28,1675,43
RS,85413,BENTO GONÇALVES,27785,36085,12753,80218,1487,67465,2108
RS,85421,POUSO NOVO,714,617,300,1707,29,1407,47
RS,85430,BOA VISTA DO BURICÁ,2589,1997,882,5599,63,4717,68
RS,85448,EUGÊNIO DE CASTRO,1089,872,485,2540,51,2055,43
RS,85456,BOM JESUS,2359,4176,1987,8795,155,6808,118
RS,85464,CRISTAL,2481,1983,1217,5848,82,4631,85
RS,85472,BOM RETIRO DO SUL,3487,4044,1464,9369,181,7905,193
RS,85480,SÃO MIGUEL DAS MISSÕES,2996,1652,1171,6004,90,4833,95
RS,85499,BOSSOROCA,2344,1801,1495,5834,104,4339,90
RS,85502,GLORINHA,1708,2953,1092,5946,102,4854,91
RS,85510,BRAGA,1408,880,627,3018,56,2391,47
RS,85529,SEGREDO,3111,1481,1008,5815,103,4807,112
RS,85537,BUTIÁ,5338,6933,3305,16231,324,12926,331
RS,85545,ALEGRIA,1616,1279,655,3678,51,3023,77
RS,85553,CAÇAPAVA DO SUL,9948,10594,3902,25624,638,21722,542
RS,85561,SALDANHA MARINHO,1023,1167,349,2611,34,2262,38
RS,85570,CACEQUI,4404,3336,2948,11000,127,8052,185
RS,85588,SÃO JOSÉ DO HERVAL,912,633,475,2084,21,1609,43
RS,85596,CACHOEIRA DO SUL,23522,27347,15433,68614,1246,53181,1066
RS,85600,VISTA ALEGRE,1217,735,320,2348,33,2028,43
RS,85618,CACHOEIRINHA,33602,38746,16090,92485,2016,76395,2031
RS,85626,IVORÁ,751,822,278,1924,41,1646,32
RS,85634,CACIQUE DOBLE,1311,1701,529,3668,63,3139,64
RS,85642,VILA MARIA,1250,1624,380,3400,82,3020,64
RS,85650,CAIBATÉ,1903,1210,616,3882,90,3266,63
RS,85669,TAQUARUÇU DO SUL,1049,966,328,2430,32,2102,55
RS,85677,CAIÇARA,1857,1495,416,3881,48,3465,65
RS,85685,IMBÉ,4776,5873,3001,14029,190,11028,189
RS,85693,CAMAQUÃ,17932,20465,8593,48581,960,39988,631
RS,85707,SEDE NOVA,1104,850,384,2422,37,2038,47
RS,85715,CAMBARÁ DO SUL,1431,2502,1411,5543,111,4132,88
RS,85723,TUPANDI,1297,1393,321,3130,64,2809,55
RS,85731,CAMPINA DAS MISSÕES,2427,1895,805,5315,55,4510,133
RS,85740,RIOZINHO,1838,1226,605,3838,75,3233,94
RS,85758,CAMPINAS DO SUL,1281,2522,748,4668,51,3920,66
RS,85766,RELVADO,717,827,554,2156,24,1602,34
RS,85774,CAMPO BOM,19522,18956,7304,47563,852,40259,929
RS,85782,IMIGRANTE,1158,888,217,2402,60,2185,79
RS,85790,CAMPO NOVO,2051,1335,1256,4771,68,3515,61
RS,85804,CIDREIRA,3074,3606,2667,9583,115,6916,121
RS,85812,CANDELÁRIA,10431,7915,4179,23559,602,19380,432
RS,85820,MONTAURI,645,564,138,1403,24,1265,32
RS,85839,CÂNDIDO GODÓI,1963,2760,539,5448,80,4909,106
RS,85847,VISTA GAÚCHA,1320,749,433,2566,22,2133,42
RS,85855,CANELA,7169,15045,4555,27852,553,23297,530
RS,85863,VISTA ALEGRE DO PRATA,679,600,242,1562,18,1320,23
RS,85871,CANGUÇU,16295,18181,7542,43830,1112,36288,700
RS,85880,CASEIROS,763,1250,380,2491,62,2111,36
RS,85898,CANOAS,94238,91566,20023,216739,5163,196716,5749
RS,85901,ITACURUBI,1210,834,802,2929,38,2127,45
RS,85910,CARAZINHO,16381,19687,7982,45430,657,37448,723
RS,85928,ENTRE RIOS DO SUL,1198,965,369,2604,36,2235,36
RS,85936,CARLOS BARBOSA,8432,7921,2441,19638,328,17197,516
RS,85944,CERRO GRANDE DO SUL,3134,2477,951,6785,116,5834,107
RS,85952,CASCA,2672,3062,1072,7113,166,6041,141
RS,85960,CAMARGO,753,970,198,2004,38,1806,45
RS,85979,CATUÍPE,3135,3321,1007,7733,161,6726,109
RS,85987,PARAÍSO DO SUL,2947,1992,963,6103,99,5140,102
RS,85995,CAXIAS DO SUL,96010,147756,50654,310335,5793,259681,10122
RS,86010,CERRO LARGO,5197,2692,1392,9650,135,8258,234
RS,86029,FAXINALZINHO,902,759,353,2081,22,1728,45
RS,86037,CHAPADA,3507,3036,1037,7872,182,6835,110
RS,86045,AMARAL FERRADOR,2553,1313,772,4812,88,4040,86
RS,86053,CHIAPETTA,1465,1199,678,3429,42,2751,45
RS,86061,VILA FLORES,901,1519,280,2842,71,2562,71
RS,86070,CIRÍACO,1715,1413,570,3877,105,3307,74
RS,86088,CERRO BRANCO,1901,1095,476,3630,67,3154,91
RS,86096,COLORADO,928,1668,428,3106,32,2678,50
RS,86100,ANDRÉ DA ROCHA,385,601,387,1410,20,1023,17
RS,86118,CONDOR,2375,2003,576,5099,56,4523,89
RS,86126,POÇO DAS ANTAS,814,707,219,1799,26,1580,33
RS,86134,CONSTANTINA,2884,3161,1274,7610,133,6336,158
RS,86142,TRÊS PALMEIRAS,1517,1212,511,3406,84,2895,82
RS,86150,CORONEL BICACO,2816,1892,1499,6392,62,4893,123
RS,86169,NOVA ALVORADA,1086,1039,215,2443,38,2228,65
RS,86177,CRISSIUMAL,5527,3655,1590,11109,156,9519,181
RS,86185,MORRO REDONDO,1799,2294,701,5047,157,4346,96
RS,86193,CRUZ ALTA,17119,18917,11188,48713,750,37525,739
RS,86207,SANTA MARIA DO HERVAL,2464,1934,395,4993,98,4598,102
RS,86215,CRUZEIRO DO SUL,4251,3647,1241,9474,141,8233,194
RS,86223,BARÃO,1739,1974,515,4389,68,3874,93
RS,86231,DAVID CANABARRO,1639,1574,554,3941,113,3387,61
RS,86240,ELDORADO DO SUL,8657,9040,4497,23061,408,18564,459
RS,86258,DOIS IRMÃOS,9837,7578,2555,20647,324,18092,353
RS,86274,DOM FELICIANO,4802,3509,1896,10636,213,8740,216
RS,86282,ALTO FELIZ,923,1103,240,2374,43,2134,65
RS,86290,DOM PEDRITO,12175,10264,6867,30073,349,23206,418
RS,86304,AMETISTA DO SUL,2348,1994,1522,6030,91,4508,75
RS,86312,DONA FRANCISCA,1098,1420,439,3044,45,2605,42
RS,86320,ARAMBARÉ,1115,1307,739,3248,37,2509,50
RS,86339,ENCANTADO,6563,6367,2647,16216,251,13569,388
RS,86347,BARÃO DO TRIUNFO,1639,2291,854,4969,91,4115,94
RS,86355,ENCRUZILHADA DO SUL,7666,7089,4439,20085,495,15646,396
RS,86363,BARRA DO GUARITA,1093,826,519,2507,24,1988,45
RS,86371,ERECHIM,28010,29110,12302,72163,1220,59861,1521
RS,86380,BARRA DO RIO AZUL,831,754,228,1855,11,1627,31
RS,86398,HERVAL,2541,1629,1299,5670,101,4371,100
RS,86401,BARRA FUNDA,1060,846,280,2249,38,1969,25
RS,86410,ERVAL GRANDE,1819,1505,423,3921,79,3498,95
RS,86428,BOA VISTA DAS MISSÕES,860,645,362,1919,18,1557,34
RS,86436,ERVAL SECO,2679,1832,1469,6180,81,4711,119
RS,86444,BOM PROGRESSO,1016,679,447,2189,19,1742,28
RS,86452,ESMERALDA,761,1127,556,2525,39,1969,42
RS,86460,CAMPESTRE DA SERRA,875,1149,368,2501,58,2133,51
RS,86479,ESPUMOSO,4099,5712,1428,11586,178,10158,169
RS,86487,CANDIOTA,3494,1855,1443,6956,71,5513,93
RS,86495,ESTÂNCIA VELHA,12598,12151,4407,30476,605,26069,715
RS,86509,CAPITÃO,1285,716,209,2293,50,2084,33
RS,86517,ESTEIO,29158,22378,12026,66216,1214,54190,1440
RS,86525,CARLOS GOMES,649,621,226,1540,27,1314,17
RS,86533,ESTRELA,9466,9536,3898,23696,361,19798,435
RS,86541,CENTENÁRIO,1043,1122,261,2497,31,2236,40
RS,86550,FARROUPILHA,17583,22600,7295,49625,914,42330,1233
RS,86568,CHARRUA,1022,1167,503,2771,24,2268,55
RS,86576,FAXINAL DO SOTURNO,2304,2173,739,5409,111,4670,82
RS,86584,COLINAS,919,893,249,2149,33,1900,55
RS,86592,FELIZ,4108,4042,1402,10006,185,8604,269
RS,86606,COQUEIROS DO SUL,846,1057,300,2268,32,1968,33
RS,86614,FLORES DA CUNHA,5760,11816,3386,22034,426,18648,646
RS,86622,CORONEL BARROS,989,935,219,2184,14,1965,27
RS,86630,FONTOURA XAVIER,3730,2560,2177,8740,113,6563,160
RS,86649,COXILHA,1130,907,363,2483,42,2120,41
RS,86657,FORMIGUEIRO,1913,2814,1076,6030,104,4954,123
RS,86665,DERRUBADAS,1155,1097,339,2642,19,2303,32
RS,86673,FREDERICO WESTPHALEN,9725,7902,4502,22782,319,18280,334
RS,86681,DOIS IRMÃOS DAS MISSÕES,876,608,384,1931,24,1547,39
RS,86690,GARIBALDI,7423,11463,3713,23692,445,19979,648
RS,86703,ENGENHO VELHO,494,459,273,1263,18,990,19
RS,86711,GAURAMA,1822,2482,656,5156,81,4500,115
RS,86720,GARRUCHOS,1418,619,911,3015,33,2104,34
RS,86738,GENERAL CÂMARA,2831,2399,1369,6824,118,5455,107
RS,86746,GENTIL,538,689,159,1437,21,1278,30
RS,86754,SÃO VICENTE DO SUL,2836,2273,1571,6934,128,5363,126
RS,86762,GRAMADO DOS LOUREIROS,1043,431,250,1786,31,1536,31
RS,86770,GETÚLIO VARGAS,3784,6413,2214,12864,205,10650,248
RS,86789,GRAMADO XAVIER,1444,856,354,2756,53,2402,49
RS,86797,GIRUÁ,5152,5254,1845,12600,153,10755,196
RS,86800,HULHA NEGRA,2039,1478,547,4168,41,3621,63
RS,86819,GRAMADO,6542,14632,4550,26851,543,22301,584
RS,86827,INHACORÁ,940,582,463,2061,33,1598,43
RS,86835,GRAVATAÍ,60062,78455,27373,173884,3824,146511,4170
RS,86843,ITAPUCA,870,583,377,1885,25,1508,30
RS,86851,GUAÍBA,25322,29747,11281,69344,1483,58063,1511
RS,86860,LAJEADO DO BUGRE,953,449,369,1854,30,1485,53
RS,86878,GUAPORÉ,6584,7180,2573,17100,387,14527,376
RS,86886,LAGOA DOS TRÊS CANTOS,464,722,131,1371,22,1240,32
RS,86894,GUARANI DAS MISSÕES,3159,2230,1104,6711,101,5607,117
RS,86908,LINDOLFO COLLOR,2253,1156,525,4078,57,3553,87
RS,86916,HORIZONTINA,6375,5347,2399,14478,160,12079,197
RS,86924,LINHA NOVA,519,570,125,1281,42,1156,25
RS,86932,CHARQUEADAS,8792,9665,3495,22818,453,19323,413
RS,86940,MANOEL VIANA,2548,1599,1562,5848,73,4286,66
RS,86959,HUMAITÁ,1981,1413,562,4092,68,3530,68
RS,86967,MAQUINÉ,2829,1694,1169,5866,74,4697,100
RS,86975,IBIAÇÁ,1386,1715,440,3675,75,3235,59
RS,86983,MARATÁ,1063,817,212,2160,32,1948,36
RS,86991,IBIRAIARAS,1872,2630,881,5650,149,4769,118
RS,87009,MARIANA PIMENTEL,1056,1631,616,3434,56,2818,75
RS,87017,IBIRUBÁ,6300,6270,2602,15654,249,13052,233
RS,87025,MATO CASTELHANO,887,1084,334,2388,27,2054,56
RS,87033,IGREJINHA,10312,9386,3323,23833,442,20510,370
RS,87041,MATO LEITÃO,1673,1032,279,3102,58,2823,60
RS,87050,IJUÍ,25922,21989,10803,60227,722,49424,791
RS,87068,MINAS DO LEÃO,1511,3369,1045,6121,100,5076,96
RS,87076,ILÓPOLIS,1266,1357,666,3434,86,2768,59
RS,87084,MONTE BELO DO SUL,912,1355,339,2747,57,2408,84
RS,87092,INDEPENDÊNCIA,2179,2364,1178,5879,80,4701,78
RS,87106,MORMAÇO,975,900,291,2238,35,1947,37
RS,87114,IRAÍ,2961,1906,991,6057,84,5066,115
RS,87122,MORRINHOS DO SUL,1427,1243,554,3326,41,2772,61
RS,87130,ITAQUI,10401,9871,6038,27007,312,20969,385
RS,87149,MORRO REUTER,1854,2224,383,4660,76,4277,123
RS,87157,ITATIBA DO SUL,1833,1242,388,3589,42,3201,84
RS,87165,MULITERNO,743,652,203,1667,37,1464,32
RS,87173,IVOTI,6183,5701,1911,14350,261,12439,294
RS,87181,NICOLAU VERGUEIRO,500,864,294,1724,33,1430,33
RS,87190,JACUTINGA,967,1424,462,2957,48,2495,56
RS,87203,NOVA BOA VISTA,737,854,208,1880,34,1672,47
RS,87211,JAGUARÃO,7183,9408,5095,22503,419,17408,398
RS,87220,NOVA PÁDUA,403,1410,195,2119,40,1924,71
RS,87238,JAGUARI,4015,3762,1769,10004,261,8235,197
RS,87246,NOVA SANTA RITA,7197,5357,2650,15774,311,13124,259
RS,87254,JÚLIO DE CASTILHOS,6447,5555,3327,15754,190,12427,235
RS,87262,NOVO BARREIRO,1595,1285,461,3430,35,2969,54
RS,87270,LAGOA VERMELHA,6561,9384,4019,20628,311,16609,353
RS,87289,NOVO MACHADO,1102,1721,335,3247,27,2912,62
RS,87297,LAJEADO,21912,19266,8699,51717,846,43018,994
RS,87300,NOVO TIRADENTES,845,560,452,1913,16,1461,40
RS,87319,LAVRAS DO SUL,2387,2374,1238,6215,100,4977,116
RS,87327,PARECI NOVO,1085,1275,404,2855,48,2451,43
RS,87335,LIBERATO SALZANO,2069,1428,650,4346,100,3696,99
RS,87343,PASSO DO SOBRADO,2903,1120,526,4728,110,4202,69
RS,87351,MACHADINHO,1980,1558,530,4245,73,3715,104
RS,87360,PICADA CAFÉ,1507,1890,482,4023,50,3541,94
RS,87378,MARAU,9222,12499,4014,26663,450,22649,478
RS,87386,PINHAL GRANDE,1842,1137,701,3784,52,3083,52
RS,87394,MARCELINO RAMOS,1929,1594,577,4220,39,3643,81
RS,87408,PINHEIRINHO DO VALE,1644,1004,407,3144,41,2737,48
RS,87416,MARIANO MORO,938,671,249,1958,62,1709,38
RS,87424,PONTÃO,1404,1266,446,3203,43,2757,44
RS,87432,MATA,1606,1693,810,4294,109,3484,76
RS,87440,PONTE PRETA,714,755,171,1688,20,1517,28
RS,87459,MAXIMILIANO DE ALMEIDA,1474,1743,689,4059,72,3370,81
RS,87467,PORTO MAUÁ,863,999,322,2245,26,1923,35
RS,87475,MIRAGUAÍ,2033,1019,549,3717,48,3168,68
RS,87483,PORTO VERA CRUZ,849,572,321,1785,17,1464,26
RS,87491,MONTENEGRO,15915,18020,7380,43145,897,35765,933
RS,87505,PRESIDENTE LUCENA,834,926,142,1977,23,1835,52
RS,87513,MOSTARDAS,2968,3990,1771,9071,175,7300,167
RS,87521,QUEVEDOS,978,730,310,2094,41,1784,35
RS,87530,MUÇUM,1364,1858,436,3868,113,3432,97
RS,87548,RIO DOS ÍNDIOS,1552,917,460,3042,48,2582,65
RS,87556,NÃO-ME-TOQUE,5095,5138,1803,12436,177,10633,223
RS,87564,SAGRADA FAMÍLIA,1039,600,397,2108,28,1711,44
RS,87572,NONOAI,4028,2829,2356,9568,135,7212,220
RS,87580,SALVADOR DAS MISSÕES,1020,1034,254,2385,33,2131,44
RS,87599,NOVA ARAÇÁ,1158,1327,418,3065,96,2647,66
RS,87602,SANTA CLARA DO SUL,2398,1492,434,4521,96,4087,101
RS,87610,NOVA BASSANO,2652,2977,990,6898,135,5908,144
RS,87629,SANTA TEREZA,695,679,192,1663,40,1471,57
RS,87637,NOVA BRÉSCIA,903,1322,254,2588,45,2334,64
RS,87645,SANTO ANTÔNIO DO PALMA,790,729,212,1804,35,1592,38
RS,87653,NOVA PALMA,2381,2045,540,5099,69,4559,64
RS,87661,SANTO ANTÔNIO DO PLANALTO,616,900,172,1753,26,1581,39
RS,87670,NOVA PETRÓPOLIS,5362,7251,2370,15700,299,13330,418
RS,87688,SANTO EXPEDITO DO SUL,941,895,177,2100,50,1923,37
RS,87696,NOVA PRATA,5752,7891,3013,17331,291,14318,384
RS,87700,SÃO JOÃO DO POLÊSINE,786,1155,412,2412,24,2000,35
RS,87718,NOVO HAMBURGO,66363,73332,28889,175950,3548,147061,3818
RS,87726,SÃO JOSÉ DOS AUSENTES,1008,1074,808,2960,36,2152,34
RS,87734,OSÓRIO,13311,11900,5704,32103,617,26399,571
RS,87742,SÃO JOSÉ DO INHACORÁ,1064,704,255,2073,22,1818,28
RS,87750,PAIM FILHO,1612,1460,477,3678,54,3201,75
RS,87769,SÃO JOSÉ DAS MISSÕES,1252,635,383,2348,29,1965,49
RS,87777,PALMEIRA DAS MISSÕES,9381,9525,4842,24395,272,19553,375
RS,87785,SÃO MARTINHO DA SERRA,949,1340,450,2835,55,2385,41
RS,87793,PALMITINHO,2916,1660,944,5665,59,4721,86
RS,87807,SÃO PEDRO DA SERRA,1205,1068,352,2726,43,2374,58
RS,87815,PANAMBI,10545,11719,4975,28023,379,23048,405
RS,87823,SÃO PEDRO DO BUTIÁ,1056,911,376,2432,29,2056,60
RS,87831,PARAÍ,2047,2533,745,5565,137,4820,103
RS,87840,SÃO VALENTIM DO SUL,879,952,290,2217,47,1927,49
RS,87858,PASSO FUNDO,56485,50779,21484,133123,2216,111639,2159
RS,87866,SÃO VALÉRIO DO SUL,1014,527,477,2067,15,1590,34
RS,87874,PEDRO OSÓRIO,2352,2534,1249,6446,192,5197,119
RS,87882,SENTINELA DO SUL,1667,1637,615,4071,93,3456,59
RS,87890,PEJUÇARA,1334,1310,478,3215,48,2737,45
RS,87904,SÉRIO,1250,531,207,2084,59,1877,37
RS,87912,PELOTAS,86829,104824,44744,247380,5018,202636,5965
RS,87920,SERTÃO SANTANA,1795,2112,816,4879,90,4063,66
RS,87939,PINHEIRO MACHADO,4207,3981,2237,10934,292,8697,217
RS,87947,SINIMBU,4986,1371,1336,7968,92,6632,183
RS,87955,PIRATINI,6399,5616,3537,16279,427,12742,300
RS,87963,TIRADENTES DO SUL,2474,1666,666,4971,50,4305,115
RS,87971,PLANALTO,3630,2593,1253,7811,165,6558,170
RS,87980,TRAVESSEIRO,905,786,212,1971,22,1759,46
RS,87998,PORTÃO,9435,7842,3432,21605,421,18173,475
RS,88005,TRÊS FORQUILHAS,1286,949,427,2744,44,2317,38
RS,88013,PORTO ALEGRE,354209,447331,212324,1063821,20989,851497,28968
RS,88021,TUPANCI DO SUL,512,555,233,1349,24,1116,25
RS,88030,PORTO LUCENA,2007,1589,580,4325,56,3745,93
RS,88048,UNIÃO DA SERRA,604,675,220,1582,37,1362,46
RS,88056,PORTO XAVIER,4168,2336,2201,8951,98,6750,148
RS,88064,VALE DO SOL,5627,1327,1014,8240,145,7226,127
RS,88072,PUTINGA,1429,1600,831,4016,85,3185,71
RS,88080,VALE REAL,1818,1722,536,4239,70,3703,93
RS,88099,QUARAÍ,7376,6059,4594,18520,231,13926,260
RS,88102,VILA NOVA DO SUL,1442,1386,786,3767,73,2981,80
RS,88110,REDENTORA,2682,1634,1630,6110,60,4480,104
RS,88129,VITÓRIA DAS MISSÕES,1788,812,387,3062,16,2675,59
RS,88137,RESTINGA SÊCA,4177,6137,2754,13450,186,10696,196
RS,88145,XANGRI-LÁ,2620,3873,1300,8026,117,6726,116
RS,88153,RIO GRANDE,66884,44409,25389,143617,3375,118228,3560
RS,88161,BOA VISTA DO SUL,1011,1064,269,2440,57,2171,39
RS,88170,RIO PARDO,14541,8830,5666,30079,555,24413,487
RS,88188,DILERMANDO DE AGUIAR,940,1229,527,2778,25,2251,57
RS,88196,ROCA SALES,3228,3064,783,7410,172,6627,163
RS,88200,CAPIVARI DO SUL,1159,1134,523,2918,47,2395,55
RS,88218,RODEIO BONITO,2108,1509,583,4343,59,3760,84
RS,88226,NOVA CANDELÁRIA,1123,851,173,2234,46,2061,41
RS,88234,ROLANTE,6102,5732,1993,14469,308,12476,334
RS,88242,FLORIANO PEIXOTO,815,845,282,2002,19,1720,41
RS,88250,RONDA ALTA,3373,2727,1029,7292,88,6263,75
RS,88269,CHUVISCA,1726,1600,424,3895,80,3471,65
RS,88277,RONDINHA,2033,1907,400,4476,76,4076,60
RS,88285,ESPERANÇA DO SUL,1378,954,423,2827,24,2404,48
RS,88293,ROQUE GONZALES,2821,1742,1058,5828,85,4770,122
RS,88307,DOUTOR RICARDO,919,646,327,1981,44,1654,45
RS,88315,ROSÁRIO DO SUL,11508,12073,7777,32199,413,24422,428
RS,88323,HERVEIRAS,1726,319,431,2530,18,2099,36
RS,88331,SALVADOR DO SUL,2097,2277,556,5142,111,4586,101
RS,88340,CARAÁ,2340,2448,1079,6060,84,4981,109
RS,88358,SANANDUVA,4507,5679,1211,11830,228,10619,205
RS,88366,FAZENDA VILANOVA,1239,1107,353,2818,63,2465,56
RS,88374,SANTA BÁRBARA DO SUL,2734,3039,1576,7542,110,5966,83
RS,88382,ITAARA,1282,1923,743,4044,33,3301,63
RS,88390,SANTA CRUZ DO SUL,44454,28051,14105,91298,2461,77193,2227
RS,88404,ESTRELA VELHA,1562,992,629,3302,54,2673,65
RS,88412,SANTA MARIA,69150,80069,36548,192884,3595,156336,3522
RS,88420,BENJAMIN CONSTANT DO SUL,928,523,459,1943,10,1484,23
RS,88439,SANTANA DA BOA VISTA,2883,2284,1562,7106,222,5544,155
RS,88447,MAÇAMBARÁ,1578,1238,1140,4033,33,2893,44
RS,88455,SANTANA DO LIVRAMENTO,27387,22730,17250,69215,910,51965,938
RS,88463,DOM PEDRO DE ALCÂNTARA,1622,1021,594,3335,55,2741,43
RS,88471,SANTA ROSA,18549,22027,9072,51001,559,41929,794
RS,88480,UNISTALDA,1102,959,591,2710,26,2119,32
RS,88498,SANTA VITÓRIA DO PALMAR,8092,9604,5756,24345,469,18589,424
RS,88501,TURUÇU,1106,1529,444,3186,53,2742,54
RS,88510,SANTIAGO,14444,14351,8711,38779,743,30068,530
RS,88528,CRISTAL DO SUL,1130,761,325,2318,46,1993,56
RS,88536,SANTO ÂNGELO,26567,19171,12912,60473,849,47561,974
RS,88544,MUITOS CAPÕES,558,1172,598,2419,52,1821,39
RS,88552,SANTO ANTÔNIO DA PATRULHA,11936,11844,5452,30567,682,25115,653
RS,88560,NOVA RAMADA,764,1004,270,2089,20,1819,31
RS,88579,SANTO ANTÔNIO DAS MISSÕES,4032,2487,2723,9516,125,6793,149
RS,88587,JARI,1458,977,585,3129,60,2544,49
RS,88595,SANTO AUGUSTO,5591,3262,2041,11214,137,9173,183
RS,88609,UBIRETAMA,587,1085,265,1983,20,1718,26
RS,88617,SANTO CRISTO,5619,4652,1579,12198,159,10619,189
RS,88625,BARRA DO QUARAÍ,1034,1169,1010,3255,15,2245,27
RS,88633,SÃO BORJA,21237,14312,11876,48434,474,36558,535
RS,88641,CERRITO,2048,2267,825,5409,171,4584,98
RS,88650,SÃO FRANCISCO DE ASSIS,7022,4758,3877,16244,307,12367,280
RS,88668,VALE VERDE,1365,819,559,2883,70,2324,70
RS,88676,SÃO FRANCISCO DE PAULA,5058,7158,2353,15250,298,12897,383
RS,88684,NOVO CABRAIS,1820,1065,402,3374,45,2972,42
RS,88692,SÃO GABRIEL,16329,18244,10158,46008,733,35850,544
RS,88706,SETE DE SETEMBRO,842,692,150,1737,21,1587,32
RS,88714,SÃO JERÔNIMO,5480,6950,2189,15171,306,12982,246
RS,88722,TABAÍ,1400,1258,442,3225,74,2783,51
RS,88730,SÃO JOSÉ DO NORTE,7889,8467,3619,20644,341,17025,328
RS,88749,VILA LÂNGARO,841,983,282,2174,39,1892,29
RS,88757,SÃO JOSÉ DO OURO,2041,2592,796,5669,132,4873,108
RS,88765,SENADOR SALGADO FILHO,747,1406,316,2518,19,2202,30
RS,88773,SÃO LEOPOLDO,67450,55005,26665,155192,2920,128527,3152
RS,88781,VESPASIANO CORRÊA,660,1099,488,2333,43,1845,43
RS,88790,SÃO LOURENÇO DO SUL,15067,12812,6332,35162,490,28830,461
RS,88803,MONTE ALEGRE DOS CAMPOS,736,1482,631,2968,74,2337,45
RS,88811,SÃO LUIZ GONZAGA,11196,8037,6819,26844,384,20025,408
RS,88820,MARQUES DE SOUZA,1665,1282,485,3550,62,3065,56
RS,88838,SÃO MARCOS,3921,8985,2718,16311,241,13593,446
RS,88846,CHUÍ,1480,1191,784,3588,78,2804,55
RS,88854,SÃO MARTINHO,2272,1664,635,4720,61,4085,88
RS,88862,ARARICÁ,1985,1390,532,4057,70,3525,80
RS,88870,SÃO NICOLAU,2054,1224,1328,4773,67,3445,100
RS,88889,PASSA SETE,2475,897,445,3934,45,3489,72
RS,88897,SÃO PAULO DAS MISSÕES,2708,1673,645,5144,57,4499,61
RS,88900,TOROPI,960,1189,369,2606,48,2237,40
RS,88919,SÃO PEDRO DO SUL,4854,5726,2312,13422,261,11110,269
RS,88927,BALNEÁRIO PINHAL,2254,3028,1954,7457,93,5503,128
RS,88935,SÃO SEBASTIÃO DO CAÍ,7152,7219,3005,18111,357,15106,378
RS,88943,MAMPITUBA,1303,949,472,2784,34,2312,26
RS,88951,SÃO SEPÉ,7573,7192,4345,19721,305,15376,306
RS,88978,SÃO VALENTIM,1175,1461,380,3128,49,2748,63
RS,88986,ACEGUÁ,1355,1675,474,3591,49,3117,38
RS,88994,SAPIRANGA,23954,21421,9012,56469,1157,47457,925
RS,89001,ALMIRANTE TAMANDARÉ DO SUL,840,727,278,1901,14,1623,42
RS,89010,SAPUCAIA DO SUL,49896,29083,16079,99082,2028,83003,1996
RS,89028,ARROIO DO PADRE,914,1257,237,2465,29,2228,28
RS,89036,SARANDI,6497,6370,3307,16706,257,13399,275
RS,89044,BOA VISTA DO CADEADO,637,966,383,2045,22,1662,37
RS,89052,SEBERI,3918,3080,1044,8312,101,7268,169
RS,89060,BOA VISTA DO INCRA,806,819,289,1963,29,1674,20
RS,89079,SELBACH,1409,2028,711,4263,61,3552,54
RS,89087,BOZANO,801,979,286,2109,15,1823,28
RS,89095,SERAFINA CORRÊA,4048,4470,1710,10781,279,9071,274
RS,89109,CANUDOS DO VALE,1226,379,325,1983,20,1658,33
RS,89117,SERTÃO,2051,2293,553,5077,82,4524,98
RS,89125,CAPÃO BONITO DO SUL,675,770,311,1799,16,1488,27
RS,89133,SEVERIANO DE ALMEIDA,1383,1341,380,3222,51,2842,67
RS,89141,CAPÃO DO CIPÓ,1174,847,462,2557,40,2095,34
RS,89150,CAPÃO DA CANOA,9262,13094,5721,29156,517,23435,562
RS,89168,COQUEIRO BAIXO,411,672,187,1318,18,1131,30
RS,89176,SOBRADINHO,4055,4433,2151,11026,189,8875,198
RS,89184,CORONEL PILAR,593,696,235,1584,28,1349,32
RS,89192,SOLEDADE,8477,8693,4911,22723,256,17812,386
RS,89206,CRUZALTENSE,646,1050,267,2032,31,1765,38
RS,89214,TAPEJARA,4595,6999,1994,14052,189,12058,275
RS,89222,FORQUETINHA,1458,727,327,2600,48,2273,40
RS,89230,TAPERA,3457,3063,1363,8104,106,6741,115
RS,89247,SANTA CECÍLIA DO SUL,737,664,290,1755,39,1465,25
RS,89249,ITATI,1035,1099,542,2771,37,2229,58
RS,89257,TAPES,4217,5482,3193,13323,229,10130,202
RS,89265,JACUIZINHO,1059,619,452,2197,29,1745,38
RS,89273,TAQUARA,14034,16777,7408,39605,681,32197,705
RS,89281,LAGOA BONITA DO SUL,1129,750,237,2209,47,1972,46
RS,89290,TAQUARI,7451,8711,3344,20211,414,16867,291
RS,89303,MATO QUEIMADO,807,534,269,1660,18,1391,32
RS,89311,TENENTE PORTELA,4295,3682,2280,10504,89,8224,158
RS,89320,NOVO XINGU,683,528,233,1481,19,1248,18
RS,89338,TORRES,8687,10825,5121,25768,497,20647,638
RS,89346,PAULO BENTO,695,932,214,1909,29,1695,39
RS,89354,TRAMANDAÍ,10442,11712,7425,30622,553,23197,490
RS,89362,PINHAL DA SERRA,878,568,522,2042,48,1520,26
RS,89370,TRÊS COROAS,6968,7058,2198,16870,325,14672,321
RS,89389,QUATRO IRMÃOS,731,502,261,1542,20,1281,28
RS,89397,TRÊS DE MAIO,6690,8108,4102,19372,219,15270,253
RS,89400,ROLADOR,1273,606,581,2549,49,1968,40
RS,89419,TRÊS PASSOS,8535,5827,2057,17018,235,14961,364
RS,89435,TRIUNFO,7036,10044,3389,21263,429,17874,365
RS,89443,SANTA MARGARIDA DO SUL,792,1119,264,2229,21,1965,33
RS,89451,TUCUNDUVA,1481,2453,679,4758,52,4079,93
RS,89460,SÃO JOSÉ DO SUL,743,722,148,1700,49,1552,38
RS,89478,TUPANCIRETÃ,6074,6730,3723,17055,271,13332,257
RS,89486,SÃO PEDRO DAS MISSÕES,756,557,289,1654,20,1365,32
RS,89494,TUPARENDI,2755,3080,821,6907,103,6086,148
RS,89508,TIO HUGO,1096,745,201,2097,22,1896,33
RS,89516,URUGUAIANA,27146,39908,20171,88909,776,68738,908
RS,89524,WESTFALIA,1256,799,290,2407,42,2117,20
RS,89532,VACARIA,12354,21824,8262,43924,781,35662,703
RS,89559,VENÂNCIO AIRES,28405,13356,7543,51346,1116,43803,926
RS,89567,PEDRAS ALTAS,823,654,584,2107,25,1523,21
RS,89575,VERA CRUZ,10620,4233,2205,17802,365,15597,379
RS,89591,VERANÓPOLIS,4405,9752,2916,17977,419,15061,485
RS,89613,VIADUTOS,1689,1938,501,4251,68,3750,55
RS,89630,VIAMÃO,56687,67560,27499,158761,3275,131262,3740
RS,89656,VICENTE DUTRA,1699,1460,1012,4307,38,3295,98
RS,89672,PALMARES DO SUL,3713,3902,2500,10376,121,7876,140
RS,89699,VICTOR GRAEFF,974,1200,343,2598,41,2255,40
RS,89710,TAVARES,1969,1530,717,4349,57,3632,76
RS,89737,CAPÃO DO LEÃO,7068,6781,3076,17575,346,14499,304
RS,89753,SALTO DO JACUÍ,3700,2804,2079,8873,148,6794,142
RS,89770,COTIPORÃ,1206,1678,448,3527,106,3079,89
RS,98213,TEUTÔNIA,10169,6970,2925,20752,319,17827,369
RS,98230,BOM PRINCÍPIO,3576,3766,963,8707,205,7744,197
RS,98256,PAROBÉ,17977,10576,5354,35155,640,29801,608
RS,98272,FORTALEZA DOS VALOS,1730,1371,649,3830,45,3181,35
RS,98299,JÓIA,3156,2008,1175,6506,74,5331,93
SC,80004,MONTE CARLO,2631,2507,1558,6881,73,5323,112
SC,80012,ABELARDO LUZ,5197,3855,2779,12154,120,9375,203
SC,80020,IPORÃ DO OESTE,3021,2348,627,6166,67,5539,103
SC,80039,AGROLÂNDIA,2808,2919,847,6833,106,5986,153
SC,80047,LINDÓIA DO SUL,1506,1417,403,3457,52,3054,79
SC,80055,AGRONÔMICA,1402,1548,451,3530,64,3079,65
SC,80063,APIÚNA,3007,2594,1139,6984,115,5845,129
SC,80071,ÁGUA DOCE,1894,2268,1080,5382,50,4302,90
SC,80080,DOUTOR PEDRINHO,921,1295,275,2576,32,2301,53
SC,80098,ÁGUAS DE CHAPECÓ,2375,1191,815,4523,55,3708,87
SC,80101,JOSÉ BOITEUX,1669,1231,714,3778,61,3064,103
SC,80110,ÁGUAS MORNAS,1827,2465,357,4888,83,4531,156
SC,80128,VITOR MEIRELES,1551,1706,960,4311,32,3351,62
SC,80136,ALFREDO WAGNER,2529,3563,711,6979,69,6268,107
SC,80144,UNIÃO DO OESTE,1103,906,359,2438,31,2079,39
SC,80152,ANCHIETA,2255,1773,829,5022,67,4193,98
SC,80160,URUPEMA,560,1142,389,2141,23,1752,27
SC,80179,ANGELINA,2360,1587,456,4574,73,4118,98
SC,80187,IRACEMINHA,1310,1472,371,3270,54,2899,63
SC,80195,ANITA GARIBALDI,2824,2426,2104,7562,81,5458,127
SC,80209,TIMBÓ GRANDE,1809,2025,1137,5103,53,3966,79
SC,80217,ANITÁPOLIS,1140,1056,439,2753,52,2314,66
SC,80225,ABDON BATISTA,734,1114,200,2131,30,1931,53
SC,80233,ANTÔNIO CARLOS,1874,3381,513,6055,106,5542,181
SC,80241,SANTA ROSA DO SUL,2595,2513,1069,6423,112,5354,134
SC,80250,ARAQUARI,5277,5343,2768,13822,174,11054,260
SC,80268,CELSO RAMOS,1149,841,459,2530,48,2071,33
SC,80276,ARARANGUÁ,17731,17559,7628,44518,722,36890,878
SC,80284,SERRA ALTA,1356,782,279,2496,45,2217,34
SC,80292,ARMAZÉM,2558,2207,654,5620,88,4966,113
SC,80306,COCAL DO SUL,4568,4782,1805,11774,218,9969,401
SC,80314,ARROIO TRINTA,1042,1335,447,2911,29,2464,58
SC,80322,NOVA ITABERABA,1929,1083,334,3447,52,3113,49
SC,80330,ASCURRA,1939,2676,935,5768,89,4833,129
SC,80349,SANTA TEREZINHA,3245,2231,1110,6774,89,5664,99
SC,80357,ATALANTA,908,1411,371,2791,41,2420,60
SC,80365,MIRIM DOCE,768,924,239,1986,18,1747,37
SC,80373,AURORA,2023,1574,322,4063,71,3741,73
SC,80381,CERRO NEGRO,1454,867,512,2920,16,2408,71
SC,80390,BALNEÁRIO CAMBORIÚ,21034,37429,18760,80166,1096,61406,1847
SC,80403,PASSO DE TORRES,1706,2042,957,4863,75,3906,83
SC,80411,BARRA VELHA,4461,6786,3483,15229,192,11746,307
SC,80420,BRAÇO DO TROMBUDO,1001,1358,442,2889,30,2447,58
SC,80438,BENEDITO NOVO,2352,4172,980,7850,132,6870,214
SC,80446,SUL BRASIL,1066,857,210,2207,20,1997,54
SC,80454,BIGUAÇU,12781,18816,5791,39422,738,33631,1296
SC,80462,VARGEM,1007,905,588,2577,20,1989,57
SC,80470,BLUMENAU,59608,113981,37327,222296,3535,184969,7845
SC,80489,ARABUTÃ,1714,1153,460,3441,49,2981,65
SC,80497,BOM RETIRO,1792,3429,1510,6921,71,5411,119
SC,80500,ÁGUAS FRIAS,1093,773,203,2113,17,1910,27
SC,80519,BOTUVERÁ,1534,1415,237,3371,101,3134,84
SC,80527,GUATAMBÚ,2138,1337,456,4059,39,3603,89
SC,80535,BRAÇO DO NORTE,6403,10933,3082,21045,248,17963,379
SC,80543,PLANALTO ALEGRE,1195,838,237,2336,27,2099,39
SC,80551,BRUSQUE,18408,40641,10636,72922,1115,62286,2122
SC,80560,RIQUEZA,1784,1219,465,3585,40,3120,77
SC,80578,CAÇADOR,19833,18641,9792,49914,720,40122,928
SC,80586,LAJEADO GRANDE,752,451,229,1463,12,1234,19
SC,80594,CAIBI,2180,1704,686,4752,52,4066,130
SC,80608,RIO RUFINO,676,990,503,2224,22,1721,33
SC,80616,CAMBORIÚ,12170,12814,6289,32616,605,26327,738
SC,80624,PASSOS MAIA,1532,904,759,3278,26,2519,57
SC,80632,CAMPO ALEGRE,2029,5294,1563,9166,108,7603,172
SC,80640,SÃO JOÃO DO OESTE,2008,2094,426,4714,67,4288,119
SC,80659,CAMPO BELO DO SUL,1797,2767,900,5623,50,4723,109
SC,80667,CALMON,969,1029,1076,3136,24,2060,38
SC,80675,CAMPO ERÊ,3374,1689,1640,6878,57,5238,118
SC,80683,BALNEÁRIO BARRA DO SUL,1931,3117,1673,6933,61,5260,151
SC,80691,CAMPOS NOVOS,7584,10956,4988,24243,304,19255,411
SC,80705,PARAÍSO,1700,1033,494,3327,39,2833,61
SC,80713,CANELINHA,2680,3665,1388,8014,129,6626,152
SC,80721,SANTA HELENA,996,777,294,2143,29,1849,47
SC,80730,CANOINHAS,12255,18998,7338,39675,455,32337,629
SC,80748,BELMONTE,789,959,227,2046,30,1819,41
SC,80756,CAPINZAL,6228,5729,2681,15235,245,12554,352
SC,80764,NOVO HORIZONTE,1009,867,321,2274,26,1953,51
SC,80772,CATANDUVAS,2864,2591,1114,6787,100,5673,118
SC,80780,SÃO MIGUEL DA BOA VISTA,826,532,233,1644,20,1411,33
SC,80799,CAXAMBU DO SUL,1948,1299,487,3868,47,3381,87
SC,80802,ARVOREDO,942,646,155,1801,20,1646,38
SC,80810,CHAPECÓ,51115,50899,18446,123959,1398,105513,2101
SC,80829,IPUAÇU,2485,939,673,4204,24,3531,83
SC,80837,CONCÓRDIA,17454,24326,9005,52555,693,43550,1077
SC,80845,OURO VERDE,788,793,255,1893,25,1638,32
SC,80853,CORONEL FREITAS,3653,3041,1083,8007,89,6924,141
SC,80861,IRATI,729,701,242,1726,17,1484,37
SC,80870,CORUPÁ,4556,4053,1535,10588,134,9053,310
SC,80888,FORMOSA DO SUL,1140,656,220,2088,28,1868,44
SC,80896,CRICIÚMA,44983,63254,23060,137659,2566,114599,3796
SC,80900,MACIEIRA,783,485,322,1643,22,1321,31
SC,80918,CUNHA PORÃ,2732,4037,1210,8323,149,7113,195
SC,80926,PONTE ALTA DO NORTE,828,1117,618,2629,19,2011,47
SC,80934,CURITIBANOS,8408,13353,6643,29279,332,22636,543
SC,80942,SÃO CRISTÓVÃO DO SUL,1185,1261,833,3358,26,2525,53
SC,80950,DESCANSO,2744,2979,694,6615,86,5921,112
SC,80969,VARGEM BONITA,1662,1388,718,3866,43,3148,55
SC,80977,DIONÍSIO CERQUEIRA,4739,3519,2273,10865,119,8592,215
SC,80985,BOMBINHAS,2559,4581,2107,9690,162,7583,281
SC,80993,DONA EMMA,1342,902,284,2612,36,2328,48
SC,81000,SANGÃO,3322,2382,1141,7095,103,5954,147
SC,81019,ERVAL VELHO,1190,1638,345,3277,35,2932,69
SC,81027,CAPIVARI DE BAIXO,7561,5134,1963,15269,268,13306,343
SC,81035,FAXINAL DOS GUEDES,4420,2091,1188,7928,80,6740,149
SC,81043,CORDILHEIRA ALTA,1755,927,273,3021,35,2748,31
SC,81051,FLORIANÓPOLIS,90520,144867,61131,314752,4901,253621,13333
SC,81060,FORQUILHINHA,6953,6562,1951,16044,281,14093,297
SC,81078,FRAIBURGO,9530,10176,5773,26309,309,20536,521
SC,81086,MORRO GRANDE,777,1457,399,2724,36,2325,55
SC,81094,GALVÃO,1154,1074,612,2927,30,2315,57
SC,81108,CORONEL MARTINS,839,814,227,1938,22,1711,36
SC,81116,GOVERNADOR CELSO RAMOS,2628,6558,2072,11739,176,9667,305
SC,81124,SÃO JOÃO DO ITAPERIÚ,955,1271,407,2710,25,2303,52
SC,81132,GAROPABA,4706,5947,2582,13859,261,11277,363
SC,81140,JARDINÓPOLIS,653,548,180,1438,27,1258,30
SC,81159,GARUVA,3091,4340,2018,9746,120,7728,177
SC,81167,ERMO,828,1248,292,2476,47,2184,61
SC,81175,GASPAR,12277,18844,5513,38129,523,32616,972
SC,81183,SÃO PEDRO DE ALCÂNTARA,1255,1749,395,3547,54,3152,94
SC,81191,GRÃO-PARÁ,1848,2715,638,5412,82,4774,129
SC,81205,SANTIAGO DO SUL,564,459,176,1255,15,1079,41
SC,81213,GRAVATAL,2511,4132,1121,8034,83,6913,187
SC,81221,BELA VISTA DO TOLDO,1852,2039,640,4666,60,4026,75
SC,81230,GUABIRUBA,3980,6220,1227,11968,197,10741,344
SC,81248,CAPÃO ALTO,664,1519,515,2776,30,2261,48
SC,81256,GUARACIABA,3626,3385,750,8013,103,7263,149
SC,81264,PAINEL,801,1065,411,2325,23,1914,25
SC,81272,GUARAMIRIM,10183,9034,3703,23761,318,20058,523
SC,81280,BOCAINA DO SUL,929,1301,284,2587,23,2303,50
SC,81299,GUARUJÁ DO SUL,1808,1327,511,3754,47,3243,61
SC,81302,ALTO BELA VISTA,731,710,190,1683,17,1493,35
SC,81310,HERVAL D'OESTE,6043,6846,2607,15958,174,13351,288
SC,81329,FREI ROGÉRIO,702,1016,449,2222,18,1773,37
SC,81337,IBICARÉ,1035,1275,285,2696,41,2411,60
SC,81345,TREVISO,1112,1708,502,3450,49,2948,79
SC,81353,IBIRAMA,5120,5208,2358,13263,170,10905,407
SC,81361,IOMERÊ,921,1111,322,2442,34,2120,54
SC,81370,IÇARA,19526,14531,6374,42335,886,35961,1018
SC,81388,BOM JESUS,1102,543,334,2044,18,1710,47
SC,81396,ILHOTA,3152,4173,1559,9346,148,7787,314
SC,81400,IBIAM,697,771,208,1732,16,1524,40
SC,81418,IMARUÍ,4151,3080,1795,9376,127,7581,223
SC,81426,ENTRE RIOS,1257,519,559,2388,16,1829,37
SC,81434,IMBITUBA,12508,11139,6170,31255,531,25085,907
SC,81442,PAIAL,814,492,266,1625,17,1359,36
SC,81450,IMBUIA,1892,1718,391,4187,101,3796,85
SC,81469,BOM JESUS DO OESTE,907,605,168,1750,32,1582,38
SC,81477,INDAIAL,11534,18263,5717,37236,614,31519,1108
SC,81485,SÃO BERNARDINO,1131,565,278,2029,19,1751,36
SC,81493,IPIRA,1594,1181,581,3483,64,2902,63
SC,81507,SANTA TEREZINHA DO PROGRESSO,1176,692,440,2375,24,1935,43
SC,81515,IPUMIRIM,2547,1947,546,5280,111,4734,129
SC,81523,SALTINHO,1682,715,438,2956,67,2518,54
SC,81531,IRANI,2920,2629,1103,6863,102,5760,109
SC,81540,JUPIÁ,860,611,256,1779,21,1523,31
SC,81558,IRINEÓPOLIS,3423,2613,1230,7456,75,6226,115
SC,81566,PALMEIRA,765,1205,426,2468,22,2042,50
SC,81574,ITÁ,2380,1977,1130,5624,47,4494,90
SC,81582,BANDEIRANTE,1098,1012,263,2435,22,2172,40
SC,81590,ITAIÓPOLIS,5277,6859,2610,15285,226,12675,313
SC,81604,FLOR DO SERTÃO,782,389,219,1439,13,1220,36
SC,81612,ITAJAÍ,39593,57521,22505,125484,2233,102979,3632
SC,81620,CUNHATAÍ,707,617,120,1499,29,1379,26
SC,81639,ITAPEMA,6886,15146,5829,28854,338,23025,655
SC,81647,PRINCESA,1141,704,244,2166,38,1922,39
SC,81655,ITAPIRANGA,4699,4765,1325,11114,139,9789,186
SC,81663,ITAPOÁ,3072,3857,2738,9997,120,7259,210
SC,81671,ITUPORANGA,6188,7360,1869,15980,200,14111,363
SC,81680,TIGRINHOS,851,421,265,1572,21,1307,14
SC,81698,JABORÁ,1304,1656,370,3440,39,3070,71
SC,81701,CHAPADÃO DO LAGEADO,902,924,238,2140,31,1902,45
SC,81710,JACINTO MACHADO,2577,4499,1274,8642,158,7368,134
SC,81728,BALNEÁRIO ARROIO DO SILVA,2603,2523,1410,6757,93,5347,128
SC,81736,JAGUARUNA,5816,4271,2140,12631,194,10491,210
SC,81744,BALNEÁRIO GAIVOTA,2300,2238,1260,5999,88,4739,113
SC,81752,JARAGUÁ DO SUL,40731,40225,16389,101269,1347,84880,2577
SC,81760,BARRA BONITA,817,710,251,1837,22,1586,37
SC,81779,JOAÇABA,6327,10152,4021,21093,256,17072,337
SC,81787,BRUNÓPOLIS,1168,798,379,2417,27,2038,45
SC,81795,JOINVILLE,104336,178754,56606,357959,6058,301353,12205
SC,81809,LUZERNA,1618,2225,430,4442,58,4012,111
SC,81817,LACERDÓPOLIS,749,843,258,1924,33,1666,41
SC,81825,ZORTÉA,1119,807,221,2204,17,1983,40
SC,81833,LAGES,27740,62072,23343,117001,1532,93658,2314
SC,81850,LAGUNA,13543,16899,6618,38462,559,31844,843
SC,81876,LAURENTINO,1700,2238,482,4648,101,4166,127
SC,81892,LAURO MÜLLER,3349,6072,1732,11662,188,9930,321
SC,81914,LEBON RÉGIS,3464,2825,2234,8808,123,6574,162
SC,81930,LEOBERTO LEAL,1303,1136,303,2837,51,2534,44
SC,81957,LONTRAS,3169,2660,1122,7214,124,6092,139
SC,81973,LUÍS ALVES,2518,3870,925,7548,81,6623,154
SC,81990,MAFRA,10030,22340,6778,40806,685,34028,973
SC,82015,MAJOR GERCINO,1071,1125,491,2781,45,2290,49
SC,82031,MAJOR VIEIRA,2277,2260,543,5241,61,4698,100
SC,82058,MARAVILHA,7382,5681,2425,15954,202,13529,264
SC,82066,MAREMA,1004,645,262,1959,20,1697,28
SC,82074,MASSARANDUBA,4366,5399,1518,11659,121,10141,255
SC,82090,MATOS COSTA,872,740,733,2408,20,1675,43
SC,82112,MELEIRO,1579,3131,756,5632,66,4876,100
SC,82139,MODELO,1430,1145,316,2966,35,2650,40
SC,82155,MONDAÍ,3707,2068,837,6835,67,5998,156
SC,82171,MONTE CASTELO,2353,2518,1534,6612,87,5078,120
SC,82198,MORRO DA FUMAÇA,4592,5029,1390,11453,170,10063,272
SC,82210,NAVEGANTES,13233,15365,7008,36911,538,29903,767
SC,82236,NOVA ERECHIM,1502,1333,343,3268,39,2925,51
SC,82252,NOVA TRENTO,3465,3795,913,8629,196,7716,260
SC,82279,NOVA VENEZA,4046,4668,1365,10507,162,9142,266
SC,82295,ORLEANS,5108,9030,2668,17412,258,14744,348
SC,82317,OURO,2230,2647,814,5873,66,5059,116
SC,82333,PALHOÇA,31209,38870,12637,87258,1658,74621,2884
SC,82350,PALMA SOLA,3184,1198,1350,5875,65,4525,78
SC,82376,PALMITOS,5288,4756,2016,12415,136,10399,219
SC,82392,PAPANDUVA,6787,4236,2616,14034,162,11418,233
SC,82414,PAULO LOPES,1997,2276,627,5107,78,4480,129
SC,82430,PEDRAS GRANDES,1635,1493,574,3859,71,3285,86
SC,82457,PENHA,4353,7512,3574,16059,254,12485,366
SC,82473,PERITIBA,968,1316,316,2677,39,2361,38
SC,82490,PETROLÂNDIA,1911,2104,545,4767,86,4222,121
SC,82511,BALNEÁRIO PIÇARRAS,3548,5071,2687,11667,140,8980,221
SC,82538,PINHALZINHO,5331,4523,1888,12103,161,10215,200
SC,82554,PINHEIRO PRETO,937,1098,452,2569,32,2117,50
SC,82570,PIRATUBA,1903,1595,745,4386,71,3641,72
SC,82597,POMERODE,7801,9092,2735,20605,297,17870,680
SC,82619,PONTE ALTA,1055,1905,996,4039,28,3043,55
SC,82635,PONTE SERRADA,3949,2400,1805,8371,75,6566,142
SC,82651,PORTO BELO,2651,4929,2092,10062,133,7970,257
SC,82678,PORTO UNIÃO,6815,11473,5346,24417,265,19071,518
SC,82694,POUSO REDONDO,4236,4045,1823,10433,118,8610,211
SC,82716,PRAIA GRANDE,2206,2354,730,5479,75,4749,114
SC,82732,PRESIDENTE CASTELO BRANCO,576,797,272,1685,13,1413,27
SC,82759,PRESIDENTE GETÚLIO,5043,3967,1552,11021,185,9469,274
SC,82775,PRESIDENTE NEREU,1033,656,457,2204,28,1747,30
SC,82791,QUILOMBO,3716,3064,1384,8384,101,7000,119
SC,82813,RANCHO QUEIMADO,936,1229,428,2726,61,2298,72
SC,82830,RIO DAS ANTAS,1657,2677,1189,5697,66,4508,108
SC,82856,RIO DO CAMPO,1829,2378,551,4910,50,4359,102
SC,82872,RIO DO OESTE,2053,2348,474,5040,70,4566,95
SC,82899,RIO DOS CEDROS,2693,3583,827,7492,126,6665,263
SC,82910,RIO DO SUL,14075,22256,7904,45923,618,38019,1070
SC,82937,RIO FORTUNA,1640,1830,327,3938,67,3611,74
SC,82953,RIO NEGRINHO,6343,17528,6341,31214,315,24873,687
SC,82970,RODEIO,2542,4626,1219,8729,131,7510,211
SC,82996,ROMELÂNDIA,2071,1337,688,4240,66,3552,78
SC,83011,SALETE,2161,2525,1084,5954,70,4870,114
SC,83038,SALTO VELOSO,1340,1381,563,3392,24,2829,84
SC,83054,SANTA CECÍLIA,3556,5493,2890,12305,149,9415,217
SC,83070,SANTA ROSA DE LIMA,899,738,228,1929,35,1701,29
SC,83097,SANTO AMARO DA IMPERATRIZ,5244,6818,1830,14555,197,12725,466
SC,83119,SÃO BENTO DO SUL,18038,27548,9018,56543,746,47525,1193
SC,83135,SÃO BONIFÁCIO,715,1411,257,2479,39,2222,57
SC,83151,SÃO CARLOS,3290,2885,901,7292,98,6391,118
SC,83178,SÃO DOMINGOS,3193,2588,845,6859,94,6014,139
SC,83194,SÃO FRANCISCO DO SUL,9260,14249,6382,30951,404,24569,656
SC,83216,SÃO JOÃO BATISTA,5041,8468,2654,16898,347,14244,388
SC,83232,SÃO JOÃO DO SUL,1937,2854,633,5631,115,4998,92
SC,83259,SÃO JOAQUIM,4683,10262,2741,18299,244,15558,369
SC,83275,SÃO JOSÉ,44600,65269,22984,140705,2608,117721,5244
SC,83291,SÃO JOSÉ DO CEDRO,4876,3641,1631,10479,139,8848,192
SC,83313,SÃO JOSÉ DO CERRITO,2831,2507,1025,6562,77,5537,122
SC,83330,SÃO LOURENÇO DO OESTE,7175,6273,2367,16338,245,13971,278
SC,83356,SÃO LUDGERO,3185,3212,1193,7825,104,6632,131
SC,83372,SÃO MARTINHO,1119,1284,260,2806,62,2546,81
SC,83399,SÃO MIGUEL DO OESTE,10741,10512,5266,27283,291,22017,473
SC,83410,SAUDADES,3122,2817,499,6648,81,6149,129
SC,83437,SCHROEDER,5373,3531,1430,10730,149,9300,247
SC,83453,SEARA,5949,5165,2155,13714,187,11559,258
SC,83470,SIDERÓPOLIS,3732,4643,1681,10453,149,8772,248
SC,83496,SOMBRIO,7277,7931,3453,19418,366,15965,391
SC,83518,TAIÓ,4238,6222,1516,12461,175,10945,310
SC,83534,TANGARÁ,2279,3323,1069,6876,89,5807,116
SC,83550,TIJUCAS,7083,11054,4215,23272,330,19057,590
SC,83577,TIMBÓ,7210,15038,3689,27171,422,23482,812
SC,83593,TRÊS BARRAS,4341,6009,2967,13716,147,10749,252
SC,83615,TREZE DE MAIO,2440,2373,737,5764,107,5027,107
SC,83631,TREZE TÍLIAS,1300,2348,870,4656,52,3786,86
SC,83658,TROMBUDO CENTRAL,1817,2252,668,4931,67,4263,127
SC,83674,TUBARÃO,26215,31421,12124,73017,1249,60893,2008
SC,83682,TUNÁPOLIS,1288,1752,378,3540,47,3162,75
SC,83690,TURVO,2924,4854,1338,9476,153,8138,207
SC,83712,URUBICI,2176,3746,1692,7778,55,6086,109
SC,83739,URUSSANGA,5259,7456,2839,16222,256,13383,412
SC,83755,VARGEÃO,1420,671,464,2649,31,2185,63
SC,83771,VIDAL RAMOS,2041,1750,523,4489,87,3966,88
SC,83798,VIDEIRA,13361,13684,6518,34794,500,28276,731
SC,83810,WITMARSUM,1409,981,420,2936,46,2516,80
SC,83836,XANXERÊ,16183,9146,5409,31690,371,26281,581
SC,83852,XAVANTINA,1546,1371,327,3341,41,3014,56
SC,83879,XAXIM,10177,5665,3159,19610,243,16451,366
SC,83895,BOM JARDIM DA SERRA,963,1650,712,3408,15,2696,68
SC,83917,MARACAJÁ,2399,1860,504,4985,104,4481,118
SC,83933,TIMBÉ DO SUL,1694,1993,510,4331,61,3821,73
SC,83950,CORREIA PINTO,3841,5214,2386,11843,193,9457,209
SC,83976,OTACÍLIO COSTA,3875,5311,2522,12056,156,9534,192
SE,31003,SANTANA DO SÃO FRANCISCO,2226,1539,1029,5003,101,3974,108
SE,31011,AMPARO DE SÃO FRANCISCO,958,550,524,2104,19,1580,53
SE,31038,AQUIDABÃ,4761,5677,4304,15401,197,11097,462
SE,31054,ARACAJU,132213,154000,70258,377868,7331,307610,14066
SE,31070,ARAUÁ,3918,2412,2150,8806,110,6656,216
SE,31097,AREIA BRANCA,3823,5084,1865,11241,151,9376,318
SE,31119,BARRA DOS COQUEIROS,5028,5413,1435,12486,274,11051,336
SE,31135,BREJO GRANDE,2327,1280,1482,5295,58,3813,148
SE,31151,BOQUIM,9470,4975,4713,20004,322,15291,524
SE,31194,CAMPO DO BRITO,5948,3600,3155,13239,171,10084,365
SE,31216,CANHOBA,1806,948,757,3679,52,2922,116
SE,31232,CANINDÉ DE SÃO FRANCISCO,9718,3451,4066,17871,165,13805,471
SE,31259,CAPELA,6956,8086,5100,21248,387,16148,719
SE,31275,CARIRA,5564,5081,4154,15376,146,11222,431
SE,31291,CARMÓPOLIS,5390,3039,2261,11141,213,8880,238
SE,31313,CEDRO DE SÃO JOÃO,2003,1419,865,4505,80,3640,138
SE,31330,CRISTINÁPOLIS,6287,1698,3709,12088,113,8379,281
SE,31356,NOSSA SENHORA APARECIDA,2983,2020,1165,6436,92,5271,176
SE,31372,CUMBE,1470,874,499,3011,55,2512,113
SE,31399,DIVINA PASTORA,1221,1204,569,3136,49,2567,93
SE,31410,ESTÂNCIA,21013,10889,9090,43108,958,34018,1158
SE,31437,FEIRA NOVA,1726,1755,934,4574,53,3640,106
SE,31453,FREI PAULO,4080,4030,1914,10439,119,8525,296
SE,31470,GENERAL MAYNARD,954,592,317,1950,30,1633,57
SE,31496,GARARU,4198,1992,1765,8314,88,6549,271
SE,31518,GRACCHO CARDOSO,2334,1214,1292,5065,80,3773,145
SE,31534,ILHA DAS FLORES,2526,1918,2407,7040,79,4633,110
SE,31550,INDIAROBA,5926,1621,2462,10445,148,7983,288
SE,31577,ITABAIANA,22436,24844,11062,60911,831,49849,1738
SE,31593,ITABAIANINHA,12988,6887,6571,27471,332,20900,693
SE,31615,ITABI,1707,1343,998,4273,78,3275,147
SE,31631,ITAPORANGA D'AJUDA,8535,8389,4276,22328,395,18052,733
SE,31658,JAPARATUBA,5831,3594,2870,12881,213,10011,373
SE,31674,JAPOATÃ,4090,2991,2453,9909,117,7456,258
SE,31690,LAGARTO,26217,22968,14118,66276,923,52158,2050
SE,31712,LARANJEIRAS,7478,7304,3107,18928,446,15821,593
SE,31739,MACAMBIRA,2349,1870,846,5288,86,4442,137
SE,31755,MALHADA DOS BOIS,1537,773,740,3179,51,2439,78
SE,31771,MALHADOR,3345,3413,1426,8744,191,7318,369
SE,31798,MARUIM,5377,3519,2204,11644,239,9440,305
SE,31810,MOITA BONITA,3026,3322,1516,8337,155,6821,318
SE,31836,MONTE ALEGRE DE SERGIPE,3864,2729,1985,8965,100,6980,287
SE,31852,MURIBECA,2099,2364,1516,6240,106,4724,155
SE,31879,NEÓPOLIS,5914,3916,3531,14021,231,10490,429
SE,31895,NOSSA SENHORA DA GLÓRIA,9798,6748,4797,22163,278,17366,542
SE,31917,NOSSA SENHORA DAS DORES,6634,6733,4081,18503,391,14422,664
SE,31933,NOSSA SENHORA DE LOURDES,2506,1409,855,4966,52,4111,144
SE,31950,NOSSA SENHORA DO SOCORRO,26124,38089,13749,81855,1596,68106,2297
SE,31976,PACATUBA,4750,2018,3464,10554,109,7090,213
SE,31992,PEDRA MOLE,1187,791,430,2522,33,2092,81
SE,32018,PEDRINHAS,3138,1617,1840,6865,86,5025,184
SE,32034,PINHÃO,2121,1620,839,4804,70,3965,154
SE,32050,PIRAMBU,2402,2533,1566,6782,102,5216,179
SE,32077,POÇO REDONDO,7151,4921,4350,17115,156,12765,537
SE,32093,POÇO VERDE,7476,4584,4675,17445,213,12770,497
SE,32115,PORTO DA FOLHA,7859,6263,5123,19976,250,14853,481
SE,32131,PROPRIÁ,7445,7640,4896,20689,329,15793,379
SE,32158,RIACHÃO DO DANTAS,8118,3019,3881,15724,190,11843,516
SE,32174,RIACHUELO,3122,2189,1069,6745,137,5676,228
SE,32190,RIBEIRÓPOLIS,5189,4737,2207,12701,161,10494,407
SE,32212,ROSÁRIO DO CATETE,2984,2385,1076,6772,144,5696,183
SE,32239,SALGADO,6841,3856,2540,13978,284,11438,457
SE,32255,SANTA LUZIA DO ITANHY,3943,2674,2551,9635,163,7084,304
SE,32298,SANTA ROSA DE LIMA,1394,1034,682,3281,71,2599,100
SE,32310,SANTO AMARO DAS BROTAS,4438,1370,2142,8304,107,6162,247
SE,32336,SÃO CRISTÓVÃO,18981,18685,8122,48502,1109,40380,1605
SE,32352,SÃO DOMINGOS,2818,2565,1754,7442,68,5688,237
SE,32379,SÃO FRANCISCO,1313,724,473,2628,44,2155,74
SE,32395,SÃO MIGUEL DO ALEIXO,1187,1065,655,3053,38,2398,108
SE,32417,SIMÃO DIAS,13329,9168,5979,30258,590,24279,1192
SE,32433,SIRIRI,2293,2139,1294,5973,111,4679,136
SE,32450,TELHA,1086,956,486,2604,23,2118,53
SE,32476,TOBIAS BARRETO,18730,8203,9234,37588,335,28354,1086
SE,32492,TOMAR DO GERU,4276,2313,3273,10309,124,7036,323
SE,32514,UMBAÚBA,6609,4645,3425,15355,288,11930,388
SP,61000,EUCLIDES DA CUNHA PAULISTA,3330,1933,2334,7826,79,5492,150
SP,61018,ADAMANTINA,7883,11950,6100,27227,632,21127,662
SP,61026,BOREBI,580,804,241,1690,21,1449,44
SP,61034,ADOLFO,1383,1036,610,3178,59,2568,90
SP,61042,TARUMÃ,3958,3541,1948,9754,142,7806,165
SP,61050,AGUAÍ,8041,8706,5311,23419,498,18108,863
SP,61069,MOTUCA,1244,1322,854,3561,71,2707,70
SP,61077,ÁGUAS DA PRATA,1634,2839,1335,6092,92,4757,192
SP,61085,IARAS,1404,1029,965,3524,49,2559,77
SP,61093,ÁGUAS DE LINDÓIA,2643,7038,2672,12936,195,10264,388
SP,61107,GUATAPARÁ,2026,1498,1114,4816,88,3702,90
SP,61115,ÁGUAS DE SÃO PEDRO,612,1841,602,3172,39,2570,78
SP,61123,DIRCE REIS,587,578,222,1445,34,1223,24
SP,61131,AGUDOS,7969,11936,5796,27578,695,21782,1182
SP,61140,ESPÍRITO SANTO DO TURVO,1428,1108,599,3216,23,2617,58
SP,61158,ALFREDO MARCONDES,1336,1281,459,3256,72,2797,108
SP,61166,ROSANA,6964,3663,5645,16796,215,11151,309
SP,61174,ALTAIR,1186,913,847,3089,45,2242,98
SP,61182,EMBAÚBA,720,1004,408,2233,45,1825,56
SP,61190,ALTINÓPOLIS,4318,5133,3020,13104,264,10084,369
SP,61204,ILHA SOLTEIRA,7542,6551,5391,20662,377,15271,801
SP,61212,ALTO ALEGRE,1275,1494,588,3563,77,2975,129
SP,61220,ALUMÍNIO,5899,4415,2433,13433,256,11000,430
SP,61239,ÁLVARES FLORENCE,890,1603,537,3192,67,2655,95
SP,61247,PEDRINHAS PAULISTA,811,1132,564,2590,19,2026,64
SP,61255,ÁLVARES MACHADO,5913,6682,3215,16544,315,13329,419
SP,61263,ARAÇARIGUAMA,3783,5117,2949,12245,170,9296,226
SP,61271,ÁLVARO DE CARVALHO,1084,1043,860,3161,51,2301,123
SP,61280,BERTIOGA,12181,12925,9673,35974,495,26301,700
SP,61298,ALVINLÂNDIA,1119,772,538,2488,30,1950,29
SP,61301,SUZANÁPOLIS,1241,800,430,2583,51,2153,61
SP,61310,AMERICANA,61359,62908,28878,163739,4070,134861,6524
SP,61328,SANTO ANTÔNIO DO ARACANGUÁ,2347,1997,667,5126,40,4459,75
SP,61336,AMÉRICO BRASILIENSE,11123,7711,4797,25130,542,20333,957
SP,61344,CANITAR,984,1529,786,3489,72,2703,118
SP,61352,AMÉRICO DE CAMPOS,1010,2568,597,4377,85,3780,117
SP,61360,BARRA DO CHAPÉU,2049,975,1169,4385,78,3216,114
SP,61379,AMPARO,11446,27209,9235,50519,813,41284,1816
SP,61387,EMILIANÓPOLIS,1029,869,348,2377,54,2029,77
SP,61395,ANALÂNDIA,876,2235,1405,4678,61,3273,101
SP,61409,NOVAIS,1082,1263,713,3248,76,2535,114
SP,61417,ANDRADINA,14781,16503,9997,43277,817,33280,1179
SP,61425,NOVA CANAÃ PAULISTA,827,652,295,1837,29,1542,34
SP,61433,ANGATUBA,5447,7088,3343,16715,319,13372,518
SP,61441,SALTINHO,1066,3400,553,5263,114,4710,130
SP,61450,ANHEMBI,1182,2168,1471,4962,50,3491,91
SP,61468,UBARANA,1846,1183,862,4052,73,3190,88
SP,61476,ANHUMAS,1155,1231,496,3001,40,2505,79
SP,61484,CAJATI,7688,7628,6508,22630,307,16122,499
SP,61492,APARECIDA,8447,13177,5027,27928,547,22901,730
SP,61506,CAMPINA DO MONTE ALEGRE,1361,1962,941,4419,52,3478,103
SP,61514,APARECIDA D'OESTE,1471,1390,847,3867,67,3020,92
SP,61522,ASPÁSIA,653,730,233,1660,18,1427,26
SP,61530,APIAÍ,7584,6051,6071,20500,318,14429,476
SP,61549,VARGEM,1756,3051,1638,6672,85,5034,142
SP,61557,ARAÇATUBA,38254,63020,27717,134884,1974,107167,3919
SP,61565,POTIM,3645,4707,2085,10778,148,8693,193
SP,61573,ARAÇOIABA DA SERRA,5329,9200,3143,18601,377,15458,552
SP,61581,ALAMBARI,980,1798,475,3347,31,2872,63
SP,61590,ARAMINA,1910,1290,761,4171,107,3410,103
SP,61603,ITAOCA,1223,690,715,2740,32,2025,80
SP,61611,ARANDU,1779,2091,940,5037,97,4097,130
SP,61620,TUIUTI,1127,2360,708,4408,75,3700,138
SP,61638,ARARAQUARA,51042,61108,29025,151210,3028,122185,7007
SP,61646,ARAPEÍ,884,765,541,2291,38,1750,63
SP,61654,ARARAS,21838,46119,15855,89035,1875,73180,3348
SP,61662,ESTIVA GERBI,2979,2971,1303,7649,139,6346,257
SP,61670,AREALVA,1780,2638,1106,5878,146,4772,208
SP,61689,ENGENHEIRO COELHO,4402,2997,2309,10079,158,7770,213
SP,61697,AREIAS,1310,1083,762,3271,34,2509,82
SP,61700,RIBEIRÃO GRANDE,2825,2113,1376,6536,88,5160,134
SP,61719,AREIÓPOLIS,2845,3292,1608,8168,232,6560,191
SP,61727,HORTOLÂNDIA,63264,30353,22350,123159,3107,100809,4085
SP,61735,ARIRANHA,2016,3327,1354,7046,151,5692,198
SP,61743,HOLAMBRA,2438,4677,1472,8915,137,7443,191
SP,61751,ARTUR NOGUEIRA,10802,10926,5185,28366,652,23181,801
SP,61760,ELISIÁRIO,1103,910,411,2493,34,2082,35
SP,61778,ARUJÁ,20841,22384,10636,56793,1123,46157,1809
SP,61786,BOM SUCESSO DE ITARARÉ,1118,1004,779,2944,15,2165,28
SP,61794,ASSIS,21069,27755,15215,67913,1549,52698,2325
SP,61808,PONTALINDA,1356,1061,792,3312,55,2520,48
SP,61816,ATIBAIA,20570,49421,19753,94169,1439,74416,2986
SP,61824,PARISI,609,925,324,1919,31,1595,30
SP,61832,AURIFLAMA,4936,3302,2287,11068,279,8781,264
SP,61840,TAQUARIVAÍ,1209,2124,1168,4584,23,3416,60
SP,61859,AVAÍ,1348,1493,740,3710,53,2970,76
SP,61867,MARAPOAMA,734,1123,367,2330,47,1963,59
SP,61875,AVANHANDAVA,2963,2582,1589,7459,154,5870,171
SP,61883,SÃO JOÃO DE IRACEMA,668,501,284,1508,21,1224,34
SP,61891,AVARÉ,14922,28929,12651,59766,1185,47115,2079
SP,61905,SÃO LOURENÇO DA SERRA,3550,3918,2155,10114,235,7959,256
SP,61913,BADY BASSITT,3939,4176,2364,11004,178,8640,347
SP,61921,ZACARIAS,795,785,322,1994,32,1672,60
SP,61930,BALBINOS,426,539,354,1390,23,1036,48
SP,61948,ITAPIRAPUÃ PAULISTA,1247,1018,662,3004,30,2342,47
SP,61956,BÁLSAMO,1812,3229,964,6361,185,5397,171
SP,61964,MESÓPOLIS,565,609,404,1638,33,1234,27
SP,61972,BANANAL,2835,3122,1626,8031,140,6405,308
SP,61980,NOVA CAMPINA,2064,2709,1550,6473,38,4923,112
SP,61999,BARBOSA,1483,2035,876,4569,62,3693,113
SP,62006,ILHA COMPRIDA,2178,2658,1841,6930,75,5089,178
SP,62014,BARÃO DE ANTONINA,797,952,423,2292,50,1869,70
SP,62022,LOURDES,690,800,383,1928,18,1545,37
SP,62030,BARIRI,4855,12024,5290,23543,567,18253,807
SP,62049,TORRE DE PEDRA,576,1043,741,2428,34,1687,34
SP,62057,BARRA BONITA,8417,13893,5928,29833,601,23905,994
SP,62065,ARCO-ÍRIS,694,805,325,1873,18,1548,31
SP,62073,BARRA DO TURVO,2730,1374,2643,6974,74,4331,153
SP,62081,BREJO ALEGRE,1018,597,304,2022,38,1718,65
SP,62090,BARRETOS,26481,34119,17697,82151,1575,64454,2279
SP,62103,CANAS,924,1634,563,3244,49,2681,74
SP,62111,BARRINHA,9751,5003,4521,20347,538,15826,534
SP,62120,PRACINHA,459,575,271,1352,18,1081,29
SP,62138,BARUERI,86635,66713,34972,198262,4070,163290,5872
SP,62146,PRATÂNIA,1017,1830,924,3945,76,3021,98
SP,62154,BASTOS,4042,8647,3866,17165,314,13299,296
SP,62162,QUADRA,621,1360,665,2713,30,2048,37
SP,62170,BATATAIS,11514,19637,8118,41358,807,33240,1282
SP,62189,SANTA CRUZ DA ESPERANÇA,470,710,432,1720,18,1288,90
SP,62197,BAURU,81455,96838,47791,243522,5803,195731,11635
SP,62200,SANTA SALETE,550,548,190,1352,34,1162,30
SP,62219,BEBEDOURO,13702,27115,12834,56408,1141,43574,1616
SP,62227,VITÓRIA BRASIL,527,636,229,1497,28,1268,77
SP,62235,BENTO DE ABREU,720,794,428,2059,48,1631,69
SP,62243,IPIGUÁ,1018,1423,601,3162,58,2561,62
SP,62251,BERNARDINO DE CAMPOS,2242,3999,1791,8422,137,6631,253
SP,62260,TAQUARAL,705,880,486,2162,51,1676,40
SP,62278,BILAC,1370,2957,1169,5770,107,4601,167
SP,62286,FERNÃO,427,624,284,1371,18,1087,18
SP,62294,BIRIGUI,21381,36732,13247,76075,1715,62828,3000
SP,62308,GAVIÃO PEIXOTO,1407,1304,424,3297,79,2873,83
SP,62316,BIRITIBA MIRIM,5790,10039,4319,20972,369,16653,455
SP,62324,JUMIRIM,555,1013,387,2030,20,1643,55
SP,62332,BOA ESPERANÇA DO SUL,4355,3149,2154,10043,150,7889,235
SP,62340,NANTES,969,690,414,2121,18,1707,30
SP,62359,BOCAINA,1898,4244,1517,8054,129,6537,266
SP,62367,NOVA CASTILHO,444,522,220,1214,9,994,19
SP,62375,BOFETE,2179,2739,2154,7408,148,5254,188
SP,62383,OUROESTE,2813,2045,1446,6626,107,5180,215
SP,62391,BOITUVA,8121,16791,6947,33628,586,26681,1183
SP,62405,PAULISTÂNIA,454,648,319,1472,20,1153,31
SP,62413,BOM JESUS DOS PERDÕES,4088,6320,2844,13876,246,11032,378
SP,62421,RIBEIRÃO DOS ÍNDIOS,815,707,338,1966,61,1628,45
SP,62430,BORÁ,384,335,191,951,13,760,28
SP,62448,TRABIJU,491,607,239,1372,14,1133,21
SP,62456,BORACÉIA,1291,1278,562,3307,68,2745,108
SP,62472,BORBOREMA,2533,5688,2577,11334,226,8757,310
SP,62499,BOTUCATU,24292,39752,17734,88616,2049,70882,4789
SP,62510,BRAGANÇA PAULISTA,25361,57440,21265,109471,1879,88206,3526
SP,62553,BRAÚNA,929,2077,577,3754,80,3177,91
SP,62570,BRODOWSKI,4607,6546,2835,14762,264,11927,510
SP,62596,BROTAS,3608,8256,3893,16613,323,12720,533
SP,62618,BURI,3960,6416,3381,14202,238,10821,207
SP,62634,BURITAMA,4134,4559,2828,12049,217,9221,311
SP,62650,BURITIZAL,685,1628,416,2879,58,2463,92
SP,62677,CABRÁLIA PAULISTA,1440,1113,924,3655,73,2731,105
SP,62693,CABREÚVA,11220,10796,5552,28903,538,23351,797
SP,62715,CAÇAPAVA,16802,32402,11664,64376,1320,52712,2188
SP,62731,CACHOEIRA PAULISTA,8720,8633,5044,23576,485,18532,694
SP,62758,CACONDE,3910,6056,3374,13859,196,10485,323
SP,62774,CAFELÂNDIA,3792,5638,3183,13170,239,9987,318
SP,62790,CAIABU,1656,1106,656,3534,60,2878,56
SP,62812,CAIEIRAS,24685,20129,9672,58265,1523,48593,2256
SP,62839,CAIUÁ,1817,1030,987,3946,43,2959,69
SP,62855,CAJAMAR,21675,16387,8453,48855,1004,40402,1336
SP,62871,CAJOBI,2701,3148,1699,7896,146,6197,202
SP,62898,CAJURU,5847,7074,4125,17938,316,13813,576
SP,62910,CAMPINAS,269856,288115,153916,761338,17407,607422,32044
SP,62936,CAMPO LIMPO PAULISTA,23473,18809,10230,56040,1116,45810,2412
SP,62952,CAMPOS DO JORDÃO,6775,19903,9170,37451,639,28281,964
SP,62979,CAMPOS NOVOS PAULISTA,1012,1540,721,3443,71,2722,99
SP,62995,CANANÉIA,2673,3638,3203,9864,125,6661,225
SP,63010,CÂNDIDO MOTA,7090,10914,5205,24442,597,19237,636
SP,63037,CÂNDIDO RODRIGUES,836,980,420,2383,69,1963,78
SP,63053,CAPÃO BONITO,10109,15401,8865,35866,607,27001,884
SP,63070,CAPELA DO ALTO,3670,5656,2138,11958,251,9820,243
SP,63096,CAPIVARI,8415,16840,6391,33435,686,27044,1103
SP,63118,CARAGUATATUBA,20732,28965,15891,68781,1284,52890,1909
SP,63134,CARAPICUÍBA,122833,78786,44570,260969,6122,216399,8658
SP,63150,CARDOSO,3771,3150,2514,9910,188,7396,287
SP,63177,CASA BRANCA,5073,9345,4962,20507,424,15545,703
SP,63193,CÁSSIA DOS COQUEIROS,692,1115,627,2595,42,1968,119
SP,63215,CASTILHO,6251,3435,1924,12196,262,10272,324
SP,63231,CATANDUVA,23180,38036,15679,81142,1425,65463,2822
SP,63258,CATIGUÁ,2260,1979,877,5511,133,4634,262
SP,63274,CEDRAL,1803,2789,961,5912,141,4951,218
SP,63290,CERQUEIRA CÉSAR,3393,6229,2955,13174,250,10219,347
SP,63312,CERQUILHO,7110,14952,4704,28351,548,23647,1037
SP,63339,CESÁRIO LANGE,2389,5862,2138,11035,242,8897,404
SP,63355,CHARQUEADA,3158,5964,2419,12135,223,9716,371
SP,63371,CHAVANTES,3050,3943,1929,9403,192,7474,289
SP,63398,CLEMENTINA,1643,2025,1093,4983,62,3890,160
SP,63410,COLINA,4937,5149,3404,14112,233,10708,389
SP,63436,COLÔMBIA,1829,1821,1391,5249,96,3858,112
SP,63452,CONCHAL,4899,9335,3611,18727,412,15116,470
SP,63479,CONCHAS,3445,5737,3671,13475,220,9804,402
SP,63495,CORDEIRÓPOLIS,4638,7498,2772,15808,332,13036,568
SP,63517,COROADOS,1115,1864,781,3926,57,3145,109
SP,63533,CORONEL MACEDO,1772,1407,801,4136,53,3335,103
SP,63550,CORUMBATAÍ,613,1710,852,3303,51,2451,77
SP,63576,COSMÓPOLIS,18325,12074,7868,40830,1160,32962,1403
SP,63592,COSMORAMA,1764,2699,959,5660,100,4701,138
SP,63614,COTIA,53800,49242,22797,132000,2457,109203,3704
SP,63630,CRAVINHOS,4937,12547,4712,23552,486,18840,870
SP,63657,CRISTAIS PAULISTA,1872,2757,1254,6101,78,4847,140
SP,63673,CRUZÁLIA,737,977,388,2164,32,1776,30
SP,63690,CRUZEIRO,14943,28681,10466,57421,1138,46955,2193
SP,63711,CUBATÃO,44125,27319,17398,93288,1879,75890,2567
SP,63738,CUNHA,7470,5638,5210,19121,319,13911,484
SP,63754,DESCALVADO,4987,13429,4822,24623,560,19801,825
SP,63770,DIADEMA,160238,80874,53340,312305,6741,258965,11112
SP,63797,DIVINOLÂNDIA,2291,4980,2210,10010,211,7800,318
SP,63819,DOBRADA,2027,2080,671,5037,121,4366,138
SP,63835,DOIS CÓRREGOS,4089,9230,4126,18273,384,14147,444
SP,63851,DOLCINÓPOLIS,1061,613,315,2070,27,1755,54
SP,63878,DOURADO,1714,3584,1533,7229,172,5696,226
SP,63894,DRACENA,10083,14525,4890,30790,621,25900,671
SP,63916,DUARTINA,3273,4109,1461,9406,195,7945,368
SP,63932,DUMONT,1803,2731,1077,5904,155,4827,138
SP,63959,ECHAPORÃ,1671,1968,1474,5307,65,3833,129
SP,63975,ELDORADO,4344,3286,3587,11590,139,8003,234
SP,63991,ELIAS FAUSTO,4385,4603,2939,12479,219,9540,333
SP,64017,EMBU,76563,56407,28705,170581,3894,141876,5012
SP,64033,EMBU-GUAÇU,19381,15640,9707,46904,940,37197,1236
SP,64050,ESTRELA D'OESTE,2101,2993,1284,6740,169,5456,193
SP,64076,ESTRELA DO NORTE,784,1000,430,2307,49,1877,44
SP,64092,FARTURA,3647,5368,2825,12376,217,9551,319
SP,64114,FERNANDÓPOLIS,20504,16143,10657,49459,990,38802,1165
SP,64130,FERNANDO PRESTES,1547,1833,981,4679,180,3698,138
SP,64157,FERRAZ DE VASCONCELOS,53711,30485,19176,109865,2691,90689,3802
SP,64173,FLORA RICA,738,537,397,1725,19,1328,34
SP,64190,FLOREAL,961,959,433,2508,72,2075,83
SP,64211,FLÓRIDA PAULISTA,3199,3261,1184,8000,178,6816,178
SP,64238,FLORÍNEA,1076,799,592,2559,49,1967,43
SP,64254,FRANCA,68968,101563,37939,218780,4177,180841,6133
SP,64270,FRANCISCO MORATO,51461,23993,18539,99210,2233,80671,2984
SP,64297,FRANCO DA ROCHA,41983,23608,15459,87013,2175,71554,3788
SP,64319,GABRIEL MONTEIRO,492,1387,488,2490,35,2002,88
SP,64335,GÁLIA,1597,2214,1484,5519,97,4035,127
SP,64351,GARÇA,6936,17645,7966,34143,677,26177,919
SP,64378,GASTÃO VIDIGAL,1496,876,761,3252,58,2491,61
SP,64394,GENERAL SALGADO,3129,3306,1201,7951,138,6750,177
SP,64416,GETULINA,2585,3188,2391,8488,136,6097,188
SP,64432,GLICÉRIO,1495,1286,853,3794,63,2941,97
SP,64459,GUAIÇARA,2993,2895,1765,7947,145,6182,149
SP,64475,GUAIMBÉ,1610,1542,897,4233,68,3336,116
SP,64491,GUAÍRA,10326,11068,6543,28855,413,22312,505
SP,64513,GUAPIAÇU,5065,5284,2740,13588,219,10848,280
SP,64530,GUAPIARA,6237,4121,4751,15622,164,10871,349
SP,64556,GUARÁ,6493,4739,3318,14995,181,11677,264
SP,64572,GUARAÇAÍ,2626,2395,1677,7036,149,5359,189
SP,64599,GUARACI,3215,2539,2172,8180,115,6008,139
SP,64610,GUARANI D'OESTE,632,520,309,1514,17,1205,36
SP,64637,GUARANTÃ,1792,2121,1219,5319,95,4100,92
SP,64653,GUARARAPES,7544,9889,5570,24121,459,18551,659
SP,64670,GUARAREMA,5962,9682,3490,19974,344,16484,496
SP,64696,GUARATINGUETÁ,24321,40707,16173,86093,1748,69920,3144
SP,64718,GUAREÍ,2459,4062,1827,8876,236,7049,292
SP,64734,GUARIBA,10781,9799,5031,26733,555,21702,567
SP,64750,GUARUJÁ,91185,69198,38894,211252,4871,172358,7104
SP,64777,GUARULHOS,299757,311328,125229,788694,18003,663465,34377
SP,64793,GUZOLÂNDIA,1717,1018,586,3478,74,2892,83
SP,64815,HERCULÂNDIA,2831,2143,1455,6723,97,5268,197
SP,64831,IACANGA,1960,3325,1054,6645,128,5591,178
SP,64858,IACRI,1645,2297,1114,5239,79,4125,104
SP,64874,IBATÉ,7037,10354,4227,22879,539,18652,722
SP,64890,IBIRÁ,1813,3997,1574,7778,153,6204,241
SP,64912,IBIRAREMA,1320,2420,773,4806,161,4033,132
SP,64939,IBITINGA,11651,18281,7803,39958,899,32155,1324
SP,64955,IBIÚNA,10681,29250,12200,54044,637,41844,1276
SP,64971,ICÉM,2438,2126,1648,6437,86,4789,139
SP,64998,IEPÊ,1431,3078,1098,5798,65,4700,126
SP,65013,IGARAÇU DO TIETÊ,6718,6978,3484,18441,549,14957,712
SP,65030,IGARAPAVA,7803,6986,5907,21713,484,15806,533
SP,65056,IGARATÁ,2361,2966,1155,6786,117,5631,187
SP,65072,IGUAPE,7035,8271,6639,22827,320,16188,562
SP,65099,ILHABELA,4854,10064,4650,20204,238,15554,398
SP,65110,INDAIATUBA,49858,51100,23659,133413,3332,109754,5464
SP,65137,INDIANA,1547,1694,818,4278,87,3460,132
SP,65153,INDIAPORÃ,1201,1127,489,2922,41,2433,64
SP,65170,INÚBIA PAULISTA,774,1504,447,2842,58,2395,59
SP,65196,IPAUSSU,2776,4721,2075,10029,199,7954,258
SP,65218,IPERÓ,6463,5522,3504,16245,306,12741,450
SP,65234,IPEÚNA,1278,2090,1028,4584,65,3556,123
SP,65250,IPORANGA,1584,689,1129,3504,38,2375,64
SP,65277,IPUÃ,3986,3679,2310,10335,172,8025,188
SP,65293,IRACEMÁPOLIS,4613,7283,2194,14856,305,12662,461
SP,65315,IRAPUÃ,1673,2338,1275,5574,134,4299,154
SP,65331,IRAPURU,1732,2315,1049,5341,118,4292,127
SP,65358,ITABERÁ,5562,4870,2833,13747,208,10914,274
SP,65374,ITAÍ,6114,5976,3591,16312,291,12721,340
SP,65390,ITAJOBI,2916,6177,2512,12211,273,9699,333
SP,65412,ITAJU,594,1352,588,2665,57,2077,74
SP,65439,ITANHAÉM,19569,23644,17646,63544,1059,45898,1626
SP,65455,ITAPECERICA DA SERRA,47185,31696,18458,102033,2096,83575,2598
SP,65471,ITAPETININGA,24277,49721,19415,98921,2045,79506,3463
SP,65498,ITAPEVA,16792,31536,14175,64567,857,50392,1207
SP,65510,ITAPEVI,65058,34061,22695,128169,2873,105474,3482
SP,65536,ITAPIRA,11343,28540,9678,52893,1202,43215,2130
SP,65552,ITÁPOLIS,8451,13010,7106,30353,753,23247,1033
SP,65579,ITAPORANGA,2949,5138,1902,10491,212,8589,290
SP,65595,ITAPUÍ,2309,3982,1650,8314,167,6664,206
SP,65617,ITAPURA,1692,575,970,3361,57,2391,67
SP,65633,ITAQUAQUECETUBA,91126,54904,34663,191064,4560,156401,5811
SP,65650,ITARARÉ,9333,16934,9301,36906,618,27605,720
SP,65676,ITARIRI,2641,3405,2618,8963,116,6345,183
SP,65692,ITATIBA,17347,34764,12601,68135,1200,55534,2223
SP,65714,ITATINGA,3484,6041,2735,12902,284,10167,358
SP,65730,ITIRAPINA,2708,4017,2296,9482,166,7186,295
SP,65757,ITIRAPUÃ,2007,1523,984,4693,64,3709,115
SP,65773,ITOBI,2341,2171,1373,6137,115,4764,137
SP,65790,ITU,32691,51204,22233,112495,2186,90262,4181
SP,65811,ITUPEVA,9220,11194,5478,27206,460,21728,854
SP,65838,ITUVERAVA,9840,11129,7805,30016,567,22211,675
SP,65854,JABORANDI,2294,1390,670,4642,155,3972,133
SP,65870,JABOTICABAL,12008,25509,12177,51959,933,39782,1332
SP,65897,JACAREÍ,48951,68044,27140,151373,2543,124233,4695
SP,65919,JACI,1798,1712,797,4496,96,3699,93
SP,65935,JACUPIRANGA,3433,5685,3960,13504,174,9544,252
SP,65951,JAGUARIÚNA,8876,14562,6270,31330,692,25060,930
SP,65978,JALES,11645,15753,8090,37333,796,29243,1049
SP,65994,JAMBEIRO,1086,2037,664,3920,46,3256,87
SP,66010,JANDIRA,31933,25213,12875,73537,1577,60662,1939
SP,66036,JARDINÓPOLIS,6823,11628,5529,25231,524,19702,727
SP,66052,JARINU,4928,7243,4005,16867,242,12862,449
SP,66079,JAÚ,22439,49177,16509,93264,1933,76755,3206
SP,66095,JERIQUARA,1188,971,979,3261,54,2282,69
SP,66117,JOANÓPOLIS,2337,4253,1824,8821,143,6997,264
SP,66133,JOÃO RAMALHO,1222,1365,979,3718,55,2739,97
SP,66150,JOSÉ BONIFÁCIO,7152,10824,4409,23515,565,19106,565
SP,66176,JÚLIO MESQUITA,1624,1116,559,3463,82,2904,82
SP,66192,JUNDIAÍ,87527,117146,47851,270140,5091,222289,12525
SP,66214,JUNQUEIRÓPOLIS,4150,5960,1903,12565,236,10662,316
SP,66230,JUQUIÁ,4596,6168,5928,17222,171,11294,359
SP,66257,JUQUITIBA,7006,8371,5345,21530,335,16185,473
SP,66273,LAGOINHA,1086,2653,1145,5067,87,3922,96
SP,66290,LARANJAL PAULISTA,3876,11103,3715,19504,271,15789,539
SP,66311,LAVÍNIA,1844,1215,676,3927,69,3251,123
SP,66338,LAVRINHAS,1757,2482,1036,5522,103,4486,144
SP,66354,LEME,23540,27484,11625,66482,1471,54857,2362
SP,66370,LENÇÓIS PAULISTA,9976,23995,7544,44111,1068,36567,1528
SP,66397,LIMEIRA,62736,84646,36094,195464,4649,159370,7339
SP,66419,LINDÓIA,976,2859,892,4934,73,4042,134
SP,66435,LINS,13196,25454,12298,53631,1020,41333,1663
SP,66451,LORENA,16163,29291,12894,61818,1371,48924,2099
SP,66478,LOUVEIRA,8396,12933,5613,28157,501,22544,714
SP,66494,LUCÉLIA,4702,5885,3709,14907,220,11198,391
SP,66516,LUCIANÓPOLIS,698,744,356,1876,30,1520,48
SP,66532,LUÍS ANTÔNIO,3314,2596,1487,7775,141,6288,237
SP,66559,LUIZIÂNIA,1517,1411,953,4018,47,3065,90
SP,66575,LUPÉRCIO,1472,1223,870,3697,63,2827,69
SP,66591,LUTÉCIA,997,828,498,2429,50,1931,56
SP,66613,MACATUBA,3764,5741,2744,12906,270,10162,387
SP,66630,MACAUBAL,1336,3251,960,5888,185,4928,156
SP,66656,MACEDÔNIA,1207,1036,559,2966,70,2407,94
SP,66672,MAGDA,1162,943,616,2850,71,2234,58
SP,66699,MAIRINQUE,13849,12117,6940,34520,689,27580,925
SP,66710,MAIRIPORÃ,16087,22857,10588,52095,952,41507,1611
SP,66737,MANDURI,2065,3198,1571,7174,148,5603,192
SP,66753,MARABÁ PAULISTA,1362,1034,945,3459,48,2514,70
SP,66770,MARACAÍ,4414,3744,1619,10245,210,8626,258
SP,66796,MARIÁPOLIS,1268,1125,680,3237,81,2557,83
SP,66818,MARÍLIA,40198,76945,31990,157606,3265,125616,5208
SP,66834,MARINÓPOLIS,691,808,444,2021,37,1577,41
SP,66850,MARTINÓPOLIS,4419,8900,4126,18174,281,14048,448
SP,66877,MATÃO,20924,25506,10566,60250,1213,49684,2041
SP,66893,MAUÁ,124708,94076,46856,283964,6137,237108,12187
SP,66915,MENDONÇA,1617,1231,695,3669,58,2974,68
SP,66931,MERIDIANO,1313,1167,761,3381,66,2620,74
SP,66958,MIGUELÓPOLIS,6209,5269,4575,16553,209,11978,291
SP,66974,MINEIROS DO TIETÊ,2505,4192,1792,8933,212,7141,232
SP,66990,MIRACATU,5229,5560,5546,16810,176,11264,299
SP,67016,MIRA ESTRELA,985,779,469,2358,63,1889,62
SP,67032,MIRANDÓPOLIS,6807,7355,4740,20178,493,15438,783
SP,67059,MIRANTE DO PARANAPANEMA,5842,3883,3853,14055,199,10202,278
SP,67075,MIRASSOL,12197,16905,7761,38891,807,31130,1221
SP,67091,MIRASSOLÂNDIA,970,1672,626,3408,69,2782,71
SP,67113,MOCOCA,9694,28393,12007,52735,966,40728,1675
SP,67130,MOGI DAS CRUZES,80686,126106,46124,268116,5664,221992,9536
SP,67156,MOGI GUAÇU,34524,43951,18359,103633,2701,85274,4098
SP,67172,MOGI MIRIM,13348,34699,11856,63449,1335,51593,2211
SP,67199,MOMBUCA,723,1304,437,2615,65,2178,86
SP,67210,MONÇÕES,693,670,287,1792,78,1505,64
SP,67237,MONGAGUÁ,11645,12479,10028,35368,442,25340,774
SP,67253,MONTE ALEGRE DO SUL,1341,2726,754,5115,88,4361,206
SP,67270,MONTE ALTO,9860,16547,7635,35844,836,28209,966
SP,67296,MONTE APRAZÍVEL,5381,6176,2406,14767,333,12361,471
SP,67318,MONTE AZUL PAULISTA,4294,6844,3611,15565,351,11954,465
SP,67334,MONTE CASTELO,1629,828,523,3099,46,2576,73
SP,67350,MONTEIRO LOBATO,976,1544,535,3213,56,2678,102
SP,67377,MONTE MOR,15171,9984,7471,34526,828,27055,1072
SP,67393,MORRO AGUDO,6838,8292,3866,19848,336,15982,516
SP,67415,MORUNGABA,2001,5164,1386,8991,149,7605,291
SP,67431,MURUTINGA DO SUL,1247,1282,739,3432,52,2693,112
SP,67458,NARANDIBA,1401,1350,704,3556,36,2852,65
SP,67474,NATIVIDADE DA SERRA,1651,2672,1840,6446,90,4606,193
SP,67490,NAZARÉ PAULISTA,4170,5000,3044,12826,204,9782,408
SP,67512,NEVES PAULISTA,2811,2652,1441,7331,197,5890,230
SP,67539,NHANDEARA,2298,3637,1300,7615,193,6315,187
SP,67555,NIPOÃ,1318,1323,710,3500,65,2790,84
SP,67571,NOVA ALIANÇA,1801,1884,790,4779,95,3989,209
SP,67598,NOVA EUROPA,2845,2683,1726,7578,124,5852,200
SP,67610,NOVA GRANADA,5125,5572,3261,14654,279,11393,417
SP,67636,NOVA GUATAPORANGA,849,520,241,1680,27,1439,43
SP,67652,NOVA INDEPENDÊNCIA,1048,783,414,2346,37,1932,64
SP,67679,NOVA LUZITÂNIA,1131,1044,391,2642,26,2251,50
SP,67695,NOVA ODESSA,16937,12012,6422,37688,950,31266,1367
SP,67717,NOVO HORIZONTE,7738,12436,5668,27073,567,21405,664
SP,67733,NUPORANGA,1291,2818,571,4927,106,4356,141
SP,67750,OCAUÇU,1098,1325,698,3313,80,2615,112
SP,67776,ÓLEO,656,1244,555,2584,51,2029,78
SP,67792,OLÍMPIA,11262,16268,8032,37221,715,29189,944
SP,67814,ONDA VERDE,1299,1140,635,3190,53,2555,63
SP,67830,ORIENTE,1763,2028,604,4648,100,4044,153
SP,67857,ORINDIÚVA,1540,1870,924,4503,60,3579,109
SP,67873,ORLÂNDIA,8038,14529,5826,29827,511,24001,923
SP,67890,OSASCO,221584,184677,94537,531965,11016,437428,20151
SP,67911,OSCAR BRESSANE,672,1156,545,2463,40,1918,50
SP,67938,OSVALDO CRUZ,6714,10710,5697,24149,410,18452,618
SP,67954,OURINHOS,22712,31317,16088,73786,1507,57698,2162
SP,67970,OURO VERDE,2863,1609,821,5477,72,4656,112
SP,67997,PACAEMBU,2503,4015,1975,8849,166,6874,190
SP,68012,PALESTINA,2294,3791,1240,7667,148,6427,194
SP,68039,PALMARES PAULISTA,3081,2249,1307,7014,165,5707,212
SP,68055,PALMEIRA D'OESTE,3157,2573,1696,7781,165,6085,190
SP,68071,PALMITAL,4577,7747,3657,16760,364,13103,415
SP,68098,PANORAMA,3852,3667,2404,10240,142,7836,175
SP,68110,PARAGUAÇU PAULISTA,11197,11626,7013,31320,714,24307,770
SP,68136,PARAIBUNA,4930,5255,2969,13647,161,10678,332
SP,68152,PARAÍSO,1704,1991,880,4826,77,3946,174
SP,68179,PARANAPANEMA,5166,4687,2849,13191,203,10342,286
SP,68195,PARANAPUÃ,1141,1106,348,2726,72,2378,59
SP,68217,PARAPUÃ,2718,3417,2063,8681,185,6618,298
SP,68233,PARDINHO,1277,2014,1117,4620,84,3503,128
SP,68250,PARIQUERA-AÇU,4456,5854,3745,14601,213,10856,333
SP,68276,PATROCÍNIO PAULISTA,2626,5013,1940,9952,157,8012,216
SP,68292,PAULICÉIA,1785,1689,983,4616,77,3633,82
SP,68314,PAULÍNIA,21757,18350,8004,51649,1526,43645,2012
SP,68330,PAULO DE FARIA,2466,2336,1424,6483,70,5059,187
SP,68357,PEDERNEIRAS,10550,12009,5749,29973,692,24224,973
SP,68373,PEDRA BELA,1627,1784,987,4571,66,3584,107
SP,68390,PEDRANÓPOLIS,905,743,276,2005,38,1729,43
SP,68411,PEDREGULHO,5205,4060,3661,13502,245,9841,331
SP,68438,PEDREIRA,9683,14227,5331,31239,684,25908,1314
SP,68454,PEDRO DE TOLEDO,2699,2237,2422,7638,105,5216,175
SP,68470,PENÁPOLIS,14654,17949,9531,44540,876,35009,1530
SP,68497,PEREIRA BARRETO,6365,7771,5280,20070,291,14790,363
SP,68519,PEREIRAS,1708,2761,1631,6318,102,4687,116
SP,68535,PERUÍBE,13925,19377,14291,49508,730,35217,1185
SP,68551,PIACATU,1172,2069,784,4179,45,3395,109
SP,68578,PIEDADE,9502,19294,7522,37849,641,30327,890
SP,68594,PILAR DO SUL,6009,9038,3719,19440,277,15721,397
SP,68616,PINDAMONHANGABA,28228,48736,18415,100759,2021,82344,3359
SP,68632,PINDORAMA,3674,4693,2103,11121,265,9018,386
SP,68659,ESPÍRITO SANTO DO PINHAL,7739,16477,7171,33146,721,25975,1038
SP,68675,PINHALZINHO,2706,4419,2046,9632,159,7586,302
SP,68691,PIQUEROBI,1426,822,565,2943,51,2378,79
SP,68713,PIQUETE,3128,5088,1732,10566,197,8834,421
SP,68730,PIRACAIA,4832,9924,4526,20131,292,15605,557
SP,68756,PIRACICABA,69669,129866,47876,263714,5896,215838,10407
SP,68772,PIRAJU,6349,9463,5345,22371,446,17026,768
SP,68799,PIRAJUÍ,4087,6649,3871,15403,373,11532,423
SP,68810,PIRANGI,2072,3761,1520,7779,192,6259,234
SP,68837,PIRAPORA DO BOM JESUS,4043,3463,1862,9744,163,7882,213
SP,68853,PIRAPOZINHO,6699,7588,4269,19377,354,15108,467
SP,68870,PIRASSUNUNGA,12723,25254,11475,52781,1343,41306,1986
SP,68896,PIRATININGA,2494,3787,1226,7992,181,6766,304
SP,68918,PITANGUEIRAS,8814,9269,6236,25566,523,19330,724
SP,68934,PLANALTO,1403,1221,692,3481,74,2789,91
SP,68950,PLATINA,885,1013,546,2572,69,2026,59
SP,68977,POÁ,37116,26690,15089,84045,2124,68956,3026
SP,68993,POLONI,1231,2018,901,4378,111,3477,117
SP,69019,POMPÉIA,3855,7899,1929,14405,227,12476,495
SP,69035,PONGAÍ,760,1635,521,3064,62,2543,86
SP,69051,PONTAL,10494,9155,6240,27270,577,21030,804
SP,69078,PONTES GESTAL,768,866,427,2142,33,1715,48
SP,69094,POPULINA,1511,1058,541,3332,102,2791,120
SP,69116,PORANGABA,1958,2729,1377,6324,94,4947,166
SP,69132,PORTO FELIZ,10475,17097,6948,36411,755,29463,1136
SP,69159,PORTO FERREIRA,9624,19986,7074,38570,822,31496,1064
SP,69175,POTIRENDABA,3739,5096,2571,12126,302,9555,418
SP,69191,PRADÓPOLIS,4756,4750,2756,12948,322,10192,364
SP,69213,PRAIA GRANDE,58430,63489,37385,166903,2885,129518,4714
SP,69230,PRESIDENTE ALVES,1088,1474,567,3245,49,2678,67
SP,69256,PRESIDENTE BERNARDES,3626,4373,2804,11217,201,8413,213
SP,69272,PRESIDENTE EPITÁCIO,11077,10787,7418,30576,571,23158,723
SP,69299,PRESIDENTE PRUDENTE,42635,72236,34865,157132,2874,122267,4522
SP,69310,PRESIDENTE VENCESLAU,8015,13207,6525,29132,550,22607,835
SP,69337,PROMISSÃO,11038,8182,6088,26643,600,20555,735
SP,69353,QUATÁ,2641,4747,2421,10223,177,7802,237
SP,69370,QUEIROZ,1139,659,497,2357,24,1860,38
SP,69396,QUELUZ,2898,2529,1885,7598,117,5713,169
SP,69418,QUINTANA,1758,1858,926,4797,99,3871,156
SP,69434,RAFARD,1987,3542,1110,6989,126,5879,224
SP,69450,RANCHARIA,6818,10356,5411,23489,404,18078,500
SP,69477,REDENÇÃO DA SERRA,1028,1677,890,3735,51,2845,89
SP,69493,REGENTE FEIJÓ,4245,6843,2809,14502,269,11693,336
SP,69515,REGINÓPOLIS,1035,2165,814,4272,93,3458,165
SP,69531,REGISTRO,11796,18537,10636,42320,533,31684,818
SP,69558,RESTINGA,2393,1735,1139,5480,95,4341,118
SP,69574,RIBEIRA,1126,932,497,2641,28,2144,58
SP,69590,RIBEIRÃO BONITO,2436,3888,1577,8392,175,6815,316
SP,69612,RIBEIRÃO BRANCO,6051,4000,3992,14416,105,10424,268
SP,69639,RIBEIRÃO CORRENTE,1211,1486,702,3506,34,2804,73
SP,69655,RIBEIRÃO DO SUL,1655,1209,606,3621,51,3015,100
SP,69671,RIBEIRÃO PIRES,31113,33330,15142,85083,1813,69941,3685
SP,69698,RIBEIRÃO PRETO,114115,178183,86067,405927,7779,319860,19783
SP,69710,RIVERSUL,1857,1621,1152,4855,98,3703,127
SP,69736,RIFAINA,1264,1419,1142,3932,58,2790,49
SP,69752,RINCÃO,2585,3109,1618,7749,192,6131,245
SP,69779,RINÓPOLIS,2001,3723,1672,7713,132,6041,185
SP,69795,RIO CLARO,35598,65553,25085,135465,2559,110380,6670
SP,69817,RIO DAS PEDRAS,7082,10156,4291,22727,502,18436,696
SP,69833,RIO GRANDE DA SERRA,13413,11106,5890,32133,695,26243,1029
SP,69850,RIOLÂNDIA,2178,2909,1858,7152,82,5294,125
SP,69876,ROSEIRA,2038,3581,1474,7356,118,5882,145
SP,69892,RUBIÁCEA,681,952,537,2291,57,1754,64
SP,69914,RUBINÉIA,917,783,423,2224,42,1801,59
SP,69930,SABINO,2058,1307,1049,4622,81,3573,127
SP,69957,SAGRES,775,728,335,1900,16,1565,46
SP,69973,SALES,1135,2093,860,4285,76,3425,121
SP,69990,SALES OLIVEIRA,2229,3761,1297,7710,151,6413,272
SP,70017,SALESÓPOLIS,3859,6640,2859,13977,259,11118,360
SP,70033,SALMOURÃO,1342,1574,809,3863,61,3054,77
SP,70050,SALTO,31047,28546,13307,77256,1593,63949,2763
SP,70076,SALTO DE PIRAPORA,9032,10853,5141,26571,687,21430,858
SP,70092,SALTO GRANDE,1781,2931,1728,6745,122,5017,183
SP,70114,SANDOVALINA,1148,1138,754,3107,16,2353,51
SP,70130,SANTA ADÉLIA,3656,4619,2425,11282,232,8857,350
SP,70157,SANTA ALBERTINA,1479,1897,876,4458,95,3582,111
SP,70173,SANTA BÁRBARA D'OESTE,59587,39322,21961,129516,3427,107555,5219
SP,70190,ÁGUAS DE SANTA BÁRBARA,1240,1929,1260,4670,94,3410,147
SP,70211,SANTA BRANCA,3176,5200,2614,11463,189,8849,284
SP,70238,SANTA CLARA D'OESTE,720,787,402,2003,44,1601,50
SP,70254,SANTA CRUZ DA CONCEIÇÃO,1094,1383,566,3219,60,2653,116
SP,70270,SANTA CRUZ DAS PALMEIRAS,5453,10922,4424,21759,445,17335,515
SP,70297,SANTA CRUZ DO RIO PARDO,6417,18087,6693,32781,653,26088,931
SP,70319,SANTA ERNESTINA,2027,1607,823,4693,96,3870,140
SP,70335,SANTA FÉ DO SUL,7027,9814,5379,23344,495,17965,629
SP,70351,SANTA GERTRUDES,5609,6270,2635,15420,348,12785,558
SP,70378,SANTA ISABEL,11899,16770,6475,36937,650,30462,1143
SP,70394,SANTA LÚCIA,3691,1947,1605,7728,187,6123,298
SP,70416,SANTA MARIA DA SERRA,1287,1767,591,3804,66,3213,93
SP,70432,SANTA MERCEDES,873,804,575,2311,26,1736,33
SP,70459,SANTANA DA PONTE PENSA,564,553,235,1445,38,1210,55
SP,70475,SANTANA DE PARNAÍBA,25003,25859,11134,64702,1161,53568,1545
SP,70491,SANTA RITA D'OESTE,885,856,357,2186,45,1829,43
SP,70513,SANTA RITA DO PASSA QUATRO,5580,9999,4554,21411,450,16857,828
SP,70530,SANTA ROSA DE VITERBO,6106,7596,3971,18811,438,14840,700
SP,70556,SANTO ANASTÁCIO,5662,6132,4068,16913,440,12845,611
SP,70572,SANTO ANDRÉ,197936,207663,104547,546594,10083,442047,26365
SP,70599,SANTO ANTÔNIO DA ALEGRIA,1821,2017,1188,5291,93,4103,172
SP,70610,SANTO ANTÔNIO DE POSSE,3984,7563,2924,15080,289,12156,320
SP,70637,SANTO ANTÔNIO DO JARDIM,1533,2498,944,5204,88,4260,141
SP,70653,SANTO ANTÔNIO DO PINHAL,1432,2921,1206,5758,91,4552,108
SP,70670,SANTO EXPEDITO,1103,749,419,2379,37,1960,71
SP,70696,SANTÓPOLIS DO AGUAPEÍ,1213,1143,567,3105,75,2538,107
SP,70718,SANTOS,97019,150503,57613,324033,5485,266420,13413
SP,70734,SÃO BENTO DO SAPUCAÍ,2095,4270,1853,8584,166,6731,200
SP,70750,SÃO BERNARDO DO CAMPO,241547,188188,96451,560781,10204,464330,24391
SP,70777,SÃO CAETANO DO SUL,28038,62329,14257,111409,1839,97152,4946
SP,70793,SÃO CARLOS,41101,78937,31911,162490,3234,130579,7307
SP,70815,SÃO FRANCISCO,934,826,500,2383,67,1883,56
SP,70831,SÃO JOÃO DA BOA VISTA,16595,31989,11800,63730,1140,51930,2206
SP,70858,SÃO JOÃO DAS DUAS PONTES,1046,627,375,2180,63,1805,69
SP,70874,SÃO JOÃO DO PAU D'ALHO,688,737,233,1720,31,1487,31
SP,70890,SÃO JOAQUIM DA BARRA,11146,15222,6552,34639,734,28087,985
SP,70912,SÃO JOSÉ DA BELA VISTA,2254,2364,1773,6701,159,4928,151
SP,70939,SÃO JOSÉ DO BARREIRO,1070,1542,667,3437,56,2770,102
SP,70955,SÃO JOSÉ DO RIO PARDO,11058,19100,8307,40432,880,32125,1087
SP,70971,SÃO JOSÉ DO RIO PRETO,85378,131703,58274,291237,5305,232963,10577
SP,70998,SÃO JOSÉ DOS CAMPOS,143940,191970,79267,438252,8621,358985,14454
SP,71013,SÃO LUÍS DO PARAITINGA,2275,4874,1596,9110,156,7514,209
SP,71030,SÃO MANUEL,8201,13266,5961,29655,798,23694,1429
SP,71056,SÃO MIGUEL ARCANJO,6600,11014,5240,23842,342,18602,646
SP,71072,SÃO PAULO,2961897,3427671,1573666,8479849,174986,6906183,341629
SP,71099,SÃO PEDRO,4517,12333,5589,23447,346,17858,662
SP,71110,SÃO PEDRO DO TURVO,1398,2574,868,5042,79,4174,123
SP,71137,SÃO ROQUE,15645,25544,10420,54048,975,43628,1464
SP,71153,SÃO SEBASTIÃO,19547,18497,11872,52108,861,40236,1331
SP,71170,SÃO SEBASTIÃO DA GRAMA,2436,4074,2401,9342,140,6941,291
SP,71196,SÃO SIMÃO,3065,5256,2538,11407,178,8869,370
SP,71218,SÃO VICENTE,97168,85858,45209,242870,5577,197661,9058
SP,71234,SARAPUÍ,2257,2625,1497,6701,105,5204,217
SP,71250,SARUTAIÁ,1325,1017,745,3193,35,2448,71
SP,71277,SEBASTIANÓPOLIS DO SUL,746,1349,415,2636,61,2221,65
SP,71293,SERRA AZUL,2270,2407,1451,6390,110,4939,152
SP,71315,SERRANA,9180,11995,5605,28124,579,22519,765
SP,71331,SERRA NEGRA,4530,10959,4871,21273,287,16402,626
SP,71358,SERTÃOZINHO,27857,29277,16691,78909,1956,62218,3128
SP,71374,SETE BARRAS,3855,3433,3465,11110,131,7645,226
SP,71390,SEVERÍNIA,3566,5248,2412,11672,228,9260,218
SP,71412,SILVEIRAS,1602,2168,936,4923,96,3987,121
SP,71439,SOCORRO,5011,15550,6041,27903,357,21862,944
SP,71455,SOROCABA,139307,168870,70127,406977,9270,336850,19403
SP,71471,SUD MENNUCCI,2578,2126,1190,6133,126,4943,113
SP,71498,SUMARÉ,71532,47315,28869,156368,3839,127499,4813
SP,71510,SUZANO,70103,73748,32391,186320,4174,153929,5904
SP,71536,TABAPUÃ,2508,4120,1434,8551,188,7117,301
SP,71552,TABATINGA,3572,4754,2557,11433,243,8876,307
SP,71579,TABOÃO DA SERRA,79126,62175,34319,185783,3925,151464,6238
SP,71595,TACIBA,2020,1664,956,4778,62,3822,76
SP,71617,TAGUAÍ,2739,3097,1530,7603,108,6073,129
SP,71633,TAIAÇU,1530,1734,1011,4486,91,3475,120
SP,71650,TAIÚVA,1058,2360,984,4602,85,3618,115
SP,71676,TAMBAÚ,4906,7947,3120,16744,306,13624,465
SP,71692,TANABI,5666,8953,4177,19471,265,15294,410
SP,71714,TAPIRAÍ,1423,2761,1883,6298,103,4415,128
SP,71730,TAPIRATIBA,3717,3870,2016,10085,207,8069,275
SP,71757,TAQUARITINGA,11749,17010,8713,39657,1028,30944,1157
SP,71773,TAQUARITUBA,7062,6525,3975,18181,292,14206,327
SP,71790,TARABAI,2147,1701,1058,5130,69,4072,155
SP,71811,TATUÍ,16288,40703,15070,76496,1444,61426,2991
SP,71838,TAUBATÉ,59316,93067,41125,206499,4846,165374,8145
SP,71854,TEJUPÁ,1522,1388,1047,4088,40,3041,91
SP,71870,TEODORO SAMPAIO,6047,5373,4118,16038,194,11920,306
SP,71897,TERRA ROXA,2386,2588,1460,6681,116,5221,131
SP,71919,TIETÊ,5422,14722,5243,26678,409,21435,882
SP,71935,TIMBURI,668,1160,539,2491,48,1952,76
SP,71951,TORRINHA,1881,3481,1451,7163,149,5712,201
SP,71978,TREMEMBÉ,5889,11291,4604,23076,448,18472,844
SP,71994,TRÊS FRONTEIRAS,1733,1632,865,4397,72,3532,95
SP,72010,TUPÃ,14060,21777,11373,49370,741,37997,1419
SP,72036,TUPI PAULISTA,3631,4605,2059,10671,154,8612,222
SP,72052,TURIÚBA,492,820,247,1612,20,1365,33
SP,72079,TURMALINA,798,531,446,1879,49,1433,55
SP,72095,UBATUBA,15432,26503,14028,58399,920,44371,1516
SP,72117,UBIRAJARA,998,1546,523,3197,52,2674,78
SP,72133,UCHOA,2428,3387,1525,7706,162,6181,204
SP,72150,UNIÃO PAULISTA,471,655,531,1701,23,1170,21
SP,72176,URÂNIA,2695,2190,1002,6245,158,5243,200
SP,72192,URU,396,565,309,1331,21,1022,40
SP,72214,URUPÊS,2804,4910,2057,10246,200,8189,275
SP,72230,VALENTIM GENTIL,2646,3542,1679,8199,159,6520,173
SP,72257,VALINHOS,22212,35285,15025,77689,1886,62664,3281
SP,72273,VALPARAÍSO,5360,5662,3417,15036,258,11619,339
SP,72311,VARGEM GRANDE DO SUL,6071,16250,5723,29134,472,23411,618
SP,72338,VÁRZEA PAULISTA,34882,22781,11864,74289,1720,62425,3042
SP,72354,VERA CRUZ,2787,3513,1903,8660,163,6757,294
SP,72370,VINHEDO,11219,26963,9452,50219,1062,40767,1523
SP,72397,VIRADOURO,4871,5395,2617,13549,330,10932,336
SP,72419,VISTA ALEGRE DO ALTO,1720,1857,777,4677,152,3900,171
SP,72435,VOTORANTIM,32127,28655,13423,79230,1849,65807,3176
SP,72451,VOTUPORANGA,18476,30320,12637,64773,1347,52136,1993
SP,72737,VARGEM GRANDE PAULISTA,11787,12150,5864,31205,624,25341,780
TO,73008,ABREULÂNDIA,956,369,627,2008,10,1381,46
TO,73016,PIRAQUÊ,846,755,916,2594,17,1678,60
TO,73024,RIACHINHO,1801,543,977,3421,26,2444,74
TO,73032,DARCINÓPOLIS,1532,978,977,3608,37,2631,84
TO,73040,PALMEIRAS DO TOCANTINS,1759,963,1070,3912,39,2842,81
TO,73059,MAURILÂNDIA DO TOCANTINS,1372,525,793,2770,16,1977,64
TO,73067,CACHOEIRINHA,716,423,639,1836,13,1197,45
TO,73075,ANGICO,979,775,561,2400,18,1839,67
TO,73083,PALMEIRANTE,1401,734,1020,3252,17,2232,80
TO,73091,CAMPOS LINDOS,1993,1264,1685,5104,45,3419,117
TO,73105,SÃO FÉLIX DO TOCANTINS,451,236,227,948,1,721,33
TO,73113,LAGOA DO TOCANTINS,1434,362,477,2352,10,1875,69
TO,73121,BOM JESUS DO TOCANTINS,1353,680,316,2431,23,2115,59
TO,73130,SANTA MARIA DO TOCANTINS,1042,659,322,2093,14,1771,56
TO,73148,NOVO ALEGRE,767,382,280,1503,19,1223,55
TO,73156,SANDOLÂNDIA,1096,879,987,3033,18,2046,53
TO,73164,TAIPAS DO TOCANTINS,687,341,511,1577,8,1066,30
TO,73172,NOVO JARDIM,773,490,665,1995,13,1330,54
TO,73180,SÃO MIGUEL DO TOCANTINS,3403,1176,1663,6453,57,4790,154
TO,73199,FORTALEZA DO TABOCÃO,799,662,327,1860,19,1533,53
TO,73202,ITAPIRATINS,999,787,774,2668,29,1894,79
TO,73210,CENTENÁRIO,827,421,684,2024,19,1340,73
TO,73229,RECURSOLÂNDIA,1238,571,801,2737,25,1936,102
TO,73237,TUPIRATINS,771,226,401,1450,17,1049,35
TO,73245,BRASILÂNDIA DO TOCANTINS,667,513,310,1543,21,1233,32
TO,73253,JUARINA,692,582,241,1562,11,1321,36
TO,73261,PAU D'ARCO,1320,990,1184,3574,13,2390,67
TO,73270,MATEIROS,666,280,474,1490,7,1016,63
TO,73288,SÃO BENTO DO TOCANTINS,1655,883,925,3547,15,2622,69
TO,73296,ESPERANTINA,2850,1009,1855,5900,49,4045,137
TO,73300,CARIRI DO TOCANTINS,1156,735,501,2477,29,1976,56
TO,73318,ARAGUANÃ,1676,1112,1667,4566,25,2899,86
TO,73326,CARMOLÂNDIA,835,600,646,2143,9,1497,53
TO,73334,ARAGOMINAS,1534,1242,1661,4582,47,2921,98
TO,73342,MURICILÂNDIA,875,529,314,1779,19,1465,42
TO,73350,SANTA FÉ DO ARAGUAIA,1612,1521,698,3963,20,3265,112
TO,73369,JAÚ DO TOCANTINS,1310,684,826,2897,24,2071,53
TO,73377,SUCUPIRA,497,558,302,1406,10,1104,39
TO,73385,LAGOA DA CONFUSÃO,2753,1487,1705,6059,37,4354,77
TO,73393,SÃO SALVADOR DO TOCANTINS,1161,353,1084,2671,14,1587,59
TO,73407,LAJEADO,869,539,249,1725,29,1476,39
TO,73415,RIO DOS BOIS,915,412,313,1706,12,1393,54
TO,73423,CARRASCO BONITO,1279,713,922,3004,15,2082,75
TO,73431,RIO DA CONCEIÇÃO,718,298,393,1445,5,1052,31
TO,73440,PALMAS,54959,46570,32867,140028,2166,107161,3466
TO,73458,TUPIRAMA,551,310,162,1059,6,897,30
TO,73466,OLIVEIRA DE FÁTIMA,472,396,214,1108,8,894,18
TO,73474,CHAPADA DE AREIA,552,472,327,1376,10,1049,15
TO,73482,CHAPADA DA NATIVIDADE,1330,545,1073,3035,16,1962,71
TO,73504,TALISMÃ,946,343,222,1569,17,1347,41
TO,73512,AGUIARNÓPOLIS,1630,822,772,3313,23,2541,66
TO,73520,LUZINÓPOLIS,1006,471,609,2182,26,1573,70
TO,73539,SANTA TEREZINHA DO TOCANTINS,891,556,463,1988,20,1525,58
TO,73547,SANTA RITA DO TOCANTINS,544,473,243,1302,11,1059,31
TO,73555,CRIXÁS DO TOCANTINS,458,348,173,1005,6,832,20
TO,73563,MONTE SANTO DO TOCANTINS,866,446,198,1558,13,1360,35
TO,73571,PUGMIL,817,427,580,1869,9,1289,36
TO,73580,BANDEIRANTES DO TOCANTINS,814,805,325,1996,14,1671,38
TO,73598,IPUEIRAS,549,468,353,1432,11,1079,51
TO,73601,LAVANDEIRA,624,331,343,1363,15,1020,50
TO,73610,BARRA DO OURO,1540,559,1037,3234,23,2197,75
TO,92002,BERNARDO SAYÃO,1089,1259,924,3361,32,2437,57
TO,92045,BURITI DO TOCANTINS,2585,1718,1716,6225,53,4509,153
TO,92070,ALMAS,1941,1564,1724,5400,25,3676,146
TO,92088,CASEARA,1531,821,1073,3524,10,2451,89
TO,92134,ALVORADA,2934,1663,893,5707,57,4814,160
TO,92142,COMBINADO,1490,935,1077,3623,35,2546,86
TO,92185,DIVINÓPOLIS DO TOCANTINS,2296,1248,1177,4864,35,3687,108
TO,92193,ANANÁS,3271,1589,2250,7330,55,5080,165
TO,92240,GOIANORTE,1360,1465,799,3750,28,2951,98
TO,92304,MARIANÓPOLIS DO TOCANTINS,1291,727,874,2962,26,2088,44
TO,92371,ARAGUACEMA,2066,866,1431,4479,28,3048,88
TO,92398,ARAGUAÇU,1891,2673,2244,7012,71,4768,133
TO,92401,NOVA ROSALÂNDIA,957,879,609,2522,28,1913,49
TO,92410,ARAGUAÍNA,33902,33061,21892,92258,1108,70366,2295
TO,92436,ARAGUATINS,7050,5829,5794,19232,133,13438,426
TO,92452,ARAPOEMA,2091,1323,1506,5100,56,3594,124
TO,92479,ARRAIAS,3670,1139,3022,8134,67,5112,236
TO,92487,PEQUIZEIRO,1591,1045,1122,3851,19,2729,74
TO,92509,PORTO ALEGRE DO TOCANTINS,863,447,757,2122,14,1365,41
TO,92525,PRAIA NORTE,2472,1099,1933,5659,28,3726,127
TO,92533,AURORA DO TOCANTINS,1243,680,810,2856,27,2046,96
TO,92541,SAMPAIO,1314,765,757,2926,27,2169,63
TO,92576,AXIXÁ DO TOCANTINS,3534,2263,1830,7943,73,6113,243
TO,92584,SANTA ROSA DO TOCANTINS,1366,950,1177,3618,20,2441,105
TO,92592,BABAÇULÂNDIA,3087,1535,1772,6600,46,4828,160
TO,92606,SANTA TEREZA DO TOCANTINS,1138,433,543,2164,18,1621,32
TO,92681,SÃO VALÉRIO DA NATIVIDADE,1755,766,1452,4086,22,2634,91
TO,92738,BREJINHO DE NAZARÉ,1853,1022,818,3844,44,3026,107
TO,93114,COLINAS DO TOCANTINS,7500,7722,5868,21666,181,15798,395
TO,93130,CONCEIÇÃO DO TOCANTINS,1248,608,1241,3221,18,1980,106
TO,93211,COUTO DE MAGALHÃES,1510,859,685,3127,19,2442,54
TO,93238,CRISTALÂNDIA,2219,1530,1728,5601,35,3873,89
TO,93416,DIANÓPOLIS,4876,3246,3594,12060,99,8466,245
TO,93459,DOIS IRMÃOS DO TOCANTINS,2488,876,1645,5172,34,3527,129
TO,93475,DUERÉ,1211,937,465,2710,27,2245,70
TO,93556,FILADÉLFIA,2429,1757,2208,6558,43,4350,121
TO,93653,FORMOSO DO ARAGUAIA,5242,3803,4739,14101,77,9362,240
TO,93858,GURUPI,19652,18056,13057,52581,639,39524,1177
TO,94056,ITACAJÁ,2150,1513,1219,5097,53,3878,162
TO,94099,ITAGUATINS,2257,911,1631,4968,31,3337,138
TO,94170,ITAPORÃ DO TOCANTINS,873,560,492,1978,13,1486,40
TO,94617,MIRACEMA DO TOCANTINS,7111,2964,4182,14795,142,10613,396
TO,94633,MIRANORTE,4067,2780,2966,10094,97,7128,184
TO,94692,MONTE DO CARMO,1933,1283,1102,4483,30,3381,135
TO,94811,NATIVIDADE,2204,2212,2361,7006,47,4645,182
TO,94838,NAZARÉ,1819,807,1091,3846,36,2755,93
TO,94994,NOVO ACORDO,1324,858,821,3092,22,2271,67
TO,95192,PARAÍSO DO TOCANTINS,10075,11987,7211,30195,363,22984,559
TO,95214,PARANÃ,3477,798,2846,7388,30,4542,237
TO,95257,PEDRO AFONSO,3341,2356,1064,6981,50,5917,170
TO,95273,PEIXE,3255,1572,1919,6957,62,5038,149
TO,95290,COLMÉIA,2047,2564,1986,6802,64,4816,141
TO,95338,GOIATINS,3651,1423,2579,7981,48,5402,280
TO,95370,PINDORAMA DO TOCANTINS,1298,1122,1147,3669,17,2522,85
TO,95478,PIUM,1783,1537,1560,5023,25,3463,118
TO,95516,PONTE ALTA DO BOM JESUS,1456,659,672,2905,26,2233,92
TO,95532,PONTE ALTA DO TOCANTINS,2141,1197,1554,5092,43,3538,157
TO,95591,PORTO NACIONAL,13880,9222,7742,32112,468,24370,800
TO,95699,LIZARDA,1311,393,946,2750,20,1804,80
TO,96032,SÃO SEBASTIÃO DO TOCANTINS,1486,620,975,3181,17,2206,83
TO,96130,SÍTIO NOVO DO TOCANTINS,3665,1162,2417,7508,69,5091,195
TO,96156,TAGUATINGA,5198,1678,3340,10509,67,7169,226
TO,96199,TOCANTÍNIA,2367,782,1273,4523,25,3250,76
TO,96210,TOCANTINÓPOLIS,8301,2546,3891,15294,158,11403,398
TO,96270,GUARAÍ,6422,5277,4224,16481,160,12257,398
TO,96296,PRESIDENTE KENNEDY,1162,675,410,2338,25,1928,66
TO,96431,XAMBIOÁ,3480,1962,1556,7289,91,5733,200
TO,96490,PALMEIRÓPOLIS,1935,1803,1110,4965,33,3855,84
TO,96598,SILVANÓPOLIS,1511,1237,866,3745,29,2879,102
TO,96636,NOVA OLINDA,3064,2075,2294,7705,63,5411,209
TO,96652,WANDERLÂNDIA,2884,1990,2241,7369,63,5128,191
TO,96679,FIGUEIRÓPOLIS,1865,1037,492,3560,50,3068,116
TO,96792,RIO SONO,1934,888,615,3528,16,2913,75
TO,96830,FÁTIMA,1156,1053,944,3232,29,2288,50
TO,96857,AUGUSTINÓPOLIS,4957,3020,3100,11431,113,8331,241
TO,96954,ALIANÇA DO TOCANTINS,2116,988,1375,4590,22,3215,89
TO,96970,APARECIDA DO RIO NEGRO,1445,1023,847,3436,30,2589,91
TO,96997,BARROLÂNDIA,2288,1031,1167,4596,36,3429,74
VT,99901,SÃO PAULO,3932,4181,3700,12059,67,8359,179
VT,99902,BELO HORIZONTE,1491,1405,1216,4268,58,3052,98
VT,99903,RIO DE JANEIRO,1389,1134,1217,3870,33,2653,97
VT,99904,PORTO ALEGRE,756,924,647,2380,25,1733,28
VT,99905,SALVADOR,817,538,696,2096,15,1400,30
VT,99906,CURITIBA,1065,1772,1042,3982,26,2940,77
VT,99907,FORTALEZA,1487,912,684,3169,34,2485,52
VT,99908,RECIFE,1364,830,625,2903,37,2278,47
VT,99909,FLORIANÓPOLIS,1044,1413,875,3451,32,2576,87
VT,99910,GOIÂNIA,934,1175,1149,3351,31,2202,62
VT,99911,SÃO LUÍS,1168,477,593,2302,26,1709,38
VT,99912,JOÃO PESSOA,761,546,370,1738,17,1368,44
VT,99913,BELÉM,835,878,765,2539,19,1774,42
VT,99914,VITÓRIA,532,612,497,1680,16,1183,23
VT,99915,TERESINA,595,368,351,1365,28,1014,23
VT,99916,NATAL,1006,741,544,2366,23,1822,52
VT,99917,MACEIÓ,338,314,283,953,6,670,12
VT,99918,CUIABÁ,521,542,537,1627,14,1090,13
VT,99919,CAMPO GRANDE,434,781,507,1770,19,1263,29
VT,99920,BRASÍLIA,3154,2401,1992,7777,79,5785,151
VT,99921,ARACAJU,688,477,392,1618,28,1226,33
VT,99922,MANAUS,1429,670,836,3021,39,2185,47
VT,99923,PORTO VELHO,970,610,581,2234,28,1653,45
VT,99924,RIO BRANCO,155,220,123,513,6,390,9
VT,99925,MACAPÁ,407,336,435,1205,5,770,22
VT,99926,BOA VISTA,349,329,267,963,11,696,7
VT,99927,PALMAS,397,431,394,1258,9,864,27
ZZ,29254,ABIDJAN-COTE,30,6,43,80,1,37,0
ZZ,29262,ABU DHABI-EAU,16,19,29,64,0,35,0
ZZ,29289,AMÃ-JORD,100,40,215,360,0,145,5
ZZ,29297,ANCARA-TURQ,4,7,21,32,0,11,0
ZZ,29300,ARGEL-ARGL,9,9,14,32,0,18,0
ZZ,29327,ASSUNÇÃO-PARG,271,431,431,1170,24,739,13
ZZ,29335,ATENAS-GREC,93,86,183,371,3,188,6
ZZ,29343,BANGKOK-TAIL,10,31,34,76,0,42,1
ZZ,29351,BARCELONA-ESPA,327,290,903,1562,19,659,23
ZZ,29360,BEIRUTE-LBAN,394,205,712,1341,17,629,13
ZZ,29378,BELGRADO-SERV,13,12,11,38,2,27,0
ZZ,29386,BERLIM-RFA,371,343,1600,2363,11,763,38
ZZ,29394,BISSAU-GUIB,25,25,58,108,0,50,0
ZZ,29408,BOGOTÁ-COLO,98,143,325,580,12,255,2
ZZ,29416,BOSTON-EUA,2040,3298,6690,12330,154,5640,148
ZZ,29432,BRUXELAS-BELG,518,456,978,2002,22,1024,28
ZZ,29440,BUCARESTE-ROME,3,23,33,62,1,29,2
ZZ,29459,BUDAPESTE-HUNG,26,30,44,100,0,56,0
ZZ,29467,BUENOS AIRES-ARGT,1297,748,1745,3877,41,2132,46
ZZ,29475,CAIENA-GUIF,986,665,1540,3278,33,1738,54
ZZ,29483,CAIRO-EGIT,27,14,60,103,1,43,1
ZZ,29491,CAMBERRA-AUST,25,36,555,617,1,62,0
ZZ,29505,CARACAS-VENE,173,275,497,959,5,462,9
ZZ,29513,CHICAGO-EUA,97,386,822,1329,17,507,7
ZZ,29530,CIDADE DO CABO-RAFS,16,49,62,129,2,67,0
ZZ,29548,CINGAPURA-CING,17,133,151,303,0,152,2
ZZ,29556,CIUDAD DEL ESTE-PARG,545,783,1208,2571,9,1363,26
ZZ,29564,CIUDAD GUAYANA-VENE,32,30,50,114,0,64,2
ZZ,29572,COCHABAMBA-BOLI,51,64,182,302,4,120,1
ZZ,29580,CONCEPCIÓN-PARG,13,13,37,64,0,27,1
ZZ,29599,COPENHAGUE-DINA,149,113,299,581,14,282,6
ZZ,29602,CÓRDOBA-ARGT,110,39,141,292,0,151,2
ZZ,29610,DACAR-SENE,15,24,51,91,1,40,0
ZZ,29637,DAMASCO-SIRI,37,18,99,158,0,59,4
ZZ,29645,DILI-TIML,44,21,62,130,2,68,1
ZZ,29653,DOHA-CATA,18,35,42,95,0,53,0
ZZ,29661,DUBLIN-IRLS,37,66,96,203,1,107,3
ZZ,29670,ENCARNACIÓN-PARG,36,23,37,99,2,62,1
ZZ,29688,ESTOCOLMO-SUEC,315,259,806,1421,28,615,13
ZZ,29696,FRANKFURT-RFA,449,613,2000,3133,33,1133,38
ZZ,29700,GENEBRA-SUIC,375,438,1025,1905,34,880,33
ZZ,29718,GEORGETOWN-GUIA,11,16,46,74,1,28,0
ZZ,29726,GUATEMALA-GUAT,30,61,83,176,0,93,2
ZZ,29742,HAMAMATSU-JAPA,100,232,151,496,11,345,2
ZZ,29777,HAVANA-CUBA,248,6,252,512,3,260,3
ZZ,29785,HELSINQUE-FINL,53,61,86,210,4,124,6
ZZ,29793,HONG KONG-HONG,24,49,100,175,0,75,2
ZZ,29807,HOUSTON-EUA,270,1146,4827,6295,24,1468,28
ZZ,29840,JACARTA-INDO,0,8,30,38,0,8,0
ZZ,29866,KINGSTON-JAMA,19,4,17,40,0,23,0
ZZ,29874,KINSHASA-RCON,7,8,21,38,2,17,0
ZZ,29882,KUAITE-KUAI,10,11,21,42,0,21,0
ZZ,29890,KUALA LUMPUR-MALA,12,20,28,61,0,33,1
ZZ,29904,LA PAZ-BOLI,70,106,139,318,2,179,1
ZZ,29912,LAGOS-NIGR,13,19,36,69,1,33,0
ZZ,29939,LIBREVILLE-GABA,19,2,22,43,0,21,0
ZZ,29947,LIMA-PERU,128,250,264,660,11,396,7
ZZ,29955,LISBOA-PORT,2289,1667,8117,12360,151,4243,136
ZZ,29971,LONDRES-GBRE,1299,1783,3651,6981,117,3330,131
ZZ,29980,LOS ANGELES-EUA,268,937,1542,2791,19,1249,25
ZZ,29998,LUANDA-ANGO,78,67,124,275,3,151,3
ZZ,30066,MADRI-ESPA,697,537,3426,4742,41,1316,41
ZZ,30074,MANÁGUA-NICA,50,35,41,128,0,87,2
ZZ,30082,MANILA-FILI,18,5,47,71,1,24,0
ZZ,30090,MAPUTO-MOÇA,107,79,271,463,3,192,3
ZZ,30104,MÉXICO-MEXI,129,232,363,732,5,369,3
ZZ,30112,MIAMI-EUA,692,3340,6100,10273,78,4173,63
ZZ,30120,MILÃO-ITAL,1899,1429,7868,11415,116,3547,103
ZZ,30139,MITSUKAIDO-JAPA,103,293,196,617,17,421,8
ZZ,30147,MONTEVIDÉU-URUG,413,389,654,1511,36,857,19
ZZ,30155,MONTREAL-CANA,548,954,923,2544,56,1621,63
ZZ,30163,MOSCOU-RUSS,12,23,52,91,1,39,3
ZZ,30180,MUNIQUE-RFA,467,638,1855,3037,41,1182,36
ZZ,30198,NAGOYA-JAPA,557,1608,2966,5225,65,2259,29
ZZ,30201,NAIROBI-QUEN,6,10,40,56,0,16,0
ZZ,30210,NOVA DELHI-INDI,6,7,55,68,0,13,0
ZZ,30228,NOVA YORK-EUA,2340,5715,12563,21076,205,8513,253
ZZ,30236,OIZUMI-JAPA,280,795,478,1618,38,1140,27
ZZ,30244,OSLO-NORG,146,97,421,680,5,259,11
ZZ,30252,OTTAWA-CANA,126,256,264,685,19,421,20
ZZ,30260,PANAMÁ-PANA,110,182,217,514,3,297,2
ZZ,30279,PARAMARIBO-SURI,120,106,621,865,10,244,8
ZZ,30287,PARIS-FRAN,1037,772,2026,3947,57,1921,55
ZZ,30309,PEDRO CABALLERO-PARG,27,39,51,126,5,75,4
ZZ,30317,PEQUIM-CHIN,18,50,63,131,0,68,0
ZZ,30341,PORTO-PORT,2093,1516,6976,10822,152,3846,85
ZZ,30350,PRAGA-TCHE,22,29,39,92,1,53,1
ZZ,30368,PRAIA-CABO,33,6,30,71,0,41,2
ZZ,30376,PRETÓRIA-RAFS,58,107,299,476,7,177,5
ZZ,30392,QUITO-EQUA,81,97,313,497,3,184,3
ZZ,30406,RABAT-MARR,9,5,20,34,0,14,0
ZZ,30414,RAMALLAH-PALE,355,31,477,886,7,409,16
ZZ,30422,RIADE-ARAB,7,16,26,49,0,23,0
ZZ,30449,ROMA-ITAL,833,814,1757,3488,37,1731,47
ZZ,30457,ROTERDÃ-HOLA,483,500,941,1999,32,1058,43
ZZ,30465,SALTOS DO GUAIRA-PARG,22,55,47,125,1,78,0
ZZ,30473,STA C LA SIERRA-BOLI,184,474,379,1051,9,672,5
ZZ,30481,SANTIAGO-CHIL,372,562,689,1652,11,963,18
ZZ,30490,SÃO DOMINGOS-RDOM,65,72,81,221,2,140,1
ZZ,30503,SÃO FRANCISCO-EUA,422,1183,2032,3700,28,1668,35
ZZ,30511,SÃO JOSÉ-RICA,106,178,111,411,6,300,10
ZZ,30520,SÃO SALVADOR-ELSA,38,35,74,148,1,74,0
ZZ,30538,SEUL-CORS,6,26,31,64,0,33,1
ZZ,30554,SUZUKA-JAPA,40,87,67,201,4,134,3
ZZ,30562,SYDNEY-AUST,138,354,829,1363,16,534,26
ZZ,30570,TAIPÉ-TAIW,8,27,49,84,0,35,0
ZZ,30589,TAKAOKA-JAPA,5,14,14,38,1,24,4
ZZ,30600,TEGUCIGALPA-HOND,22,55,79,162,5,83,1
ZZ,30619,TEL AVIV-ISRA,19,85,174,282,2,108,2
ZZ,30627,TÓQUIO-JAPA,403,1065,1111,2681,61,1570,41
ZZ,30635,TORONTO-CANA,467,1139,1415,3111,39,1696,51
ZZ,30643,TOYOHASHI-JAPA,33,112,126,276,3,150,2
ZZ,30708,TUNIS-TUNI,7,5,27,40,1,13,0
ZZ,30724,UEDA-JAPA,97,289,258,675,13,417,18
ZZ,30740,VARSÓVIA-POLO,18,28,82,129,0,47,1
ZZ,30767,VIENA-OSTE,178,235,633,1078,15,445,17
ZZ,30783,WASHINGTON-EUA,640,1784,3248,5773,54,2525,47
ZZ,30805,WELLINGTON-NZEL,14,31,456,501,0,45,0
ZZ,30848,XANGAI-CHIN,25,151,141,330,6,189,7
ZZ,30864,ZURIQUE-SUIC,1359,1457,3368,6391,114,3023,93
ZZ,30880,DONGGUAN-CHIN,6,14,16,37,1,21,0
ZZ,30902,HARTFORD-EUA,74,142,220,451,5,231,10
ZZ,39004,Mendonza-ARGT,48,28,35,115,2,80,2
ZZ,39063,VANCOUVER-CANA,89,230,539,891,15,352,18
ZZ,39080,ATLANTA-EUA,160,526,2213,2922,14,709,9
ZZ,39187,BRAZZAVILLE-CONG,5,6,21,32,0,11,0
