SG_UF,CD_MUNICIPIO,NM_MUNICIPIO,"('QT_VOTOS', 13, 'Partido dos Trabalhadores')","('QT_VOTOS', 45, 'Partido da Social Democracia Brasileira')",QT_ABST,QT_APTOS,QT_BRANCOS,QT_COMPARECIMENTOS,QT_NULOS
AC,1007,BUJARI,1833,3558,1352,6902,45,5550,114
AC,1015,CAPIXABA,1462,3496,1883,6941,27,5058,73
AC,1023,PORTO ACRE,3152,5279,2759,11434,79,8675,165
AC,1031,SANTA ROSA DO PURUS,852,693,1173,2783,17,1610,48
AC,1040,MARECHAL THAUMATURGO,2997,2764,2898,8799,18,5901,122
AC,1058,BRASILÉIA,4882,7553,4392,17128,92,12736,209
AC,1066,PORTO WALTER,1777,1775,1796,5444,12,3648,84
AC,1074,CRUZEIRO DO SUL,13506,21388,15515,51461,343,35946,709
AC,1082,RODRIGUES ALVES,2782,3562,3238,9731,43,6493,106
AC,1090,MÂNCIO LIMA,3900,3413,3336,10818,55,7482,114
AC,1104,JORDÃO,1552,1232,1465,4311,9,2846,53
AC,1112,EPITACIOLÂNDIA,2529,4984,2696,10408,62,7712,137
AC,1120,ACRELÂNDIA,2210,4076,2736,9143,38,6407,83
AC,1139,FEIJÓ,7333,4934,5919,18595,70,12676,339
AC,1392,RIO BRANCO,59921,135243,30469,232202,2139,201733,4430
AC,1457,SENA MADUREIRA,5380,10951,9212,25964,87,16752,334
AC,1473,TARAUACÁ,8366,6054,8188,23055,87,14867,360
AC,1490,XAPURI,4114,4167,2844,11344,41,8500,178
AC,1511,PLÁCIDO DE CASTRO,2868,5965,3455,12516,69,9061,159
AC,1538,SENADOR GUIOMARD,3836,8493,3991,16632,95,12641,217
AC,1554,MANOEL URBANO,1764,1981,2109,5992,30,3883,108
AC,1570,ASSIS BRASIL,1966,2116,990,5186,22,4196,92
AL,27006,PARIPUEIRA,3589,2700,1441,8056,111,6615,215
AL,27014,ÁGUA BRANCA,8717,1431,3105,13647,77,10542,317
AL,27022,PARICONHA,4991,562,1351,7146,43,5795,199
AL,27030,ANADIA,5452,2559,3505,12013,136,8508,361
AL,27049,ESTRELA DE ALAGOAS,6268,1235,2808,10714,70,7906,333
AL,27057,ARAPIRACA,63635,41362,18728,128774,1448,110046,3601
AL,27065,JEQUIÁ DA PRAIA,3170,1850,1616,6812,53,5196,123
AL,27073,ATALAIA,12895,7598,6439,28032,366,21593,734
AL,27081,CAMPESTRE,2176,1114,1156,4627,62,3471,119
AL,27090,BARRA DE SANTO ANTÔNIO,4832,2465,2089,9804,145,7715,273
AL,27111,BARRA DE SÃO MIGUEL,2334,2133,940,5610,40,4670,163
AL,27138,BATALHA,6389,2029,2300,11049,60,8749,271
AL,27154,BELÉM,2174,1024,1058,4457,66,3399,135
AL,27170,BELO MONTE,2689,563,950,4328,20,3378,106
AL,27197,BOCA DA MATA,8306,5008,4367,18557,264,14190,612
AL,27219,BRANQUINHA,3205,1764,2096,7378,100,5282,213
AL,27235,CACIMBINHAS,3977,1279,1752,7260,49,5508,203
AL,27251,CAJUEIRO,5009,4426,3057,13074,164,10017,418
AL,27278,CAMPO ALEGRE,9741,5284,5157,20988,223,15831,583
AL,27294,CAMPO GRANDE,4802,844,1357,7243,60,5886,180
AL,27316,CANAPI,7265,934,3151,11722,82,8571,290
AL,27332,CAPELA,5326,3332,2787,11936,138,9149,353
AL,27359,CARNEIROS,3498,684,1382,5745,36,4363,145
AL,27375,CHÃ PRETA,2810,952,1396,5391,48,3995,185
AL,27391,COITÉ DO NÓIA,4986,964,1615,7845,58,6230,222
AL,27413,COLÔNIA LEOPOLDINA,4357,4602,3681,13168,151,9487,377
AL,27430,COQUEIRO SECO,2181,1154,588,4113,66,3525,124
AL,27456,CORURIPE,12319,14774,8314,36985,454,28671,1124
AL,27472,DELMIRO GOUVEIA,21827,3871,6899,33645,252,26746,796
AL,27499,DOIS RIACHOS,4306,1242,2058,7848,47,5790,195
AL,27510,FEIRA GRANDE,9865,2006,2280,14748,159,12468,438
AL,27537,FELIZ DESERTO,1327,844,854,3151,28,2297,98
AL,27553,FLEXEIRAS,1934,3579,1970,7814,79,5844,252
AL,27570,GIRAU DO PONCIANO,15217,2116,4655,22708,145,18053,575
AL,27596,IBATEGUARA,3574,3439,2085,9567,133,7482,336
AL,27618,IGACI,10945,1648,4630,17868,154,13238,491
AL,27634,IGREJA NOVA,9189,2794,2942,15476,150,12534,401
AL,27650,INHAPI,7072,879,2564,10983,80,8419,388
AL,27677,JACARÉ DOS HOMENS,2626,596,967,4306,18,3339,99
AL,27693,JACUÍPE,2132,1151,1202,4722,77,3520,160
AL,27715,JAPARATINGA,1489,2505,1486,5685,69,4199,136
AL,27731,JARAMATAIA,2461,662,920,4202,43,3282,116
AL,27758,JOAQUIM GOMES,5653,2935,2782,11811,114,9029,327
AL,27774,JUNDIÁ,1007,1426,1263,3826,37,2563,93
AL,27790,JUNQUEIRO,8443,3892,4075,17049,199,12974,440
AL,27812,LAGOA DA CANOA,7774,2333,1824,12380,104,10556,345
AL,27839,LIMOEIRO DE ANADIA,9069,2661,2981,15261,157,12280,393
AL,27855,MACEIÓ,223476,214112,82209,551863,9243,469654,22823
AL,27871,MAJOR ISIDORO,6952,2736,3393,13519,102,10126,336
AL,27898,MARAGOGI,4946,8245,3378,17351,292,13973,490
AL,27910,MARAVILHA,3748,1372,1725,7089,50,5364,194
AL,27936,MARECHAL DEODORO,11840,11613,6915,31720,434,24805,918
AL,27952,MARIBONDO,4486,2468,2461,9847,122,7386,310
AL,27979,MAR VERMELHO,1655,539,681,3007,36,2326,96
AL,27995,MATA GRANDE,9243,1546,3752,15096,120,11344,435
AL,28010,MATRIZ DE CAMARAGIBE,5838,6011,3991,16484,231,12493,413
AL,28037,MESSIAS,5330,3404,2279,11413,125,9134,275
AL,28053,MINADOR DO NEGRÃO,2265,614,775,3790,26,3015,110
AL,28070,MONTEIRÓPOLIS,3078,758,1262,5238,35,3976,105
AL,28096,MURICI,7262,5772,3995,17759,243,13764,487
AL,28118,NOVO LINO,2871,2944,2192,8338,102,6146,229
AL,28134,OLHO D'ÁGUA DAS FLORES,5263,4466,3310,13503,111,10193,353
AL,28150,OLHO D'ÁGUA DO CASADO,4170,375,1350,6077,32,4727,150
AL,28177,OLHO D'ÁGUA GRANDE,2511,343,819,3792,17,2973,102
AL,28193,OLIVENÇA,4266,1410,1814,7713,44,5899,179
AL,28215,OURO BRANCO,4421,1052,1382,7095,56,5713,184
AL,28231,PALESTINA,2239,548,949,3847,31,2898,80
AL,28258,PALMEIRA DOS ÍNDIOS,25643,10210,9245,46881,505,37636,1278
AL,28274,PÃO DE AÇÚCAR,9440,2411,4072,16431,114,12359,394
AL,28290,PASSO DE CAMARAGIBE,5043,2262,2624,10336,149,7712,258
AL,28312,PAULO JACINTO,2889,1285,1487,5919,55,4432,203
AL,28339,PENEDO,19536,8753,9332,39014,436,29682,957
AL,28355,PIAÇABUÇU,6218,2109,3273,12003,94,8730,309
AL,28371,PILAR,9456,7947,4725,23176,358,18451,690
AL,28398,PINDOBA,1200,489,465,2236,15,1771,67
AL,28410,PIRANHAS,10556,1042,3439,15550,89,12111,424
AL,28436,POÇO DAS TRINCHEIRAS,5870,834,1966,8915,60,6949,185
AL,28452,PORTO CALVO,3722,8977,4781,18207,259,13426,468
AL,28479,PORTO DE PEDRAS,1824,2389,1658,6113,70,4455,172
AL,28495,PORTO REAL DO COLÉGIO,8313,1889,2516,13157,119,10641,320
AL,28517,QUEBRANGULO,4985,1667,1875,8851,76,6976,248
AL,28533,RIO LARGO,23450,13884,8505,48338,954,39833,1545
AL,28550,ROTEIRO,1785,1074,799,3854,49,3055,147
AL,28576,SANTA LUZIA DO NORTE,2858,1200,746,5027,63,4281,160
AL,28592,SANTANA DO IPANEMA,17188,4412,5553,28075,170,22522,752
AL,28614,SANTANA DO MUNDAÚ,3954,1498,1378,7107,66,5729,211
AL,28630,SÃO BRÁS,3019,821,1224,5220,63,3996,93
AL,28657,SÃO JOSÉ DA LAJE,6540,5162,2966,15387,206,12421,513
AL,28673,SÃO JOSÉ DA TAPERA,11049,2215,4416,18315,127,13899,508
AL,28690,SÃO LUÍS DO QUITUNDE,7870,7159,4664,20560,293,15896,574
AL,28711,SÃO MIGUEL DOS CAMPOS,10057,16827,6887,35546,539,28659,1236
AL,28738,SÃO MIGUEL DOS MILAGRES,1763,2163,1485,5680,73,4195,196
AL,28754,SÃO SEBASTIÃO,12849,4096,4494,22243,241,17749,563
AL,28770,SATUBA,4626,2386,1615,9050,165,7435,258
AL,28797,TANQUE D'ARCA,2627,811,1129,4774,58,3645,149
AL,28819,TAQUARANA,6078,3147,2371,12185,164,9814,425
AL,28835,TRAIPU,9164,1852,4354,15834,73,11480,391
AL,28851,UNIÃO DOS PALMARES,19456,11032,8136,40396,440,32260,1332
AL,28878,VIÇOSA,7889,5616,3969,18241,223,14272,544
AL,28894,CRAÍBAS,10397,2024,2783,15760,112,12977,444
AL,28916,SENADOR RUI PALMEIRA,4910,970,1712,7849,51,6137,206
AL,28932,TEOTÔNIO VILELA,10358,8176,5805,25481,387,19676,755
AM,2003,APUÍ,3845,1913,3324,9479,44,6155,353
AM,2011,NOVO AIRÃO,3876,1736,1628,7676,35,6048,401
AM,2020,GUAJARÁ,3478,1313,3478,8659,30,5181,360
AM,2038,ANORI,3930,2050,2993,9328,45,6335,310
AM,2046,CAREIRO DA VÁRZEA,7536,1941,2590,12802,64,10212,671
AM,2054,ATALAIA DO NORTE,2596,1531,2452,6919,10,4467,330
AM,2070,AUTAZES,11482,2631,7241,22305,93,15064,858
AM,2097,BARCELOS,2541,2401,3921,9227,30,5306,334
AM,2119,BARREIRINHA,9390,1213,5653,16917,53,11264,608
AM,2135,BENJAMIN CONSTANT,11457,1732,4742,18891,58,14149,902
AM,2151,BOCA DO ACRE,8287,4043,5451,18823,109,13372,933
AM,2178,BORBA,9690,2045,6287,18757,51,12470,684
AM,2194,CANUTAMA,3393,987,2463,7171,32,4708,296
AM,2216,CARAUARI,8769,2099,6228,17735,50,11507,589
AM,2232,CAREIRO,10546,2533,7246,21450,108,14204,1017
AM,2259,COARI,19740,9776,14433,46097,192,31664,1956
AM,2275,CODAJÁS,6930,1765,4875,14131,45,9256,516
AM,2291,EIRUNEPÉ,8500,2550,8312,20282,91,11970,829
AM,2313,ENVIRA,5383,943,3748,10492,34,6744,384
AM,2330,FONTE BOA,7780,1222,3911,13463,43,9552,507
AM,2356,HUMAITÁ,13317,4383,7780,26562,115,18782,967
AM,2372,SANTA ISABEL DO RIO NEGRO,2428,1203,2993,6863,19,3870,220
AM,2399,IPIXUNA,5018,875,3121,9566,37,6445,515
AM,2410,ITACOATIARA,31335,11092,9970,55262,344,45292,2521
AM,2437,ITAPIRANGA,3730,1050,1670,6666,35,4996,181
AM,2453,JAPURÁ,1780,781,1115,3815,7,2700,132
AM,2470,JURUÁ,2461,1463,2421,6610,23,4189,242
AM,2496,JUTAÍ,5682,882,3433,10630,35,7197,598
AM,2518,LÁBREA,10676,2423,8187,22262,80,14075,896
AM,2534,MANACAPURU,28182,11972,9115,52230,319,43115,2642
AM,2550,MANAUS,529604,409409,216613,1244365,22948,1027752,65791
AM,2577,MANICORÉ,12273,4446,7783,25437,54,17654,881
AM,2593,MARAÃ,4634,570,2914,8445,13,5531,314
AM,2615,MAUÉS,15630,2951,9243,28916,119,19673,973
AM,2631,NHAMUNDÁ,6631,1723,3405,12139,26,8734,354
AM,2658,NOVA OLINDA DO NORTE,8104,1656,5130,15508,49,10378,569
AM,2674,NOVO ARIPUANÃ,5464,1151,4317,11384,39,7067,413
AM,2690,PARINTINS,32693,9011,20254,64211,339,43957,1914
AM,2712,PAUINI,3912,1341,3501,9147,29,5646,364
AM,2739,SANTO ANTÔNIO DO IÇÁ,6263,1937,3139,12057,48,8918,670
AM,2755,SÃO PAULO DE OLIVENÇA,8816,1969,3037,14756,64,11719,870
AM,2771,SILVES,3891,584,1759,6462,28,4703,200
AM,2798,TAPAUÁ,5058,1601,4761,11880,22,7119,438
AM,2810,TEFÉ,18925,5839,10978,37434,178,26456,1514
AM,2836,SÃO GABRIEL DA CACHOEIRA,13721,3052,9157,26782,70,17625,782
AM,2852,URUCARÁ,6406,1016,3044,10816,39,7772,311
AM,2879,URUCURITUBA,6493,953,3779,11595,35,7816,335
AM,2895,ALVARÃES,4894,1350,2397,9058,20,6661,397
AM,2917,AMATURÁ,2695,818,1284,5112,18,3828,297
AM,2933,ANAMÃ,3503,1035,1907,6734,31,4827,258
AM,2950,BERURI,5957,1005,2710,10092,30,7382,390
AM,2976,BOA VISTA DO RAMOS,5252,806,3212,9572,19,6360,283
AM,2992,CAAPIRANGA,3930,594,2408,7237,41,4829,264
AM,98353,IRANDUBA,13649,3680,2160,20899,142,18739,1268
AM,98370,ITAMARATI,2602,1240,1863,5997,8,4134,284
AM,98396,MANAQUIRI,6608,1110,3789,12005,43,8216,455
AM,98418,PRESIDENTE FIGUEIREDO,9676,3148,2896,16729,135,13833,874
AM,98434,RIO PRETO DA EVA,6511,2562,2198,11987,86,9789,630
AM,98450,SÃO SEBASTIÃO DO UATUMÃ,2709,928,1649,5494,28,3845,180
AM,98477,TABATINGA,14730,4449,7361,28416,193,21055,1683
AM,98493,UARINI,3796,985,1937,6997,13,5060,266
AM,98515,TONANTINS,4669,1078,2218,8268,15,6050,288
AP,6009,PRACUÚBA,1511,473,412,2471,5,2059,70
AP,6017,AMAPÁ,3025,1038,1036,5301,25,4265,177
AP,6025,PORTO GRANDE,6521,2470,2053,11533,52,9480,437
AP,6033,CALÇOENE,3339,1639,1543,6777,26,5234,230
AP,6041,ITAUBAL,2329,832,771,4037,11,3266,94
AP,6050,MACAPÁ,130334,92838,33715,268449,2076,234734,9486
AP,6068,CUTIAS,1888,687,706,3357,5,2651,71
AP,6076,MAZAGÃO,7672,2375,1828,12257,32,10429,350
AP,6084,PEDRA BRANCA DO AMAPARI,4024,1608,1849,7745,29,5896,235
AP,6092,OIAPOQUE,6818,3420,4973,15974,98,11001,665
AP,6106,SERRA DO NAVIO,1528,923,504,3079,25,2575,99
AP,6114,FERREIRA GOMES,2370,1403,1450,5435,22,3985,190
AP,6122,VITÓRIA DO JARI,5348,1300,1666,8668,46,7002,308
AP,6130,LARANJAL DO JARI,13612,6541,4789,26136,208,21347,986
AP,6157,SANTANA,33218,23741,7762,67381,482,59619,2178
AP,6173,TARTARUGALZINHO,3972,1492,1293,7055,41,5762,257
BA,30007,LUÍS EDUARDO MAGALHÃES,13328,16078,9094,39379,332,30285,547
BA,30058,EUNÁPOLIS,24163,26128,21367,74030,646,52663,1726
BA,30660,IUIU,4387,1438,2224,8255,59,6031,147
BA,30678,JABORANDI,4165,1054,1041,6539,65,5498,214
BA,30694,JUSSARI,2086,1102,1649,4963,25,3314,101
BA,30716,AMÉRICA DOURADA,6776,1358,3893,12361,65,8468,269
BA,30732,ARATACA,2885,1320,615,5000,44,4385,136
BA,30759,BARRO ALTO,5524,1430,2068,9267,72,7199,173
BA,30775,BARROCAS,7042,1975,2812,12173,59,9361,285
BA,30791,BURITIRAMA,7015,2666,4773,14827,59,10054,314
BA,30813,CAPELA DO ALTO ALEGRE,4250,1925,2453,9075,124,6622,323
BA,30830,CAPIM GROSSO,8843,5523,5594,20808,252,15214,596
BA,30856,CANUDOS,6841,1296,3614,12056,55,8442,250
BA,30872,DIAS D'ÁVILA,23939,7657,10114,43918,715,33804,1493
BA,30899,FÁTIMA,7855,2154,4059,14546,140,10487,338
BA,30910,FILADÉLFIA,6753,2427,3878,13557,136,9679,363
BA,30937,GAVIÃO,1832,954,1112,4063,28,2951,137
BA,30953,GUAJERU,3691,747,2791,7452,37,4661,186
BA,30970,HELIÓPOLIS,6184,1330,3498,11254,63,7756,179
BA,30996,JOÃO DOURADO,8330,3515,4809,17116,126,12307,336
BA,33014,ABAÍRA,3055,1481,1880,6739,79,4859,244
BA,33030,ABARÉ,7089,2156,2189,11806,43,9617,329
BA,33057,ACAJUTIBA,5140,2190,3086,10801,124,7715,261
BA,33065,ADUSTINA,6809,1369,1334,9948,102,8614,334
BA,33073,ÁGUA FRIA,5128,2691,3477,11912,111,8435,505
BA,33090,ÉRICO CARDOSO,3488,1774,3439,9044,69,5605,274
BA,33111,AIQUARA,2061,630,1578,4418,43,2840,106
BA,33138,ALAGOINHAS,50335,26250,24407,106318,1623,81911,3703
BA,33154,ALCOBAÇA,8653,2426,5859,17505,137,11646,430
BA,33170,ALMADINA,2203,1047,1828,5215,26,3387,111
BA,33197,AMARGOSA,10853,6958,5874,24713,312,18839,716
BA,33219,AMÉLIA RODRIGUES,9847,3161,3510,17343,249,13833,576
BA,33235,ANAGÉ,8004,4570,4572,17738,129,13166,463
BA,33251,ANDARAÍ,5441,781,3563,10179,85,6616,309
BA,33260,ANDORINHA,7695,1058,1183,10357,86,9174,335
BA,33278,ANGICAL,7695,1182,2520,11700,72,9180,231
BA,33294,ANGUERA,5274,1097,2178,8832,63,6654,220
BA,33316,ANTAS,5305,1682,2757,10069,79,7312,246
BA,33332,ANTÔNIO CARDOSO,6863,1100,1951,10266,83,8315,269
BA,33359,ANTÔNIO GONÇALVES,4117,1411,1974,7741,39,5767,200
BA,33375,APORÁ,5872,2801,4287,13386,109,9099,317
BA,33383,ARAÇÁS,5267,1721,2888,10233,128,7345,229
BA,33391,ARACATU,6676,1855,3337,12286,97,8949,321
BA,33405,APUAREMA,2295,1178,1907,5573,38,3666,155
BA,33413,ARACI,21009,4348,12574,38916,174,26342,811
BA,33430,ARAMARI,4824,1255,1708,8160,105,6452,268
BA,33456,ARATUÍPE,4038,1271,2062,7637,72,5575,194
BA,33472,AURELINO LEAL,4654,1402,1384,7760,79,6376,241
BA,33499,BAIANÓPOLIS,6478,1465,2495,10735,73,8240,224
BA,33510,BAIXA GRANDE,6159,4168,4550,15505,170,10955,458
BA,33529,BANZAÊ,4832,1834,2929,9821,47,6892,179
BA,33537,BARRA,19941,3409,10309,34725,185,24416,881
BA,33553,BARRA DA ESTIVA,8594,4705,3665,17542,163,13877,415
BA,33570,BARRA DO CHOÇA,11441,6380,6969,25787,238,18818,759
BA,33596,BARRA DO MENDES,6917,792,3664,11668,74,8004,221
BA,33618,BARRA DO ROCHA,1960,768,473,3336,27,2863,108
BA,33634,BARREIRAS,46377,21165,19791,89971,721,70180,1917
BA,33650,BARRO PRETO,2456,1438,1393,5470,46,4077,137
BA,33677,BELMONTE,6830,2822,4537,14696,104,10159,403
BA,33693,BELO CAMPO,5574,3600,4658,14274,81,9616,361
BA,33715,BIRITINGA,6742,1141,3165,11593,101,8428,444
BA,33731,BOA NOVA,6150,1381,5252,13267,90,8015,394
BA,33758,BOA VISTA DO TUPIM,6016,2982,3611,13123,92,9512,422
BA,33774,BOM JESUS DA LAPA,25521,5069,12873,44730,370,31857,897
BA,33782,BOM JESUS DA SERRA,4557,816,2993,8633,43,5640,224
BA,33790,BONINAL,4674,1768,3016,9810,78,6794,274
BA,33804,BONITO,5968,1799,3158,11230,67,8072,238
BA,33812,BOQUIRA,8908,1397,4587,15392,101,10805,399
BA,33839,BOTUPORÃ,4255,2036,2844,9412,45,6568,232
BA,33855,BREJÕES,4865,2008,4147,11420,117,7273,283
BA,33871,BREJOLÂNDIA,3829,1312,2220,7594,68,5374,165
BA,33898,BROTAS DE MACAÚBAS,4255,1937,2240,8734,57,6494,245
BA,33910,BRUMADO,25214,10633,7916,45606,395,37690,1448
BA,33936,BUERAREMA,2666,5990,1610,10720,82,9110,372
BA,33952,CAATIBA,3053,1587,2754,7638,62,4884,182
BA,33960,CABACEIRAS DO PARAGUAÇU,6417,1527,1346,9653,64,8307,299
BA,33979,CACHOEIRA,13663,3841,5763,24150,276,18387,607
BA,33995,CACULÉ,7208,4540,3512,15871,163,12359,448
BA,34010,CAEM,4310,1036,2491,8106,49,5615,220
BA,34029,CAETANOS,5059,780,3068,9157,38,6089,212
BA,34037,CAETITÉ,19805,8298,7345,37038,293,29693,1297
BA,34053,CAFARNAUM,6552,2050,3693,12655,120,8962,240
BA,34070,CAIRU,5820,2237,3383,11849,133,8466,276
BA,34096,CALDEIRÃO GRANDE,4573,1323,2666,8835,51,6169,222
BA,34118,CAMACAN,7420,4398,5237,17689,163,12452,471
BA,34134,CAMAÇARI,70085,43595,29548,151897,2587,122349,6082
BA,34150,CAMAMU,9051,6116,8718,24856,256,16138,715
BA,34177,CAMPO ALEGRE DE LOURDES,12583,1881,7060,22131,69,15071,538
BA,34193,CAMPO FORMOSO,26763,8932,11785,49073,400,37288,1193
BA,34215,CANÁPOLIS,4531,1143,1710,7683,35,5973,264
BA,34231,CANARANA,9866,2603,3587,16521,117,12934,348
BA,34258,CANAVIEIRAS,10191,4737,3095,18848,181,15753,644
BA,34274,CANDEAL,4260,1006,1256,6781,42,5525,217
BA,34290,CANDEIAS,37172,6677,12511,59473,988,46962,2125
BA,34312,CANDIBA,6319,1600,1882,10205,97,8323,307
BA,34339,CÂNDIDO SALES,9350,2887,2236,14984,116,12748,395
BA,34355,CANSANÇÃO,15201,2154,7735,25807,196,18072,521
BA,34363,CARAÍBAS,3417,2078,2239,7956,45,5717,177
BA,34371,CARAVELAS,7610,2099,3519,13792,103,10273,461
BA,34398,CARDEAL DA SILVA,3582,831,2286,7029,98,4743,232
BA,34410,CARINHANHA,9128,4949,5843,20514,90,14671,504
BA,34436,CASA NOVA,32318,5395,9607,48957,307,39350,1330
BA,34452,CASTRO ALVES,12005,3239,6116,21982,136,15866,486
BA,34479,CATOLÂNDIA,1901,378,388,2768,30,2380,71
BA,34495,CATU,21640,7081,7284,38761,998,31477,1758
BA,34509,CATURAMA,3664,903,2148,6943,57,4795,171
BA,34517,CENTRAL,7026,2200,2912,12529,116,9617,275
BA,34533,CHORROCHÓ,4872,1151,2332,8602,44,6270,203
BA,34550,CÍCERO DANTAS,12479,4723,6077,24123,275,18046,569
BA,34576,CIPÓ,6228,2650,3558,12909,94,9351,379
BA,34592,COARACI,6794,4610,4772,16719,149,11947,394
BA,34614,COCOS,6168,3048,1914,11637,100,9723,407
BA,34630,CONCEIÇÃO DA FEIRA,8928,2468,2656,14755,207,12099,496
BA,34657,CONCEIÇÃO DO ALMEIDA,8356,1864,3895,14591,135,10696,341
BA,34673,CONCEIÇÃO DO COITÉ,23795,13178,8692,47302,485,38610,1152
BA,34690,CONCEIÇÃO DO JACUÍPE,12359,4301,4206,21934,327,17728,741
BA,34711,CONDE,8487,2406,4974,16433,143,11459,423
BA,34738,CONDEÚBA,6617,3094,4474,14765,140,10291,440
BA,34754,CONTENDAS DO SINCORÁ,1915,777,756,3541,15,2785,78
BA,34770,CORAÇÃO DE MARIA,12182,2540,4863,20308,207,15445,516
BA,34797,CORDEIROS,2438,1844,1940,6438,45,4498,171
BA,34819,CORIBE,6379,1755,1939,10393,66,8454,254
BA,34835,CORONEL JOÃO SÁ,7181,1770,3751,13094,84,9343,308
BA,34851,CORRENTINA,11603,5436,7393,25356,251,17963,673
BA,34878,COTEGIPE,6187,1065,3001,10536,54,7535,229
BA,34894,CRAVOLÂNDIA,1834,842,1329,4211,52,2882,154
BA,34916,CRISÓPOLIS,8072,2295,5519,16315,88,10796,341
BA,34932,CRISTÓPOLIS,6398,1692,2857,11280,71,8423,262
BA,34959,CRUZ DAS ALMAS,23134,10120,7084,41920,574,34836,1008
BA,34975,CURAÇÁ,14422,2951,6031,24065,165,18034,496
BA,34991,DÁRIO MEIRA,4206,999,3458,8995,80,5537,252
BA,35017,DOM BASÍLIO,6260,1120,1713,9420,79,7707,248
BA,35033,DOM MACEDO COSTA,2046,685,390,3256,27,2866,108
BA,35050,ELÍSIO MEDRADO,3752,1059,2399,7498,82,5099,206
BA,35076,ENCRUZILHADA,6347,3389,1850,12183,132,10333,465
BA,35092,ENTRE RIOS,14154,4803,9484,30016,483,20532,1092
BA,35114,ESPLANADA,12362,3709,6132,23124,270,16992,651
BA,35130,EUCLIDES DA CUNHA,24134,4836,10391,40608,248,30217,999
BA,35149,FEIRA DA MATA,2181,1095,1334,4707,22,3373,75
BA,35157,FEIRA DE SANTANA,197054,98326,71638,387973,5015,316335,15940
BA,35173,FIRMINO ALVES,1722,1061,1411,4354,42,2943,118
BA,35190,FLORESTA AZUL,3228,1668,2168,7342,58,5174,220
BA,35211,FORMOSA DO RIO PRETO,7586,3975,4687,16689,89,12002,352
BA,35238,GANDU,8283,5858,5130,20137,251,15007,615
BA,35254,GENTIO DO OURO,5097,1361,1946,8627,50,6681,173
BA,35270,GLÓRIA,7948,1148,2812,12265,78,9453,279
BA,35297,GONGOGI,2529,618,1002,4327,30,3325,148
BA,35319,GOVERNADOR MANGABEIRA,7514,3493,1857,13339,146,11482,329
BA,35335,GUANAMBI,31844,12627,11020,57669,525,46649,1653
BA,35351,GUARATINGA,7793,2266,4489,15090,104,10601,438
BA,35378,IAÇU,9114,3097,8124,21018,191,12894,492
BA,35394,IBIASSUCÊ,3862,2468,2043,8607,40,6564,194
BA,35416,IBICARAÍ,7130,5578,4893,18230,168,13337,461
BA,35432,IBICOARA,6261,2843,2860,12419,150,9559,305
BA,35459,IBICUÍ,5048,2335,3306,11037,93,7731,255
BA,35475,IBIPEBA,7597,1199,3616,12737,63,9121,262
BA,35491,SANTA RITA DE CÁSSIA,11478,2936,6817,21837,141,15020,465
BA,35513,IBIPITANGA,5617,1889,3754,11598,86,7844,252
BA,35530,IBIQUERA,1551,494,1115,3289,15,2174,114
BA,35556,IBIRAPITANGA,6157,3012,3852,13606,135,9754,450
BA,35572,IBIRAPUÃ,2334,2130,1426,6117,51,4691,176
BA,35599,IBIRATAIA,6580,3647,1657,12598,179,10941,535
BA,35610,IBITIARA,5644,2081,3081,11152,86,8071,260
BA,35637,IBITITÁ,9118,1354,3155,13977,90,10822,260
BA,35653,IBOTIRAMA,8827,4207,4476,17987,103,13511,374
BA,35670,ICHU,2828,1030,827,4866,38,4039,143
BA,35696,IGAPORÃ,6777,1436,2216,10814,74,8598,311
BA,35700,IGRAPIÚNA,4676,1553,3254,9857,95,6603,279
BA,35718,IGUAÍ,8491,3138,7276,19635,125,12359,605
BA,35734,ILHÉUS,52546,35371,40230,133400,1465,93170,3788
BA,35750,INHAMBUPE,11867,5855,6247,24988,290,18741,729
BA,35777,IPECAETÁ,6967,2058,3267,12682,85,9415,305
BA,35793,IPIAÚ,13658,7688,3099,25704,319,22605,940
BA,35815,IPIRÁ,20459,9878,11425,43516,404,32091,1350
BA,35831,IPUPIARA,4029,1279,1817,7314,64,5497,125
BA,35858,IRAJUBA,2933,753,1441,5297,40,3856,130
BA,35874,IRAMAIA,3879,1844,3032,9034,76,6002,203
BA,35890,IRAQUARA,10495,1396,3220,15492,83,12272,298
BA,35912,IRARÁ,12241,3500,5646,22230,193,16584,650
BA,35939,IRECÊ,22696,8465,11553,44301,427,32748,1160
BA,35947,ITABELA,8933,4938,7714,22505,250,14791,670
BA,35955,ITABERABA,20358,8527,9380,40201,498,30821,1438
BA,35971,ITABUNA,56381,50974,36419,148834,1435,112415,3625
BA,35998,ITACARÉ,6855,2279,3811,13467,166,9656,356
BA,36013,ITAETÉ,5042,1553,3120,10117,87,6997,315
BA,36030,ITAGI,4240,2718,3186,10489,65,7303,280
BA,36056,ITAGIBÁ,5980,2067,3494,12056,125,8562,390
BA,36072,ITAGIMIRIM,1925,1639,2005,5780,41,3775,170
BA,36080,ITAGUAÇU DA BAHIA,5884,758,2488,9386,45,6898,211
BA,36099,ITAJU DO COLÔNIA,1718,1307,1400,4540,23,3140,92
BA,36110,ITAJUÍPE,7243,4165,4681,16622,164,11941,369
BA,36137,ITAMARAJU,14715,13865,12299,42294,379,29995,1036
BA,36153,ITAMARI,2894,1293,2319,6711,43,4392,162
BA,36170,ITAMBÉ,7691,3950,5932,18059,117,12127,369
BA,36196,ITANAGRA,2266,669,1681,4784,40,3103,128
BA,36218,ITANHÉM,6588,3903,4587,15692,128,11105,486
BA,36234,ITAPARICA,9397,1834,4612,16380,133,11768,404
BA,36250,ITAPÉ,3997,1871,2791,8996,73,6205,264
BA,36277,ITAPEBI,3220,1547,3175,8166,70,4991,154
BA,36293,ITAPETINGA,15064,18517,9730,44525,377,34795,837
BA,36315,ITAPICURU,12471,2426,7326,23128,143,15802,762
BA,36331,ITAPITANGA,2929,1171,2571,6819,31,4248,117
BA,36358,ITAQUARA,2799,1611,1601,6245,50,4644,184
BA,36374,ITARANTIM,5611,3439,3568,13110,129,9542,363
BA,36382,ITATIM,5704,2274,2692,11133,142,8441,321
BA,36390,ITIRUÇU,4207,1914,3097,9587,110,6490,259
BA,36412,ITIÚBA,11952,6610,8913,28255,200,19342,580
BA,36439,ITORORÓ,5357,4686,5500,16090,124,10590,423
BA,36455,ITUAÇU,5784,4972,2758,14042,114,11284,414
BA,36471,ITUBERÁ,8353,4195,6148,19391,200,13243,495
BA,36498,JACARACI,6041,1624,3414,11427,71,8013,277
BA,36510,JACOBINA,28950,9993,14183,55249,420,41066,1703
BA,36536,JAGUAQUARA,16130,7333,10380,35390,378,25010,1169
BA,36552,JAGUARARI,11648,4791,4282,21404,175,17122,508
BA,36579,JAGUARIPE,6927,1545,2977,12022,182,9045,391
BA,36595,JANDAÍRA,3973,969,2633,7839,53,5206,211
BA,36617,JEQUIÉ,53735,22269,25482,106634,1582,81152,3566
BA,36633,JEREMOABO,15803,2804,5955,25462,143,19507,757
BA,36650,JIQUIRIÇÁ,4516,2440,3274,10606,114,7332,262
BA,36676,JITAÚNA,5167,3173,5242,14118,123,8876,413
BA,36692,JUAZEIRO,80611,27212,27687,139557,1091,111870,2956
BA,36706,JUCURUÇU,3960,1079,2647,7929,47,5282,196
BA,36714,JUSSARA,7309,943,2854,11516,67,8662,343
BA,36730,JUSSIAPE,3410,1147,1693,6459,47,4766,162
BA,36757,LAFAIETE COUTINHO,2217,414,728,3492,35,2764,98
BA,36765,LAGOA REAL,5892,1280,2399,9881,53,7482,257
BA,36773,LAJE,8551,4509,4636,18355,155,13719,504
BA,36790,LAJEDÃO,2037,949,1168,4278,19,3110,105
BA,36811,LAJEDINHO,1840,303,803,3082,18,2279,118
BA,36820,LAJEDO DO TABOCAL,3227,719,1669,5854,63,4185,176
BA,36838,LAMARÃO,3687,661,2716,7264,44,4548,156
BA,36854,LAURO DE FREITAS,57596,24317,24573,112526,1594,87953,4446
BA,36870,LENÇÓIS,3714,808,2304,7091,45,4787,220
BA,36897,LICÍNIO DE ALMEIDA,4957,1747,2036,9012,86,6976,186
BA,36919,LIVRAMENTO DE NOSSA SENHORA,17928,5059,8303,32406,336,24103,780
BA,36935,MACAJUBA,3981,1721,3649,9718,65,6069,302
BA,36951,MACARANI,4678,3830,4256,13323,132,9067,427
BA,36978,MACAÚBAS,15777,5915,10409,33120,237,22711,782
BA,36994,MACURURÉ,3397,987,2040,6564,19,4524,121
BA,37010,MAIQUINIQUE,2917,1881,1850,6895,50,5045,197
BA,37036,MAIRI,6895,2308,4444,14211,131,9767,433
BA,37052,MALHADA,6431,2220,3477,12449,93,8972,228
BA,37079,MALHADA DE PEDRAS,3609,1566,1539,6905,44,5366,147
BA,37095,MANOEL VITORINO,6369,1397,2620,10685,59,8065,240
BA,37117,MARACÁS,7725,5040,6763,20229,179,13466,522
BA,37133,MARAGOGIPE,18933,5141,7094,32064,247,24970,649
BA,37150,MARAÚ,6107,1576,4103,12232,108,8129,338
BA,37176,MARCIONÍLIO SOUZA,3855,958,2535,7610,67,5075,195
BA,37192,MASCOTE,3825,1789,3096,8992,59,5896,223
BA,37214,MATA DE SÃO JOÃO,17289,6937,7906,33910,657,26004,1121
BA,37222,MATINA,5385,678,2358,8717,47,6359,249
BA,37230,MEDEIROS NETO,7543,4660,4768,17614,105,12846,538
BA,37257,MIGUEL CALMON,10282,3424,7340,21765,118,14425,601
BA,37273,MILAGRES,4345,1752,2392,8782,64,6390,229
BA,37290,MIRANGABA,6096,1704,3817,11977,61,8160,299
BA,37303,MIRANTE,3487,1334,2330,7354,37,5024,166
BA,37311,MONTE SANTO,24128,3279,13282,42063,260,28781,1114
BA,37338,MORPARÁ,3631,1175,1935,6954,40,5019,173
BA,37354,MORRO DO CHAPÉU,12517,3575,5953,22916,179,16963,692
BA,37370,MORTUGABA,3710,2671,2646,9290,47,6644,216
BA,37397,MUCUGÊ,3687,2385,1897,8308,61,6411,278
BA,37419,MUCURI,10159,6206,9294,26511,258,17217,594
BA,37427,MULUNGU DO MORRO,5314,983,2690,9189,52,6499,150
BA,37435,MUNDO NOVO,7701,2222,4810,15301,115,10491,453
BA,37451,MUNIZ FERREIRA,3848,1249,1696,7019,55,5323,171
BA,37460,MUQUÉM DO SÃO FRANCISCO,4230,1646,2434,8476,27,6042,139
BA,37478,MURITIBA,11208,3376,2566,18009,250,15443,609
BA,37494,MUTUÍPE,6637,5163,4965,17419,172,12454,482
BA,37516,NAZARÉ,12088,3097,5220,21235,291,16015,539
BA,37532,NILO PEÇANHA,4110,1601,1952,8063,102,6111,298
BA,37559,NOVA CANAÃ,6418,1718,3856,12453,80,8597,381
BA,37567,NOVA FÁTIMA,3213,1856,1587,6916,65,5329,195
BA,37575,NOVA ITARANA,2516,1081,1634,5446,54,3812,161
BA,37583,NOVA REDENÇÃO,3570,370,1706,5886,50,4180,190
BA,37591,NOVA SOURE,10581,2242,5193,18668,134,13475,518
BA,37613,NOVA VIÇOSA,10478,7832,8737,28098,268,19361,783
BA,37621,NOVO TRIUNFO,3394,1398,2720,7736,33,5016,191
BA,37630,OLINDINA,10516,1770,7001,19938,157,12937,494
BA,37656,OLIVEIRA DOS BREJINHOS,8965,2330,4097,15888,111,11791,385
BA,37672,OURIÇANGAS,3249,1410,1912,6834,77,4922,186
BA,37680,OUROLÂNDIA,5000,3402,4187,12939,73,8752,277
BA,37699,PALMAS DE MONTE ALTO,10145,1843,3619,16187,108,12568,472
BA,37710,PALMEIRAS,3755,764,1384,6112,38,4728,171
BA,37737,PARAMIRIM,8480,2280,4853,16070,136,11217,321
BA,37753,PARATINGA,12716,2396,5827,21488,116,15661,433
BA,37770,PARIPIRANGA,12915,3458,2736,19849,146,17113,594
BA,37796,PAU BRASIL,3327,1606,2162,7340,59,5178,186
BA,37818,PAULO AFONSO,47477,8490,19594,77753,625,58159,1567
BA,37834,PEDRÃO,3319,650,1780,5904,42,4124,113
BA,37850,PEDRO ALEXANDRE,5282,850,2810,9235,50,6425,243
BA,37877,PIATÃ,7915,2033,4465,15000,91,10535,496
BA,37893,PILÃO ARCADO,14465,2269,6106,23571,124,17465,607
BA,37915,PINDAÍ,7130,1503,2840,11940,94,9100,373
BA,37931,PINDOBAÇU,6697,3509,3899,14552,117,10653,330
BA,37940,PIRAÍ DO NORTE,2765,1237,1219,5430,54,4211,155
BA,37958,PIRIPÁ,3459,1827,3569,9095,38,5526,202
BA,37974,PIRITIBA,7089,1988,3672,13252,95,9580,408
BA,37990,PLANALTINO,3446,933,1539,6124,40,4585,166
BA,38016,PLANALTO,8339,4661,3557,17171,156,13614,458
BA,38032,POÇÕES,15151,6395,11075,33862,326,22787,915
BA,38059,POJUCA,11558,6370,4908,25061,862,20153,1363
BA,38067,PONTO NOVO,5277,2486,4033,12122,84,8089,242
BA,38075,PORTO SEGURO,34131,21166,24091,82457,905,58366,2164
BA,38091,POTIRAGUÁ,3098,1848,3550,8792,65,5242,231
BA,38113,PRADO,8189,4226,7775,20845,131,13070,524
BA,38130,PRESIDENTE DUTRA,7016,966,2329,10633,85,8304,237
BA,38156,PRESIDENTE JÂNIO QUADROS,4955,1364,4525,11128,41,6603,243
BA,38164,PRESIDENTE TANCREDO NEVES,6559,6507,5267,19059,177,13792,549
BA,38172,QUEIMADAS,10065,2775,5401,18844,127,13443,476
BA,38199,QUINJINGUE,9608,4863,5015,20132,141,15117,505
BA,38210,REMANSO,17009,3813,6997,28820,203,21823,798
BA,38237,RETIROLÂNDIA,6430,1605,1940,10359,97,8419,287
BA,38253,RIACHÃO DAS NEVES,10442,1738,4565,17261,85,12696,431
BA,38270,RIACHÃO DO JACUÍPE,14140,4651,4351,24209,278,19858,789
BA,38296,RIACHO DE SANTANA,13111,3213,5258,22318,174,17060,562
BA,38318,RIBEIRA DO AMPARO,6482,1002,3556,11403,69,7847,294
BA,38334,RIBEIRA DO POMBAL,18165,8123,11867,39360,328,27493,877
BA,38342,RIBEIRÃO DO LARGO,3703,1413,1045,6430,43,5385,226
BA,38350,RIO DE CONTAS,5834,2188,3067,11517,102,8450,326
BA,38377,RIO DO ANTÔNIO,6092,1188,3480,11203,113,7723,330
BA,38393,RIO DO PIRES,4239,1834,3944,10283,47,6339,219
BA,38415,RIO REAL,13531,5280,8474,28424,413,19950,726
BA,38431,RODELAS,3504,906,1328,5913,37,4585,138
BA,38458,RUY BARBOSA,10886,4137,7812,23667,188,15855,644
BA,38474,SALINAS DA MARGARIDA,7209,1016,2329,10975,137,8646,284
BA,38490,SALVADOR,918550,447339,427236,1923807,29435,1496571,101247
BA,38512,SANTA BÁRBARA,10768,1977,3625,16929,106,13304,453
BA,38539,SANTA BRÍGIDA,6756,1086,3466,11667,81,8201,278
BA,38555,SANTA CRUZ CABRÁLIA,5625,5540,5776,17514,149,11738,424
BA,38571,SANTA CRUZ DA VITÓRIA,1624,1045,1846,4686,40,2840,131
BA,38598,SANTA INÊS,4205,893,2662,8041,70,5379,211
BA,38610,SANTALUZ,13376,6736,6896,28212,318,21316,886
BA,38636,SANTA MARIA DA VITÓRIA,14449,6043,8037,29462,213,21425,720
BA,38652,SANTANA,9893,4098,4584,19183,131,14599,477
BA,38679,SANTANÓPOLIS,4797,1020,2212,8324,82,6112,213
BA,38695,SANTA TEREZINHA,4342,1238,2508,8435,74,5927,273
BA,38717,SANTO AMARO,26515,6496,9845,44853,687,35008,1310
BA,38733,SANTO ANTÔNIO DE JESUS,30984,15538,5803,55273,759,49470,2189
BA,38750,SANTO ESTEVÃO,18820,5581,9836,35625,364,25789,1024
BA,38776,SÃO DESIDÉRIO,10742,3811,2672,18004,164,15332,615
BA,38792,SÃO FÉLIX,5902,1576,2092,9893,91,7801,232
BA,38806,SÃO DOMINGOS,3548,1579,1536,6912,64,5376,185
BA,38814,SÃO FELIPE,7560,4365,4171,16649,200,12478,353
BA,38822,SÃO FÉLIX DO CORIBE,4984,2727,2155,10187,93,8032,228
BA,38830,SÃO FRANCISCO DO CONDE,17181,5063,5210,28739,441,23529,844
BA,38857,SÃO GONÇALO DOS CAMPOS,15386,3591,3960,23842,253,19882,652
BA,38865,SÃO JOSÉ DO JACUÍPE,3823,1304,2023,7503,96,5480,257
BA,38873,SÃO MIGUEL DAS MATAS,4312,1967,1729,8278,69,6549,201
BA,38890,SÃO SEBASTIÃO DO PASSÉ,19948,3799,5941,31179,442,25238,1049
BA,38911,SAPEAÇU,7694,2644,2877,13661,139,10784,307
BA,38938,SÁTIRO DIAS,5675,2302,4610,13029,97,8419,345
BA,38946,SAUBARA,6251,1242,3090,11019,126,7929,310
BA,38954,SAÚDE,4165,1416,2670,8541,79,5871,211
BA,38970,SEABRA,17835,4043,6460,29262,179,22802,745
BA,38997,SEBASTIÃO LARANJEIRAS,3827,871,1919,6834,51,4915,166
BA,39012,SENHOR DO BONFIM,23533,11907,4707,42086,535,37379,1404
BA,39039,SENTO SÉ,13623,4429,9160,27848,170,18688,466
BA,39047,SERRA DO RAMALHO,12661,2292,7724,23310,147,15586,486
BA,39055,SERRA DOURADA,6512,3601,4517,14951,82,10434,239
BA,39071,SERRA PRETA,9050,1852,4778,16230,109,11452,441
BA,39098,SERRINHA,30551,10381,11140,54461,419,43321,1970
BA,39110,SERROLÂNDIA,4437,2061,3183,10069,92,6886,296
BA,39136,SIMÕES FILHO,46045,11165,15739,77044,1255,61305,2840
BA,39144,SÍTIO DO MATO,5501,828,3045,9551,51,6506,126
BA,39152,SOUTO SOARES,7036,1508,2758,11534,56,8776,176
BA,39179,TABOCAS DO BREJO VELHO,5431,1146,3000,9844,61,6844,206
BA,39195,TANHAÇU,7527,5030,3194,16258,97,13064,410
BA,39217,TANQUINHO,3833,1199,1193,6413,43,5220,145
BA,39233,TAPEROÁ,5763,2821,3012,12118,116,9106,406
BA,39250,TAPIRAMUTÁ,4928,1432,4031,10876,84,6845,401
BA,39276,TEODORO SAMPAIO,3747,632,1774,6428,59,4654,216
BA,39292,TEOFILÂNDIA,8916,2392,5135,17035,107,11900,485
BA,39314,TEOLÂNDIA,4677,2211,2581,9841,85,7260,287
BA,39330,TERRA NOVA,5002,1560,2405,9460,118,7055,375
BA,39357,TREMEDAL,6597,3013,5404,15477,84,10073,379
BA,39373,TUCANO,19795,5029,11908,38072,316,26164,1024
BA,39390,UAUÁ,11866,2277,5646,20355,120,14709,446
BA,39411,UBAÍRA,6799,3804,4075,15331,164,11256,489
BA,39438,UBAITABA,5711,3889,2119,12225,116,10106,390
BA,39454,UBATÃ,5276,3112,4066,13015,115,8949,446
BA,39470,UIBAÍ,6052,2071,2334,10747,66,8413,224
BA,39489,UMBURANAS,3997,2612,3393,10265,55,6872,208
BA,39497,UNA,5922,3797,1887,12193,145,10306,442
BA,39519,URANDI,7500,1040,3186,12127,121,8941,280
BA,39535,URUÇUCA,6393,5194,5223,17480,149,12257,521
BA,39551,UTINGA,6674,1753,3904,12787,98,8883,358
BA,39578,VALENÇA,26244,14803,16274,60932,1030,44658,2581
BA,39594,VALENTE,8366,5429,3325,17830,149,14505,561
BA,39616,VÁRZEA DO POÇO,3221,1332,1838,6619,56,4781,172
BA,39624,VARZEDO,3473,2146,796,6638,51,5842,172
BA,39632,VERA CRUZ,16790,3810,8614,30228,346,21614,668
BA,39640,VEREDA,2869,1223,1887,6160,28,4273,153
BA,39659,VITÓRIA DA CONQUISTA,82827,84871,48492,224776,2283,176284,6303
BA,39675,WAGNER,2935,1305,2499,6940,54,4441,147
BA,39691,WENCESLAU GUIMARÃES,6997,3176,3804,14601,136,10797,488
BA,39713,XIQUE-XIQUE,16809,5788,9998,33600,194,23602,811
BA,39730,LAPÃO,12038,2690,5200,20457,131,15257,398
BA,39748,MADRE DE DEUS,7162,3000,3042,13800,190,10758,406
BA,39756,MAETINGA,2608,1333,2680,6841,23,4161,197
BA,39772,MANSIDÃO,4710,640,3691,9225,32,5534,152
BA,39799,NORDESTINA,5083,1044,3430,9907,78,6477,272
BA,39810,PÉ DE SERRA,4745,3056,2274,10405,73,8131,257
BA,39837,PINTADAS,3091,2438,2242,8056,52,5814,233
BA,39845,QUIXABEIRA,3409,1921,2055,7615,63,5560,167
BA,39853,RAFAEL JAMBEIRO,7519,3887,5270,17241,148,11971,417
BA,39870,SANTA LUZIA,3316,1609,3974,9168,48,5194,221
BA,39896,SÃO GABRIEL,10080,1205,3219,14965,109,11746,352
BA,39900,SÍTIO DO QUINTO,4725,1671,2778,9468,63,6690,231
BA,39918,TANQUE NOVO,6748,2010,2849,12080,131,9231,342
BA,39926,SÃO JOSÉ DA VITÓRIA,2084,1234,483,3968,32,3485,135
BA,39934,TEIXEIRA DE FREITAS,36935,29504,27827,97411,820,69584,2325
BA,39942,NOVO HORIZONTE,4406,1580,1698,7926,79,6228,163
BA,39950,VÁRZEA NOVA,4430,1411,3053,9217,60,6164,263
BA,39969,NOVA IBIÁ,2061,1260,1746,5266,48,3520,151
BA,39977,VÁRZEA DA ROÇA,5315,1666,2901,10333,135,7432,316
BA,39985,SOBRADINHO,10481,2396,3693,17166,140,13473,456
BA,39993,WANDERLEY,5179,1692,2507,9641,63,7134,200
CE,13005,JIJOCA DE JERICOACOARA,6506,2350,3200,12794,152,9594,586
CE,13013,ABAIARA,4433,561,1524,6820,72,5296,230
CE,13021,MADALENA,7989,1093,3911,13481,91,9570,397
CE,13030,ACARAÚ,24144,5029,12117,42998,435,30881,1273
CE,13048,PIRES FERREIRA,4543,908,1964,7633,28,5669,190
CE,13056,ACOPIARA,24346,3146,7519,36817,373,29298,1433
CE,13064,GRAÇA,6857,750,4577,12629,95,8052,350
CE,13072,AIUABA,6488,719,3566,11286,57,7720,456
CE,13080,TURURU,8191,1490,2553,12719,131,10166,354
CE,13099,ALCÂNTARAS,5233,926,1224,7850,117,6626,350
CE,13102,QUITERIANÓPOLIS,8841,1634,4868,16017,123,11149,551
CE,13110,ALTANEIRA,3446,723,1528,5944,51,4416,196
CE,13129,BARREIRA,9880,3162,3556,17624,202,14068,824
CE,13137,ALTO SANTO,7877,963,3165,12487,87,9322,395
CE,13145,ACARAPE,6571,1765,2267,11179,177,8912,399
CE,13153,ANTONINA DO NORTE,3426,527,2327,6536,42,4209,214
CE,13161,CHOROZINHO,10760,1755,2789,16089,224,13300,561
CE,13170,APUIARÉS,7119,1351,3242,12140,86,8898,342
CE,13188,HORIZONTE,29074,7716,8500,47751,772,39251,1689
CE,13196,AQUIRAZ,29653,7698,4503,44750,599,40247,2297
CE,13200,ERERÊ,2813,776,1432,5218,34,3786,163
CE,13218,ARACATI,31367,8384,10958,53059,830,42101,1520
CE,13226,EUSÉBIO,20162,6019,4710,32758,458,28048,1409
CE,13234,ARACOIABA,14114,2866,4780,22612,190,17832,662
CE,13242,GUAIÚBA,11138,2919,3728,18448,119,14720,544
CE,13250,ARARIPE,10305,1187,5048,17339,84,12291,715
CE,13269,POTIRETAMA,3511,305,1148,5149,33,4001,152
CE,13277,ARATUBA,6097,1276,2575,10382,93,7807,341
CE,13285,PINDORETAMA,10621,2215,3015,16608,134,13593,623
CE,13293,ARNEIROZ,3590,889,1969,6747,45,4778,254
CE,13307,OCARA,12661,3484,4090,21070,163,16980,672
CE,13315,ASSARÉ,10122,2281,5552,18657,133,13105,569
CE,13323,TEJUÇUOCA,9031,1517,3222,14378,121,11156,487
CE,13331,AURORA,11120,3512,5340,20769,140,15429,657
CE,13340,IPAPORANGA,4702,1393,1238,7738,44,6500,361
CE,13358,BAIXIO,3337,443,1425,5377,35,3952,137
CE,13366,TARRAFAS,3694,1146,2445,7538,47,5093,206
CE,13374,BARBALHA,22078,10165,7730,41720,441,33990,1306
CE,13382,BANABUIÚ,8507,1204,3845,14013,71,10168,386
CE,13390,BARRO,9989,1491,4978,17038,125,12060,455
CE,13404,BARROQUINHA,6976,1141,3445,12033,111,8588,360
CE,13412,BATURITÉ,15360,3842,7537,27936,339,20399,858
CE,13420,ARARENDÁ,4402,1425,2529,8707,39,6178,312
CE,13439,BEBERIBE,23310,6086,9631,40856,476,31225,1353
CE,13447,CATUNDA,4880,585,2651,8406,61,5755,229
CE,13455,BELA CRUZ,10974,3734,6552,22219,202,15667,757
CE,13463,CHORÓ,6807,888,3587,11691,83,8104,326
CE,13471,BOA VIAGEM,23524,3731,13662,42318,266,28656,1135
CE,13480,ITAITINGA,15887,4215,4399,25888,309,21489,1078
CE,13498,BREJO SANTO,20737,4434,7873,34246,213,26373,989
CE,13501,FORTIM,7870,1472,2551,12388,113,9837,382
CE,13510,CAMOCIM,26162,7067,11978,47182,472,35204,1503
CE,13536,CAMPOS SALES,11478,2182,5956,20378,139,14422,623
CE,13552,CANINDÉ,32402,5956,16574,56986,405,40412,1649
CE,13579,CAPISTRANO,9263,1604,3669,15145,138,11476,471
CE,13595,CARIDADE,9985,1150,3678,15428,116,11750,499
CE,13617,CARIRÉ,8128,2797,3978,15563,121,11585,539
CE,13633,CARIRIAÇU,11901,4029,6944,23803,153,16859,776
CE,13650,CARIÚS,9005,1617,4951,16145,136,11194,436
CE,13676,CARNAUBAL,6829,1487,4567,13524,92,8957,549
CE,13692,CASCAVEL,30918,8006,11560,53294,716,41734,2094
CE,13714,CATARINA,5040,828,2711,8932,56,6221,297
CE,13730,CAUCAIA,127594,29329,35456,203853,2395,168397,9079
CE,13757,CEDRO,12085,2538,4742,20307,154,15565,788
CE,13773,CHAVAL,5846,1027,3398,10729,95,7331,363
CE,13811,COREAÚ,9114,3536,5009,18464,136,13455,669
CE,13838,CRATEÚS,30687,7973,7776,49520,594,41744,2490
CE,13854,CRATO,56341,11096,16969,87678,782,70709,2490
CE,13870,FARIAS BRITO,10021,2034,3625,16477,160,12852,637
CE,13897,FORTALEZA,857266,405154,290746,1658634,22207,1367888,83261
CE,13919,FRECHEIRINHA,6234,1866,2445,11086,126,8641,415
CE,13935,GENERAL SAMPAIO,3495,1222,1501,6501,51,5000,232
CE,13951,GRANJA,22759,4413,10560,39910,378,29350,1800
CE,13978,GRANJEIRO,2662,696,1617,5145,28,3528,142
CE,13994,GROAÍRAS,4349,1787,2045,8689,186,6644,322
CE,14010,GUARACIABA DO NORTE,16676,3899,9914,31900,243,21986,1168
CE,14036,GUARAMIRANGA,3262,675,1346,5483,61,4137,139
CE,14052,HIDROLÂNDIA,8175,2361,4885,15980,105,11095,454
CE,14060,IBARETAMA,7299,967,2556,11257,76,8701,359
CE,14079,IBIAPINA,8836,2863,5803,18408,188,12605,718
CE,14095,ICÓ,29473,4400,16938,52547,350,35609,1386
CE,14117,IGUATU,39547,10772,17534,70759,747,53225,2159
CE,14133,INDEPENDÊNCIA,11007,3252,6634,21757,146,15123,718
CE,14150,IPAUMIRIM,5907,807,2153,9262,78,7109,317
CE,14176,IPU,17858,3369,10516,32995,228,22479,1024
CE,14192,IPUEIRAS,15526,4039,11992,33082,292,21090,1233
CE,14214,IRACEMA,6763,1069,3090,11325,89,8235,314
CE,14230,IRAUÇUBA,10583,1920,4510,17695,142,13185,540
CE,14257,ITAIÇABA,3594,1251,1156,6266,64,5110,201
CE,14273,ITAPAGÉ,22201,6180,8401,38432,494,30031,1156
CE,14290,ITAPIPOCA,50087,12240,20001,85486,730,65485,2428
CE,14311,ITAPIÚNA,8982,1961,4512,16261,140,11749,666
CE,14338,ITATIRA,10313,1226,4607,16747,60,12140,541
CE,14354,JAGUARETAMA,9125,1515,4738,15872,103,11134,391
CE,14370,JAGUARIBARA,5074,791,1814,7961,54,6147,228
CE,14397,JAGUARIBE,17098,2983,8574,29645,221,21071,769
CE,14419,JAGUARUANA,13546,6029,6499,27578,557,21079,947
CE,14435,JARDIM,13153,2223,6020,22220,157,16200,667
CE,14451,JATI,4386,431,1564,6612,38,5048,193
CE,14478,JUAZEIRO DO NORTE,101260,25092,13866,147657,1839,133791,5600
CE,14494,JUCÁS,9985,3061,6125,20081,187,13956,723
CE,14516,LAVRAS DA MANGABEIRA,14275,2249,7534,25088,178,17554,852
CE,14532,LIMOEIRO DO NORTE,27811,4864,9502,44397,577,34895,1643
CE,14559,MARANGUAPE,46604,9325,13301,72902,826,59601,2846
CE,14575,MARCO,9862,5746,3749,20355,236,16606,762
CE,14591,MARTINÓPOLE,5637,892,2004,8888,69,6884,286
CE,14613,MASSAPÊ,13334,7582,6002,28237,337,22235,982
CE,14630,MAURITI,17434,7211,8201,34165,260,25964,1059
CE,14656,MERUOCA,6235,1984,1786,10583,173,8797,405
CE,14672,MILAGRES,13519,2800,5769,22827,123,17058,616
CE,14680,MIRAÍMA,6544,1081,3429,11370,58,7941,258
CE,14699,MISSÃO VELHA,17373,3034,6398,28149,272,21751,1072
CE,14710,MOMBAÇA,18595,3436,10034,33642,289,23608,1288
CE,14737,MONSENHOR TABOSA,8314,1172,4701,14695,93,9994,415
CE,14753,MORADA NOVA,31530,9033,14440,57373,514,42933,1856
CE,14770,MORAÚJO,3656,1117,1758,6830,58,5072,241
CE,14796,MORRINHOS,6635,4992,3020,15211,136,12191,428
CE,14818,MUCAMBO,6163,1727,4172,12591,136,8419,393
CE,14834,MULUNGU,5237,771,2349,8659,76,6310,226
CE,14850,NOVA OLINDA,7173,1648,2703,11994,92,9291,378
CE,14877,NOVA RUSSAS,12284,2933,7406,23693,225,16287,845
CE,14893,NOVO ORIENTE,11055,2404,7193,21817,228,14624,937
CE,14915,ORÓS,11099,1319,5074,18140,125,13066,523
CE,14931,PACAJUS,29276,6954,8179,47103,770,38924,1924
CE,14958,PACATUBA,26648,6751,7729,43652,567,35923,1957
CE,14974,PACOTI,5912,1486,2528,10441,102,7913,413
CE,14990,PACUJÁ,3334,606,1462,5686,49,4224,235
CE,15016,PALHANO,4973,1335,1518,8131,89,6613,216
CE,15032,PALMÁCIA,5453,891,1843,8565,74,6722,304
CE,15059,PARACURU,16649,3620,6018,27627,328,21609,1012
CE,15075,PARAMBU,9066,7402,9828,27790,308,17962,1186
CE,15091,PARAMOTI,5799,1357,2769,10280,58,7511,297
CE,15113,PEDRA BRANCA,20160,2593,11981,36197,250,24216,1213
CE,15130,PENAFORTE,4645,741,1137,6796,75,5659,198
CE,15156,PENTECOSTE,18174,4347,6880,30714,280,23834,1033
CE,15172,PEREIRO,7624,1789,4292,14191,92,9899,394
CE,15199,PIQUET CARNEIRO,7328,873,2232,10857,91,8625,333
CE,15210,PORANGA,4965,1190,3108,9763,60,6655,440
CE,15237,PORTEIRAS,8546,929,3472,13476,78,10004,451
CE,15253,POTENGI,4406,748,2035,7516,66,5481,261
CE,15270,QUIXADÁ,29026,11734,13974,57181,584,43207,1863
CE,15296,QUIXERAMOBIM,31491,7483,14232,55224,420,40992,1598
CE,15318,QUIXERÉ,9859,2702,3622,17072,244,13450,645
CE,15334,REDENÇÃO,13725,3289,5634,24031,322,18397,1061
CE,15350,RERIUTABA,8506,1756,5281,16207,142,10926,522
CE,15377,RUSSAS,31232,8184,10183,51880,537,41697,1744
CE,15393,SABOEIRO,7386,1221,4063,13287,98,9224,519
CE,15415,SANTANA DO ACARAÚ,15710,2358,5289,24313,210,19024,746
CE,15431,SANTANA DO CARIRI,8306,1077,3779,13706,85,9927,459
CE,15440,SALITRE,7697,1282,2995,12424,77,9429,373
CE,15458,SANTA QUITÉRIA,18513,4981,10430,35150,253,24720,973
CE,15474,SÃO BENEDITO,19078,4993,11936,37733,387,25797,1339
CE,15490,SÃO GONÇALO DO AMARANTE,20961,6862,7931,37683,418,29752,1511
CE,15512,SÃO JOÃO DO JAGUARIBE,4627,623,1827,7338,52,5511,209
CE,15539,SÃO LUÍS DO CURU,6994,1315,2740,11554,117,8814,388
CE,15555,SENADOR POMPEU,10163,5052,5638,21672,167,16034,652
CE,15571,SENADOR SÁ,3390,637,1203,5455,44,4252,181
CE,15598,SOBRAL,76120,25644,10982,120504,2518,109522,5240
CE,15610,SOLONÓPOLE,8469,1365,4347,14618,85,10271,352
CE,15636,TABULEIRO DO NORTE,14926,3166,5616,24779,251,19163,820
CE,15652,TAMBORIL,10762,3403,6018,21041,122,15023,736
CE,15679,TAUÁ,19711,9273,13125,44344,445,31219,1790
CE,15695,TIANGUÁ,26977,9994,10385,50217,709,39832,2152
CE,15717,TRAIRI,22678,5025,10950,40263,375,29313,1235
CE,15733,UBAJARA,12857,4280,6125,24852,446,18727,1144
CE,15750,UMARI,3287,1166,1576,6298,36,4722,233
CE,15776,URUBURETAMA,10127,2383,3028,16314,182,13286,594
CE,15792,URUOCA,6068,1555,3246,11329,77,8083,383
CE,15814,VÁRZEA ALEGRE,16814,5208,7433,30927,294,23494,1178
CE,15830,VIÇOSA DO CEARÁ,23526,7019,10326,42946,398,32620,1677
CE,15857,MARACANAÚ,93760,23566,25876,152582,1937,126706,7443
CE,15873,AMONTADA,15835,5087,9554,31678,235,22124,967
CE,15881,CROATÁ,7261,1302,5292,14537,123,9245,559
CE,15890,CRUZ,9477,4070,5460,19784,166,14324,611
CE,15911,FORQUILHA,9988,2819,1617,15419,312,13802,683
CE,15920,IBICUITINGA,7199,1572,2556,11784,118,9228,339
CE,15938,ICAPUÍ,7769,4120,3217,15709,171,12492,432
CE,15954,ITAREMA,15797,4143,7916,29029,258,21113,915
CE,15970,MILHÃ,7128,764,3105,11322,49,8217,276
CE,15989,DEPUTADO IRAPUAN PINHEIRO,4391,737,1521,6886,50,5365,187
CE,15997,PARAIPABA,13277,3686,4867,22931,297,18064,804
CE,98531,QUIXELÔ,8303,1906,2286,13102,115,10816,492
CE,98558,UMIRIM,8819,1642,4173,15212,96,11039,482
CE,98574,VARJOTA,7224,2732,4243,14937,189,10694,549
DF,97012,BRASÍLIA,582354,946171,240413,1901543,29171,1661130,103434
ES,56006,SÃO DOMINGOS DO NORTE,3312,2369,1447,7293,61,5846,104
ES,56014,AFONSO CLÁUDIO,7259,10310,6501,24890,248,18389,572
ES,56022,ÁGUA DOCE DO NORTE,4618,2591,2885,10345,77,7460,174
ES,56030,ALEGRE,8573,8482,3564,21410,283,17846,508
ES,56049,IRUPI,2557,3799,2569,9170,91,6601,154
ES,56057,ALFREDO CHAVES,2499,6153,2385,11452,161,9067,254
ES,56065,ALTO RIO NOVO,3074,1458,1259,5947,47,4688,109
ES,56073,ANCHIETA,7034,9324,4318,21545,343,17227,526
ES,56081,VILA PAVÃO,3677,2225,1225,7345,78,6120,140
ES,56090,APIACÁ,2305,1947,1167,5598,45,4431,134
ES,56103,MARECHAL FLORIANO,3559,6014,2887,12930,204,10043,266
ES,56111,ARACRUZ,20864,25544,14834,64044,963,49210,1839
ES,56120,MARATAÍZES,8661,10316,6490,26309,334,19819,508
ES,56138,ATÍLIO VIVÁCQUA,3488,2915,1556,8181,90,6625,132
ES,56146,BREJETUBA,2914,3185,2808,9163,94,6355,162
ES,56154,BAIXO GUANDU,8736,8134,2844,20496,327,17652,455
ES,56162,SÃO ROQUE DO CANAÃ,2965,4353,2066,9669,97,7603,188
ES,56170,BARRA DE SÃO FRANCISCO,14866,8881,8496,32973,258,24477,472
ES,56189,SOORETAMA,7793,4687,4946,18080,261,13134,393
ES,56197,BOA ESPERANÇA,4778,3156,1083,9311,103,8228,191
ES,56200,PONTO BELO,2923,1430,1831,6331,47,4500,100
ES,56219,BOM JESUS DO NORTE,2632,2251,941,6146,75,5205,247
ES,56227,VILA VALÉRIO,6503,2955,2438,12168,93,9730,179
ES,56235,CACHOEIRO DE ITAPEMIRIM,38146,63085,29142,134633,1660,105491,2600
ES,56251,CARIACICA,101296,88090,51037,250926,4153,199889,6350
ES,56278,CASTELO,5877,15458,5162,27369,317,22207,555
ES,56294,COLATINA,21301,43812,17903,85809,933,67906,1860
ES,56308,GOVERNADOR LINDENBERG,3860,2748,2006,8847,71,6841,162
ES,56316,CONCEIÇÃO DA BARRA,9039,5171,7287,22340,264,15053,579
ES,56332,CONCEIÇÃO DO CASTELO,1658,5068,2018,9117,110,7099,263
ES,56359,DIVINO DE SÃO LOURENÇO,945,1739,1144,3941,41,2797,72
ES,56375,DOMINGOS MARTINS,5371,15255,2336,23768,374,21432,432
ES,56391,DORES DO RIO PRETO,2507,1569,1006,5311,81,4305,148
ES,56413,ECOPORANGA,8427,5004,4164,18089,166,13925,328
ES,56430,FUNDÃO,4767,5016,2647,12923,182,10276,311
ES,56456,GUAÇUÍ,5663,8905,6098,21443,263,15345,514
ES,56472,GUARAPARI,20815,40362,20609,85368,1345,64759,2237
ES,56499,IBIRAÇU,2598,3972,1261,8238,132,6977,275
ES,56502,IBITIRAMA,2086,2826,2432,7585,110,5153,131
ES,56510,ICONHA,3604,4994,1675,10683,129,9008,281
ES,56537,ITAGUAÇU,4346,4338,1461,10496,134,9035,217
ES,56553,ITAPEMIRIM,8569,10041,3175,22708,357,19533,566
ES,56570,ITARANA,2748,4550,965,8571,125,7606,183
ES,56596,IÚNA,5376,9234,5760,20973,216,15213,387
ES,56618,JERÔNIMO MONTEIRO,3562,3504,1935,9362,97,7427,264
ES,56626,JOÃO NEIVA,3893,5967,2892,13340,162,10448,426
ES,56634,LINHARES,29308,48275,23948,105915,1530,81967,2854
ES,56650,MANTENÓPOLIS,4176,3679,2510,10601,72,8091,164
ES,56677,MIMOSO DO SUL,8061,6909,6172,21847,249,15675,456
ES,56693,MONTANHA,6117,3666,3723,14004,161,10281,337
ES,56715,MUCURICI,2202,1168,610,4085,35,3475,70
ES,56731,MUNIZ FREIRE,4591,5742,2223,13016,128,10793,332
ES,56758,MUQUI,4350,4089,2041,10848,119,8807,249
ES,56774,NOVA VENÉCIA,14868,11935,8616,36438,361,27822,658
ES,56790,PANCAS,6192,4946,4558,16064,112,11506,256
ES,56812,PINHEIROS,7391,4986,4083,16983,188,12900,335
ES,56839,PIÚMA,3869,5811,3480,13750,203,10270,387
ES,56855,PRESIDENTE KENNEDY,3193,4157,2909,10538,101,7629,178
ES,56871,RIO NOVO DO SUL,2369,4808,967,8437,133,7470,160
ES,56898,SANTA LEOPOLDINA,3993,3475,1147,8962,113,7815,234
ES,56910,SANTA TERESA,4063,10192,2133,17019,214,14886,417
ES,56936,SÃO GABRIEL DA PALHA,8705,9685,5526,24619,265,19093,438
ES,56952,SÃO JOSÉ DO CALÇADO,3969,2453,2234,9082,108,6848,318
ES,56979,SÃO MATEUS,33631,21814,19364,77593,935,58229,1849
ES,56995,SERRA,117942,95174,62551,289233,5076,226682,8490
ES,57010,VIANA,18494,14680,6895,41674,662,34779,943
ES,57037,VILA VELHA,94516,131124,65739,304173,4617,238434,8177
ES,57053,VITÓRIA,76361,117734,56683,260713,3565,204030,6370
ES,57070,MARILÂNDIA,3502,4559,1996,10407,124,8411,226
ES,57096,IBATIBA,4681,7707,4356,17230,192,12874,294
ES,57118,RIO BANANAL,6607,4576,3141,14716,152,11575,240
ES,57134,JAGUARÉ,9775,5009,4364,19712,218,15348,346
ES,57150,PEDRO CANÁRIO,7065,4222,5913,17851,223,11938,428
ES,57916,LARANJA DA TERRA,3072,4352,1842,9517,97,7675,154
ES,57932,SANTA MARIA DE JETIBÁ,7066,15281,3567,26637,286,23070,437
ES,57959,VARGEM ALTA,3301,7850,3194,14772,153,11578,274
ES,57975,VENDA NOVA DO IMIGRANTE,2586,10233,3532,16837,179,13305,307
ES,57991,ÁGUIA BRANCA,4331,2007,1677,8152,45,6475,92
GO,92010,ABADIÂNIA,2060,5063,2203,9691,117,7488,248
GO,92029,BONFINÓPOLIS,1727,2710,1197,5947,68,4750,245
GO,92037,ÁGUA LIMPA,840,749,476,2128,9,1652,54
GO,92053,ALEXÂNIA,4516,8640,3480,17406,216,13926,554
GO,92061,CAMPOS VERDES,2007,812,1416,4413,29,2997,149
GO,92096,ALOÂNDIA,786,708,421,2004,34,1583,55
GO,92100,CEZARINA,2769,2636,1770,7516,63,5746,278
GO,92118,ALTO PARAÍSO DE GOIÁS,1557,1573,1805,5199,49,3394,215
GO,92126,COLINAS DO SUL,1483,535,1254,3386,22,2132,92
GO,92150,ALVORADA DO NORTE,1947,2135,1773,6104,49,4331,200
GO,92169,MORRO AGUDO DE GOIÁS,725,1127,449,2381,26,1932,54
GO,92177,AMORINÓPOLIS,1350,1490,861,3820,26,2959,93
GO,92207,EDEALINA,1480,1174,720,3535,39,2815,122
GO,92215,ANÁPOLIS,61326,135007,37600,247344,3945,209744,9466
GO,92223,FAINA,2789,1521,1774,6287,42,4513,161
GO,92231,ANHANGÜERA,401,345,203,995,16,792,30
GO,92258,ANICUNS,5350,6624,3964,16626,148,12662,540
GO,92266,GOUVELÂNDIA,1702,1183,836,3874,35,3038,118
GO,92274,APARECIDA DE GOIÂNIA,92924,110169,37883,257443,3991,219560,12476
GO,92282,ITAGUARI,1800,1439,813,4202,50,3389,100
GO,92290,APORÉ,853,1119,1309,3406,38,2097,87
GO,92312,ARAÇU,1467,1742,839,4215,31,3376,136
GO,92320,MATRINCHÃ,1165,1434,1201,3903,17,2702,86
GO,92339,ARAGARÇAS,4993,4598,4215,14350,157,10135,387
GO,92347,MIMOSO DE GOIÁS,1026,847,653,2617,23,1964,68
GO,92355,ARAGOIÂNIA,2536,2825,953,6686,76,5733,296
GO,92363,MONTIVIDIU,2154,4154,1967,8645,78,6678,292
GO,92444,NOVO PLANALTO,1496,794,891,3307,34,2416,92
GO,92460,PALESTINA DE GOIÁS,1170,1139,1059,3471,39,2412,64
GO,92495,ARUANÃ,1866,1922,1660,5617,37,3957,132
GO,92517,AURILÂNDIA,1421,1057,727,3331,31,2604,95
GO,92550,AVELINÓPOLIS,906,1464,778,3274,28,2496,98
GO,92568,SANTA FÉ DE GOIÁS,1531,1155,1324,4172,30,2848,132
GO,92614,BALIZA,1077,767,1083,3034,12,1951,95
GO,92622,SÃO JOÃO DA PARAÚNA,634,795,484,1967,6,1483,48
GO,92630,BARRO ALTO,2499,2689,1884,7358,72,5474,214
GO,92649,SÃO LUIZ DO NORTE,1447,1298,1213,4125,41,2912,126
GO,92657,BELA VISTA DE GOIÁS,5544,8776,2994,18299,222,15305,763
GO,92665,SÃO MIGUEL DO PASSA QUATRO,1336,1468,677,3593,24,2916,88
GO,92673,BOM JARDIM DE GOIÁS,2925,1930,1856,6925,38,5069,176
GO,92690,BOM JESUS DE GOIÁS,5175,5941,3939,15823,250,11884,518
GO,92703,SENADOR CANEDO,21071,23868,8709,57296,1067,48587,2581
GO,92711,BRAZABRANTES,1025,1057,372,2576,45,2204,77
GO,92720,SIMOLÂNDIA,1955,1572,1658,5431,58,3773,188
GO,92754,BRITÂNIA,1535,1735,1398,4829,40,3431,121
GO,92762,TERESINA DE GOIÁS,807,709,1000,2593,10,1593,67
GO,92770,BURITI ALEGRE,2363,3213,1411,7358,86,5947,285
GO,92789,TROMBAS,1008,858,949,2928,18,1979,95
GO,92797,CABECEIRAS,2077,2308,1415,6039,83,4624,156
GO,92800,TURVELÂNDIA,1572,1504,1611,4803,34,3192,82
GO,92819,CACHOEIRA ALTA,2778,2452,1979,7534,90,5555,235
GO,92827,RIO QUENTE,844,1479,895,3351,28,2456,105
GO,92835,CACHOEIRA DE GOIÁS,493,570,407,1525,11,1118,44
GO,92851,CAÇU,2421,4285,1977,9101,97,7124,321
GO,92860,GUARINOS,809,675,441,1987,5,1546,57
GO,92878,CAIAPÔNIA,4104,4464,3210,12370,96,9160,496
GO,92886,COCALZINHO DE GOIÁS,4019,5319,2384,12480,211,10096,547
GO,92894,CALDAS NOVAS,15305,23671,13719,55762,830,42043,2237
GO,92908,SANTO ANTÔNIO DE GOIÁS,1929,1759,704,4641,61,3937,188
GO,92916,CAMPESTRE DE GOIÁS,1131,1235,473,2960,25,2487,96
GO,92924,CHAPADÃO DO CÉU,1837,2299,1542,5862,61,4320,123
GO,92932,CAMPINORTE,2911,3201,2341,8775,85,6434,237
GO,92940,ALTO HORIZONTE,1811,2112,1342,5427,29,4085,133
GO,92959,CAMPO ALEGRE DE GOIÁS,1958,1557,1023,4687,37,3664,112
GO,92967,CASTELÂNDIA,1429,1008,1073,3631,33,2558,88
GO,92975,CAMPOS BELOS,5893,3466,4572,14528,127,9956,470
GO,92983,JESÚPOLIS,493,1137,678,2424,33,1746,83
GO,92991,CARMO DO RIO VERDE,2739,2593,1558,7171,80,5613,201
GO,93009,APARECIDA DO RIO DOCE,1019,792,619,2544,32,1925,82
GO,93017,CATALÃO,26547,21237,12749,64622,1022,51873,3067
GO,93025,CIDADE OCIDENTAL,14395,11702,7795,35851,582,28056,1377
GO,93033,CATURAÍ,1648,1384,492,3748,59,3256,165
GO,93041,PROFESSOR JAMIL,1293,1027,870,3311,25,2441,96
GO,93050,CAVALCANTE,2758,955,3197,7231,37,4034,284
GO,93068,PEROLÂNDIA,916,1085,994,3096,28,2102,73
GO,93076,CERES,4781,7560,2835,15756,142,12921,438
GO,93084,NOVA IGUAÇU DE GOIÁS,839,1037,696,2649,18,1953,59
GO,93092,DIVINÓPOLIS DE GOIÁS,1834,1098,1527,4690,45,3163,186
GO,93106,BURITI DE GOIÁS,968,1055,770,2906,40,2136,73
GO,93122,CALDAZINHA,928,1146,418,2634,41,2216,101
GO,93149,GUARAÍTA,940,893,452,2386,38,1934,63
GO,93157,CÓRREGO DO OURO,676,1234,611,2621,27,2010,73
GO,93165,INACIOLÂNDIA,1941,1443,1233,4860,57,3627,186
GO,93173,CORUMBÁ DE GOIÁS,1866,3171,1478,6912,115,5434,282
GO,93181,MONTIVIDIU DO NORTE,1272,824,1059,3253,13,2194,85
GO,93190,CORUMBAÍBA,2435,2225,1345,6278,64,4933,209
GO,93203,SANTO ANTÔNIO DA BARRA,1556,1243,730,3706,34,2976,143
GO,93220,TEREZÓPOLIS DE GOIÁS,2071,2042,653,5041,66,4388,209
GO,93246,UIRAPURU,1142,529,678,2434,15,1756,70
GO,93254,CRISTALINA,6984,14955,7805,30946,473,23141,729
GO,93262,BURITINÓPOLIS,821,1092,1112,3145,23,2033,97
GO,93270,CRISTIANÓPOLIS,896,1403,657,3079,30,2422,93
GO,93289,VILA BOA,1284,880,1138,3419,21,2281,96
GO,93297,CRIXÁS,5197,3413,3293,12363,109,9070,351
GO,93300,VALPARAÍSO DE GOIÁS,28734,25171,14923,72911,1281,57988,2802
GO,93319,CROMÍNIA,1214,1443,598,3395,35,2797,105
GO,93327,NOVO GAMA,18000,16463,11206,48460,952,37254,1839
GO,93335,CUMARI,1118,763,562,2554,28,1992,83
GO,93343,ÁGUAS LINDAS DE GOIÁS,33520,23134,16126,77611,1786,61485,3045
GO,93351,DAMIANÓPOLIS,1036,1102,982,3251,32,2269,99
GO,93360,ABADIA DE GOIÁS,1958,3131,995,6351,63,5356,204
GO,93378,DAMOLÂNDIA,842,1543,319,2866,42,2547,120
GO,93386,AMARALINA,1089,808,704,2683,10,1979,72
GO,93394,DAVINÓPOLIS,1094,827,455,2446,18,1991,52
GO,93408,BONÓPOLIS,1307,491,856,2758,14,1902,90
GO,93424,PORTEIRÃO,1230,790,898,2990,21,2092,51
GO,93432,DIORAMA,899,788,431,2194,14,1763,62
GO,93440,SANTA RITA DO NOVO DESTINO,1131,772,625,2621,18,1996,75
GO,93483,SÃO PATRÍCIO,592,906,360,1945,25,1585,62
GO,93491,EDÉIA,2956,3661,1896,8924,98,7028,313
GO,93505,VILA PROPÍCIO,1551,1223,1055,4011,38,2956,144
GO,93513,ESTRELA DO NORTE,1112,996,742,2951,18,2209,83
GO,93530,FAZENDA NOVA,1946,1840,1496,5479,42,3983,155
GO,93548,IPIRANGA DE GOIÁS,1082,966,654,2792,28,2138,62
GO,93564,GAMELEIRA DE GOIÁS,971,1109,487,2649,19,2162,63
GO,93572,FIRMINÓPOLIS,2616,3355,1810,8111,62,6301,268
GO,93580,CAMPO LIMPO DE GOIÁS,1624,2238,681,4770,55,4089,172
GO,93599,FLORES DE GOIÁS,2396,1821,2177,6672,47,4495,231
GO,93602,LAGOA SANTA,418,560,374,1406,9,1032,45
GO,93610,FORMOSA,22020,28474,14809,68753,972,53944,2478
GO,93637,FORMOSO,1733,1158,1310,4332,28,3022,103
GO,93670,GOIANÁPOLIS,2805,4369,1325,8956,127,7631,330
GO,93696,GOIANDIRA,1833,1438,779,4288,53,3509,185
GO,93718,GOIANÉSIA,15717,17806,10251,46160,775,35909,1611
GO,93734,GOIÂNIA,225505,469527,189922,932852,10681,742930,37217
GO,93750,GOIANIRA,9845,10479,5363,27118,374,21755,1057
GO,93777,GOIÁS,7386,6695,5463,20194,152,14731,498
GO,93793,GOIATUBA,6638,12416,6442,26801,368,20359,937
GO,93815,GUAPÓ,4481,4205,1819,11067,112,9248,450
GO,93831,GUARANI DE GOIÁS,1474,1127,1034,3762,18,2728,109
GO,93874,HEITORAÍ,1323,1316,817,3605,46,2788,103
GO,93890,HIDROLÂNDIA,4398,6032,2687,13926,167,11239,642
GO,93912,HIDROLINA,1642,1101,965,3845,27,2880,110
GO,93939,IACIARA,3119,2127,2789,8322,64,5533,223
GO,93955,INHUMAS,11865,17320,5685,37124,558,31439,1696
GO,93971,IPAMERI,6480,7275,5366,20110,217,14744,772
GO,93998,IPORÁ,8960,8591,6113,24604,254,18491,686
GO,94013,ISRAELÂNDIA,1077,866,792,2828,20,2036,73
GO,94030,ITABERAÍ,10161,10070,6639,27998,319,21359,809
GO,94072,ITAGUARU,2178,1732,954,5071,48,4117,159
GO,94110,ITAJÁ,1078,1650,1124,4001,30,2877,119
GO,94137,ITAPACI,5076,4792,3966,14423,137,10457,452
GO,94153,ITAPIRAPUÃ,2242,2444,2079,7044,65,4965,214
GO,94196,ITAPURANGA,9381,6585,4197,21241,314,17044,764
GO,94218,ITARUMÃ,1510,1726,1487,4890,41,3403,126
GO,94234,ITAUÇU,2406,2995,1262,6931,80,5669,188
GO,94250,ITUMBIARA,20423,32825,15668,71892,984,56224,1992
GO,94277,IVOLÂNDIA,1190,838,946,3055,23,2109,58
GO,94293,JANDAIA,2079,2310,1423,6071,66,4648,193
GO,94315,JARAGUÁ,7989,14537,7068,30926,399,23858,933
GO,94331,JATAÍ,20293,26410,16217,66065,895,49848,2250
GO,94358,JAUPACI,1143,860,733,2844,28,2111,80
GO,94374,JOVIÂNIA,1891,2316,1413,5895,65,4482,210
GO,94390,JUSSARA,5474,5152,3744,15000,136,11256,494
GO,94439,LEOPOLDO DE BULHÕES,1856,2470,1360,5970,56,4610,228
GO,94455,LUZIÂNIA,33336,49130,24210,113688,2053,89478,4959
GO,94471,MAIRIPOTABA,641,1183,562,2471,21,1909,64
GO,94498,MAMBAÍ,1480,2340,1643,5640,51,3997,126
GO,94510,MARA ROSA,3440,2185,2317,8239,55,5922,242
GO,94536,MARZAGÃO,797,608,506,1992,14,1486,67
GO,94552,PARANAIGUARA,3044,2487,1566,7451,77,5885,277
GO,94579,MAURILÂNDIA,3182,2955,2367,8804,94,6437,206
GO,94595,MINEIROS,11937,15962,9501,39527,672,30026,1455
GO,94650,MOIPORÁ,643,855,600,2178,22,1578,58
GO,94676,MONTE ALEGRE DE GOIÁS,2146,1221,1897,5500,41,3603,195
GO,94714,MONTES CLAROS DE GOIÁS,2478,2039,1709,6457,41,4748,190
GO,94730,MORRINHOS,12183,12836,6970,33474,387,26504,1098
GO,94757,MOSSÂMEDES,1678,1462,1071,4390,39,3319,140
GO,94773,MOZARLÂNDIA,3540,3571,3182,10754,113,7572,348
GO,94790,MUTUNÓPOLIS,1285,1452,715,3547,23,2832,72
GO,94854,NAZÁRIO,2006,3202,1609,7090,73,5481,200
GO,94870,NERÓPOLIS,6625,8261,3037,18903,244,15866,736
GO,94897,NIQUELÂNDIA,11808,8875,8069,29816,284,21747,780
GO,94919,NOVA AMÉRICA,726,907,426,2186,29,1760,98
GO,94935,NOVA AURORA,876,642,307,1912,14,1605,73
GO,94951,NOVA ROMA,1004,803,913,2829,33,1916,76
GO,94978,NOVA VENEZA,2284,2770,810,6200,69,5390,267
GO,95010,NOVO BRASIL,1423,1189,694,3443,27,2749,110
GO,95036,ORIZONA,3340,5300,1947,11198,143,9251,468
GO,95052,OURO VERDE DE GOIÁS,815,1734,354,3077,41,2723,133
GO,95079,OUVIDOR,2571,1847,786,5504,64,4718,236
GO,95095,PADRE BERNARDO,5608,5818,4727,16825,197,12098,475
GO,95117,PALMEIRAS DE GOIÁS,4892,9524,3733,18780,148,15047,483
GO,95133,PALMELO,639,946,456,2128,11,1672,76
GO,95150,PALMINÓPOLIS,1214,1660,847,3816,16,2969,79
GO,95176,PANAMÁ,798,983,626,2512,35,1886,70
GO,95230,PARAÚNA,3127,3118,2429,9000,64,6571,262
GO,95311,PETROLINA DE GOIÁS,1797,3715,1899,7793,92,5894,290
GO,95354,PILAR DE GOIÁS,1123,727,783,2726,23,1943,70
GO,95397,PIRACANJUBA,6524,7332,4710,19298,165,14588,567
GO,95419,PIRANHAS,3918,2728,2435,9516,91,7081,344
GO,95435,PIRENÓPOLIS,6883,7231,3436,18317,240,14881,527
GO,95451,PIRES DO RIO,5353,10130,5543,22248,281,16705,941
GO,95494,PONTALINA,5752,4924,3294,14548,145,11254,433
GO,95559,PORANGATU,12337,8921,8602,30828,228,22226,740
GO,95575,PORTELÂNDIA,1149,1315,846,3454,54,2608,90
GO,95613,POSSE,7463,8929,5885,23096,219,17211,600
GO,95630,QUIRINÓPOLIS,11899,12715,7820,34144,540,26324,1170
GO,95656,RIALMA,2687,3569,2065,8729,93,6664,315
GO,95672,RIANÁPOLIS,947,1746,1071,3958,39,2887,155
GO,95710,RIO VERDE,30710,56787,25256,118488,1737,93232,3998
GO,95737,RUBIATABA,4219,6774,3501,15210,179,11709,537
GO,95753,SANCLERLÂNDIA,2389,2848,1596,7091,54,5495,204
GO,95770,SANTA BÁRBARA DE GOIÁS,1552,2000,1063,4804,43,3741,146
GO,95796,SANTA CRUZ DE GOIÁS,770,1254,921,3044,27,2123,72
GO,95818,SANTA HELENA DE GOIÁS,10932,10276,5496,28528,654,23032,1170
GO,95834,SANTA RITA DO ARAGUAIA,1263,1589,1175,4201,39,3026,135
GO,95850,SANTA ROSA DE GOIÁS,1080,1205,615,3069,57,2454,112
GO,95877,SANTA TEREZA DE GOIÁS,975,1181,1062,3333,39,2271,76
GO,95893,SANTA TEREZINHA DE GOIÁS,3547,2240,2173,8240,59,6067,221
GO,95915,SÃO DOMINGOS,2464,1961,2757,7490,50,4733,258
GO,95931,SÃO FRANCISCO DE GOIÁS,1267,2248,1138,4916,80,3778,183
GO,95958,PLANALTINA,20512,17584,11790,53269,1080,41479,2303
GO,95974,SÃO JOÃO D'ALIANÇA,1909,2196,1855,6187,74,4332,153
GO,95990,SÃO LUÍS DE MONTES BELOS,5613,11292,5603,23529,249,17926,772
GO,96016,SÃO MIGUEL DO ARAGUAIA,6112,5911,5788,18454,153,12666,490
GO,96059,SÃO SIMÃO,6730,3729,3515,14506,162,10991,370
GO,96075,SERRANÓPOLIS,2089,1847,1324,5457,39,4133,158
GO,96091,SILVÂNIA,4899,6397,2979,14820,146,11841,399
GO,96113,SÍTIO D'ABADIA,871,685,1046,2685,10,1639,73
GO,96172,TAQUARAL DE GOIÁS,1116,1726,920,3946,46,3026,138
GO,96237,TRÊS RANCHOS,1294,1090,747,3245,26,2498,88
GO,96253,TRINDADE,25403,32484,10579,72029,912,61450,2651
GO,96318,TURVÂNIA,1481,1901,947,4493,37,3546,127
GO,96334,URUAÇU,9457,9222,6710,26418,295,19708,734
GO,96350,URUANA,3498,4186,3059,11283,142,8224,398
GO,96377,URUTAÍ,873,1102,667,2784,37,2117,105
GO,96393,VARJÃO,887,1717,923,3724,52,2801,145
GO,96415,VIANÓPOLIS,2281,5055,1883,9540,78,7657,243
GO,96458,ACREÚNA,5365,5655,4269,15965,207,11696,469
GO,96474,MINAÇU,10016,6133,9518,26557,218,17039,672
GO,96512,MUNDO NOVO,1800,1428,1781,5152,19,3371,124
GO,96539,NOVA CRIXÁS,3283,2321,2845,8726,55,5881,222
GO,96555,NOVA GLÓRIA,2685,2220,2014,7203,67,5189,217
GO,96571,VICENTINÓPOLIS,1924,2544,1228,5925,47,4697,182
GO,96610,AMERICANO DO BRASIL,1555,2318,1088,5148,48,4060,139
GO,96695,ARAGUAPAZ,2260,1980,1717,6146,37,4429,152
GO,96717,ARENÓPOLIS,1390,977,879,3330,16,2451,68
GO,96733,CACHOEIRA DOURADA,2889,2322,2101,7614,94,5513,208
GO,96750,DOVERLÂNDIA,2320,2017,1360,5869,45,4509,127
GO,96776,SANTO ANTÔNIO DO DESCOBERTO,14315,13977,9513,39985,727,30472,1453
GO,96814,INDIARA,4894,2838,2483,10722,142,8239,365
GO,96873,CAMPINAÇU,1374,719,1010,3209,23,2199,83
GO,96890,SANTA ISABEL,1211,1311,835,3495,31,2660,107
GO,96911,ADELÂNDIA,818,1160,580,2634,18,2054,58
GO,96938,ÁGUA FRIA DE GOIÁS,1083,1865,1421,4495,32,3074,94
MA,7005,ÁGUA DOCE DO MARANHÃO,5677,840,3644,10433,62,6789,210
MA,7013,AFONSO CUNHA,3617,287,1515,5552,25,4037,108
MA,7021,ALTO ALEGRE DO MARANHÃO,8860,1510,4657,15517,80,10860,410
MA,7030,ALCÂNTARA,9286,1083,5890,16637,92,10747,286
MA,7048,ALTO ALEGRE DO PINDARÉ,10937,1647,7408,20525,114,13117,419
MA,7056,ALDEIAS ALTAS,8975,1902,5342,16788,85,11446,484
MA,7064,APICUM-AÇU,5490,1302,3232,10173,26,6941,123
MA,7072,ALTAMIRA DO MARANHÃO,2741,596,1760,5242,30,3482,115
MA,7080,AMAPÁ DO MARANHÃO,2242,883,1561,4837,25,3276,126
MA,7099,ALTO PARNAÍBA,3444,1553,2336,7535,36,5199,166
MA,7102,ARAGUANÃ,4191,414,2457,7188,19,4731,107
MA,7110,AMARANTE DO MARANHÃO,13199,3629,6603,24014,143,17411,440
MA,7129,BACABEIRA,8222,1076,2300,11896,87,9596,211
MA,7137,ANAJATUBA,11157,1274,6146,19077,110,12931,390
MA,7145,BACURITUBA,2502,362,2360,5303,23,2943,56
MA,7153,ANAPURUS,7503,1163,2327,11287,58,8960,236
MA,7161,BELÁGUA,3558,230,1227,5157,26,3930,116
MA,7170,ARAIOSES,17711,2739,9610,30896,205,21286,631
MA,7188,BELA VISTA DO MARANHÃO,5168,652,2821,8824,44,6003,139
MA,7196,ARARI,11925,2512,6512,21528,175,15016,404
MA,7200,BERNARDO DO MEARIM,2822,517,1422,4861,25,3439,75
MA,7218,AXIXÁ,5634,727,2837,9394,53,6557,143
MA,7226,CACHOEIRA GRANDE,3919,353,2603,7004,37,4401,92
MA,7234,BACABAL,34918,10215,19611,66474,507,46863,1223
MA,7242,DAVINÓPOLIS,5696,1495,2640,10038,91,7398,116
MA,7250,BACURI,6513,1562,4811,13139,53,8328,200
MA,7269,BOM JESUS DAS SELVAS,9023,2647,4342,16322,80,11980,230
MA,7277,BALSAS,26570,14155,13285,55134,372,41849,752
MA,7285,BOM LUGAR,5851,1140,3091,10289,29,7198,178
MA,7293,BARÃO DE GRAJAÚ,7821,1504,3492,13249,77,9757,355
MA,7307,BREJO DE AREIA,3427,1021,1991,6628,33,4637,156
MA,7315,BARRA DO CORDA,28734,9471,9110,48645,374,39535,956
MA,7323,BOA VISTA DO GURUPI,2682,713,1503,4976,22,3473,56
MA,7331,BARREIRINHAS,23672,3493,11027,38896,160,27869,544
MA,7340,BURITICUPU,21381,5563,11982,39773,241,27791,606
MA,7358,BENEDITO LEITE,2203,496,860,3659,13,2799,87
MA,7366,BURITIRANA,5116,1633,2689,9709,70,7020,201
MA,7374,BEQUIMÃO,8130,1911,5464,15873,122,10409,246
MA,7382,CAMPESTRE DO MARANHÃO,5308,1009,2994,9495,69,6501,115
MA,7390,BREJO,13916,2380,6760,23597,118,16837,423
MA,7404,CAPINZAL DO NORTE,4566,1299,2081,8144,42,6063,156
MA,7412,BURITI,11136,1915,6106,19755,105,13649,493
MA,7420,CENTRAL DO MARANHÃO,3368,246,2762,6508,15,3746,117
MA,7439,BURITI BRAVO,8711,1502,5809,16416,83,10607,311
MA,7447,CENTRO DO GUILHERME,4635,554,1108,6399,27,5291,75
MA,7455,CAJAPIÓ,4405,445,2934,7975,56,5041,135
MA,7463,CENTRO NOVO DO MARANHÃO,5750,929,2607,9548,60,6941,202
MA,7471,CAJARI,8500,638,3246,12649,50,9403,215
MA,7480,CIDELÂNDIA,5447,1319,2797,9768,54,6971,151
MA,7498,CÂNDIDO MENDES,6659,1898,5430,14235,47,8805,201
MA,7501,CONCEIÇÃO DO LAGO-AÇU,5743,1079,2788,9865,52,7077,203
MA,7510,CANTANHEDE,6975,996,3952,12285,76,8333,286
MA,7528,FEIRA NOVA DO MARANHÃO,2675,1447,1680,5975,41,4295,132
MA,7536,CAROLINA,8537,2860,5222,17137,148,11915,370
MA,7544,FERNANDO FALCÃO,3938,862,913,5839,22,4926,104
MA,7552,CARUTAPERA,7681,2599,5051,15654,75,10603,248
MA,7560,FORMOSA DA SERRA NEGRA,5748,2550,2902,11416,47,8514,169
MA,7579,CAXIAS,61672,11415,31587,107693,804,76106,2215
MA,7595,CEDRAL,4407,644,2868,8099,61,5231,119
MA,7609,GOVERNADOR EDISON LOBÃO,6327,2378,2945,11897,88,8952,159
MA,7617,CHAPADINHA,30173,5938,13789,51229,309,37440,1020
MA,7625,GOVERNADOR LUIZ ROCHA,3111,921,1823,6010,45,4187,110
MA,7633,CODÓ,38555,8912,31535,81121,540,49586,1579
MA,7641,GOVERNADOR NEWTON BELLO,3948,810,2767,7691,36,4924,130
MA,7650,COELHO NETO,18226,3766,11890,34733,176,22843,675
MA,7668,GOVERNADOR NUNES FREIRE,9205,1992,4567,16104,75,11537,265
MA,7676,COLINAS,14939,2384,8872,26808,126,17936,487
MA,7684,IGARAPÉ DO MEIO,5876,722,3310,10162,67,6852,187
MA,7692,COROATÁ,23296,5484,15361,45487,318,30126,1028
MA,7706,ITAIPAVA DO GRAJAÚ,5274,1061,2992,9482,30,6490,125
MA,7714,CURURUPU,12334,1774,9735,24326,151,14591,332
MA,7722,ITINGA DO MARANHÃO,6946,4194,5376,16797,90,11421,191
MA,7730,DOM PEDRO,9475,2761,5009,17641,107,12632,289
MA,7749,JATOBÁ,3499,615,1621,5850,25,4229,90
MA,7757,DUQUE BACELAR,5146,727,2770,8874,32,6104,199
MA,7765,JENIPAPO DOS VIEIRAS,5809,1435,1579,9069,43,7490,203
MA,7773,ESPERANTINÓPOLIS,8155,1316,4136,13957,87,9821,263
MA,7781,JUNCO DO MARANHÃO,2725,521,1267,4610,24,3343,73
MA,7790,FORTALEZA DOS NOGUEIRAS,4868,1709,2566,9354,64,6788,147
MA,7803,LAGO DOS RODRIGUES,4262,1172,1733,7320,30,5587,123
MA,7811,FORTUNA,6886,1008,3607,11873,84,8266,288
MA,7820,LAGOA DO MATO,4471,668,2451,7837,46,5386,201
MA,7838,GODOFREDO VIANA,3289,1004,2568,6984,26,4416,97
MA,7846,LAGOA GRANDE DO MARANHÃO,4872,950,2199,8183,38,5984,124
MA,7854,GONÇALVES DIAS,7080,1155,3565,12063,54,8498,209
MA,7862,LAJEADO NOVO,2802,1202,1792,5887,15,4095,76
MA,7870,GOVERNADOR ARCHER,4435,897,2238,7762,34,5524,158
MA,7889,MARACAÇUMÉ,6545,1764,4395,13000,69,8605,227
MA,7897,GOVERNADOR EUGÊNIO BARROS,6485,1074,3438,11231,55,7793,179
MA,7900,MARAJÁ DO SENA,3453,726,2070,6394,17,4324,128
MA,7919,GRAÇA ARANHA,3371,476,1637,5560,16,3923,60
MA,7927,MARANHÃOZINHO,4317,713,1661,6815,26,5154,98
MA,7935,GRAJAÚ,22105,8322,11659,42919,207,31260,626
MA,7943,MATÕES DO NORTE,3823,403,2557,6983,34,4426,166
MA,7951,GUIMARÃES,5425,536,3953,10206,79,6253,213
MA,7960,MILAGRES DO MARANHÃO,3007,348,1670,5148,16,3478,107
MA,7978,HUMBERTO DE CAMPOS,10293,1625,7837,20165,65,12328,345
MA,7986,NOVA COLINAS,2191,805,1077,4150,21,3073,56
MA,7994,ICATU,11182,1044,7083,19745,92,12662,344
MA,8001,NOVA OLINDA DO MARANHÃO,6822,1053,4004,12173,71,8169,223
MA,8010,IGARAPÉ GRANDE,4592,1075,2050,7927,53,5877,157
MA,8028,OLINDA NOVA DO MARANHÃO,5138,471,3476,9361,61,5885,215
MA,8036,IMPERATRIZ,74962,49814,35502,164407,1585,128905,2544
MA,8044,PAULINO NEVES,7044,1063,3796,12168,58,8372,207
MA,8052,SÃO LUÍS GONZAGA DO MARANHÃO,10576,1131,6156,18345,93,12189,389
MA,8060,PEDRO DO ROSÁRIO,9445,959,5119,15911,87,10792,301
MA,8079,ITAPECURU MIRIM,23015,4571,12551,41302,294,28751,871
MA,8087,PERITORÓ,9338,1106,4844,15720,94,10876,338
MA,8095,JOÃO LISBOA,10585,3241,5406,19805,188,14399,385
MA,8109,PORTO RICO DO MARANHÃO,2821,644,2708,6280,43,3572,64
MA,8117,JOSELÂNDIA,7113,1170,3294,11816,50,8522,189
MA,8125,PRESIDENTE MÉDICI,2815,481,1600,4993,22,3393,75
MA,8133,LAGO DA PEDRA,15568,6259,11441,34011,200,22570,543
MA,8141,PRESIDENTE SARNEY,7294,889,4496,12941,39,8445,223
MA,8150,LAGO DO JUNCO,4542,979,2245,7937,43,5692,128
MA,8168,RAPOSA,9888,2200,2970,15484,161,12514,265
MA,8176,LAGO VERDE,6798,1015,3463,11535,59,8072,200
MA,8184,RIBAMAR FIQUENE,3227,1168,1905,6402,32,4497,70
MA,8192,LIMA CAMPOS,4249,2157,2723,9414,75,6691,210
MA,8206,SANTA FILOMENA DO MARANHÃO,2924,665,1517,5231,24,3714,101
MA,8214,LORETO,4533,985,2336,8046,48,5710,144
MA,8222,SANTANA DO MARANHÃO,3699,685,2618,7171,38,4553,131
MA,8230,LUÍS DOMINGUES,2321,1065,1942,5428,27,3486,73
MA,8249,SANTO AMARO DO MARANHÃO,4579,689,3063,8494,37,5431,126
MA,8257,MAGALHÃES DE ALMEIDA,5737,2012,4083,12121,82,8038,207
MA,8265,SÃO DOMINGOS DO AZEITÃO,3235,435,891,4676,12,3785,103
MA,8273,MATA ROMA,7773,1349,3025,12470,71,9445,252
MA,8281,SÃO FRANCISCO DO BREJÃO,3308,1436,1849,6738,47,4889,98
MA,8290,MATINHA,10840,1303,5415,18034,147,12619,329
MA,8303,SÃO JOÃO DO CARÚ,4707,1111,3642,9684,34,6042,190
MA,8311,MATÕES,13410,1633,8026,23651,116,15625,466
MA,8320,SÃO JOÃO DO PARAÍSO,4167,1716,2194,8252,49,6058,126
MA,8338,MIRADOR,7978,1331,4911,14635,57,9724,358
MA,8346,SÃO JOÃO DO SOTER,7139,544,3157,11196,58,8039,298
MA,8354,MIRINZAL,5764,948,3916,10845,66,6929,151
MA,8362,SÃO JOSÉ DOS BASÍLIOS,4063,406,2229,6822,26,4593,98
MA,8370,MONÇÃO,11581,1371,6461,19866,88,13405,365
MA,8389,SÃO PEDRO DA ÁGUA BRANCA,4077,1144,3092,8443,30,5351,100
MA,8397,MONTES ALTOS,3755,1445,1985,7356,47,5371,124
MA,8400,SÃO PEDRO DOS CRENTES,1251,1256,1032,3639,32,2607,68
MA,8419,MORROS,7630,992,4405,13400,75,8995,298
MA,8427,SÃO RAIMUNDO DO DOCA BEZERRA,2690,461,1594,4852,14,3258,93
MA,8435,NINA RODRIGUES,4675,751,3069,8716,40,5647,181
MA,8443,SÃO ROBERTO,2439,393,1246,4184,34,2938,72
MA,8451,NOVA IORQUE,2005,364,741,3196,11,2455,75
MA,8460,SATUBINHA,3149,486,1574,5333,27,3759,97
MA,8478,OLHO D'ÁGUA DAS CUNHÃS,8107,1081,4503,14068,62,9565,315
MA,8486,SENADOR ALEXANDRE COSTA,3913,847,2039,6940,30,4901,111
MA,8494,PAÇO DO LUMIAR,33853,9171,7946,52914,770,44968,1174
MA,8508,SENADOR LA ROCQUE,7653,1686,3854,13542,96,9688,253
MA,8516,PALMEIRÂNDIA,8801,817,5855,15840,81,9985,286
MA,8524,SERRANO DO MARANHÃO,4514,301,2596,7639,37,5043,191
MA,8532,PARAIBANO,7575,1491,5485,14998,86,9513,361
MA,8540,SUCUPIRA DO RIACHÃO,2367,424,1317,4229,21,2912,100
MA,8559,PARNARAMA,13732,1828,8982,25198,113,16216,543
MA,8567,TRIZIDELA DO VALE,7760,2555,3176,13830,107,10654,232
MA,8575,PASSAGEM FRANCA,6961,1670,3525,12576,79,9051,341
MA,8583,TUFILÂNDIA,3544,313,2216,6233,41,4017,119
MA,8591,PASTOS BONS,6975,1643,2274,11208,54,8934,262
MA,8605,TURILÂNDIA,6936,1102,5395,13701,51,8306,217
MA,8613,PEDREIRAS,15098,5191,9012,29962,225,20950,436
MA,8621,VILA NOVA DOS MARTÍRIOS,3320,1207,2049,6716,48,4667,92
MA,8630,PENALVA,13480,1157,10059,25267,107,15208,464
MA,8656,PERI MIRIM,5553,840,4286,10843,51,6557,113
MA,8672,PINDARÉ-MIRIM,13988,2049,6876,23526,158,16650,455
MA,8699,PINHEIRO,27404,8832,17527,54973,349,37446,861
MA,8710,PIO XII,11192,1659,5772,19137,81,13365,433
MA,8737,PIRAPEMAS,6711,704,4473,12231,65,7758,278
MA,8753,POÇÃO DE PEDRAS,8482,1906,5050,15782,87,10732,257
MA,8770,PORTO FRANCO,6958,4857,4530,16614,71,12084,198
MA,8796,PRESIDENTE DUTRA,16509,5032,9091,31241,205,22150,404
MA,8818,PRESIDENTE JUSCELINO,5152,395,3032,8732,32,5700,121
MA,8834,PRESIDENTE VARGAS,5414,595,3000,9243,49,6243,185
MA,8850,PRIMEIRA CRUZ,4812,598,3932,9497,30,5565,125
MA,8877,RIACHÃO,7723,1989,4219,14335,85,10116,319
MA,8893,SÃO JOSÉ DE RIBAMAR,55483,12764,9963,80927,1100,70964,1617
MA,8915,ROSÁRIO,17629,2499,8172,29053,248,20881,505
MA,8931,SAMBAÍBA,2488,769,1551,4909,24,3358,77
MA,8958,SANTA HELENA,10994,2836,8952,23237,153,14285,302
MA,8974,SANTA LUZIA,25344,4748,15457,46601,230,31144,822
MA,8990,SANTA QUITÉRIA DO MARANHÃO,11695,1699,6134,19940,71,13806,341
MA,9016,SANTA RITA,13079,2426,5765,21864,174,16099,420
MA,9032,SANTO ANTÔNIO DOS LOPES,6448,1894,3086,11729,84,8643,217
MA,9059,SÃO BENEDITO DO RIO PRETO,8233,852,3582,12972,59,9390,246
MA,9075,SÃO BENTO,13630,2172,10994,27390,168,16396,426
MA,9091,SÃO BERNARDO,10607,2497,6251,20014,164,13763,495
MA,9113,SÃO DOMINGOS DO MARANHÃO,13059,4814,8056,26607,171,18551,507
MA,9130,SÃO FÉLIX DE BALSAS,2126,319,1290,3832,12,2542,85
MA,9156,SÃO FRANCISCO DO MARANHÃO,5436,755,2621,9107,59,6486,236
MA,9172,SÃO JOÃO BATISTA,10180,895,5734,17137,75,11403,253
MA,9199,SÃO JOÃO DOS PATOS,9447,3154,6222,19283,137,13061,323
MA,9210,SÃO LUÍS,362296,152503,79153,620088,9400,540935,16736
MA,9237,SÃO MATEUS DO MARANHÃO,14541,3107,10740,29195,181,18455,626
MA,9253,SÃO RAIMUNDO DAS MANGABEIRAS,6640,2674,3980,13651,91,9671,266
MA,9270,SÃO VICENTE FERRER,8078,928,4938,14308,96,9370,268
MA,9296,SÍTIO NOVO,6699,2574,3440,12980,63,9540,204
MA,9318,SUCUPIRA DO NORTE,4892,766,2469,8362,41,5893,194
MA,9334,TASSO FRAGOSO,2813,1453,1662,6072,32,4410,112
MA,9350,TIMBIRAS,10514,1207,2672,14950,107,12278,450
MA,9377,TIMON,66470,14431,23558,107652,740,84094,2453
MA,9393,TUNTUM,13398,4517,9242,27951,210,18709,584
MA,9415,TURIAÇU,13226,2397,9404,25462,80,16058,355
MA,9431,TUTÓIA,17581,5806,12961,37265,310,24304,607
MA,9458,URBANO SANTOS,12110,1327,4368,18287,104,13919,378
MA,9474,VARGEM GRANDE,15974,3131,9672,29719,184,20047,758
MA,9490,VIANA,19522,3830,11618,35780,247,24162,563
MA,9512,VITÓRIA DO MEARIM,12568,2675,8989,24937,201,15948,504
MA,9539,VITORINO FREIRE,12149,3330,7385,23504,157,16119,483
MA,9555,BOM JARDIM,13754,2749,9167,26379,168,17212,541
MA,9571,SANTA INÊS,31103,9087,15807,57399,474,41592,928
MA,9598,PAULO RAMOS,8281,1647,4752,15069,89,10317,300
MA,9610,AÇAILÂNDIA,35386,18768,18941,74729,699,55788,935
MA,9636,ESTREITO,9797,5190,6119,21588,126,15469,356
MA,9652,SANTA LUZIA DO PARUÁ,9324,1716,4422,15868,134,11446,272
MA,9679,ARAME,9518,3688,6784,20385,61,13601,334
MA,9695,MIRANDA DO NORTE,7609,1524,4640,14143,113,9503,257
MA,9717,ZÉ DOCA,17641,3175,11010,32463,166,21453,471
MG,40002,ALFREDO VASCONCELOS,2931,1290,693,5112,43,4419,155
MG,40010,ABADIA DOS DOURADOS,2790,1689,952,5634,45,4682,158
MG,40029,ARAPORÃ,2017,2156,595,4942,45,4347,129
MG,40037,ABAETÉ,5288,8327,4272,18385,192,14113,306
MG,40045,BRASILÂNDIA DE MINAS,5725,2059,2447,10451,75,8004,145
MG,40053,ABRE CAMPO,4984,3207,2670,11174,100,8504,213
MG,40061,CAPITÃO ANDRADE,1636,1224,948,3919,35,2971,76
MG,40070,ACAIACA,1739,722,936,3484,23,2548,64
MG,40088,CARNEIRINHO,4040,2111,1281,7574,41,6293,101
MG,40096,AÇUCENA,3465,1898,2959,8667,122,5708,223
MG,40100,CATUJI,3301,1605,2144,7248,57,5104,141
MG,40118,ÁGUA BOA,5106,2063,4269,11824,79,7555,307
MG,40126,DIVISA ALEGRE,1908,1328,1509,4915,43,3406,127
MG,40134,ÁGUA COMPRIDA,820,732,488,2129,28,1641,61
MG,40142,DIVISÓPOLIS,3014,1339,1581,6118,39,4537,145
MG,40150,AGUANIL,1961,950,743,3802,50,3059,98
MG,40169,DURANDÉ,2971,1393,1510,6057,48,4547,135
MG,40177,ÁGUAS FORMOSAS,5679,3989,4496,14624,85,10128,375
MG,40185,ENTRE FOLHAS,2435,1467,1356,5417,42,4061,117
MG,40193,ÁGUAS VERMELHAS,4234,1881,3681,10106,60,6425,250
MG,40207,FERVEDOURO,4543,1630,1927,8355,71,6428,184
MG,40215,AIMORÉS,8240,5399,4352,18582,194,14230,397
MG,40223,FRANCISCÓPOLIS,2057,849,1771,4834,42,3063,115
MG,40231,AIURUOCA,1935,1743,1278,5158,45,3880,157
MG,40240,ICARAÍ DE MINAS,4268,1134,1931,7441,19,5510,89
MG,40258,ALAGOA,456,1372,503,2386,22,1883,33
MG,40266,IPABA,6917,2853,3073,13193,128,10120,222
MG,40274,ALBERTINA,367,1542,461,2455,14,1994,71
MG,40282,JAÍBA,13599,3237,5402,22895,174,17493,483
MG,40290,ALÉM PARAÍBA,13533,6840,6917,28266,265,21349,711
MG,40304,JAMPRUCA,2253,652,999,4035,32,3036,99
MG,40312,ALFENAS,19167,24145,11925,57167,690,45242,1240
MG,40320,JUATUBA,7123,6445,3286,17777,310,14491,613
MG,40339,ALMENARA,14884,4751,8672,29153,190,20481,656
MG,40347,LAGOA GRANDE,3010,2111,1383,6642,40,5259,98
MG,40355,ALPERCATA,3151,1453,1608,6393,46,4785,135
MG,40363,LIMEIRA DO OESTE,3222,1250,814,5414,43,4600,85
MG,40371,ALPINÓPOLIS,7344,4202,2810,14781,142,11971,283
MG,40380,LONTRA,4275,859,2423,7762,43,5339,162
MG,40398,ALTEROSA,4836,4356,1941,11381,84,9440,164
MG,40401,MAMONAS,3394,716,1455,5730,33,4275,132
MG,40410,ALTO RIO DOCE,4434,2347,3077,10127,74,7050,195
MG,40428,MATA VERDE,2567,1834,946,5550,24,4604,179
MG,40436,ALVARENGA,1831,1417,968,4287,15,3319,56
MG,40444,MATIAS CARDOSO,3481,833,1755,6231,32,4476,130
MG,40452,ALVINÓPOLIS,6771,2776,3127,13145,108,10018,363
MG,40460,MONTEZUMA,2846,851,1133,5064,39,3931,195
MG,40479,ALVORADA DE MINAS,1695,731,1223,3783,36,2560,98
MG,40487,NAQUE,2455,1178,1329,5120,62,3791,96
MG,40495,AMPARO DO SERRA,2440,828,1113,4543,52,3430,110
MG,40509,NOVO ORIENTE DE MINAS,3487,1650,3401,8870,59,5469,273
MG,40517,ANDRADAS,6784,15457,4836,28277,342,23441,858
MG,40525,PALMÓPOLIS,2193,1480,2343,6216,22,3873,178
MG,40533,CACHOEIRA DE PAJEÚ,3227,1394,1882,6726,44,4844,179
MG,40541,PEDRAS DE MARIA DA CRUZ,4378,595,2556,7681,29,5125,123
MG,40550,ANDRELÂNDIA,3462,3341,2460,9633,112,7173,258
MG,40568,PERIQUITO,2590,1646,1896,6274,53,4378,89
MG,40576,ANTÔNIO CARLOS,5247,1960,1770,9375,121,7605,277
MG,40584,PONTO DOS VOLANTES,3500,2009,2486,8256,58,5770,203
MG,40592,ANTÔNIO DIAS,3963,2205,2290,8772,108,6482,206
MG,40606,RIACHINHO,2657,914,1520,5218,29,3698,98
MG,40614,ANTÔNIO PRADO DE MINAS,683,642,358,1733,17,1375,33
MG,40622,ROSÁRIO DA LIMEIRA,2761,1050,905,4871,55,3966,100
MG,40630,ARAÇAÍ,758,1033,713,2596,21,1883,71
MG,40649,SANTA BÁRBARA DO LESTE,2856,2172,1618,6894,72,5276,176
MG,40657,ARACITABA,1018,503,578,2208,46,1630,63
MG,40665,SANTA RITA DE MINAS,2444,1803,1222,5668,48,4446,151
MG,40673,ARAÇUAÍ,10625,6955,9598,27790,132,18192,480
MG,40681,SANTANA DO PARAÍSO,7632,5011,3691,16965,217,13274,414
MG,40690,ARAGUARI,37850,27254,17176,85828,931,68652,2617
MG,40703,SÃO JOÃO DA LAGOA,2411,741,1154,4403,21,3249,76
MG,40711,ARANTINA,1457,570,563,2684,31,2121,63
MG,40720,SÃO JOÃO DO MANHUAÇU,4002,1994,1463,7672,56,6209,157
MG,40738,ARAPONGA,3597,894,1885,6572,53,4687,143
MG,40746,SÃO JOÃO DO MANTENINHA,2702,1122,1020,4946,39,3926,63
MG,40754,ARAPUÁ,889,1351,655,3023,41,2368,87
MG,40762,SÃO JOÃO DO PACUÍ,2172,429,929,3611,19,2682,62
MG,40770,ARAÚJOS,1372,3499,1089,6138,74,5049,104
MG,40789,SÃO JOSÉ DA LAPA,6332,6702,2780,16415,207,13635,394
MG,40797,ARAXÁ,27523,28519,14491,73369,817,58878,2019
MG,40800,SARZEDO,7219,6955,2673,17611,274,14938,490
MG,40819,ARCEBURGO,1594,3867,1148,6925,84,5777,232
MG,40827,SEM PEIXE,1406,653,1308,3470,41,2162,62
MG,40835,ARCOS,11982,11344,4915,29826,555,24911,1030
MG,40843,SENADOR AMARAL,1991,1796,679,4605,43,3926,96
MG,40851,AREADO,2540,6305,2234,11438,121,9204,238
MG,40860,UBAPORANGA,3427,3483,2691,9865,71,7174,193
MG,40878,ARGIRITA,1329,714,618,2743,22,2125,60
MG,40886,URUCUIA,3641,1025,1989,6771,30,4782,86
MG,40894,ARINOS,6254,2742,4175,13492,72,9317,249
MG,40908,VARGEM ALEGRE,2609,1542,2073,6394,44,4321,126
MG,40916,ASTOLFO DUTRA,5308,3123,1895,10647,113,8752,208
MG,40924,JOSENÓPOLIS,1567,543,1375,3599,15,2224,99
MG,40932,ATALÉIA,5808,1593,4013,11716,72,7703,230
MG,40940,JUVENÍLIA,2373,1059,1770,5315,22,3545,91
MG,40959,AUGUSTO DE LIMA,1757,1007,1448,4337,42,2889,83
MG,40967,LEME DO PRADO,1483,1027,1386,3978,19,2592,63
MG,40975,BAEPENDI,6282,5517,2895,15311,201,12416,416
MG,40983,LUISBURGO,2059,1929,1101,5208,38,4107,81
MG,40991,BALDIM,2530,2563,1447,6740,86,5293,114
MG,41009,LUISLÂNDIA,3308,442,1804,5677,24,3873,99
MG,41017,BAMBUÍ,7589,5842,4798,18778,161,13980,388
MG,41025,MÁRIO CAMPOS,3744,3824,1754,9800,164,8046,314
MG,41033,BANDEIRA,2191,679,1213,4244,28,3031,133
MG,41041,MARTINS SOARES,3123,1529,1399,6246,60,4847,135
MG,41050,BANDEIRA DO SUL,1669,2348,835,5009,61,4174,96
MG,41068,MIRAVÂNIA,1968,481,1345,3889,13,2544,82
MG,41076,BARÃO DE COCAIS,9306,8090,4078,22515,366,18437,675
MG,41084,MONTE FORMOSO,1460,930,1496,3992,16,2496,90
MG,41092,BARÃO DE MONTE ALTO,2795,1140,929,5010,32,4081,114
MG,41106,NATALÂNDIA,1655,483,701,2893,15,2192,39
MG,41114,BARBACENA,47436,26535,17250,96392,1109,79142,4062
MG,41122,NINHEIRA,3049,1625,2607,7605,84,4998,240
MG,41130,BARRA LONGA,2507,1309,1549,5502,39,3953,98
MG,41149,NOVA BELÉM,1557,1060,996,3711,31,2715,67
MG,41157,TRÊS MARIAS,8172,7844,5572,22398,254,16826,556
MG,41165,NOVA PORTEIRINHA,3986,833,1194,6152,44,4958,95
MG,41173,BARROSO,7794,4810,3093,16661,325,13568,639
MG,41181,NOVORIZONTE,1921,1109,1093,4281,48,3188,110
MG,41190,BELA VISTA DE MINAS,4357,1455,1198,7285,79,6087,196
MG,41203,OLHOS D'ÁGUA,2566,744,1407,4846,24,3439,105
MG,41211,BELMIRO BRAGA,1553,795,503,2929,14,2426,64
MG,41220,ORATÓRIOS,2276,856,961,4191,31,3230,67
MG,41238,BELO HORIZONTE,521813,939427,371781,1912443,21833,1540662,57589
MG,41246,ORIZÂNIA,3215,1252,1428,6020,23,4592,102
MG,41254,BELO ORIENTE,9375,3846,4447,18473,308,14026,497
MG,41262,PADRE CARVALHO,1911,1026,1702,4748,21,3046,88
MG,41270,BELO VALE,3285,2509,1678,7722,97,6044,153
MG,41289,PAI PEDRO,2814,463,1140,4581,36,3441,128
MG,41297,BERILO,3866,1722,3860,9700,60,5840,192
MG,41300,PATIS,2452,677,1202,4447,25,3245,91
MG,41319,BERTÓPOLIS,1477,923,1158,3689,23,2531,108
MG,41327,PEDRA BONITA,2625,1612,1204,5562,29,4358,92
MG,41335,BETIM,117153,91287,45331,267506,4108,222175,9627
MG,41343,PIEDADE DE CARATINGA,2754,1932,1460,6330,58,4870,126
MG,41351,BIAS FORTES,1675,813,928,3537,20,2609,101
MG,41360,PINGO D'ÁGUA,1893,881,1223,4113,20,2890,96
MG,41378,BICAS,4385,3725,2721,11367,109,8646,427
MG,41386,PINTÓPOLIS,3196,810,1892,6014,35,4122,81
MG,41394,BIQUINHAS,1039,956,761,2813,15,2052,42
MG,41408,PONTO CHIQUE,1827,568,1222,3699,17,2477,65
MG,41416,BOA ESPERANÇA,10548,12509,6880,30773,329,23893,507
MG,41424,REDUTO,2559,1510,1262,5465,36,4203,98
MG,41432,BOCAINA DE MINAS,1378,1894,1038,4496,49,3458,137
MG,41440,SANTA BÁRBARA DO MONTE VERDE,1523,912,814,3343,23,2529,71
MG,41459,BOCAIÚVA,18103,7106,8569,34760,300,26191,682
MG,41467,SANTA CRUZ DE MINAS,2213,2927,940,6394,102,5454,212
MG,41475,BOM DESPACHO,8134,19756,7252,36547,508,29295,897
MG,41483,SANTA CRUZ DE SALINAS,2326,478,1397,4332,21,2935,110
MG,41491,BOM JARDIM DE MINAS,2540,1577,1246,5573,57,4327,153
MG,41505,SANTA HELENA DE MINAS,2024,1247,1302,4703,18,3401,112
MG,41513,BOM JESUS DA PENHA,1098,1505,606,3304,34,2698,61
MG,41521,SANTO ANTÔNIO DO RETIRO,3121,609,1675,5631,45,3956,181
MG,41530,BOM JESUS DO AMPARO,2057,1515,659,4433,58,3774,144
MG,41548,SÃO DOMINGOS DAS DORES,2424,1560,1097,5190,42,4093,67
MG,41556,BOM JESUS DO GALHO,5381,3362,2392,11555,131,9163,289
MG,41564,SÃO FÉLIX DE MINAS,1235,1028,891,3226,19,2335,53
MG,41572,BOM REPOUSO,3529,3486,1081,8350,89,7269,165
MG,41580,SÃO GERALDO DO BAIXIO,1312,800,666,2851,17,2185,56
MG,41599,BOM SUCESSO,4909,6132,3493,15087,166,11594,387
MG,41602,SÃO JOÃO DAS MISSÕES,4668,1269,1976,8219,53,6243,253
MG,41610,BONFIM,2473,2259,1299,6389,119,5090,239
MG,41629,SÃO JOAQUIM DE BICAS,8286,4839,3842,17628,219,13786,442
MG,41637,BONFINÓPOLIS DE MINAS,1851,1502,1566,5025,38,3459,68
MG,41645,SÃO JOSÉ DA BARRA,2756,1630,1385,5970,67,4585,132
MG,41653,BORDA DA MATA,4132,6058,2320,12977,128,10657,339
MG,41661,ALTO CAPARAÓ,1320,1804,614,3853,43,3239,72
MG,41670,BOTELHOS,5777,3787,2680,12616,135,9936,237
MG,41688,ANGELÂNDIA,2420,1486,2159,6255,47,4096,143
MG,41696,BOTUMIRIM,2310,977,1711,5158,29,3447,131
MG,41700,ARICANDUVA,1886,927,1337,4286,21,2949,115
MG,41718,BRASÍLIA DE MINAS,13637,3961,7518,25880,209,18362,555
MG,41726,BERIZAL,1887,802,718,3512,17,2794,88
MG,41734,BRÁS PIRES,1424,1480,966,3983,37,3017,76
MG,41742,BONITO DE MINAS,3989,525,2317,7033,35,4716,167
MG,41750,BRAÚNAS,1781,952,1020,3918,56,2898,109
MG,41769,BUGRE,1757,1410,1141,4422,33,3281,81
MG,41777,BRAZÓPOLIS,3123,6606,2729,12809,101,10080,250
MG,41785,CABECEIRA GRANDE,1870,1771,1363,5138,61,3775,73
MG,41793,BRUMADINHO,8369,11601,4502,25702,330,21200,900
MG,41807,CAMPO AZUL,1851,563,1107,3604,19,2497,64
MG,41815,BUENO BRANDÃO,1941,4787,1664,8692,111,7028,189
MG,41823,CANTAGALO,1653,886,1132,3800,41,2668,88
MG,41831,BUENÓPOLIS,2807,2019,3298,8378,71,5080,183
MG,41840,CATAS ALTAS,1685,1796,773,4405,48,3632,103
MG,41858,BURITIS,6781,5683,4406,17277,124,12871,283
MG,41866,CATUTI,2265,537,1238,4179,26,2941,113
MG,41874,BURITIZEIRO,9509,3438,5946,19576,199,13630,484
MG,41882,CHAPADA GAÚCHA,4002,1370,1931,7499,40,5568,156
MG,41890,CABO VERDE,4363,3011,2197,9786,70,7589,145
MG,41904,CÔNEGO MARINHO,3397,601,1426,5577,40,4151,113
MG,41912,CACHOEIRA DA PRATA,1089,1603,567,3380,30,2813,91
MG,41920,CONFINS,1504,3007,782,5475,66,4693,116
MG,41939,CACHOEIRA DE MINAS,2344,4848,1464,8964,89,7500,219
MG,41947,CÓRREGO FUNDO,1869,2062,727,4928,94,4201,176
MG,41955,CACHOEIRA DOURADA,1063,446,503,2053,11,1550,30
MG,41963,CRISÓLITA,2030,1001,1293,4464,13,3171,127
MG,41971,CAETANÓPOLIS,2605,3418,1545,7950,98,6405,284
MG,41980,CUPARAQUE,1357,1525,1046,3992,16,2946,48
MG,41998,CAETÉ,10807,14172,6642,32936,380,26294,935
MG,42005,CURRAL DE DENTRO,2282,1692,1647,5806,33,4159,152
MG,42013,CAIANA,2131,746,659,3683,55,3024,92
MG,42021,DELTA,2578,1465,1102,5307,62,4205,100
MG,42030,CAJURI,2044,917,707,3827,45,3120,114
MG,42048,DOM BOSCO,1312,1031,805,3201,8,2396,45
MG,42056,CALDAS,3776,4609,1807,10537,93,8730,252
MG,42064,FREI LAGONEGRO,1580,708,908,3277,14,2369,67
MG,42072,CAMACHO,1135,1235,723,3180,31,2457,56
MG,42080,FRUTA DE LEITE,2246,674,2007,5089,23,3082,139
MG,42099,CAMANDUCAIA,4988,7546,3269,16426,230,13157,393
MG,42102,GAMELEIRAS,2295,718,1061,4193,16,3132,103
MG,42110,CAMBUÍ,5806,9946,3969,20656,251,16687,684
MG,42129,GLAUCILÂNDIA,1963,615,640,3272,18,2632,36
MG,42137,CAMBUQUIRA,2456,5158,2097,10056,85,7959,260
MG,42145,GOIABEIRA,1142,949,708,2864,19,2156,46
MG,42153,CAMPANÁRIO,1445,739,996,3270,32,2274,58
MG,42161,GOIANÁ,1569,1091,876,3685,35,2809,114
MG,42170,CAMPANHA,2528,6561,2407,11854,109,9447,249
MG,42188,GUARACIAMA,3182,719,1097,5109,27,4012,84
MG,42196,CAMPESTRE,4433,8237,2901,16167,238,13266,358
MG,42200,IBIRACATU,2640,988,1897,5699,36,3802,138
MG,42218,CAMPINA VERDE,5601,5760,3295,15058,115,11763,287
MG,42226,IMBÉ DE MINAS,2572,1426,1614,5738,24,4124,102
MG,42234,CAMPO BELO,16294,13373,8137,39400,542,31263,1054
MG,42242,INDAIABIRA,2412,1395,1955,5972,29,4017,181
MG,42250,CAMPO DO MEIO,4771,2361,2381,9812,122,7431,177
MG,42269,JAPONVAR,4176,767,2494,7657,54,5163,166
MG,42277,CAMPO FLORIDO,2349,1842,1072,5390,38,4318,89
MG,42285,JENIPAPO DE MINAS,1893,1269,2349,5658,32,3309,115
MG,42293,CAMPOS ALTOS,3260,3894,2842,10253,108,7411,149
MG,42307,JOSÉ GONÇALVES DE MINAS,1285,1086,1245,3719,26,2474,77
MG,42315,CAMPOS GERAIS,6890,8240,4669,20420,216,15751,405
MG,42323,JOSÉ RAYDAN,1726,858,1309,4016,26,2707,97
MG,42331,CANAÃ,2288,860,645,3935,44,3290,98
MG,42340,SÃO SEBASTIÃO DA VARGEM ALEGRE,1435,680,553,2785,38,2232,79
MG,42358,CANÁPOLIS,4464,2379,2329,9396,42,7067,182
MG,42366,SÃO SEBASTIÃO DO ANTA,2237,1344,1403,5106,40,3703,82
MG,42374,CANA VERDE,2616,1078,750,4599,54,3849,101
MG,42382,SERRANÓPOLIS DE MINAS,2139,609,844,3683,17,2839,74
MG,42390,CANDEIAS,4179,4545,2595,11877,202,9282,356
MG,42404,SETUBINHA,3859,1081,3027,8305,42,5278,296
MG,42412,CAPARAÓ,1924,1148,973,4206,51,3233,110
MG,42420,TAPARUBA,1413,1013,806,3301,23,2495,46
MG,42439,CAPELA NOVA,1716,1397,712,4054,102,3342,127
MG,42447,UNIÃO DE MINAS,1682,752,991,3487,25,2496,37
MG,42455,CAPELINHA,9798,7986,6784,25440,249,18656,623
MG,42463,URUANA DE MINAS,1345,814,915,3164,22,2249,68
MG,42471,CAPETINGA,2043,2191,1515,5909,51,4394,109
MG,42480,VARGEM GRANDE DO RIO PARDO,1590,1103,971,3792,19,2821,109
MG,42498,CAPIM BRANCO,2262,3490,1263,7303,97,6040,191
MG,42501,VARJÃO DE MINAS,2133,1898,1011,5192,46,4181,104
MG,42510,CAPINÓPOLIS,5572,3191,2212,11223,80,9011,168
MG,42528,VERDELÂNDIA,3550,787,1819,6305,39,4486,110
MG,42536,CAPITÃO ENÉAS,5732,2605,2968,11646,73,8678,268
MG,42544,VEREDINHA,2293,1029,1244,4702,37,3458,99
MG,42552,CAPITÓLIO,2792,2624,1524,7156,80,5632,136
MG,42560,VERMELHO NOVO,2054,1439,905,4548,48,3643,102
MG,42579,CAPUTIRA,3878,1703,1710,7593,116,5883,186
MG,42587,TOCOS DO MOJI,1793,1432,412,3727,28,3315,62
MG,42595,CARAÍ,6762,2143,5448,14868,76,9420,439
MG,42617,CARANAÍBA,1288,1056,502,2989,65,2487,78
MG,42633,CARANDAÍ,9401,5798,2758,19027,422,16269,648
MG,42650,CARANGOLA,12003,5642,6492,25057,227,18565,693
MG,42676,CARATINGA,23374,19657,15185,60521,627,45336,1678
MG,42692,CARBONITA,2933,2301,2301,7705,64,5404,106
MG,42714,CAREAÇU,1665,2223,906,4898,30,3992,74
MG,42730,CARLOS CHAGAS,5995,4606,5643,16704,130,11061,330
MG,42757,CARMÉSIA,817,657,597,2130,15,1533,44
MG,42773,CARMO DA CACHOEIRA,3855,3297,2111,9620,115,7509,242
MG,42790,CARMO DA MATA,3308,3979,1622,9259,115,7637,235
MG,42811,CARMO DE MINAS,3369,4181,1759,9612,111,7853,192
MG,42838,CARMO DO CAJURU,6421,6828,2708,16700,263,13992,480
MG,42854,CARMO DO PARANAÍBA,6716,8895,5257,21755,326,16498,561
MG,42870,CARMO DO RIO CLARO,5806,5924,3367,15514,129,12147,288
MG,42897,CARMÓPOLIS DE MINAS,4715,5289,2053,12555,151,10502,347
MG,42919,CARRANCAS,1097,1408,593,3200,34,2607,68
MG,42935,CARVALHÓPOLIS,1122,1379,575,3141,17,2566,48
MG,42951,CARVALHOS,1311,1510,891,3901,49,3010,140
MG,42978,CASA GRANDE,927,835,425,2307,48,1882,72
MG,42994,CASCALHO RICO,1282,816,646,2819,23,2173,52
MG,43010,CÁSSIA,5674,4822,3101,14063,106,10962,360
MG,43036,CONCEIÇÃO DA BARRA DE MINAS,1408,1418,494,3433,38,2939,75
MG,43052,CATAGUASES,30452,9897,10921,53253,501,42332,1482
MG,43079,CATAS ALTAS DA NORUEGA,1650,767,924,3445,33,2521,71
MG,43095,CAXAMBU,6955,5772,4554,17878,166,13324,431
MG,43117,CEDRO DO ABAETÉ,248,671,471,1416,12,945,14
MG,43133,CENTRAL DE MINAS,2882,1449,1461,5953,40,4492,121
MG,43150,CENTRALINA,3749,1560,1298,6794,57,5496,130
MG,43176,CHÁCARA,1370,740,470,2674,28,2204,66
MG,43192,CHALÉ,2492,1072,825,4542,60,3717,93
MG,43214,CHAPADA DO NORTE,4036,1473,4104,9928,63,5824,252
MG,43230,CHIADOR,1043,1196,720,3070,27,2350,84
MG,43257,CIPOTÂNEA,1724,1563,1992,5450,80,3458,91
MG,43273,CLARAVAL,979,2682,782,4529,23,3747,63
MG,43290,CLARO DOS POÇÕES,3419,2002,1951,7581,63,5630,146
MG,43311,CLÁUDIO,3019,12987,2874,19546,222,16672,444
MG,43338,COIMBRA,2696,1962,635,5660,118,5025,249
MG,43354,COLUNA,2902,1481,2244,6858,69,4614,162
MG,43370,COMENDADOR GOMES,1027,880,571,2533,15,1962,40
MG,43397,COMERCINHO,3321,1034,2343,6900,46,4557,156
MG,43419,CONCEIÇÃO DA APARECIDA,3563,2391,1718,7844,66,6126,106
MG,43435,CONCEIÇÃO DAS PEDRAS,1009,1015,465,2587,37,2122,61
MG,43451,CONCEIÇÃO DAS ALAGOAS,8859,5023,3875,18185,147,14310,281
MG,43478,CONCEIÇÃO DE IPANEMA,1956,956,656,3673,32,3017,73
MG,43494,CONCEIÇÃO DO MATO DENTRO,6000,3665,4512,14793,182,10281,434
MG,43516,CONCEIÇÃO DO PARÁ,1298,2300,888,4694,71,3806,137
MG,43532,CONCEIÇÃO DO RIO VERDE,3242,4139,2260,9946,134,7686,171
MG,43559,CONCEIÇÃO DOS OUROS,2514,4300,1341,8405,74,7064,176
MG,43575,CONGONHAL,2551,3904,1002,7677,69,6675,151
MG,43591,CONGONHAS,16683,14228,5404,38526,656,33122,1555
MG,43613,CONGONHAS DO NORTE,1799,765,1279,4029,39,2750,147
MG,43630,CONQUISTA,1909,2137,748,5002,43,4254,165
MG,43656,CONSELHEIRO LAFAIETE,44717,27011,13273,89902,1324,76629,3577
MG,43672,CONSELHEIRO PENA,6419,5027,4671,16640,169,11969,354
MG,43699,CONSOLAÇÃO,431,871,335,1687,14,1352,36
MG,43710,CONTAGEM,163283,176754,81414,443726,6136,362312,16139
MG,43737,COQUEIRAL,2840,2834,1728,7654,97,5926,155
MG,43753,CORAÇÃO DE JESUS,12033,2485,5938,20961,141,15023,364
MG,43770,CORDISBURGO,2637,2367,1785,7001,72,5216,140
MG,43796,CORDISLÂNDIA,1105,1171,776,3116,17,2340,47
MG,43818,CORINTO,8447,5030,5949,19967,194,14018,347
MG,43834,COROACI,3747,2379,3001,9415,76,6414,212
MG,43850,COROMANDEL,9374,7490,5011,22671,269,17660,527
MG,43877,CORONEL FABRICIANO,31363,27352,17953,79716,927,61763,2121
MG,43893,CORONEL MURTA,3565,1300,1857,6900,54,5043,124
MG,43915,CORONEL PACHECO,1331,765,367,2569,31,2202,75
MG,43931,CORONEL XAVIER CHAVES,999,1182,462,2740,26,2278,71
MG,43958,CÓRREGO DANTA,1112,1024,909,3106,20,2197,41
MG,43974,CÓRREGO DO BOM JESUS,1060,1792,625,3592,36,2967,79
MG,43990,CÓRREGO NOVO,1712,611,1400,3816,21,2416,72
MG,44016,COUTO DE MAGALHÃES DE MINAS,1598,828,1211,3779,38,2568,104
MG,44032,CRISTAIS,3402,2696,1633,8121,136,6488,254
MG,44059,CRISTÁLIA,2656,671,1475,4891,31,3416,58
MG,44075,CRISTIANO OTONI,2041,1343,596,4212,82,3616,150
MG,44091,CRISTINA,1771,4289,1702,8054,78,6352,214
MG,44113,CRUCILÂNDIA,1338,2162,975,4662,73,3687,114
MG,44130,CRUZEIRO DA FORTALEZA,1262,1481,941,3781,35,2840,62
MG,44156,CRUZÍLIA,5238,3937,2370,11914,122,9544,247
MG,44172,CURVELO,24162,17938,10656,54493,629,43837,1108
MG,44199,DATAS,2016,1067,1464,4732,51,3268,134
MG,44210,DELFIM MOREIRA,1970,3163,1265,6588,54,5323,136
MG,44237,DELFINÓPOLIS,1845,2455,1518,5992,60,4474,114
MG,44253,DESCOBERTO,1789,1627,769,4363,45,3594,133
MG,44270,DESTERRO DE ENTRE RIOS,1374,3065,982,5683,120,4701,142
MG,44296,DESTERRO DO MELO,1278,1095,533,3021,38,2488,77
MG,44318,DIAMANTINA,16023,8887,9689,35812,333,26123,880
MG,44334,DIOGO DE VASCONCELOS,2058,667,958,3806,24,2848,99
MG,44350,DIONÍSIO,3220,1286,2521,7279,100,4758,152
MG,44377,DIVINÉSIA,1559,1259,524,3447,35,2923,70
MG,44393,DIVINO,7445,3241,3852,14951,124,11099,289
MG,44415,DIVINO DAS LARANJEIRAS,1698,1259,1156,4251,40,3095,98
MG,44431,DIVINOLÂNDIA DE MINAS,2505,1415,1944,6083,46,4139,173
MG,44458,DIVINÓPOLIS,70325,56409,16409,152058,2365,135649,6550
MG,44474,DIVISA NOVA,1989,1670,898,4679,40,3781,82
MG,44490,DOM CAVATI,1793,1914,1001,4835,38,3834,89
MG,44512,DOM JOAQUIM,1676,963,962,3745,42,2783,102
MG,44539,DOM SILVÉRIO,2083,1279,875,4430,46,3555,147
MG,44555,DOM VIÇOSO,759,1463,398,2679,21,2281,38
MG,44571,DONA EUSÉBIA,2911,1276,785,5120,56,4335,92
MG,44598,DORES DE CAMPOS,2595,3306,884,7355,181,6471,389
MG,44610,DORES DE GUANHÃES,2628,778,1328,4881,33,3553,114
MG,44636,DORES DO INDAIÁ,2891,5071,2978,11275,114,8297,221
MG,44652,DORES DO TURVO,2104,1328,976,4571,43,3595,120
MG,44679,DORESÓPOLIS,530,697,446,1734,21,1288,40
MG,44695,DOURADOQUARA,819,651,400,1917,14,1517,33
MG,44717,ELÓI MENDES,5288,10164,2972,19020,215,16048,381
MG,44733,ENGENHEIRO CALDAS,2820,2735,1698,7534,96,5836,185
MG,44750,ENGENHEIRO NAVARRO,3266,760,1636,5860,50,4224,148
MG,44776,ENTRE RIOS DE MINAS,4448,4606,1908,11465,139,9557,364
MG,44792,ERVÁLIA,8064,3787,3292,15904,302,12612,459
MG,44814,ESMERALDAS,18358,12720,8849,41442,526,32593,989
MG,44830,ESPERA FELIZ,8531,3455,2905,15534,202,12629,441
MG,44857,ESPINOSA,12122,4157,8456,25305,174,16849,396
MG,44873,ESPÍRITO SANTO DO DOURADO,1053,2491,540,4235,55,3695,96
MG,44890,ESTIVA,2756,4301,1338,8756,108,7418,253
MG,44911,ESTRELA DALVA,1280,526,702,2601,21,1899,72
MG,44938,ESTRELA DO INDAIÁ,703,1371,892,3075,38,2183,71
MG,44954,ESTRELA DO SUL,2984,1335,1473,5964,61,4491,111
MG,44970,EUGENÓPOLIS,4101,2273,1668,8318,85,6650,191
MG,44997,EWBANK DA CÂMARA,2213,658,690,3677,30,2987,86
MG,45012,EXTREMA,6293,12622,5276,25206,352,19930,663
MG,45039,FAMA,1089,989,550,2720,23,2170,69
MG,45055,FARIA LEMOS,1747,483,519,2831,21,2312,61
MG,45071,FELÍCIO DOS SANTOS,1404,1454,1769,4753,37,2984,89
MG,45098,SÃO GONÇALO DO RIO PRETO,1144,755,900,2907,35,2007,73
MG,45110,FELISBURGO,2019,1207,1815,5184,32,3369,111
MG,45136,FELIXLÂNDIA,4230,3978,3010,11527,127,8517,182
MG,45152,FERNANDES TOURINHO,1037,929,634,2708,25,2074,83
MG,45179,FERROS,4031,2007,2129,8503,90,6374,246
MG,45195,FLORESTAL,2564,1927,1128,5880,71,4752,190
MG,45217,FORMIGA,16696,24076,10301,53611,841,43310,1697
MG,45233,FORMOSO,2258,1639,1351,5427,37,4076,142
MG,45250,FORTALEZA DE MINAS,1122,1363,877,3505,49,2628,94
MG,45276,FORTUNA DE MINAS,1157,896,564,2696,34,2132,45
MG,45292,FRANCISCO BADARÓ,2369,1938,2840,7333,47,4493,139
MG,45314,FRANCISCO DUMONT,1972,801,1476,4362,41,2886,72
MG,45330,FRANCISCO SÁ,10644,2638,4363,18244,142,13881,457
MG,45357,FREI GASPAR,2442,927,1332,4883,35,3551,147
MG,45373,FREI INOCÊNCIO,3388,1414,1908,6873,53,4965,110
MG,45390,FRONTEIRA,4681,2523,2529,10018,88,7489,197
MG,45411,FRUTAL,16662,13661,8611,40180,450,31569,796
MG,45438,FUNILÂNDIA,1403,1524,983,4049,35,3066,104
MG,45454,GALILÉIA,2180,1622,1261,5182,36,3921,83
MG,45470,GONÇALVES,510,2324,728,3659,28,2931,69
MG,45497,GONZAGA,1681,1526,1279,4635,34,3356,115
MG,45519,GOUVEIA,4765,2082,2913,10088,87,7175,241
MG,45535,GOVERNADOR VALADARES,72134,75853,48224,201791,1796,153567,3784
MG,45551,GRÃO MOGOL,5499,2023,3507,11423,70,7916,324
MG,45578,GRUPIARA,500,607,344,1495,15,1151,29
MG,45594,GUANHÃES,8216,8496,6294,24014,282,17720,726
MG,45616,GUAPÉ,3639,3950,2556,10375,98,7819,132
MG,45632,GUARACIABA,3879,1762,2211,8137,77,5926,208
MG,45659,GUARANÉSIA,7607,3853,2867,14860,167,11993,366
MG,45675,GUARANI,3080,2308,1413,7080,87,5667,192
MG,45691,GUARARÁ,1464,1117,725,3462,44,2737,112
MG,45713,GUARDA-MOR,2394,1574,1475,5585,46,4110,96
MG,45730,GUAXUPÉ,15920,13008,7428,37953,445,30525,1152
MG,45756,GUIDOVAL,3000,1919,1175,6341,83,5166,164
MG,45772,GUIMARÂNIA,2371,2399,1434,6407,72,4973,131
MG,45799,GUIRICEMA,3820,1845,922,6883,111,5961,185
MG,45810,GURINHATÃ,2286,1284,1609,5272,24,3663,69
MG,45837,HELIODORA,1669,2312,868,4986,50,4118,87
MG,45853,IAPU,3399,2522,1846,8086,109,6240,210
MG,45870,IBERTIOGA,2560,1039,947,4676,39,3729,91
MG,45896,IBIÁ,6703,5584,4660,17500,188,12840,365
MG,45918,IBIAÍ,3481,629,2062,6285,25,4223,88
MG,45934,IBIRACI,2336,4545,1746,8843,87,7097,129
MG,45950,IBIRITÉ,49200,31957,18470,104659,1751,86189,3281
MG,45977,IBITIÚRA DE MINAS,935,1640,615,3312,41,2697,81
MG,45993,IBITURUNA,739,1123,556,2487,17,1931,52
MG,46019,IGARAPÉ,10849,8897,5328,26291,404,20963,813
MG,46035,IGARATINGA,3282,1908,1184,6743,163,5559,206
MG,46051,IGUATAMA,2484,2714,1285,6666,67,5381,116
MG,46078,IJACI,1466,2629,568,4877,77,4309,137
MG,46094,ILICÍNEA,3872,3401,1737,9201,65,7464,126
MG,46116,INCONFIDENTES,2232,2773,930,6104,63,5174,106
MG,46132,INDIANÓPOLIS,2306,1255,1271,5012,59,3741,121
MG,46159,INGAÍ,896,1293,561,2831,24,2270,57
MG,46175,INHAPIM,8965,5474,4633,19695,201,15062,422
MG,46191,INHAÚMA,2029,1943,1034,5190,52,4156,132
MG,46213,INIMUTABA,2754,1542,1295,5754,60,4459,103
MG,46230,IPANEMA,6168,4778,3792,15196,157,11404,301
MG,46256,IPATINGA,63340,71599,38314,181075,2367,142761,5455
MG,46272,IPIAÇU,1602,972,965,3613,21,2648,53
MG,46299,IPUIÚNA,3163,3081,1174,7605,54,6431,133
MG,46310,IRAÍ DE MINAS,2603,1714,1282,5769,48,4487,122
MG,46337,ITABIRA,36160,33385,15344,89314,1172,73970,3253
MG,46353,ITABIRINHA,3326,2640,2033,8317,113,6284,205
MG,46370,ITABIRITO,11589,17958,6158,37624,626,31466,1293
MG,46396,ITACAMBIRA,2354,640,1539,4629,22,3090,74
MG,46418,ITACARAMBI,6527,2131,3943,13115,131,9172,383
MG,46434,ITAGUARA,2846,4856,1095,9337,211,8242,329
MG,46450,ITAIPÉ,2477,2895,2803,8409,67,5606,167
MG,46477,ITAJUBÁ,18311,35320,14186,70747,785,56561,2145
MG,46493,ITAMARANDIBA,11005,5536,5977,23298,224,17321,556
MG,46515,ITAMARATI DE MINAS,1970,831,720,3670,25,2950,124
MG,46531,ITAMBACURI,8860,2744,6032,18222,115,12190,471
MG,46558,ITAMBÉ DO MATO DENTRO,1133,600,571,2407,35,1836,68
MG,46574,ITAMOGI,3225,3605,1990,9270,98,7280,352
MG,46590,ITAMONTE,2769,5685,1917,10940,168,9023,401
MG,46612,ITANHANDU,3347,5897,2083,11736,115,9653,294
MG,46639,ITANHOMI,3956,3111,2177,9564,89,7387,231
MG,46655,ITAOBIM,5516,5324,5381,16740,128,11359,391
MG,46671,ITAPAGIPE,4279,3355,2204,10067,75,7863,154
MG,46698,ITAPECERICA,5430,7748,3282,17276,263,13994,553
MG,46710,ITAPEVA,1886,3350,888,6340,57,5452,159
MG,46736,ITATIAIUÇU,2827,3608,1604,8393,137,6789,217
MG,46752,ITAÚNA,14750,37251,10847,66459,1066,55612,2545
MG,46779,ITAVERAVA,2813,1231,1254,5482,61,4228,123
MG,46795,ITINGA,5041,1975,3607,10892,69,7285,200
MG,46817,ITUETA,2120,1765,1316,5375,52,4059,122
MG,46833,ITUIUTABA,40377,17560,16882,76584,577,59702,1188
MG,46850,ITUMIRIM,1803,2640,1054,5718,76,4664,145
MG,46876,ITURAMA,14434,7165,5978,28302,228,22324,497
MG,46892,ITUTINGA,1133,1590,746,3576,35,2830,72
MG,46914,JABOTICATUBAS,5188,5002,2387,12956,103,10569,276
MG,46930,JACINTO,3442,2483,2574,8754,66,6180,189
MG,46957,JACUÍ,1303,3209,1495,6227,52,4732,168
MG,46973,JACUTINGA,2374,11074,3083,17009,113,13926,365
MG,46990,JAGUARAÇU,1340,832,506,2767,33,2261,56
MG,47015,JANAÚBA,27020,9683,11234,49460,442,38226,1081
MG,47031,JANUÁRIA,26606,5530,14608,47981,346,33373,891
MG,47058,JAPARAÍBA,1211,1384,497,3183,38,2686,53
MG,47074,JECEABA,1883,2194,1182,5453,83,4271,111
MG,47090,JEQUERI,4756,2061,2588,9827,114,7239,308
MG,47112,JEQUITAÍ,3537,758,2337,6820,55,4483,133
MG,47139,JEQUITIBÁ,1999,2027,1196,5385,57,4189,106
MG,47155,JEQUITINHONHA,8324,2799,6197,17836,101,11639,415
MG,47171,JESUÂNIA,1551,1710,930,4324,30,3394,103
MG,47198,JOAÍMA,4929,1870,3925,11158,96,7233,338
MG,47210,JOANÉSIA,2104,1125,1363,4823,77,3460,154
MG,47236,JOÃO MONLEVADE,22785,20562,12234,58306,796,46072,1929
MG,47252,JOÃO PINHEIRO,16609,9399,8861,35750,311,26889,570
MG,47279,JOAQUIM FELÍCIO,1252,943,1337,3631,22,2294,77
MG,47295,JORDÂNIA,3414,1625,2668,7936,50,5268,179
MG,47317,NOVA UNIÃO,2480,1483,1286,5412,63,4126,100
MG,47333,JUIZ DE FORA,186765,108320,75553,392930,5148,317377,17144
MG,47350,JURAMENTO,2468,884,1042,4498,27,3456,77
MG,47376,JURUAIA,2952,2910,1244,7361,84,6117,171
MG,47392,LADAINHA,4896,2658,4212,12207,70,7995,371
MG,47414,LAGAMAR,2705,2051,1385,6299,57,4914,101
MG,47430,LAGOA DA PRATA,9200,16747,6406,33586,437,27180,796
MG,47457,LAGOA DOS PATOS,1856,668,1248,3876,38,2628,66
MG,47473,LAGOA DOURADA,3492,4179,1345,9559,197,8214,346
MG,47490,LAGOA FORMOSA,5042,5404,1993,12921,231,10928,251
MG,47511,LAGOA SANTA,9172,22005,7145,39776,514,32631,940
MG,47538,LAJINHA,7081,4288,3444,15404,185,11960,406
MG,47554,LAMBARI,5606,6363,3315,15946,158,12631,504
MG,47570,LAMIM,1726,670,705,3216,47,2511,68
MG,47597,LARANJAL,2804,1513,1052,5565,54,4513,142
MG,47619,LASSANCE,2529,1163,1689,5499,46,3810,72
MG,47635,LAVRAS,22846,30546,12294,69255,1000,56961,2569
MG,47651,LEANDRO FERREIRA,763,1572,615,3061,35,2446,76
MG,47678,LEOPOLDINA,20921,8986,8820,40012,456,31192,829
MG,47694,LIBERDADE,1911,1321,911,4313,53,3402,117
MG,47716,LIMA DUARTE,6999,3151,2888,13572,121,10684,413
MG,47732,LUMINÁRIAS,1242,2085,736,4190,52,3454,75
MG,47759,LUZ,3909,6616,3572,14582,214,11010,271
MG,47775,MACHACALIS,2344,1503,1482,5477,30,3995,118
MG,47791,MACHADO,8152,14309,5609,29058,315,23449,673
MG,47813,MADRE DE DEUS DE MINAS,1582,1589,958,4332,61,3374,142
MG,47830,MALACACHETA,6369,3100,5662,15699,157,10037,411
MG,47856,MANGA,7962,2599,4848,15858,127,11010,322
MG,47872,MANHUAÇU,23703,17876,11511,55088,641,43577,1357
MG,47899,MANHUMIRIM,6551,5065,4102,16279,164,12177,397
MG,47910,MANTENA,8658,5724,4387,19308,192,14921,347
MG,47937,MARAVILHAS,2322,2347,1070,5893,52,4823,102
MG,47953,MAR DE ESPANHA,3820,3584,1956,9704,75,7748,269
MG,47970,MARIA DA FÉ,4096,5511,2057,12061,118,10004,279
MG,47996,MARIANA,23469,10534,8322,44511,583,36189,1603
MG,48011,MARILAC,1716,1057,1070,3978,32,2908,103
MG,48038,MARIPÁ DE MINAS,1366,883,496,2854,25,2358,84
MG,48054,MARLIÉRIA,1734,1197,760,3829,35,3069,103
MG,48070,MARMELÓPOLIS,1088,983,368,2515,27,2147,49
MG,48097,MARTINHO CAMPOS,2794,4799,2755,10774,159,8019,267
MG,48119,MATERLÂNDIA,1852,670,1660,4338,39,2678,117
MG,48135,MATEUS LEME,7264,8974,4533,21915,412,17382,732
MG,48151,MATIAS BARBOSA,5715,2988,1878,11135,130,9257,424
MG,48178,MATIPÓ,7152,3525,3390,14560,142,11170,351
MG,48194,MATO VERDE,5396,2170,2557,10447,75,7890,249
MG,48216,MATOZINHOS,9973,11776,5107,28238,446,23131,936
MG,48232,MATUTINA,1115,1318,802,3351,30,2549,86
MG,48259,MEDEIROS,800,1317,807,3005,18,2198,63
MG,48275,MEDINA,7401,3349,4417,15737,165,11320,405
MG,48291,MENDES PIMENTEL,2192,1583,1284,5218,66,3934,93
MG,48313,MERCÊS,4101,1969,1663,8005,77,6342,195
MG,48330,MESQUITA,2117,1411,1574,5308,69,3734,137
MG,48356,MINAS NOVAS,9489,2898,9381,22475,171,13094,536
MG,48372,MINDURI,1136,1255,730,3207,25,2477,61
MG,48399,MIRABELA,5909,1544,3042,10753,70,7711,188
MG,48410,MIRADOURO,4077,2266,1847,8564,112,6717,262
MG,48437,MIRAÍ,4639,2643,2548,10209,110,7661,269
MG,48453,MOEDA,1593,2015,1085,4846,38,3761,115
MG,48470,MOEMA,2156,2583,1418,6351,55,4933,139
MG,48496,MONJOLOS,903,611,677,2263,17,1586,55
MG,48518,MONSENHOR PAULO,2712,2576,1060,6541,57,5481,136
MG,48534,MONTALVÂNIA,5953,2193,4249,12720,69,8471,256
MG,48550,MONTE ALEGRE DE MINAS,7035,3845,3724,15101,156,11377,341
MG,48577,MONTE AZUL,10203,2903,3983,17605,142,13622,374
MG,48593,MONTE BELO,4098,3778,2492,10700,135,8208,197
MG,48615,MONTE CARMELO,17546,9310,7714,35930,386,28216,974
MG,48631,MONTE SANTO DE MINAS,5484,6635,3954,16855,261,12901,521
MG,48658,MONTES CLAROS,124302,76170,43978,255344,2857,211366,8037
MG,48674,MONTE SIÃO,3446,9597,3422,16972,168,13550,339
MG,48690,MORADA NOVA DE MINAS,2605,2577,1962,7329,54,5367,131
MG,48712,MORRO DA GARÇA,1255,694,772,2774,17,2002,36
MG,48739,MORRO DO PILAR,1269,991,736,3137,33,2401,108
MG,48755,MUNHOZ,1779,2611,1070,5630,47,4560,123
MG,48771,MURIAÉ,36502,20386,15415,75534,833,60119,2398
MG,48798,MUTUM,9363,6197,4472,20793,283,16321,478
MG,48810,MUZAMBINHO,7106,6096,3593,17313,197,13720,321
MG,48836,NACIP RAYDAN,1313,445,986,2793,12,1807,37
MG,48852,NANUQUE,11851,8633,9880,31295,294,21415,637
MG,48879,NATÉRCIA,935,2361,710,4143,51,3433,86
MG,48895,NAZARENO,2591,2156,1219,6157,69,4938,122
MG,48917,NEPOMUCENO,7118,8097,4340,20273,266,15933,452
MG,48933,NOVA ERA,6960,4033,3376,14904,172,11528,363
MG,48950,NOVA LIMA,20925,27786,10286,61906,812,51620,2097
MG,48976,NOVA MÓDICA,1352,952,935,3326,15,2391,72
MG,48992,NOVA PONTE,4808,3114,2472,10713,114,8241,205
MG,49018,NOVA RESENDE,4474,5047,1953,11824,133,9871,217
MG,49034,NOVA SERRANA,9484,26724,8428,46351,834,37923,881
MG,49050,NOVO CRUZEIRO,9088,4166,9769,23808,177,14039,608
MG,49077,OLARIA,1060,521,433,2082,17,1649,51
MG,49093,OLÍMPIO NORONHA,838,936,445,2295,18,1850,58
MG,49115,OLIVEIRA,9110,15347,5929,31847,514,25918,947
MG,49131,OLIVEIRA FORTES,1206,412,363,2068,22,1705,65
MG,49158,ONÇA DE PITANGUI,884,1358,647,2962,29,2315,44
MG,49174,OURO BRANCO,11384,10704,5032,28269,313,23237,836
MG,49190,OURO FINO,5224,13618,4796,24513,288,19717,587
MG,49212,OURO PRETO,27226,17688,10697,58347,827,47650,1909
MG,49239,OURO VERDE DE MINAS,2527,1614,2135,6460,45,4325,139
MG,49255,PADRE PARAÍSO,6028,2661,5100,14286,119,9186,378
MG,49271,PAINEIRAS,1771,1396,969,4265,36,3296,93
MG,49298,PAINS,2226,3129,1116,6653,62,5537,120
MG,49310,PAIVA,698,499,337,1620,29,1283,57
MG,49336,PALMA,2740,1148,1063,5105,44,4042,110
MG,49352,FRONTEIRA DOS VALES,1883,799,1320,4134,28,2814,104
MG,49379,PAPAGAIOS,4721,4073,1935,11019,83,9084,207
MG,49395,PARACATU,22793,24487,12621,61848,714,49227,1233
MG,49417,PARÁ DE MINAS,20092,25695,8506,59037,1040,50531,3704
MG,49433,PARAGUAÇU,5536,7410,3043,16525,183,13482,353
MG,49450,PARAISÓPOLIS,3121,9147,3000,15856,157,12856,431
MG,49476,PARAOPEBA,7223,6842,3518,18348,272,14830,493
MG,49492,PASSABÉM,742,579,439,1835,13,1396,62
MG,49514,PASSA QUATRO,4475,5486,2242,12852,199,10610,450
MG,49530,PASSA TEMPO,2628,2506,1696,7213,115,5517,268
MG,49557,PASSA VINTE,645,963,400,2068,15,1668,45
MG,49573,PASSOS,32358,28756,14576,78253,895,63677,1668
MG,49590,PATOS DE MINAS,40254,39149,21671,105064,1381,83393,2609
MG,49611,PATROCÍNIO,24156,22481,12597,61934,980,49337,1720
MG,49638,PATROCÍNIO DO MURIAÉ,2529,1304,1065,5110,56,4045,156
MG,49654,PAULA CÂNDIDO,3979,1473,1699,7389,67,5690,171
MG,49670,PAULISTAS,2001,722,1345,4220,24,2875,128
MG,49697,PAVÃO,2315,1922,1716,6167,53,4451,161
MG,49719,PEÇANHA,5446,2608,4526,12964,91,8438,293
MG,49735,PEDRA AZUL,7450,4012,6876,18986,136,12110,512
MG,49751,PEDRA DO ANTA,2026,539,756,3452,34,2696,97
MG,49778,PEDRA DO INDAIÁ,1198,1598,666,3621,60,2955,99
MG,49794,PEDRA DOURADA,1149,568,380,2162,21,1782,44
MG,49816,PEDRALVA,2431,4866,1873,9472,98,7599,204
MG,49832,PEDRINÓPOLIS,1254,1115,652,3110,27,2458,62
MG,49859,PEDRO LEOPOLDO,14859,21189,7327,45438,667,38111,1396
MG,49875,PEDRO TEIXEIRA,1051,613,235,1938,12,1703,27
MG,49891,PEQUERI,1285,930,609,2929,27,2320,78
MG,49913,PEQUI,1545,1195,698,3544,24,2846,82
MG,49930,PERDIGÃO,1148,4525,1340,7250,90,5910,147
MG,49956,PERDIZES,2573,5332,2829,10971,84,8142,153
MG,49972,PERDÕES,6919,5817,2839,16380,253,13541,552
MG,49999,PESCADOR,1316,1091,862,3363,30,2501,64
MG,50016,PIAU,1494,739,615,2972,32,2357,92
MG,50032,PIEDADE DE PONTE NOVA,1896,941,802,3759,42,2957,78
MG,50059,PIEDADE DO RIO GRANDE,1565,1313,999,4033,46,3034,110
MG,50075,PIEDADE DOS GERAIS,1734,1450,982,4364,93,3382,105
MG,50091,PIMENTA,2479,2411,1453,6638,127,5185,168
MG,50113,PIRACEMA,2850,1662,970,5730,75,4760,173
MG,50130,PIRAJUBA,1633,1240,777,3754,35,2977,69
MG,50156,PIRANGA,5245,3067,4745,13576,160,8831,359
MG,50172,PIRANGUÇU,1282,2351,851,4598,24,3747,90
MG,50199,PIRANGUINHO,2239,3154,1129,6745,66,5616,157
MG,50210,PIRAPETINGA,5094,2162,1433,9096,130,7663,277
MG,50237,PIRAPORA,15833,12862,10227,40463,437,30236,1104
MG,50253,PIRAÚBA,4197,3079,1683,9304,114,7621,231
MG,50270,PITANGUI,5308,10273,3692,20015,222,16323,520
MG,50296,PIUMHI,8044,10591,5400,25021,322,19621,664
MG,50318,PLANURA,3581,2223,2025,8093,99,6068,165
MG,50334,POÇO FUNDO,5407,4824,1989,12605,147,10616,238
MG,50350,POÇOS DE CALDAS,38152,48215,22394,113376,1161,90982,3454
MG,50377,POCRANE,2964,2352,1882,7366,48,5484,120
MG,50393,POMPÉU,10740,6392,4508,22350,258,17842,452
MG,50415,PONTE NOVA,23442,10063,7632,42447,423,34815,887
MG,50431,PORTEIRINHA,17604,4571,7195,30315,260,23120,685
MG,50458,PORTO FIRME,4068,1833,2232,8411,71,6179,207
MG,50474,POTÉ,4628,3398,3749,12211,87,8462,349
MG,50490,POUSO ALEGRE,29353,47029,17231,97474,1068,80243,2793
MG,50512,POUSO ALTO,1253,2964,965,5365,50,4400,133
MG,50539,PRADOS,2672,2754,930,6678,113,5748,209
MG,50555,PRATA,10022,4994,4390,19917,162,15527,349
MG,50571,PRATÁPOLIS,2918,2773,1417,7450,113,6033,229
MG,50598,PRATINHA,967,1049,726,2833,43,2107,48
MG,50610,PRESIDENTE BERNARDES,2114,1353,1666,5293,54,3627,106
MG,50636,PRESIDENTE JUSCELINO,1896,715,1371,4088,15,2717,91
MG,50652,PRESIDENTE KUBITSCHEK,1308,560,613,2594,22,1981,91
MG,50679,PRESIDENTE OLEGÁRIO,7487,4109,4135,16294,166,12159,397
MG,50695,ALTO JEQUITIBÁ,2370,2814,1416,6845,59,5429,186
MG,50717,PRUDENTE DE MORAIS,2662,3516,1308,7924,128,6616,310
MG,50733,QUARTEL GERAL,1131,1127,844,3199,31,2355,66
MG,50750,QUELUZITO,1012,651,401,2162,27,1761,71
MG,50776,RAPOSOS,6218,3638,1506,12007,197,10501,448
MG,50792,RAUL SOARES,8081,4745,3917,17339,161,13422,435
MG,50814,RECREIO,3916,1798,1735,7701,80,5966,172
MG,50830,RESENDE COSTA,3275,3576,1639,8841,130,7202,221
MG,50857,RESPLENDOR,4284,5156,3239,13058,110,9819,269
MG,50873,RESSAQUINHA,2161,1135,454,3936,56,3482,130
MG,50890,RIACHO DOS MACHADOS,4090,899,2091,7334,64,5243,190
MG,50911,RIBEIRÃO DAS NEVES,77642,63600,35426,185431,3014,150005,5749
MG,50938,RIBEIRÃO VERMELHO,1144,1333,515,3190,47,2675,151
MG,50954,RIO ACIMA,3018,3066,990,7453,114,6463,265
MG,50970,RIO CASCA,5154,2788,3287,11613,141,8326,243
MG,50997,RIO DOCE,951,849,378,2241,16,1863,47
MG,51012,RIO DO PRADO,2134,700,1126,4112,35,2986,117
MG,51039,RIO ESPERA,1940,1572,1214,4900,75,3686,99
MG,51055,RIO MANSO,1943,1522,721,4318,34,3597,98
MG,51071,RIO NOVO,2863,2500,1340,7018,80,5678,235
MG,51098,RIO PARANAÍBA,3920,3013,2296,9607,132,7311,246
MG,51110,RIO PARDO DE MINAS,10671,3673,5372,20521,109,15149,696
MG,51136,RIO PIRACICABA,5756,3255,2848,12370,153,9522,358
MG,51152,RIO POMBA,5455,4474,3018,13732,239,10714,546
MG,51179,RIO PRETO,2428,1457,1076,5131,33,4055,137
MG,51195,RIO VERMELHO,3969,2202,4490,11030,85,6540,284
MG,51217,RITÁPOLIS,1656,1770,793,4407,45,3614,143
MG,51233,ROCHEDO DE MINAS,981,761,445,2261,17,1816,57
MG,51250,RODEIRO,2658,1915,857,5665,79,4808,156
MG,51276,ROMARIA,1611,858,797,3342,16,2545,60
MG,51292,RUBELITA,3613,1063,2794,7660,48,4866,142
MG,51314,RUBIM,2695,1795,1942,6656,51,4714,173
MG,51330,SABARÁ,31075,36522,15722,87755,1358,72033,3078
MG,51357,SABINÓPOLIS,5342,2498,4036,12347,120,8311,351
MG,51373,SACRAMENTO,6599,7634,4272,19169,129,14897,535
MG,51390,SALINAS,13344,8559,7793,30610,289,22817,625
MG,51411,SALTO DA DIVISA,2095,1233,1415,4899,16,3484,140
MG,51438,SANTA BÁRBARA,10664,6498,4135,22104,248,17969,559
MG,51454,SANTA BÁRBARA DO TUGÚRIO,2547,749,614,4114,40,3500,164
MG,51470,SANTA CRUZ DO ESCALVADO,2469,891,1107,4577,29,3470,81
MG,51497,SANTA EFIGÊNIA DE MINAS,1809,783,994,3727,53,2733,88
MG,51519,SANTA FÉ DE MINAS,1654,502,1273,3483,13,2210,41
MG,51535,SANTA JULIANA,3559,3107,1473,8418,102,6945,177
MG,51551,SANTA LUZIA,53475,62735,27664,150778,2294,123114,4610
MG,51578,SANTA MARGARIDA,6310,2992,2327,11979,125,9652,225
MG,51594,SANTA MARIA DE ITABIRA,4259,2197,1817,8601,99,6784,229
MG,51616,SANTA MARIA DO SALTO,1478,1065,1684,4376,34,2692,115
MG,51632,SANTA MARIA DO SUAÇUÍ,4906,2454,4783,12452,58,7669,251
MG,51659,SANTANA DA VARGEM,2497,2258,832,5748,61,4916,100
MG,51675,SANTANA DE CATAGUASES,1481,1270,441,3281,19,2840,70
MG,51691,SANTANA DE PIRAPAMA,3324,1838,2064,7452,63,5388,163
MG,51713,SANTANA DO DESERTO,1668,857,585,3186,29,2601,47
MG,51730,SANTANA DO GARAMBÉU,843,729,355,2020,42,1665,51
MG,51756,SANTANA DO JACARÉ,1634,1275,849,3888,58,3039,72
MG,51772,SANTANA DO MANHUAÇU,3344,1455,1918,6898,61,4980,120
MG,51799,SANTANA DO RIACHO,1509,1680,1395,4703,35,3308,84
MG,51810,SANTANA DOS MONTES,1353,1300,769,3554,48,2785,84
MG,51837,SANTA RITA DE CALDAS,2603,3255,1238,7320,50,6082,174
MG,51853,SANTA RITA DE JACUTINGA,1926,1469,1067,4617,39,3550,116
MG,51870,SANTA RITA DE IBITIPOCA,1642,598,813,3179,34,2366,92
MG,51896,SANTA RITA DO ITUETO,1881,1637,752,4407,42,3655,95
MG,51918,SANTA RITA DO SAPUCAÍ,3725,19349,4872,28688,246,23816,496
MG,51934,SANTA ROSA DA SERRA,1214,826,938,3054,33,2116,43
MG,51950,SANTA VITÓRIA,8537,3239,3107,15251,132,12144,236
MG,51977,SANTO ANTÔNIO DO AMPARO,6517,3658,2738,13416,177,10678,326
MG,51993,SANTO ANTÔNIO DO AVENTUREIRO,1340,1196,513,3209,44,2696,116
MG,52019,SANTO ANTÔNIO DO GRAMA,1779,1051,857,3793,34,2936,72
MG,52035,SANTO ANTÔNIO DO ITAMBÉ,1423,701,1470,3732,29,2262,109
MG,52051,SANTO ANTÔNIO DO JACINTO,2676,3033,2713,8743,67,6030,254
MG,52078,SANTO ANTÔNIO DO MONTE,3942,10793,3572,18995,248,15423,440
MG,52094,SANTO ANTÔNIO DO RIO ABAIXO,619,673,373,1724,19,1351,40
MG,52116,SANTO HIPÓLITO,1147,709,1211,3166,31,1955,68
MG,52132,SANTOS DUMONT,20351,8763,7616,38627,507,31011,1390
MG,52159,SÃO BENTO ABADE,1229,1853,775,3994,38,3219,99
MG,52175,SÃO BRÁS DO SUAÇUÍ,1191,1199,559,3091,50,2532,92
MG,52191,SÃO DOMINGOS DO PRATA,6602,3914,2474,13541,130,11067,421
MG,52213,SÃO FRANCISCO,21013,4825,12224,38846,212,26622,572
MG,52230,SÃO FRANCISCO DE PAULA,2781,1542,1134,5646,65,4512,124
MG,52256,SÃO FRANCISCO DE SALES,2495,966,814,4387,24,3573,88
MG,52272,SÃO FRANCISCO DO GLÓRIA,2505,885,789,4313,47,3524,87
MG,52299,SÃO GERALDO,3059,1935,1260,6516,88,5256,174
MG,52310,SÃO GERALDO DA PIEDADE,1777,743,1122,3766,37,2644,87
MG,52337,SÃO GONÇALO DO ABAETÉ,1858,1586,1124,4691,44,3567,79
MG,52353,SÃO GONÇALO DO PARÁ,2342,3703,1302,7736,137,6434,252
MG,52370,SÃO GONÇALO DO RIO ABAIXO,3180,4156,1149,8845,105,7696,255
MG,52396,SÃO GONÇALO DO SAPUCAÍ,6377,7461,3830,18230,187,14400,375
MG,52418,SÃO GOTARDO,7741,10015,5891,24576,349,18685,580
MG,52434,SÃO JOÃO BATISTA DO GLÓRIA,1903,2724,976,5816,70,4840,143
MG,52450,SÃO JOÃO DA MATA,882,1339,484,2789,30,2305,54
MG,52477,SÃO JOÃO DA PONTE,11713,2134,7783,22141,121,14358,390
MG,52493,SÃO JOÃO DEL REI,21435,30855,9721,65023,923,55302,2089
MG,52515,SÃO JOÃO DO ORIENTE,3522,1798,1402,6949,81,5547,146
MG,52531,SÃO JOÃO DO PARAÍSO,6123,4822,5260,17128,282,11868,641
MG,52558,SÃO JOÃO EVANGELISTA,5836,2499,3015,11695,89,8680,256
MG,52574,SÃO JOÃO NEPOMUCENO,8462,6692,4028,20074,217,16046,675
MG,52590,SÃO JOSÉ DA SAFIRA,1546,928,1165,3737,22,2572,76
MG,52612,SÃO JOSÉ DA VARGINHA,1140,1403,752,3450,51,2698,104
MG,52639,SÃO JOSÉ DO ALEGRE,855,1946,634,3548,32,2914,81
MG,52655,SÃO JOSÉ DO DIVINO,1233,1195,799,3297,12,2498,58
MG,52671,SÃO JOSÉ DO GOIABAL,2341,893,1320,4753,51,3433,148
MG,52698,SÃO JOSÉ DO JACURI,2054,1316,1348,4926,54,3578,154
MG,52710,SÃO JOSÉ DO MANTIMENTO,1009,859,452,2401,36,1949,45
MG,52736,SÃO LOURENÇO,7793,16599,6678,32309,318,25631,921
MG,52752,SÃO MIGUEL DO ANTA,3195,1382,1007,5802,71,4795,147
MG,52779,SÃO PEDRO DA UNIÃO,1626,1622,895,4288,42,3393,103
MG,52795,SÃO PEDRO DOS FERROS,3242,1461,1989,6945,82,4956,171
MG,52817,SÃO PEDRO DO SUAÇUÍ,1859,1225,1157,4400,27,3243,132
MG,52833,SÃO ROMÃO,2918,1090,2391,6567,31,4176,137
MG,52850,SÃO ROQUE DE MINAS,971,3013,1358,5462,32,4104,88
MG,52876,SÃO SEBASTIÃO DA BELA VISTA,2060,1638,755,4561,41,3806,67
MG,52892,SÃO SEBASTIÃO DO MARANHÃO,2570,2244,3380,8445,52,5065,199
MG,52914,SÃO SEBASTIÃO DO OESTE,2789,1772,1222,5985,62,4763,140
MG,52930,SÃO SEBASTIÃO DO PARAÍSO,17367,18693,11017,49035,591,38018,1367
MG,52957,SÃO SEBASTIÃO DO RIO PRETO,386,671,393,1497,12,1104,35
MG,52973,SÃO SEBASTIÃO DO RIO VERDE,505,1089,295,1945,13,1650,43
MG,52990,SÃO TIAGO,2341,4378,1482,8556,142,7074,213
MG,53015,SÃO TOMÁS DE AQUINO,1963,2282,1349,5777,43,4428,140
MG,53031,SÃO THOMÉ DAS LETRAS,2216,1619,1394,5433,62,4039,142
MG,53058,SÃO VICENTE DE MINAS,1279,2877,1227,5605,67,4378,155
MG,53074,SAPUCAÍ-MIRIM,1509,2312,1099,5101,59,4002,122
MG,53090,SARDOÁ,2053,1072,1241,4575,64,3334,145
MG,53112,SENADOR CORTES,993,734,659,2470,18,1811,66
MG,53139,SENADOR FIRMINO,3067,1886,902,6055,57,5153,143
MG,53155,SENADOR JOSÉ BENTO,841,1006,528,2434,17,1906,42
MG,53171,SENADOR MODESTINO GONÇALVES,1505,1203,1748,4580,36,2832,88
MG,53198,SENHORA DE OLIVEIRA,2317,1477,1393,5355,70,3962,98
MG,53210,SENHORA DO PORTO,1142,965,861,3079,35,2218,76
MG,53236,SENHORA DOS REMÉDIOS,3666,2354,1326,7594,55,6268,193
MG,53252,SERICITA,2760,1851,1415,6178,38,4763,114
MG,53279,SERITINGA,671,664,463,1870,20,1407,52
MG,53295,SERRA AZUL DE MINAS,1308,776,1371,3609,34,2238,120
MG,53317,SERRA DA SAUDADE,197,500,392,1104,2,712,13
MG,53333,SERRA DOS AIMORÉS,2591,1397,1686,5849,55,4163,120
MG,53350,SERRA DO SALITRE,3579,2453,2131,8388,79,6257,146
MG,53376,SERRANIA,2241,2580,1416,6412,65,4996,110
MG,53392,SERRANOS,707,709,472,1947,14,1475,45
MG,53414,SERRO,7051,3329,5483,16522,147,11039,512
MG,53430,SETE LAGOAS,58317,64222,26740,158229,2830,131489,6120
MG,53457,SILVEIRÂNIA,1249,629,528,2486,24,1958,56
MG,53473,SILVIANÓPOLIS,1317,2468,816,4741,43,3925,97
MG,53490,SIMÃO PEREIRA,1244,847,676,2851,24,2175,60
MG,53511,SIMONÉSIA,6479,4060,3762,14787,168,11025,318
MG,53538,SOBRÁLIA,1978,1228,1143,4527,57,3384,121
MG,53554,SOLEDADE DE MINAS,1433,2436,911,4933,41,4022,112
MG,53570,TABULEIRO,1840,1227,928,4163,51,3235,117
MG,53597,TAIOBEIRAS,6577,10903,6082,24330,158,18248,610
MG,53619,TAPIRA,1112,1856,678,3743,43,3065,54
MG,53635,TAPIRAÍ,858,537,773,2199,15,1426,16
MG,53651,TAQUARAÇU DE MINAS,1214,1846,996,4181,39,3185,86
MG,53678,TARUMIRIM,3864,3881,2279,10320,87,8041,209
MG,53694,TEIXEIRAS,4956,2499,2127,9978,126,7851,270
MG,53716,TEÓFILO OTONI,40927,30241,28172,102769,956,74597,2473
MG,53732,TIMÓTEO,24052,20828,12250,59895,758,47645,2007
MG,53759,TIRADENTES,1999,2729,888,5890,82,5002,192
MG,53775,TIROS,1394,2482,1590,5628,59,4038,103
MG,53791,TOCANTINS,5676,4456,2254,12997,224,10743,387
MG,53813,TOLEDO,1175,2970,1042,5344,57,4302,100
MG,53830,TOMBOS,3105,2202,1732,7285,57,5553,189
MG,53856,TRÊS CORAÇÕES,16700,25636,9873,54306,660,44433,1437
MG,53872,TRÊS PONTAS,16557,16987,7319,42137,501,34818,773
MG,53899,TUMIRITINGA,2100,1505,1396,5145,43,3749,101
MG,53910,TUPACIGUARA,9888,5008,4175,19630,160,15455,399
MG,53937,TURMALINA,7559,2823,3433,14162,119,10729,228
MG,53953,TURVOLÂNDIA,1593,1437,801,3968,41,3167,96
MG,53970,UBÁ,30738,22465,12679,68944,999,56265,2063
MG,53996,UBAÍ,4602,1675,2279,8745,34,6466,155
MG,54011,UBERABA,96296,71089,42353,219364,2422,177011,7204
MG,54038,UBERLÂNDIA,201230,155188,83491,463038,5844,379547,17285
MG,54054,UMBURATIBA,1029,661,637,2420,27,1783,66
MG,54070,UNAÍ,18266,25239,13136,58169,552,45033,976
MG,54097,URUCÂNIA,3957,2244,1882,8368,88,6486,197
MG,54119,VARGEM BONITA,675,880,576,2177,19,1601,27
MG,54135,VARGINHA,29837,46549,15446,95719,1267,80273,2620
MG,54151,VÁRZEA DA PALMA,12062,6666,7653,27207,333,19554,493
MG,54178,VARZELÂNDIA,7242,2514,5128,15284,86,10156,314
MG,54194,VAZANTE,8955,2989,3433,15822,141,12389,304
MG,54216,WENCESLAU BRAZ,852,1190,468,2591,18,2123,63
MG,54232,VERÍSSIMO,1094,926,579,2663,20,2084,44
MG,54259,VESPASIANO,25763,29884,14435,72988,1017,58553,1889
MG,54275,VIÇOSA,27840,13856,10742,54674,768,43932,1468
MG,54291,VIEIRAS,1856,995,699,3655,29,2956,76
MG,54313,MATHIAS LOBATO,1535,675,894,3174,19,2280,51
MG,54330,VIRGEM DA LAPA,3841,2401,3684,10243,68,6559,249
MG,54356,VIRGÍNIA,2302,3258,1301,7043,57,5742,125
MG,54372,VIRGINÓPOLIS,3207,2463,2181,8222,127,6041,244
MG,54399,VIRGOLÂNDIA,2141,762,1080,4143,41,3063,119
MG,54410,VISCONDE DO RIO BRANCO,13837,9645,4878,29464,431,24586,673
MG,54437,VOLTA GRANDE,1952,933,1244,4285,44,3041,112
MG,54453,ITAÚ DE MINAS,3791,5393,2539,12315,179,9776,413
MS,55000,NOVA ALVORADA DO SUL,5462,4386,3984,14037,99,10053,106
MS,55018,ALCINÓPOLIS,994,1353,953,3356,23,2403,33
MS,55026,LAGUNA CARAPÃ,1631,1934,1094,4728,18,3634,51
MS,55034,JAPORÃ,2345,1513,1405,5364,23,3959,78
MS,55042,NOVO HORIZONTE DO SUL,1547,1380,872,3893,41,3021,53
MS,55050,PARAÍSO DAS ÁGUAS,1072,1368,1112,3603,16,2491,35
MS,55069,FIGUEIRÃO,715,1066,642,2469,12,1827,34
MS,90034,ÁGUA CLARA,3638,3042,3494,10331,66,6837,91
MS,90115,AMAMBAI,8569,8561,6525,24092,146,17567,291
MS,90131,ANASTÁCIO,6706,5872,5224,18126,115,12902,209
MS,90158,ANAURILÂNDIA,2221,2358,1799,6495,31,4696,86
MS,90174,ANTÔNIO JOÃO,2106,2941,1628,6812,34,5184,103
MS,90190,APARECIDA DO TABOADO,4472,7790,4589,17370,177,12781,342
MS,90212,AQUIDAUANA,11426,11506,10353,33871,194,23518,392
MS,90298,BANDEIRANTES,2154,1971,922,5154,25,4232,82
MS,90379,BATAGUASSU,5474,5943,4604,16410,160,11806,229
MS,90395,BATAYPORÃ,3342,2909,2356,8843,86,6487,150
MS,90417,BELA VISTA,5123,6254,5067,16716,96,11649,176
MS,90433,BONITO,5214,6447,4494,16451,85,11957,211
MS,90450,BRASILÂNDIA,2723,3463,3181,9601,99,6420,135
MS,90492,CAMAPUÃ,4241,4098,2477,11002,57,8525,129
MS,90514,CAMPO GRANDE,175412,283120,107188,582367,5596,475179,11051
MS,90530,CARACOL,1482,1835,1175,4532,11,3357,29
MS,90557,CAARAPÓ,6698,7290,4155,18591,190,14436,258
MS,90573,CASSILÂNDIA,3436,8088,4556,16508,143,11952,285
MS,90611,CORGUINHO,1207,1298,1005,3561,15,2556,36
MS,90638,CORUMBÁ,27625,21397,19611,69936,501,50325,802
MS,90654,COXIM,9500,7549,7545,25065,171,17520,300
MS,90735,DOURADOS,42954,69691,30607,147502,1381,116895,2869
MS,90751,FÁTIMA DO SUL,6103,6503,2650,15553,97,12903,200
MS,90794,GLÓRIA DE DOURADOS,2610,3149,1581,7560,90,5979,130
MS,90816,GUIA LOPES DA LAGUNA,2757,2703,2028,7671,58,5643,125
MS,90859,IGUATEMI,2882,4553,3286,10887,46,7601,120
MS,90875,INOCÊNCIA,1624,2568,2065,6391,50,4326,84
MS,90891,ITAPORÃ,5168,5319,2800,13604,111,10804,206
MS,90930,IVINHEMA,6700,6924,3503,17643,235,14140,281
MS,90972,JARAGUARI,1702,1638,682,4104,23,3422,59
MS,90999,JARDIM,6157,6549,5054,18100,110,13046,230
MS,91014,JATEÍ,1521,1332,862,3763,24,2901,24
MS,91030,LADÁRIO,5082,3899,3881,13110,74,9229,174
MS,91073,MARACAJU,9309,10945,5789,26528,185,20739,300
MS,91111,MIRANDA,6926,5952,5602,18792,107,13190,205
MS,91138,NAVIRAÍ,11079,14264,9140,35442,413,26302,546
MS,91154,NIOAQUE,4031,3365,2930,10495,63,7565,106
MS,91235,NOVA ANDRADINA,11215,12097,8738,32740,304,24002,386
MS,91251,PARANAÍBA,9905,12448,7337,30419,275,23082,454
MS,91278,PEDRO GOMES,2088,2195,1830,6237,38,4407,86
MS,91316,PONTA PORÃ,15741,26807,14523,58228,559,43705,598
MS,91375,PORTO MURTINHO,2222,3217,3240,8774,27,5534,68
MS,91413,RIBAS DO RIO PARDO,5005,4935,3395,13624,105,10229,184
MS,91430,RIO BRILHANTE,8486,9295,4840,23189,216,18349,352
MS,91456,RIO NEGRO,1462,1521,996,4073,24,3077,70
MS,91472,RIO VERDE DE MATO GROSSO,5030,4894,4073,14218,79,10145,142
MS,91499,ROCHEDO,868,1969,876,3791,31,2915,47
MS,91570,SIDROLÂNDIA,11657,9964,5978,28264,305,22286,360
MS,91596,TERENOS,4696,4525,2863,12326,83,9463,159
MS,91650,TRÊS LAGOAS,23502,29232,17502,72668,970,55166,1462
MS,91693,ANGÉLICA,2862,2780,1736,7581,72,5845,131
MS,91715,ARAL MOREIRA,2694,2277,1612,6713,34,5101,96
MS,91731,ELDORADO,2225,4254,2541,9231,69,6690,142
MS,91758,DEODÁPOLIS,3562,3932,1924,9683,116,7759,149
MS,91782,CHAPADÃO DO SUL,3663,6616,3825,14423,115,10598,204
MS,91790,MUNDO NOVO,4236,6091,2934,13580,103,10646,216
MS,91804,DOIS IRMÃOS DO BURITI,3522,2028,2207,7898,33,5691,108
MS,91820,JUTI,2218,1348,1137,4813,29,3676,81
MS,91847,PARANHOS,2956,2397,2250,7836,40,5586,193
MS,91863,SANTA RITA DO PARDO,1405,1896,1489,4863,29,3374,44
MS,91880,SONORA,3651,3756,3186,10761,56,7575,112
MS,91901,VICENTINA,2157,2011,659,4920,44,4261,49
MS,98019,BODOQUENA,2394,2080,2155,6724,17,4569,78
MS,98035,COSTA RICA,4751,6972,4158,16194,135,12036,178
MS,98051,DOURADINA,1513,1719,641,3981,29,3340,79
MS,98078,ITAQUIRAÍ,4910,4411,4044,13617,101,9573,151
MS,98094,SÃO GABRIEL DO OESTE,4789,8121,4557,17764,106,13207,191
MS,98116,SELVÍRIA,2065,1862,1464,5542,55,4078,96
MS,98132,SETE QUEDAS,2363,3055,1853,7441,47,5588,123
MS,98159,TACURU,3124,1598,2010,6862,28,4852,102
MS,98175,TAQUARUSSU,1431,904,596,2980,18,2384,31
MS,98590,CORONEL SAPUCAIA,3457,3504,2879,10014,46,7135,128
MT,89788,COLNIZA,6121,5408,5794,17651,141,11857,187
MT,89796,COLÍDER,3567,12420,6556,22979,150,16423,286
MT,89800,CURVELÂNDIA,1186,1640,954,3846,25,2892,41
MT,89818,NOVA BRASILÂNDIA,1090,1381,963,3508,19,2545,55
MT,89826,NOVA SANTA HELENA,920,1114,895,2972,14,2077,29
MT,89834,PARANATINGA,2681,6341,4366,13603,75,9237,140
MT,89843,SANTO ANTÔNIO DO LESTE,490,876,993,2406,15,1413,32
MT,89850,SINOP,23067,37915,22687,85425,570,62738,1186
MT,89877,ALTA FLORESTA,11457,14935,10415,37553,185,27138,561
MT,89893,ARAPUTANGA,2929,5380,3278,11849,73,8571,189
MT,89915,JAURU,1982,3525,2440,8113,54,5673,112
MT,89931,SÃO JOSÉ DOS QUATRO MARCOS,4575,5317,4136,14404,129,10268,247
MT,89958,RIO BRANCO,1248,1611,1067,4014,17,2947,71
MT,89960,RONDOLÂNDIA,782,680,1138,2657,12,1519,45
MT,89974,SALTO DO CÉU,753,1349,647,2826,33,2179,44
MT,89990,PONTES E LACERDA,6320,14275,4760,26000,212,21240,433
MT,90018,ACORIZAL,2917,1219,970,5220,20,4250,94
MT,90026,SÃO JOSÉ DO POVO,1152,848,708,2788,20,2080,60
MT,90042,ALTO BOA VISTA,327,1758,1284,3408,15,2124,24
MT,90050,ALTO ARAGUAIA,3225,5180,3456,12177,89,8721,227
MT,90069,QUERÊNCIA,1756,4667,3287,9887,58,6600,119
MT,90077,ALTO GARÇAS,2177,2890,1705,6960,50,5255,138
MT,90085,CANABRAVA DO NORTE,656,1725,1301,3739,12,2438,45
MT,90093,ALTO PARAGUAI,2462,1752,1461,5815,42,4354,98
MT,90107,SANTA CARMEM,889,1339,849,3123,12,2274,34
MT,90123,NOVA MARINGÁ,1194,1312,1261,3835,16,2574,52
MT,90140,NOVA GUARITA,1232,1418,971,3680,20,2709,39
MT,90166,NOVA MARILÂNDIA,696,996,770,2507,19,1737,26
MT,90182,PORTO ESTRELA,1497,583,926,3092,24,2166,62
MT,90204,GLÓRIA D'OESTE,838,1024,576,2490,12,1914,40
MT,90220,TABAPORÃ,1461,2778,2386,6711,30,4325,56
MT,90239,ARAGUAINHA,360,242,269,898,10,629,17
MT,90247,SÃO JOSÉ DO XINGU,781,1531,1674,4050,12,2376,52
MT,90255,ARENÁPOLIS,2186,3033,2350,7766,56,5416,141
MT,90263,APIACÁS,1842,1732,1578,5262,36,3684,74
MT,90271,ARIPUANÃ,3144,4890,5018,13238,54,8220,132
MT,90280,CONFRESA,3830,7467,5157,16745,88,11588,203
MT,90301,LAMBARI D'OESTE,1246,1668,1542,4546,27,3004,63
MT,90310,BARÃO DE MELGAÇO,3030,925,1998,6063,12,4065,98
MT,90328,SANTO AFONSO,734,781,672,2232,17,1560,28
MT,90336,BARRA DO BUGRES,8875,6956,6602,22939,142,16337,364
MT,90344,PLANALTO DA SERRA,782,749,359,1931,8,1572,33
MT,90352,BARRA DO GARÇAS,14551,14503,11419,41522,346,30103,703
MT,90360,NOVA MONTE VERDE,1678,1946,1871,5592,26,3721,71
MT,90387,NOVA BANDEIRANTES,2030,3586,3011,8833,68,5822,138
MT,90409,SÃO PEDRO DA CIPA,1354,1039,814,3270,29,2456,34
MT,90425,COTRIGUAÇU,2604,3037,2778,8582,40,5804,123
MT,90441,RIBEIRÃOZINHO,682,637,627,1973,6,1346,21
MT,90468,BRASNORTE,2679,4003,3235,10097,52,6862,128
MT,90476,CÁCERES,23537,18822,18128,61493,332,43365,674
MT,90484,CAMPO NOVO DO PARECIS,4551,8454,5454,18826,131,13372,236
MT,90506,CAMPO VERDE,8016,10450,5863,24772,160,18909,283
MT,90522,CLÁUDIA,1714,3566,2298,7713,32,5415,103
MT,90549,CASTANHEIRA,1742,2301,1470,5628,33,4158,82
MT,90565,JANGADA,2724,1680,1266,5809,25,4543,114
MT,90581,JURUENA,1602,2454,1964,6132,34,4168,78
MT,90590,CHAPADA DOS GUIMARÃES,6136,3897,3264,13573,60,10309,216
MT,90603,LUCAS DO RIO VERDE,10844,15713,6245,33590,271,27345,517
MT,90620,MATUPÁ,3357,4117,2895,10551,63,7656,119
MT,90646,NOVA MUTUM,5553,11249,6614,23810,155,17196,239
MT,90662,RIBEIRÃO CASCALHEIRA,1173,3086,1909,6281,22,4372,91
MT,90670,CUIABÁ,150605,164820,83407,410557,3162,327150,8563
MT,90689,TAPURAH,1906,3013,1995,7016,41,5021,61
MT,90697,DIAMANTINO,4449,5956,4372,15005,80,10633,148
MT,90700,PONTAL DO ARAGUAIA,1655,1505,942,4193,31,3251,60
MT,90719,DOM AQUINO,2021,2370,1754,6281,34,4527,102
MT,90727,SAPEZAL,3241,4809,4293,12569,72,8276,154
MT,90743,CAMPOS DE JÚLIO,1053,1607,605,3352,36,2747,51
MT,90760,CARLINDA,2400,2744,1990,7268,29,5278,105
MT,90778,GENERAL CARNEIRO,1331,1105,912,3414,25,2502,41
MT,90786,FELIZ NATAL,1816,1939,2152,5983,27,3831,49
MT,90808,NOVO MUNDO,1553,1795,1497,4921,20,3424,56
MT,90824,GAÚCHA DO NORTE,401,2239,1411,4132,15,2721,66
MT,90832,GUIRATINGA,2503,3582,2341,8640,40,6299,174
MT,90840,UNIÃO DO SUL,664,980,911,2575,6,1664,14
MT,90867,NOVA LACERDA,1558,1321,1581,4531,17,2950,54
MT,90883,NOVA UBIRATÃ,1905,1960,2049,5998,28,3949,56
MT,90905,BOM JESUS DO ARAGUAIA,1275,1303,1405,4070,22,2665,65
MT,90913,ITIQUIRA,2629,2727,2415,7920,53,5505,96
MT,90921,SERRA NOVA DOURADA,261,523,285,1085,3,800,13
MT,90948,NOVO SANTO ANTÔNIO,370,562,604,1562,9,958,17
MT,90956,JACIARA,5594,8882,4957,19849,149,14892,267
MT,90964,NOVA NAZARÉ,458,733,878,2107,5,1229,33
MT,90980,SANTA CRUZ DO XINGU,310,656,549,1545,9,996,21
MT,91006,CONQUISTA D'OESTE,634,1067,841,2604,14,1763,48
MT,91022,VALE DE SÃO DOMINGOS,693,1314,523,2585,15,2062,40
MT,91049,SANTA RITA DO TRIVELATO,446,752,587,1803,4,1216,14
MT,91057,LUCIARA,431,853,350,1661,6,1311,21
MT,91081,IPIRANGA DO NORTE,893,1701,956,3611,26,2655,35
MT,91090,VILA BELA DA SANTÍSSIMA TRINDADE,2900,3602,2977,9609,36,6632,94
MT,91103,ITANHANGÁ,978,1785,1388,4197,19,2809,27
MT,91170,NOBRES,3887,4063,1833,10012,64,8179,165
MT,91197,NORTELÂNDIA,1803,1794,1324,5034,25,3710,88
MT,91219,NOSSA SENHORA DO LIVRAMENTO,5788,2238,2229,10483,29,8254,199
MT,91294,POCONÉ,11660,4963,3405,20490,111,17085,351
MT,91332,PONTE BRANCA,586,571,480,1671,9,1191,25
MT,91359,PORTO DOS GAÚCHOS,1024,1752,1254,4101,28,2847,43
MT,91391,POXORÉU,4749,3685,4390,13106,73,8716,209
MT,91510,RONDONÓPOLIS,51420,56103,21374,133444,1287,112070,3260
MT,91537,ROSÁRIO OESTE,5246,3194,2417,11143,78,8726,208
MT,91553,SANTO ANTÔNIO DO LEVERGER,7101,3442,2564,13351,72,10787,172
MT,91618,TESOURO,789,650,833,2333,23,1500,38
MT,91634,TORIXORÉU,1304,1115,848,3331,16,2483,48
MT,91677,VÁRZEA GRANDE,79834,56580,39121,180173,1379,141052,3259
MT,91774,MIRASSOL D'OESTE,6312,7380,5257,19436,189,14179,298
MT,91812,PEDRA PRETA,4705,4045,3189,12260,110,9071,211
MT,91839,SÃO FÉLIX DO ARAGUAIA,1398,2339,2582,6421,25,3839,77
MT,91855,TANGARÁ DA SERRA,12231,31875,17042,62311,367,45269,796
MT,91898,JUSCIMEIRA,3105,3178,2400,8895,76,6495,136
MT,91910,ÁGUA BOA,2645,7656,4614,15146,84,10532,147
MT,91936,CANARANA,2337,6622,4633,13848,74,9215,182
MT,91952,NOVA XAVANTINA,3735,5919,4605,14555,79,9950,217
MT,91979,SANTA TEREZINHA,1566,1483,1674,4821,23,3147,75
MT,91995,SÃO JOSÉ DO RIO CLARO,2797,4636,3333,10959,69,7626,124
MT,98191,JUARA,4464,11306,7450,23642,138,16192,284
MT,98310,JUÍNA,8748,12126,8386,29804,195,21418,349
MT,98337,DENISE,2080,1991,1667,5858,39,4191,81
MT,98612,ALTO TAQUARI,1353,2788,1952,6212,38,4260,81
MT,98639,ARAGUAIANA,895,712,361,2009,15,1648,26
MT,98655,CAMPINÁPOLIS,2689,3228,2654,8725,27,6071,127
MT,98671,COCALINHO,1438,1174,973,3658,17,2685,56
MT,98698,ITAÚBA,897,1601,1364,3929,17,2565,50
MT,98710,MARCELÂNDIA,2234,3505,3148,9034,31,5886,116
MT,98736,NOVA OLÍMPIA,4433,3780,3428,11917,103,8489,173
MT,98752,NOVA CANAÃ DO NORTE,1913,4736,2815,9626,55,6811,107
MT,98779,NOVO SÃO JOAQUIM,1079,2074,1784,5014,24,3230,53
MT,98795,NOVO HORIZONTE DO NORTE,720,1450,838,3043,17,2205,18
MT,98817,PEIXOTO DE AZEVEDO,7225,5873,5105,18604,133,13499,268
MT,98833,PARANAÍTA,2364,3245,2165,7896,45,5731,77
MT,98850,PORTO ALEGRE DO NORTE,1522,2837,2371,6829,29,4458,70
MT,98876,PORTO ESPERIDIÃO,2792,2574,2389,7920,49,5531,116
MT,98892,PRIMAVERA DO LESTE,9852,19126,10642,40432,270,29790,542
MT,98914,RESERVA DO CABAÇAL,658,729,585,2011,14,1426,25
MT,98930,SORRISO,14443,21683,11672,48606,265,36934,543
MT,98957,TERRA NOVA DO NORTE,3331,2714,2620,8798,45,6178,88
MT,98973,VERA,2055,2372,1862,6400,26,4538,85
MT,98990,VILA RICA,2636,5793,4795,13461,67,8666,170
MT,99015,COMODORO,3064,5851,4345,13528,66,9183,202
MT,99031,FIGUEIRÓPOLIS D'OESTE,554,1676,902,3193,27,2291,34
MT,99058,GUARANTÃ DO NORTE,5301,8386,6476,20588,128,14112,297
MT,99074,INDIAVAÍ,733,622,278,1676,13,1398,30
PA,4006,GOIANÉSIA DO PARÁ,8767,4922,8358,22935,138,14577,750
PA,4014,ABAETETUBA,54729,21346,20157,99238,473,79081,2533
PA,4022,TAILÂNDIA,16853,11915,13066,43389,288,30323,1267
PA,4030,ACARÁ,19210,8240,9807,38634,168,28827,1209
PA,4049,BOM JESUS DO TOCANTINS,3524,2600,3377,9916,67,6539,348
PA,4057,AFUÁ,9815,6206,6421,23114,38,16693,634
PA,4065,SÃO JOÃO DE PIRABAS,7790,3160,5194,16628,84,11434,400
PA,4073,ALENQUER,12894,11934,9574,35525,160,25951,963
PA,4081,TUCUMÃ,8303,7970,7407,24597,168,17190,749
PA,4090,ALMEIRIM,9998,3673,6075,20414,96,14339,572
PA,4103,MÃE DO RIO,8958,7454,6465,23585,134,17120,574
PA,4111,ALTAMIRA,23178,22265,18774,67494,712,48720,2565
PA,4120,ELDORADO DOS CARAJÁS,7340,4757,5363,18272,128,12909,684
PA,4138,ANAJÁS,5187,5489,5365,16713,35,11348,637
PA,4146,SANTA LUZIA DO PARÁ,6533,4091,4229,15411,86,11182,472
PA,4154,ANANINDEUA,117008,102343,30733,264568,3831,233835,10653
PA,4162,PALESTINA DO PARÁ,2286,1665,1808,5949,37,4141,153
PA,4170,AUGUSTO CORRÊA,14054,7447,10634,33344,166,22710,1043
PA,4189,IPIXUNA DO PARÁ,7638,4394,5351,18105,72,12754,650
PA,4197,AVEIRO,4174,1531,4013,10023,33,6010,272
PA,4200,JACAREACANGA,1909,3121,3219,8650,42,5431,359
PA,4219,BAGRE,5767,1126,4337,11561,33,7224,298
PA,4227,BRASIL NOVO,4123,4900,2916,12420,99,9504,382
PA,4235,BAIÃO,9711,5766,5732,21980,101,16248,670
PA,4243,SANTA BÁRBARA DO PARÁ,6792,3788,2783,14002,114,11219,525
PA,4251,BARCARENA,40527,14516,11513,69338,653,57825,2129
PA,4260,ÁGUA AZUL DO NORTE,3003,2972,3082,9466,73,6384,336
PA,4278,BELÉM,361601,402307,206376,1022967,13382,816591,39301
PA,4286,TRAIRÃO,3058,2874,3291,9503,41,6212,239
PA,4294,BENEVIDES,16262,10955,7498,36241,319,28743,1207
PA,4308,PAU D'ARCO,2370,1518,2169,6251,17,4082,177
PA,4316,BONITO,5366,2424,2485,10712,60,8227,377
PA,4324,ULIANÓPOLIS,6336,3871,4999,15691,80,10692,405
PA,4332,BRAGANÇA,32363,21757,20917,77784,488,56867,2259
PA,4340,AURORA DO PARÁ,8192,3368,4303,16492,81,12189,548
PA,4359,BREVES,22412,12042,19803,56444,238,36641,1949
PA,4367,TERRA SANTA,4785,2958,3721,11737,50,8016,223
PA,4375,BUJARU,9141,4404,4146,18366,83,14220,592
PA,4383,NOVO PROGRESSO,4457,6732,6133,17910,126,11777,462
PA,4391,CACHOEIRA DO ARARI,8678,1905,5690,16829,56,11139,500
PA,4405,VITÓRIA DO XINGU,3179,3313,3236,10090,58,6854,304
PA,4413,CAMETÁ,42054,19712,17537,81663,284,64126,2076
PA,4421,NOVO REPARTIMENTO,15306,10028,13535,40480,190,26945,1421
PA,4430,CAPANEMA,21286,13878,9178,46382,517,37204,1523
PA,4448,BREU BRANCO,12361,5798,10677,29931,161,19254,934
PA,4456,CAPITÃO POÇO,15192,11275,5209,33120,230,27911,1214
PA,4464,SÃO DOMINGOS DO ARAGUAIA,6253,3579,5308,15805,122,10497,543
PA,4472,CASTANHAL,47657,47460,12795,112881,1162,100086,3807
PA,4480,NOVA ESPERANÇA DO PIRIÁ,5834,3278,3531,13100,43,9569,414
PA,4499,CHAVES,4630,2138,4964,12181,33,7217,416
PA,4502,ABEL FIGUEIREDO,2474,1160,1752,5593,27,3841,180
PA,4510,COLARES,4754,1603,2770,9467,50,6697,290
PA,4529,CUMARU DO NORTE,1968,1717,2988,6887,27,3899,187
PA,4537,CONCEIÇÃO DO ARAGUAIA,9721,10850,10456,32371,200,21915,1144
PA,4545,TERRA ALTA,4649,2175,1357,8462,42,7105,239
PA,4553,CURRALINHO,9482,2419,5186,17725,45,12539,593
PA,4561,FLORESTA DO ARAGUAIA,4640,3253,4129,12505,64,8376,419
PA,4570,CURUÇÁ,15750,4597,4908,26437,153,21529,1029
PA,4588,BANNACH,856,1021,1205,3159,13,1954,64
PA,4596,FARO,2947,723,2365,6145,17,3780,93
PA,4600,NOVA IPIXUNA,3388,3527,3559,10885,50,7326,361
PA,4618,GURUPÁ,7171,4228,4225,16067,26,11842,417
PA,4626,PLACAS,3676,3246,4053,11351,70,7298,306
PA,4634,IGARAPÉ-AÇU,13583,6950,6069,27632,231,21563,799
PA,4642,MARITUBA,31193,18466,13195,65844,780,52649,2210
PA,4650,IGARAPÉ-MIRI,22542,9032,11813,44866,210,33053,1269
PA,4669,TRACUATEUA,11544,4149,5330,21780,74,16450,683
PA,4677,INHANGAPI,3285,3053,1677,8344,46,6667,283
PA,4685,QUATIPURU,3763,2267,3407,9661,42,6254,182
PA,4693,IRITUIA,12198,5008,5655,23649,114,17994,674
PA,4707,CANAÃ DOS CARAJÁS,10118,8282,7333,26940,352,19607,855
PA,4715,ITAITUBA,24874,17512,26648,71213,388,44565,1791
PA,4723,ANAPU,4774,4805,3721,13915,104,10194,511
PA,4731,ITUPIRANGA,13648,5444,11634,31994,155,20360,1113
PA,4740,CURUÁ,4747,1875,2596,9476,29,6880,229
PA,4758,JACUNDÁ,11884,9425,11602,34147,216,22545,1020
PA,4766,CACHOEIRA DO PIRIÁ,5935,2027,4236,12808,49,8572,561
PA,4774,JURUTI,12063,7583,8588,29173,120,20585,819
PA,4782,PIÇARRA,3446,1871,3086,8794,37,5708,354
PA,4790,LIMOEIRO DO AJURU,9723,3957,3514,17656,59,14142,403
PA,4804,BELTERRA,4676,4777,3723,13718,78,9995,464
PA,4812,MAGALHÃES BARATA,3689,1602,1973,7486,21,5513,201
PA,4820,SÃO JOÃO DA PONTA,2612,1314,1319,5416,18,4097,153
PA,4839,MARABÁ,64163,40884,38561,151468,1486,112907,6374
PA,4847,SAPUCAIA,1294,1186,1349,4005,23,2656,153
PA,4855,MARACANÃ,9959,6568,5283,22497,101,17214,586
PA,4863,MOJUÍ DOS CAMPOS,4361,6874,5234,16970,55,11736,446
PA,4871,MARAPANIM,10498,4884,6550,22567,99,16017,536
PA,4898,MELGAÇO,4107,3235,6266,14059,30,7793,421
PA,4910,MOCAJUBA,11683,4081,5205,21672,86,16467,617
PA,4936,MOJU,22452,9582,12403,45797,196,33394,1164
PA,4952,MONTE ALEGRE,14555,15503,12009,43243,181,31234,995
PA,4979,MUANÁ,12862,3157,5468,22298,66,16830,745
PA,4995,NOVA TIMBOTEUA,5025,2602,2842,10910,107,8068,334
PA,5010,ÓBIDOS,14976,6867,10477,33419,174,22942,925
PA,5037,OEIRAS DO PARÁ,10664,3028,4533,18921,52,14388,644
PA,5053,ORIXIMINÁ,13839,11639,15368,42101,192,26733,1063
PA,5070,OURÉM,6256,3513,3673,13909,73,10236,394
PA,5096,PARAGOMINAS,24496,22600,13550,63398,430,49848,2322
PA,5118,PEIXE-BOI,3612,1697,1228,6795,33,5567,225
PA,5134,PONTA DE PEDRAS,9094,3906,4522,18127,75,13605,530
PA,5150,PORTEL,11022,6582,12218,30875,91,18657,962
PA,5177,PORTO DE MOZ,7989,2890,6296,17728,41,11432,512
PA,5193,PRAINHA,9371,5313,5710,21015,76,15305,545
PA,5215,PRIMAVERA,4033,2463,2683,9547,51,6864,317
PA,5231,SALINÓPOLIS,12695,7583,7374,28422,135,21048,635
PA,5258,SALVATERRA,8310,3243,4782,16949,104,12167,510
PA,5274,SANTA CRUZ DO ARARI,2573,959,2930,6636,20,3706,154
PA,5290,SANTA ISABEL DO PARÁ,18742,12043,7974,40547,439,32573,1349
PA,5312,SANTA MARIA DO PARÁ,8025,5901,4496,19261,190,14765,649
PA,5339,SANTANA DO ARAGUAIA,5889,6338,7553,20598,121,13045,697
PA,5355,SANTARÉM,59744,83913,51136,202016,1405,150880,5818
PA,5371,SANTARÉM NOVO,3378,942,1442,5912,20,4470,130
PA,5398,SANTO ANTÔNIO DO TAUÁ,11220,5048,4601,21634,157,17033,608
PA,5410,SÃO CAETANO DE ODIVELAS,6595,3253,3845,14067,93,10222,281
PA,5436,SÃO DOMINGOS DO CAPIM,9217,6247,5613,21871,112,16258,682
PA,5452,SÃO FÉLIX DO XINGU,9967,11361,11174,33886,225,22712,1159
PA,5479,SÃO FRANCISCO DO PARÁ,5860,3948,2445,12720,106,10275,361
PA,5495,SÃO JOÃO DO ARAGUAIA,4463,1772,3389,10071,63,6682,384
PA,5517,SÃO MIGUEL DO GUAMÁ,14916,10047,8675,34724,221,26049,865
PA,5533,SÃO SEBASTIÃO DA BOA VISTA,9299,3341,4942,18126,65,13184,479
PA,5550,SENADOR JOSÉ PORFÍRIO,3417,1741,3311,8768,25,5457,274
PA,5576,SOURE,9515,3055,6083,19324,102,13241,569
PA,5592,TOMÉ-AÇU,17094,10932,12038,41721,291,29683,1366
PA,5614,TUCURUÍ,28752,17129,24028,72568,554,48540,2105
PA,5630,VIGIA,17022,6864,9176,34195,288,25019,845
PA,5657,VISEU,21047,3720,12016,38412,126,26396,1503
PA,5673,REDENÇÃO,16842,19160,17269,55296,339,38027,1686
PA,5690,RIO MARIA,4391,4614,3603,13167,109,9564,450
PA,5711,XINGUARA,8820,11034,9151,30268,241,21117,1022
PA,5738,RONDON DO PARÁ,11478,6871,10622,30292,225,19670,1096
PA,5754,URUARÁ,7483,9122,9496,27198,181,17702,916
PA,5770,MEDICILÂNDIA,4055,7539,4622,16857,148,12235,493
PA,5797,SÃO GERALDO DO ARAGUAIA,6802,5179,7056,19884,134,12828,713
PA,5819,CONCÓRDIA DO PARÁ,8361,5948,4411,19343,69,14932,554
PA,5835,PARAUAPEBAS,54176,40897,33644,135348,1962,101704,4669
PA,5851,CURIONÓPOLIS,5673,4831,4614,15740,114,11126,508
PA,5878,GARRAFÃO DO NORTE,8983,4237,5495,19430,81,13935,634
PA,5894,RURÓPOLIS,6443,4035,5481,16636,110,11155,567
PA,5916,PACAJÁ,9190,5791,8206,24263,161,16057,915
PA,5932,BREJO GRANDE DO ARAGUAIA,2758,1182,1987,6114,29,4127,158
PA,5959,OURILÂNDIA DO NORTE,7315,5910,7912,21773,121,13861,515
PA,5975,DOM ELISEU,12753,5812,9259,28890,195,19631,871
PA,5991,SANTA MARIA DAS BARREIRAS,3960,3387,5606,13498,53,7892,492
PB,19003,RIACHÃO DO POÇO,2007,966,863,4004,32,3141,136
PB,19011,ÁGUA BRANCA,3982,808,1986,7203,71,5217,356
PB,19020,SOBRADO,3397,1421,1592,6756,95,5164,251
PB,19038,AGUIAR,2547,758,557,4075,41,3518,172
PB,19046,SÃO JOSÉ DOS RAMOS,2727,846,1001,4807,57,3806,176
PB,19054,ALAGOA GRANDE,9980,5020,7059,23487,374,16428,1054
PB,19062,CAPIM,1979,1492,483,4257,79,3774,224
PB,19070,ALAGOA NOVA,5986,4625,3950,15545,240,11595,744
PB,19089,CUITÉ DE MAMANGUAPE,3151,1139,629,5325,113,4696,293
PB,19097,ALAGOINHA,5712,1912,2851,11070,171,8219,424
PB,19100,CURRAL DE CIMA,2124,1198,1357,5006,77,3649,250
PB,19119,ALHANDRA,7961,4724,2638,16405,353,13767,729
PB,19127,RIACHÃO DO BACAMARTE,2086,833,841,4066,83,3225,223
PB,19135,SÃO JOÃO DO RIO DO PEIXE,8350,2145,3323,14500,167,11177,515
PB,19143,MATINHAS,1715,1103,820,3893,60,3073,195
PB,19151,ARAÇAGI,7029,2345,4783,14850,182,10067,511
PB,19160,LOGRADOURO,1732,669,263,2878,45,2615,169
PB,19178,ARARA,4030,2002,2817,9411,121,6594,441
PB,19186,SERTÃOZINHO,1723,1206,808,3928,50,3120,141
PB,19194,ARARUNA,5028,4074,4153,13937,184,9784,498
PB,19208,RIACHÃO,1500,1083,613,3348,29,2735,123
PB,19216,AREIA,10027,3267,4604,19206,355,14602,953
PB,19224,SÃO DOMINGOS DO CARIRI,1143,881,348,2467,16,2119,79
PB,19232,AREIAL,2565,1545,1195,5635,103,4440,227
PB,19240,CARAÚBAS,2260,513,620,3595,28,2975,174
PB,19259,AROEIRAS,8681,2438,4020,16032,222,12012,671
PB,19267,SANTO ANDRÉ,1534,351,585,2599,29,2014,100
PB,19275,DAMIÃO,2573,463,1000,4259,40,3259,183
PB,19283,SOSSÊGO,1712,556,582,3016,25,2434,141
PB,19291,BAÍA DA TRAIÇÃO,3096,1275,1272,5977,67,4705,267
PB,19305,BARAÚNA,2187,702,840,3954,54,3114,171
PB,19313,BANANEIRAS,8455,3514,4831,17841,250,13010,791
PB,19321,ASSUNÇÃO,1842,610,791,3448,50,2657,155
PB,19330,BARRA DE SANTA ROSA,6051,1788,2737,11119,116,8382,427
PB,19348,ZABELÊ,1121,488,331,2022,18,1691,64
PB,19356,BARRA DE SÃO MIGUEL,2625,937,701,4582,65,3881,254
PB,19364,CACIMBAS,2862,563,1564,5365,65,3801,311
PB,19372,BAYEUX,35746,17795,12013,70574,1357,58561,3663
PB,19380,CAJAZEIRINHAS,1949,593,783,3476,17,2693,134
PB,19399,BELÉM,6217,3337,3394,13613,175,10219,490
PB,19402,SÃO BENTINHO,1586,945,812,3515,39,2703,133
PB,19410,BELÉM DO BREJO DO CRUZ,2967,1287,1183,5685,48,4502,200
PB,19429,SÃO DOMINGOS DE POMBAL,1390,746,577,2868,25,2291,130
PB,19437,BOA VENTURA,2775,895,1402,5308,47,3906,189
PB,19445,SÃO JOSÉ DE PRINCESA,2014,326,964,3537,27,2573,206
PB,19453,BOM JESUS,1706,379,512,2732,30,2220,105
PB,19461,MARIZÓPOLIS,3120,847,872,5104,62,4232,203
PB,19470,BOM SUCESSO,2546,633,951,4296,44,3345,122
PB,19488,MATO GROSSO,1391,422,643,2561,17,1918,88
PB,19496,BONITO DE SANTA FÉ,3877,1567,2239,8055,64,5816,308
PB,19500,BERNARDINO BATISTA,1556,256,663,2627,22,1964,130
PB,19518,BOQUEIRÃO,7301,3299,1870,13167,166,11297,531
PB,19526,POÇO DE JOSÉ DE MOURA,2259,598,852,3925,37,3073,179
PB,19534,IGARACY,2754,928,658,4608,56,3950,212
PB,19542,SÃO JOSÉ DO BREJO DO CRUZ,1004,332,317,1743,26,1426,64
PB,19550,BORBOREMA,1989,993,1335,4573,48,3238,208
PB,19569,SANTA INÊS,2299,278,1085,3862,29,2777,171
PB,19577,BREJO DO CRUZ,4877,2254,2004,9621,100,7617,386
PB,19585,AMPARO,1470,258,384,2212,20,1828,80
PB,19593,BREJO DOS SANTOS,3139,1045,1000,5426,71,4426,171
PB,19607,CASSERENGUE,3009,833,1790,5915,53,4125,230
PB,19615,CAAPORÃ,8674,3175,3287,16379,476,13092,767
PB,19623,GADO BRAVO,4244,952,1364,7004,105,5640,339
PB,19631,CABACEIRAS,2219,1200,639,4367,95,3728,214
PB,19640,POÇO DANTAS,2058,373,834,3435,30,2601,140
PB,19658,CABEDELO,17146,13640,7104,40740,726,33636,2124
PB,19666,JOCA CLAUDINO,1427,373,607,2519,22,1912,90
PB,19674,CACHOEIRA DOS ÍNDIOS,4359,827,1616,7160,79,5544,279
PB,19682,TENÓRIO,1526,371,492,2536,29,2044,118
PB,19690,CACIMBA DE AREIA,2075,418,594,3230,36,2636,107
PB,19704,COXIXOLA,1026,303,295,1705,24,1410,57
PB,19712,CACIMBA DE DENTRO,6649,2755,3386,13535,120,10149,625
PB,19720,PARARI,1256,347,311,2011,14,1700,83
PB,19739,CAIÇARA,2901,1742,635,5641,67,5006,296
PB,19747,PEDRO RÉGIS,1646,1329,1297,4520,54,3223,194
PB,19755,CAJAZEIRAS,25483,6330,10346,44466,627,34120,1680
PB,19763,ALCANTIL,2082,1464,700,4476,63,3776,167
PB,19771,CALDAS BRANDÃO,2688,1013,1056,5032,69,3976,206
PB,19780,BARRA DE SANTANA,3692,1764,1549,7479,122,5930,352
PB,19798,CAMALAÚ,3518,345,915,5043,58,4128,207
PB,19801,CATURITÉ,2704,866,645,4472,61,3827,196
PB,19810,CAMPINA GRANDE,94487,130622,18135,263606,4748,245471,15614
PB,19828,RIACHO DE SANTO ANTÔNIO,1118,490,173,1873,25,1700,67
PB,19836,CARRAPATEIRA,1374,148,646,2280,21,1634,91
PB,19844,APARECIDA,3941,1227,1131,6621,75,5490,247
PB,19852,CATINGUEIRA,1828,1164,518,3712,40,3194,162
PB,19860,SÃO FRANCISCO,2129,738,398,3428,35,3030,128
PB,19879,CATOLÉ DO ROCHA,10871,5356,4251,21342,262,17091,602
PB,19887,VIEIRÓPOLIS,3068,644,1115,5088,40,3973,221
PB,19895,CONCEIÇÃO,7855,2184,3555,14281,143,10726,544
PB,19909,AREIA DE BARAÚNAS,1027,377,426,1907,17,1481,60
PB,19917,CONDADO,3132,1078,1253,5729,55,4476,211
PB,19925,ALGODÃO DE JANDAÍRA,1866,225,491,2730,22,2239,126
PB,19933,CONDE,8854,4409,2377,16822,329,14445,853
PB,19941,BOA VISTA,2761,1767,347,5191,96,4844,220
PB,19950,CONGO,2887,657,851,4641,44,3790,202
PB,19968,MARCAÇÃO,3126,996,1456,5941,100,4485,263
PB,19976,COREMAS,6538,1895,3154,12124,122,8970,415
PB,19984,MATURÉIA,2613,1076,1292,5251,62,3959,208
PB,19992,CRUZ DO ESPÍRITO SANTO,7048,3580,2455,14173,367,11718,723
PB,20001,SANTA CECÍLIA,2805,1596,1486,6200,62,4714,251
PB,20010,CUBATI,3254,1454,952,6041,95,5089,286
PB,20036,CUITÉ,8147,3489,4048,16520,167,12472,669
PB,20052,CUITEGI,2247,1616,1490,5705,118,4215,234
PB,20079,CURRAL VELHO,916,553,507,2086,23,1579,87
PB,20095,DESTERRO,3868,932,1837,6922,61,5085,224
PB,20117,VISTA SERRANA,1505,331,883,2898,38,2015,141
PB,20133,DIAMANTE,2931,960,1517,5660,51,4143,201
PB,20150,DONA INÊS,4521,1493,2724,9205,72,6481,395
PB,20176,DUAS ESTRADAS,1561,1067,733,3559,62,2826,136
PB,20192,EMAS,1505,644,423,2693,33,2270,88
PB,20214,ESPERANÇA,11415,6311,5711,24901,363,19190,1101
PB,20230,FAGUNDES,5584,1414,2121,9708,96,7587,493
PB,20257,FREI MARTINHO,1576,523,503,2766,27,2263,137
PB,20273,GUARABIRA,16780,12808,8104,39972,749,31868,1531
PB,20290,GURINHÉM,5501,2870,2548,11443,139,8895,385
PB,20311,GURJÃO,1667,655,555,2995,17,2440,101
PB,20338,IBIARA,2930,752,1250,5214,73,3964,209
PB,20354,IMACULADA,4493,1277,2481,8656,80,6175,325
PB,20370,INGÁ,6760,3331,3052,13957,215,10905,599
PB,20397,ITABAIANA,10431,3910,4194,19727,287,15533,905
PB,20419,ITAPORANGA,8737,3390,4175,17075,184,12900,589
PB,20435,ITAPOROROCA,4950,3920,1318,10941,217,9623,536
PB,20451,ITATUBA,4608,1609,1345,8039,95,6694,382
PB,20478,JACARAÚ,5571,3114,3397,12763,160,9366,521
PB,20494,JERICÓ,3542,1144,1497,6419,63,4922,173
PB,20516,JOÃO PESSOA,217368,174037,38367,464718,8748,426351,26198
PB,20532,JUAREZ TÁVORA,3693,1086,1638,6767,106,5129,244
PB,20559,JUAZEIRINHO,5943,3231,2648,12563,189,9915,552
PB,20575,JUNCO DO SERIDÓ,2578,1377,1060,5273,70,4213,188
PB,20591,JURIPIRANGA,4901,1846,1734,9054,124,7320,449
PB,20613,JURU,4453,735,2069,7645,62,5576,326
PB,20630,LAGOA,2364,645,1154,4391,69,3237,159
PB,20656,LAGOA DE DENTRO,3108,1342,1312,6081,69,4769,250
PB,20672,LAGOA SECA,7894,7291,1373,18090,521,16717,1011
PB,20699,LASTRO,2244,353,475,3228,29,2753,127
PB,20710,LIVRAMENTO,3180,763,1349,5577,75,4228,210
PB,20737,LUCENA,4644,2163,2606,10095,206,7489,476
PB,20753,MÃE D'ÁGUA,2183,635,780,3789,33,3009,158
PB,20770,MALTA,2755,703,1136,4821,63,3685,164
PB,20796,MAMANGUAPE,15094,7829,3440,28709,638,25269,1708
PB,20818,MANAÍRA,4741,807,2768,8725,52,5957,357
PB,20834,MARI,7959,3606,4164,16645,242,12481,674
PB,20850,MASSARANDUBA,5094,2624,921,9490,240,8569,611
PB,20877,MATARACA,3243,1586,822,6106,131,5284,324
PB,20893,MOGEIRO,5420,2218,3132,11322,139,8190,413
PB,20915,MONTADAS,2035,1125,586,4000,52,3414,202
PB,20931,MONTE HOREBE,2343,481,934,3939,21,3005,160
PB,20958,MONTEIRO,13782,4123,5052,24194,327,19142,910
PB,20974,MULUNGU,4511,2090,1590,8550,98,6960,261
PB,20990,NATUBA,2941,1160,2088,6736,138,4648,409
PB,21016,NAZAREZINHO,4217,698,1081,6304,48,5223,260
PB,21032,NOVA FLORESTA,4176,1440,1790,7811,77,6021,328
PB,21059,NOVA OLINDA,2486,615,610,3988,71,3378,206
PB,21075,NOVA PALMEIRA,1845,747,515,3277,42,2762,128
PB,21091,OLHO D'ÁGUA,3213,1354,696,5589,48,4893,278
PB,21113,OLIVEDOS,1781,938,413,3341,41,2928,168
PB,21130,OURO VELHO,1517,604,485,2711,22,2226,83
PB,21156,PASSAGEM,1276,417,478,2259,16,1781,72
PB,21172,PATOS,29842,19736,14279,67137,834,52858,2446
PB,21199,PAULISTA,4532,2374,2267,9617,109,7350,335
PB,21210,PEDRA BRANCA,1982,712,765,3625,30,2860,136
PB,21237,PEDRA LAVRADA,3038,1625,869,5890,71,5021,287
PB,21253,PEDRAS DE FOGO,11722,4148,2597,19686,298,17089,921
PB,21270,PIANCÓ,5891,3198,1865,11591,130,9726,507
PB,21296,PICUÍ,8299,2531,2967,14621,193,11654,631
PB,21318,PILAR,5164,1625,1958,9334,148,7376,439
PB,21334,PILÕES,3299,1180,1917,6816,102,4899,318
PB,21350,PILÕEZINHOS,2382,1161,1399,5249,102,3850,205
PB,21377,PIRPIRITUBA,3357,2037,2091,7890,120,5799,285
PB,21393,PITIMBU,5567,1995,2151,10349,184,8198,452
PB,21415,POCINHOS,6885,3174,2534,13443,235,10909,615
PB,21431,POMBAL,9686,8855,5478,25092,222,19614,851
PB,21458,PRATA,1864,1051,515,3600,32,3085,138
PB,21474,PRINCESA ISABEL,7453,3254,3912,15446,169,11534,658
PB,21490,PUXINANÃ,5584,2774,1530,10649,200,9119,561
PB,21512,QUEIMADAS,15990,8108,6690,32803,548,26113,1467
PB,21539,QUIXABA,1051,382,247,1783,14,1536,89
PB,21555,REMÍGIO,7344,2246,3291,13524,123,10233,520
PB,21571,RIACHO DOS CAVALOS,4292,1276,1297,7108,67,5811,176
PB,21598,RIO TINTO,8657,4128,4304,18253,311,13949,853
PB,21610,SALGADINHO,1497,543,610,2798,44,2188,104
PB,21636,SALGADO DE SÃO FÉLIX,5167,1776,3207,10696,109,7489,437
PB,21652,SANTA CRUZ,3427,754,956,5385,43,4429,205
PB,21679,SANTA HELENA,3459,483,1311,5525,46,4214,226
PB,21695,SANTA LUZIA,4862,3649,2532,11657,188,9125,426
PB,21717,SANTANA DE MANGUEIRA,2704,510,1215,4696,33,3481,234
PB,21733,SANTANA DOS GARROTES,2881,1170,1174,5590,65,4416,300
PB,21750,SANTA RITA,42839,23243,17059,90574,2191,73515,5242
PB,21776,SANTA TERESINHA,2272,1418,837,4725,51,3888,147
PB,21792,SÃO BENTO,9194,8958,5844,25048,298,19204,754
PB,21814,SÃO JOÃO DO CARIRI,2248,756,867,4058,35,3191,152
PB,21830,SÃO JOÃO DO TIGRE,2177,545,709,3647,25,2938,191
PB,21857,SÃO JOSÉ DA LAGOA TAPADA,3714,1045,1186,6341,60,5155,336
PB,21873,SÃO JOSÉ DE CAIANA,2523,697,1668,5088,39,3420,161
PB,21890,SÃO JOSÉ DE ESPINHARAS,2342,785,635,3947,28,3312,157
PB,21911,SÃO JOSÉ DE PIRANHAS,9211,1347,3633,14862,132,11229,539
PB,21938,SÃO JOSÉ DO BONFIM,1879,820,553,3382,37,2829,93
PB,21954,SÃO JOSÉ DO SABUGI,2078,1010,379,3641,43,3262,131
PB,21970,SÃO JOSÉ DOS CORDEIROS,1982,389,605,3154,46,2549,132
PB,21997,SÃO MAMEDE,3321,1591,1311,6521,79,5210,219
PB,22012,SÃO MIGUEL DE TAIPU,2586,1566,994,5457,83,4463,228
PB,22039,SÃO SEBASTIÃO DE LAGOA DE ROÇA,3427,2824,2003,8787,158,6784,375
PB,22055,SÃO SEBASTIÃO DO UMBUZEIRO,1898,303,503,2858,32,2355,122
PB,22071,SAPÉ,17929,7248,11008,38425,649,27417,1591
PB,22098,SÃO VICENTE DO SERIDÓ,4328,1733,1854,8366,142,6512,309
PB,22110,SERRA BRANCA,5083,2125,2340,10071,120,7731,403
PB,22136,SERRA DA RAIZ,932,960,232,2254,37,2022,93
PB,22152,SERRA GRANDE,1776,285,568,2759,14,2191,116
PB,22179,SERRA REDONDA,3237,1242,1646,6455,70,4809,260
PB,22195,SERRARIA,1912,1206,1319,4706,67,3387,202
PB,22217,SOLÂNEA,9939,4119,7063,22486,345,15423,1020
PB,22233,SOLEDADE,5373,2871,1942,10955,242,9013,527
PB,22250,SOUSA,27089,8391,9760,47464,551,37704,1673
PB,22276,SUMÉ,6906,2229,2955,12764,155,9809,519
PB,22292,TACIMA,3632,1441,2170,7556,78,5386,235
PB,22314,TAPEROÁ,5082,2490,2862,11014,123,8152,457
PB,22330,TAVARES,6012,1226,3437,11199,91,7762,433
PB,22357,TEIXEIRA,6179,1615,2258,10527,122,8269,353
PB,22373,TRIUNFO,4037,599,2441,7400,57,4959,266
PB,22390,UIRAÚNA,6322,1987,2548,11419,86,8871,476
PB,22411,UMBUZEIRO,3403,1369,1383,6598,97,5215,346
PB,22438,VÁRZEA,1461,429,349,2360,28,2011,93
PE,23000,QUIXABA,3673,384,1380,5585,31,4205,117
PE,23019,AFOGADOS DA INGAZEIRA,13583,6272,4166,24980,287,20814,672
PE,23027,LAGOA DO CARRO,6764,3074,2746,13098,180,10352,334
PE,23035,AFRÂNIO,9003,2793,3162,15462,127,12300,377
PE,23043,SANTA CRUZ DA BAIXA VERDE,6102,1128,1973,9514,65,7541,246
PE,23051,AGRESTINA,11683,2688,3708,18953,271,15245,603
PE,23060,XEXÉU,4452,2392,4360,11586,125,7226,257
PE,23078,ÁGUA PRETA,10463,3799,7617,22703,292,15086,532
PE,23086,VERTENTE DO LÉRIO,3882,1578,1952,7662,69,5710,181
PE,23094,ÁGUAS BELAS,15600,5943,6817,29446,229,22629,857
PE,23108,SANTA CRUZ,6910,1023,2420,10695,73,8275,269
PE,23116,ALAGOINHA,7121,1451,2195,11064,79,8869,218
PE,23124,JUCATI,5268,1112,2615,9297,96,6682,206
PE,23132,ALIANÇA,13614,5886,4004,24742,454,20738,784
PE,23140,DORMENTES,8239,2783,3278,14721,98,11443,323
PE,23159,ALTINHO,8537,3501,1400,14346,277,12946,631
PE,23167,CARNAUBEIRA DA PENHA,6820,487,2640,10227,49,7587,231
PE,23175,AMARAJI,7197,4327,5220,17718,380,12498,594
PE,23183,LAGOA GRANDE,10329,2598,4534,17987,138,13453,388
PE,23191,ANGELIM,4351,1542,2168,8343,66,6175,216
PE,23205,ARAÇOIABA,8063,3014,2880,14603,253,11723,393
PE,23213,ARARIPINA,34244,7252,6404,49625,406,43221,1319
PE,23221,CASINHAS,5777,2565,3633,12438,115,8805,348
PE,23230,ARCOVERDE,22932,12057,4636,41490,613,36854,1252
PE,23248,MANARI,6986,955,3178,11427,64,8249,244
PE,23256,BARRA DE GUABIRABA,3802,2937,2887,10033,161,7146,246
PE,23264,JATOBÁ,6730,924,3106,11031,75,7925,196
PE,23272,BARREIROS,15196,5883,4359,27048,633,22689,977
PE,23280,TAMANDARÉ,7185,4276,2559,14652,286,12093,346
PE,23299,BELÉM DE MARIA,4967,1501,1931,8749,91,6818,259
PE,23302,JAQUEIRA,4242,1599,3001,9166,109,6165,215
PE,23310,BELÉM DE SÃO FRANCISCO,9203,1765,3495,14936,100,11441,373
PE,23329,SANTA FILOMENA,6453,1010,2863,10591,45,7728,220
PE,23337,BELO JARDIM,31480,10007,13332,57528,843,44196,1866
PE,23353,BETÂNIA,5778,495,3286,9832,51,6546,222
PE,23370,BEZERROS,25384,8463,10198,46414,735,36216,1634
PE,23396,BODOCÓ,15700,2672,5889,25108,166,19219,681
PE,23418,BOM CONSELHO,18523,3879,10147,33810,266,23663,995
PE,23434,BOM JARDIM,13956,7115,9567,31649,348,22082,663
PE,23450,BONITO,13149,7902,8099,30456,383,22357,923
PE,23477,BREJÃO,5109,1705,1791,8951,83,7160,263
PE,23493,BREJINHO,3417,1489,1673,6797,59,5124,159
PE,23515,BREJO DA MADRE DE DEUS,13867,7946,7267,30379,443,23112,856
PE,23531,BUENOS AIRES,6133,1742,2687,10984,129,8297,293
PE,23558,BUÍQUE,20442,3153,11671,36844,340,25173,1238
PE,23574,CABO DE SANTO AGOSTINHO,91244,24802,27360,152626,3478,125266,5742
PE,23590,CABROBÓ,13265,3618,5868,23517,210,17649,556
PE,23612,CACHOEIRINHA,8306,2814,2026,13764,265,11738,353
PE,23639,CAETÉS,11599,1210,5340,18773,141,13433,483
PE,23655,CALÇADO,4427,1091,2091,7893,78,5802,206
PE,23671,CALUMBI,3962,479,1591,6190,22,4599,136
PE,23698,CAMOCIM DE SÃO FÉLIX,7595,2784,3547,14566,204,11019,436
PE,23710,CAMUTANGA,3460,1781,811,6376,87,5565,237
PE,23736,CANHOTINHO,8968,2851,2463,14882,157,12419,443
PE,23752,CAPOEIRAS,9214,1364,4763,15828,153,11065,334
PE,23779,CARNAÍBA,8842,1535,2080,12951,125,10871,369
PE,23795,CARPINA,25589,14902,10618,54323,1138,43705,2076
PE,23817,CARUARU,97444,67627,21249,199873,4060,178624,9493
PE,23833,CATENDE,13968,3392,4357,22667,317,18310,633
PE,23850,CEDRO,5138,1135,2836,9375,72,6539,194
PE,23876,CHÃ DE ALEGRIA,4801,2997,2003,10398,206,8395,391
PE,23892,CHÃ GRANDE,8023,4788,3357,16954,234,13597,552
PE,23914,CONDADO,8786,4519,4888,19098,336,14210,569
PE,23930,CORRENTES,7577,805,4253,12988,74,8735,279
PE,23957,CORTÊS,5119,2498,2814,10884,162,8070,291
PE,23973,CUMARU,7048,3222,4310,15137,183,10827,374
PE,23990,CUPIRA,10026,3701,2809,17353,230,14544,587
PE,24015,CUSTÓDIA,16580,2417,4611,24396,182,19785,606
PE,24031,ESCADA,27111,8778,4032,42282,841,38250,1520
PE,24058,EXU,16427,2554,8982,28830,163,19848,704
PE,24074,FEIRA NOVA,7750,4543,3160,16160,231,13000,476
PE,24090,FERREIROS,4435,2400,971,8336,180,7365,350
PE,24112,FLORES,9843,1625,4241,16222,122,11981,391
PE,24139,FLORESTA,14118,2085,5376,22157,131,16781,447
PE,24155,FREI MIGUELINHO,6087,2905,2325,11698,108,9373,273
PE,24171,GAMELEIRA,7421,3303,5515,16903,247,11388,417
PE,24198,GARANHUNS,55149,12672,8319,79639,1114,71320,2385
PE,24210,GLÓRIA DO GOITÁ,10807,5243,5638,22801,301,17163,812
PE,24236,GOIANA,35500,9136,4644,51814,1007,47170,1527
PE,24252,GRANITO,3582,811,1396,5939,28,4543,122
PE,24279,GRAVATÁ,30534,14616,12431,60836,1132,48405,2123
PE,24295,IATI,8460,1128,5172,15178,79,10006,339
PE,24317,IBIMIRIM,11628,1655,4950,18792,144,13842,415
PE,24333,IBIRAJUBA,3684,892,987,5804,69,4817,172
PE,24350,IGARASSU,45986,12754,5636,68385,1441,62749,2568
PE,24376,IGUARACI,5281,954,3092,9588,59,6496,202
PE,24392,INAJÁ,8131,770,2907,12101,64,9194,229
PE,24414,INGAZEIRA,1948,924,787,3755,28,2968,68
PE,24430,IPOJUCA,41117,7788,5753,57219,1008,51466,1553
PE,24457,IPUBI,10867,3246,6222,21028,175,14806,518
PE,24473,ITACURUBA,2528,404,1218,4259,26,3041,83
PE,24490,ITAÍBA,10054,2482,2561,15715,123,13154,495
PE,24511,ILHA DE ITAMARACÁ,9062,3239,2473,15384,243,12911,367
PE,24538,ITAPETIM,5771,2451,2723,11371,106,8648,320
PE,24554,ITAQUITINGA,6355,2871,3324,13105,232,9781,323
PE,24570,JABOATÃO DOS GUARARAPES,223571,100826,74902,428036,9115,353134,19622
PE,24597,JATAÚBA,6961,2754,3318,13416,110,10098,273
PE,24619,JOÃO ALFREDO,10655,5428,5715,22729,299,17014,632
PE,24635,JOAQUIM NABUCO,5676,2355,3759,12328,206,8569,332
PE,24651,JUPI,6759,1501,2314,10998,132,8684,292
PE,24678,JUREMA,6278,1571,1396,9683,107,8287,331
PE,24694,LAGOA DE ITAENGA,7938,5000,3431,17239,294,13808,576
PE,24716,LAGOA DO OURO,6739,795,2286,10215,87,7929,308
PE,24732,LAGOA DOS GATOS,6043,2009,3773,12248,106,8475,317
PE,24759,LAJEDO,14510,6058,5606,27360,352,21754,834
PE,24775,LIMOEIRO,22677,10599,11910,47342,747,35432,1409
PE,24791,MACAPARANA,8956,4099,3709,17739,256,14030,719
PE,24813,MACHADOS,4964,2106,2665,10109,135,7444,239
PE,24830,MARAIAL,4445,1362,3821,9975,90,6154,257
PE,24856,MIRANDIBA,6842,1326,2832,11332,79,8500,253
PE,24872,MORENO,26771,6407,4146,39990,967,35844,1699
PE,24899,NAZARÉ DA MATA,11630,7409,5764,26161,472,20397,886
PE,24910,OLINDA,161261,78774,52731,311811,5589,259080,13456
PE,24937,OROBÓ,9178,3232,6627,19848,231,13221,580
PE,24953,OROCÓ,6461,1774,2634,11150,61,8516,220
PE,24970,OURICURI,28037,3926,11854,45175,283,33321,1075
PE,24996,PALMARES,24344,6272,4339,36493,548,32154,990
PE,25011,PALMEIRINA,3553,852,2182,6814,69,4632,158
PE,25038,PANELAS,8294,5309,6809,21129,144,14320,573
PE,25054,PARANATAMA,5874,964,2024,9205,66,7181,277
PE,25070,PARNAMIRIM,11293,1401,3973,16980,60,13007,253
PE,25097,PASSIRA,12216,5241,7235,25654,320,18419,642
PE,25119,PAUDALHO,19001,10341,6925,38441,889,31516,1285
PE,25135,PAULISTA,111727,46215,34219,205328,3824,171109,9343
PE,25151,PEDRA,9286,2918,4973,17815,198,12842,440
PE,25178,PESQUEIRA,29369,4928,12711,48275,362,35564,905
PE,25194,PETROLÂNDIA,13953,4083,2786,21545,239,18759,484
PE,25216,PETROLINA,105880,40267,35162,188917,2129,153755,5479
PE,25232,POÇÃO,5684,1143,2106,9297,91,7191,273
PE,25259,POMBOS,10212,4487,3078,18797,367,15719,653
PE,25275,PRIMAVERA,5264,1899,2599,10251,189,7652,300
PE,25291,QUIPAPÁ,7680,2428,6865,17601,211,10736,417
PE,25313,RECIFE,535855,369705,88713,1067017,22148,978304,50596
PE,25330,RIACHO DAS ALMAS,9138,4363,2898,17260,277,14362,584
PE,25356,RIBEIRÃO,14240,6564,9371,31541,568,22170,798
PE,25372,RIO FORMOSO,8649,3377,2922,15615,253,12693,414
PE,25399,SAIRÉ,5392,2911,2127,11033,185,8906,418
PE,25410,SALGADINHO,3141,1152,1843,6367,73,4524,158
PE,25437,SALGUEIRO,24078,6482,3881,35532,336,31651,755
PE,25453,SALOÁ,7149,1160,4314,13116,106,8802,387
PE,25470,SANHARÓ,8116,2954,2096,13701,152,11605,383
PE,25496,SANTA CRUZ DO CAPIBARIBE,23342,19725,10838,56590,1066,45752,1619
PE,25518,SANTA MARIA DA BOA VISTA,17179,3162,6625,27677,213,21052,498
PE,25534,SANTA MARIA DO CAMBUCÁ,4322,3230,2343,10345,170,8002,280
PE,25550,SANTA TEREZINHA,3429,1953,2593,8253,73,5660,205
PE,25577,SÃO BENEDITO DO SUL,3621,1134,3006,8171,103,5165,307
PE,25593,SÃO BENTO DO UNA,17691,6218,9728,34842,396,25114,809
PE,25615,SÃO CAITANO,14076,7245,3247,26127,500,22880,1059
PE,25631,SÃO JOÃO,9021,2664,4862,17158,157,12296,454
PE,25658,SÃO JOAQUIM DO MONTE,8223,3769,1770,14594,211,12824,621
PE,25674,SÃO JOSÉ DA COROA GRANDE,5980,3791,1943,12366,248,10423,404
PE,25690,SÃO JOSÉ DO BELMONTE,15086,2047,7993,25838,137,17845,575
PE,25712,SÃO JOSÉ DO EGITO,10993,5758,7033,24642,256,17609,602
PE,25739,SÃO LOURENÇO DA MATA,39718,18048,13499,75760,1560,62261,2935
PE,25755,SÃO VICENTE FÉRRER,7095,2554,1878,12106,153,10228,426
PE,25771,SERRA TALHADA,34783,8182,5601,50376,408,44775,1402
PE,25798,SERRITA,8917,1436,4086,14743,67,10657,237
PE,25810,SERTÂNIA,14175,3337,6188,24623,275,18435,648
PE,25836,SIRINHAÉM,12504,8001,2969,24788,565,21819,749
PE,25852,MOREILÂNDIA,6171,595,1211,8228,77,7017,174
PE,25879,SOLIDÃO,3393,378,1389,5268,25,3879,83
PE,25895,SURUBIM,20280,12930,9213,43954,573,34741,958
PE,25917,TABIRA,11723,2423,2362,17023,154,14661,361
PE,25933,TACAIMBÓ,5668,1839,1112,9018,136,7906,263
PE,25950,TACARATU,8920,1438,3823,14557,101,10734,275
PE,25976,ITAMBÉ,12825,4958,2199,21030,311,18831,737
PE,25992,TAQUARITINGA DO NORTE,6908,7340,3597,18734,284,15137,605
PE,26018,TEREZINHA,3831,614,1371,6027,47,4656,164
PE,26034,TERRA NOVA,5625,627,1192,7608,35,6416,129
PE,26050,TIMBAÚBA,21834,9426,5513,38647,555,33134,1319
PE,26077,TORITAMA,13278,6981,5081,26327,373,21246,614
PE,26093,TRACUNHAÉM,4920,2943,2021,10416,237,8395,295
PE,26115,TRINDADE,12274,2460,5356,20657,140,15301,427
PE,26131,TRIUNFO,6756,1626,3357,12145,94,8788,312
PE,26158,TUPANATINGA,8126,1888,6033,16564,109,10531,408
PE,26174,TUPARETAMA,4740,782,1921,7659,58,5738,158
PE,26190,VENTUROSA,7917,1616,2673,12653,143,9980,304
PE,26212,VERDEJANTE,4845,939,1656,7647,47,5991,160
PE,26239,VERTENTES,6223,4899,3112,14799,208,11687,357
PE,26255,VICÊNCIA,9446,5684,3508,19762,335,16254,789
PE,26271,VITÓRIA DE SANTO ANTÃO,49411,25070,19248,99161,1814,79913,3618
PE,26298,CAMARAGIBE,57401,31930,18765,116158,2568,97393,5494
PE,26310,ABREU E LIMA,46553,12997,13193,77401,1419,64208,3239
PE,26336,ITAPISSUMA,10157,2754,2122,16096,384,13974,679
PE,30015,FERNANDO DE NORONHA,783,533,759,2177,48,1418,54
PI,10006,BRASILEIRA,4267,701,1815,7006,50,5191,173
PI,10014,AGRICOLÂNDIA,2882,562,1237,4842,27,3605,134
PI,10022,ALEGRETE DO PIAUÍ,2520,557,1174,4389,26,3215,112
PI,10030,ÁGUA BRANCA,7376,2326,3056,13116,91,10060,267
PI,10049,BAIXA GRANDE DO RIBEIRO,4518,1224,1705,7648,30,5943,171
PI,10057,ALTO LONGÁ,6726,1563,3033,11701,55,8668,324
PI,10065,BOM PRINCÍPIO DO PIAUÍ,3218,800,1273,5481,39,4208,151
PI,10073,ALTOS,19514,3880,6037,30404,197,24367,776
PI,10081,BONFIM DO PIAUÍ,2992,338,1023,4503,19,3480,131
PI,10090,AMARANTE,8400,1554,4013,14397,90,10384,340
PI,10103,BURITI DOS MONTES,3680,664,1464,5993,32,4529,153
PI,10111,ANGICAL DO PIAUÍ,3969,924,1715,6778,30,5063,140
PI,10120,CABECEIRAS DO PIAUÍ,5249,782,2256,8590,60,6334,243
PI,10138,ANÍSIO DE ABREU,3979,862,1534,6553,22,5019,156
PI,10146,CALDEIRÃO GRANDE DO PIAUÍ,2886,616,875,4491,16,3616,98
PI,10154,ANTÔNIO ALMEIDA,1318,692,861,2956,19,2095,66
PI,10162,CANAVIEIRA,1844,370,1085,3378,12,2293,67
PI,10170,AROAZES,3276,457,1557,5439,28,3882,121
PI,10189,COIVARAS,2492,797,844,4255,16,3411,106
PI,10197,ARRAIAL,2389,328,1241,4084,22,2843,104
PI,10200,COLÔNIA DO GURGUÉIA,2976,397,1532,5017,30,3485,82
PI,10219,AVELINO LOPES,4822,917,2483,8493,65,6010,206
PI,10227,COLÔNIA DO PIAUÍ,3549,429,1984,6133,35,4149,136
PI,10235,BARRAS,18124,5263,9156,33682,225,24526,914
PI,10243,CORONEL JOSÉ DIAS,3152,337,1066,4663,21,3597,87
PI,10251,BARREIRAS DO PIAUÍ,1555,380,1124,3153,27,2029,67
PI,10260,FARTURA DO PIAUÍ,2600,293,1256,4285,16,3029,120
PI,10278,BARRO DURO,3138,874,1892,6041,35,4149,102
PI,10286,JACOBINA DO PIAUÍ,3051,365,974,4561,40,3587,131
PI,10294,BATALHA,10581,3920,6354,21495,134,15141,506
PI,10308,JARDIM DO MULATO,2426,449,884,3890,27,3006,104
PI,10316,BENEDITINOS,5498,1031,1911,8770,54,6859,276
PI,10324,LAGOA ALEGRE,4695,655,1645,7193,30,5548,168
PI,10332,BERTOLÍNIA,2544,482,1073,4222,23,3149,100
PI,10340,LAGOA DO BARRO DO PIAUÍ,2388,368,970,3886,36,2916,124
PI,10359,BOCAINA,2978,1098,1059,5230,17,4171,78
PI,10367,MARCOLÂNDIA,3937,1017,1227,6420,50,5193,189
PI,10375,BOM JESUS,8341,3121,3200,15102,92,11902,348
PI,10383,PATOS DO PIAUÍ,2932,779,1621,5582,44,3961,206
PI,10391,BURITI DOS LOPES,8769,2259,3879,15371,118,11492,346
PI,10405,PASSAGEM FRANCA DO PIAUÍ,2171,326,1112,3712,26,2600,77
PI,10413,CAMPINAS DO PIAUÍ,3050,294,1343,4835,23,3492,125
PI,10421,QUEIMADA NOVA,4117,729,1727,6807,32,5080,202
PI,10430,CAMPO MAIOR,19782,6654,7501,35085,235,27584,913
PI,10448,SANTA CRUZ DOS MILAGRES,1895,345,1140,3456,5,2316,71
PI,10456,CANTO DO BURITI,8705,2176,4315,15609,94,11294,319
PI,10464,SANTA ROSA DO PIAUÍ,2295,783,1275,4473,23,3198,97
PI,10472,CAPITÃO DE CAMPOS,5051,1310,2474,9174,71,6700,268
PI,10480,SANTANA DO PIAUÍ,2531,351,758,3784,32,3026,112
PI,10499,CARACOL,4554,1005,2027,7802,52,5775,164
PI,10502,SÃO BRAZ DO PIAUÍ,2449,257,1071,3857,16,2786,64
PI,10510,CASTELO DO PIAUÍ,7905,2537,5362,16288,98,10926,386
PI,10529,SÃO JOSÉ DO DIVINO,2695,759,1158,4764,38,3606,114
PI,10537,COCAL,10719,3218,5799,20436,156,14637,544
PI,10545,SIGEFREDO PACHECO,4772,886,2082,7953,36,5871,177
PI,10553,CONCEIÇÃO DO CANINDÉ,2564,467,1235,4422,31,3187,125
PI,10561,SÃO LOURENÇO DO PIAUÍ,2743,418,1058,4358,28,3300,111
PI,10570,CORRENTE,10579,2466,4638,18225,99,13587,443
PI,10588,VÁRZEA BRANCA,2460,397,1068,4037,17,2969,95
PI,10596,CRISTALÂNDIA DO PIAUÍ,3040,515,1679,5386,14,3707,138
PI,10600,BARRA D'ALCÂNTARA,1803,469,845,3207,14,2362,76
PI,10618,CRISTINO CASTRO,4122,691,2383,7411,44,5028,171
PI,10626,BELA VISTA DO PIAUÍ,2361,171,322,2941,17,2619,70
PI,10634,CURIMATÁ,4511,1240,2281,8227,45,5946,150
PI,10642,BREJO DO PIAUÍ,2383,226,949,3672,18,2723,96
PI,10650,DEMERVAL LOBÃO,6730,1452,1856,10362,52,8506,272
PI,10669,BOA HORA,3231,644,1723,5783,48,4060,137
PI,10677,DOM EXPEDITO LOPES,4015,851,1192,6246,45,5054,143
PI,10685,DOM INOCÊNCIO,4712,466,1850,7251,21,5401,202
PI,10693,ELESBÃO VELOSO,7218,1366,3848,12799,53,8951,314
PI,10707,CAPITÃO GERVÁSIO OLIVEIRA,2245,164,837,3337,8,2500,83
PI,10715,ELISEU MARTINS,1957,570,1175,3806,17,2631,87
PI,10723,CAMPO GRANDE DO PIAUÍ,3000,544,1046,4776,47,3730,139
PI,10731,ESPERANTINA,14760,5444,7778,28876,202,21098,692
PI,10740,CAMPO LARGO DO PIAUÍ,2719,536,1167,4557,25,3390,110
PI,10758,FLORES DO PIAUÍ,2343,507,964,3965,25,3001,126
PI,10766,CURRAIS,3128,447,1071,4788,25,3717,117
PI,10774,FLORIANO,24706,6779,6870,39392,326,32522,711
PI,10782,GEMINIANO,3625,462,980,5291,58,4311,166
PI,10790,FRANCINÓPOLIS,2450,414,1548,4529,19,2981,98
PI,10804,GUARIBAS,2525,212,1278,4082,11,2804,56
PI,10812,FRANCISCO AYRES,2461,447,1452,4492,29,3040,103
PI,10820,ILHA GRANDE,4683,968,702,6627,57,5925,217
PI,10839,FRANCISCO SANTOS,4066,1106,1499,6869,57,5370,141
PI,10847,JUREMA,2548,501,1008,4172,22,3164,93
PI,10855,FRONTEIRAS,5713,985,2389,9348,37,6959,224
PI,10863,LAGOA DE SÃO FRANCISCO,2932,681,1364,5124,28,3760,119
PI,10871,GILBUÉS,4044,965,2454,7668,40,5214,165
PI,10880,MORRO CABEÇA NO TEMPO,2045,310,1237,3725,20,2488,113
PI,10898,GUADALUPE,4070,1466,2627,8346,43,5719,140
PI,10901,NOVO SANTO ANTÔNIO,2355,292,1013,3748,16,2735,72
PI,10910,HUGO NAPOLEÃO,2328,393,1063,3870,23,2807,63
PI,10928,NOSSA SENHORA DE NAZARÉ,3192,424,1056,4778,23,3722,83
PI,10936,INHUMA,7230,1388,3568,12594,82,9026,326
PI,10944,PAQUETÁ,2420,282,815,3679,19,2864,143
PI,10952,IPIRANGA DO PIAUÍ,4736,637,1754,7398,66,5644,205
PI,10960,NOVA SANTA RITA,2447,242,863,3650,13,2787,85
PI,10979,ISAÍAS COELHO,3631,455,1919,6181,29,4262,147
PI,10987,SÃO JOÃO DO ARRAIAL,3102,1422,1640,6422,62,4782,196
PI,10995,ITAINÓPOLIS,5910,769,2074,9143,90,7069,300
PI,11010,ITAUEIRA,5164,1029,2163,8669,81,6506,232
PI,11037,JAICÓS,6691,1433,4053,12675,97,8622,401
PI,11053,JERUMENHA,2647,428,1197,4390,24,3193,94
PI,11070,JOAQUIM PIRES,5916,2128,2985,11388,66,8403,293
PI,11088,SÃO JOÃO DA CANABRAVA,2587,573,1275,4536,14,3261,87
PI,11096,JOSÉ DE FREITAS,21014,3223,2580,27786,199,25206,770
PI,11118,LANDRI SALES,2317,511,1512,4489,21,2977,128
PI,11134,LUIS CORREIA,14145,3275,3016,21277,175,18261,666
PI,11150,LUZILÂNDIA,10176,2869,5578,19177,117,13599,437
PI,11177,MANOEL EMÍDIO,2459,540,1312,4442,29,3130,102
PI,11193,MARCOS PARENTE,1947,666,1186,3904,22,2718,83
PI,11215,MATIAS OLÍMPIO,4430,1203,2541,8441,53,5900,214
PI,11231,MIGUEL ALVES,13343,2591,7517,24301,145,16784,705
PI,11258,MIGUEL LEÃO,749,218,326,1328,12,1002,23
PI,11274,MONSENHOR GIL,6045,1210,1973,9505,48,7532,229
PI,11290,MONSENHOR HIPÓLITO,3775,941,1444,6368,38,4924,170
PI,11312,MONTE ALEGRE DO PIAUÍ,4283,934,2581,7995,34,5414,163
PI,11339,NAZARÉ DO PIAUÍ,4046,388,1927,6573,47,4646,165
PI,11355,NOSSA SENHORA DOS REMÉDIOS,3999,1102,1855,7155,40,5300,159
PI,11371,NOVO ORIENTE DO PIAUÍ,3526,415,1555,5697,32,4142,169
PI,11398,OEIRAS,16583,3813,3246,24425,168,21179,615
PI,11410,DOMINGOS MOURÃO,2108,371,1195,3771,15,2576,82
PI,11436,PADRE MARCOS,3248,850,1573,5929,51,4356,207
PI,11452,PAES LANDIM,1833,661,1065,3645,22,2580,64
PI,11479,PALMEIRA DO PIAUÍ,2390,829,1161,4484,19,3323,85
PI,11495,PALMEIRAIS,7160,1085,2578,11128,47,8550,258
PI,11517,PARNAGUÁ,3953,600,2200,6909,31,4709,125
PI,11533,PARNAÍBA,54121,24456,10328,92325,855,81997,2565
PI,11550,PAULISTANA,9035,1722,3976,15259,82,11283,444
PI,11576,PEDRO II,14406,5759,8790,29869,185,21079,729
PI,11592,PICOS,30918,8270,5477,46332,386,40855,1281
PI,11614,PIMENTEIRAS,5263,1074,2735,9319,36,6584,211
PI,11630,PIO IX,8810,1547,3145,13868,67,10723,299
PI,11657,PIRACURUCA,12511,3765,4123,21133,175,17010,559
PI,11673,PIRIPIRI,26709,7390,8794,44398,437,35604,1068
PI,11690,PORTO,4545,1047,2791,8696,60,5905,253
PI,11711,PRATA DO PIAUÍ,1790,259,1217,3378,13,2161,99
PI,11738,REDENÇÃO DO GURGUÉIA,3226,986,1861,6229,34,4368,122
PI,11754,REGENERAÇÃO,8079,1257,4303,14064,80,9761,345
PI,11770,RIBEIRO GONÇALVES,2645,831,1383,5001,22,3618,120
PI,11797,RIO GRANDE DO PIAUÍ,3293,546,1770,5789,37,4019,143
PI,11819,SANTA CRUZ DO PIAUÍ,3235,750,1101,5264,19,4163,159
PI,11835,SANTA FILOMENA,2412,749,1300,4599,24,3299,114
PI,11851,SANTA LUZ,2523,746,1008,4396,19,3388,100
PI,11878,SANTO ANTÔNIO DE LISBOA,3109,607,1152,5030,36,3878,126
PI,11894,SANTO INÁCIO DO PIAUÍ,1448,732,963,3264,21,2301,100
PI,11916,SÃO FÉLIX DO PIAUÍ,1887,567,1013,3544,13,2531,64
PI,11932,SÃO FRANCISCO DO PIAUÍ,3192,823,1490,5645,35,4155,105
PI,11959,SÃO GONÇALO DO PIAUÍ,2502,727,1090,4508,34,3418,155
PI,11975,SÃO JOÃO DA SERRA,3069,1111,1970,6361,47,4391,164
PI,11991,SÃO JOÃO DO PIAUÍ,7907,1923,3508,13715,54,10207,323
PI,12009,SÃO JOÃO DA FRONTEIRA,2443,780,1462,4822,25,3360,112
PI,12017,SÃO JOSÉ DO PEIXE,1835,240,1010,3187,28,2177,74
PI,12025,SÃO JOÃO DA VARJOTA,2463,376,960,3944,26,2984,119
PI,12033,SÃO JOSÉ DO PIAUÍ,3575,512,1473,5741,24,4268,157
PI,12041,SEBASTIÃO BARROS,2190,550,1150,3988,16,2838,82
PI,12050,SÃO JULIÃO,2823,980,1383,5339,14,3956,139
PI,12068,SEBASTIÃO LEAL,1901,749,605,3379,38,2774,86
PI,12076,SÃO MIGUEL DO TAPUIO,8327,1694,5155,15685,84,10530,425
PI,12084,ALVORADA DO GURGUÉIA,2569,237,1074,3974,13,2900,81
PI,12092,SÃO PEDRO DO PIAUÍ,5817,1702,2912,10777,93,7865,253
PI,12106,ASSUNÇÃO DO PIAUÍ,2947,895,2160,6242,36,4082,204
PI,12114,SÃO RAIMUNDO NONATO,13402,3253,4634,21848,136,17214,423
PI,12122,BETÂNIA DO PIAUÍ,3308,382,1274,5148,35,3874,149
PI,12130,SIMÕES,6403,1476,3045,11310,80,8265,306
PI,12149,BOQUEIRÃO DO PIAUÍ,3002,441,1511,5099,27,3588,118
PI,12157,SIMPLÍCIO MENDES,5263,1184,2610,9301,54,6691,190
PI,12165,CARIDADE DO PIAUÍ,2163,824,1368,4505,36,3137,114
PI,12173,SOCORRO DO PIAUÍ,1966,700,1555,4331,22,2776,88
PI,12181,CURRAL NOVO DO PIAUÍ,2429,271,1076,3924,29,2848,119
PI,12190,TERESINA,310254,122342,54711,506739,4156,452028,15276
PI,12203,JÚLIO BORGES,2705,271,1379,4462,18,3083,89
PI,12211,UNIÃO,20432,4891,7182,33695,192,26513,998
PI,12220,LAGOA DO SÍTIO,2637,442,1238,4471,21,3233,133
PI,12238,URUÇUÍ,6812,4182,3861,15357,125,11496,377
PI,12246,MILTON BRANDÃO,3036,737,1845,5793,42,3948,133
PI,12254,VALENÇA DO PIAUÍ,8799,2614,4245,16308,133,12063,517
PI,12262,PAJEÚ DO PIAUÍ,1561,439,965,3049,16,2084,68
PI,12270,VÁRZEA GRANDE,1919,580,1324,3970,18,2646,129
PI,12289,PAVUSSU,2204,212,1219,3741,11,2522,95
PI,12297,DIRCEU ARCOVERDE,3448,455,1691,5726,15,4035,117
PI,12300,RIACHO FRIO,2475,307,1281,4143,15,2862,65
PI,12319,ALAGOINHA DO PIAUÍ,3958,749,1273,6173,35,4900,158
PI,12327,ACAUÃ,3767,544,879,5368,30,4489,148
PI,12335,BELÉM DO PIAUÍ,1885,214,561,2745,15,2184,70
PI,12343,CAJAZEIRAS DO PIAUÍ,1921,192,678,2866,13,2188,62
PI,12351,CAMPO ALEGRE DO FIDALGO,2862,255,1143,4375,15,3232,100
PI,12360,COCAL DE TELHA,2640,291,1418,4504,25,3086,130
PI,12378,FRANCISCO MACEDO,1635,194,513,2423,17,1910,64
PI,12386,JOÃO COSTA,2007,201,682,2965,14,2283,61
PI,12394,JATOBÁ DO PIAUÍ,3434,681,1283,5554,37,4271,119
PI,12408,JOCA MARQUES,2531,493,1223,4377,36,3154,94
PI,12416,JUAZEIRO DO PIAUÍ,3244,732,1479,5633,39,4154,139
PI,12424,LAGOA DO PIAUÍ,2402,547,526,3568,16,3042,77
PI,12432,LAGOINHA DO PIAUÍ,1565,315,639,2578,7,1939,52
PI,12440,MADEIRO,3428,684,1832,6096,28,4264,124
PI,12459,MORRO DO CHAPÉU DO PIAUÍ,2866,925,1844,5786,20,3942,131
PI,12467,MASSAPÊ DO PIAUÍ,3464,500,1704,5877,39,4173,170
PI,12475,MURICI DOS PORTELAS,3288,762,1688,5957,41,4269,178
PI,12483,OLHO D'ÁGUA DO PIAUÍ,1466,203,593,2310,8,1717,40
PI,12491,PEDRO LAURENTINO,1480,359,686,2591,12,1905,54
PI,12505,SÃO FRANCISCO DE ASSIS DO PIAUÍ,2602,669,829,4234,23,3405,111
PI,12513,SUSSUAPARA,3810,709,887,5563,27,4676,130
PI,12521,TANQUE DO PIAUÍ,1456,263,594,2397,10,1803,74
PI,12530,TAMBORIL DO PIAUÍ,1414,398,860,2752,12,1892,68
PI,12548,VILA NOVA DO PIAUÍ,1605,461,519,2664,26,2145,53
PI,12556,VERA MENDES,1913,277,831,3154,30,2323,103
PI,12564,WALL FERRAZ,2027,711,820,3696,21,2876,117
PI,12572,CAJUEIRO DA PRAIA,3759,791,715,5429,33,4714,131
PI,12580,CURRALINHOS,2792,339,940,4182,20,3242,91
PI,12599,PORTO ALEGRE DO PIAUÍ,772,527,598,1953,7,1355,49
PI,12602,RIBEIRA DO PIAUÍ,2207,178,1064,3552,12,2488,91
PI,12610,SÃO GONÇALO DO GURGUÉIA,958,463,786,2276,15,1490,54
PI,12629,SÃO LUIS DO PIAUÍ,1486,287,602,2430,6,1828,49
PI,12637,FLORESTA DO PIAUÍ,1345,310,847,2601,20,1754,79
PI,12653,SANTO ANTÔNIO DOS MILAGRES,1163,163,398,1773,8,1375,41
PI,12661,SÃO MIGUEL DA BAIXA GRANDE,1313,324,653,2371,10,1718,71
PI,12670,CARAÚBAS DO PIAUÍ,2197,1096,1370,4843,22,3473,158
PI,12688,CAXINGÓ,2674,760,1131,4714,37,3583,112
PI,12696,COCAL DOS ALVES,2816,567,1456,4996,37,3540,120
PI,12700,SÃO MIGUEL DO FIDALGO,1448,205,826,2541,9,1715,53
PI,12718,PAU D'ARCO DO PIAUÍ,2729,390,879,4113,21,3234,94
PI,12726,NAZÁRIA,6336,1175,1009,8780,46,7771,214
PI,12734,AROEIRAS DO ITAIM,2238,293,489,3124,22,2635,82
PR,74004,GODOY MOREIRA,1148,921,745,2874,20,2129,40
PR,74012,ABATIÁ,1865,2686,1158,5847,43,4689,95
PR,74020,IBEMA,1745,2012,1162,5010,25,3848,66
PR,74039,ADRIANÓPOLIS,2276,1293,1332,5038,43,3706,94
PR,74047,LINDOESTE,2290,1487,1132,4986,32,3854,45
PR,74055,AGUDOS DO SUL,2590,2939,1136,6823,52,5687,106
PR,74063,OURO VERDE DO OESTE,1660,2057,644,4466,34,3822,71
PR,74071,ALMIRANTE TAMANDARÉ,22074,30835,12508,68269,1075,55761,1777
PR,74080,SANTA TEREZA DO OESTE,2918,3543,1617,8250,53,6633,119
PR,74098,ALTO PARANÁ,3981,3987,1954,10182,101,8228,159
PR,74101,ANAHY,890,1138,442,2514,12,2072,32
PR,74110,ALTO PIQUIRI,3332,2320,1369,7207,56,5838,130
PR,74128,ÂNGULO,821,1178,493,2572,21,2079,59
PR,74136,ALVORADA DO SUL,2524,2914,1270,6854,47,5584,99
PR,74144,BOA ESPERANÇA DO IGUAÇU,1389,564,441,2430,16,1989,20
PR,74152,AMAPORÃ,1385,1705,766,3955,42,3189,57
PR,74160,BOM SUCESSO DO SUL,1112,1262,404,2824,15,2420,31
PR,74179,AMPÉRE,6776,3925,2241,13212,89,10971,181
PR,74187,BRASILÂNDIA DO SUL,1350,933,525,2882,18,2357,56
PR,74195,ANDIRÁ,6085,6318,4530,17495,148,12965,414
PR,74209,CAFEZAL DO SUL,1424,1463,666,3616,24,2950,39
PR,74217,ANTONINA,3956,7454,4404,16259,160,11855,285
PR,74225,CANDÓI,4860,3799,2728,11581,66,8853,128
PR,74233,ANTONIO OLINTO,2161,2854,1158,6357,70,5199,114
PR,74241,CRUZEIRO DO IGUAÇU,1785,968,742,3543,18,2801,30
PR,74250,APUCARANA,24147,48615,18256,94090,919,75834,2153
PR,74268,DIAMANTE DO SUL,1276,912,767,2994,21,2227,18
PR,74276,ARAPONGAS,13987,48761,15264,80774,880,65510,1882
PR,74284,ENTRE RIOS DO OESTE,1226,1591,392,3237,9,2845,19
PR,74292,ARAPOTI,4645,9379,4200,18686,170,14486,292
PR,74306,FAROL,1091,1130,541,2833,27,2292,44
PR,74314,ARARUNA,4172,4141,2157,10707,82,8550,155
PR,74322,FAZENDA RIO GRANDE,24321,24327,13497,64856,1106,51359,1605
PR,74330,MARILÂNDIA DO SUL,1924,3635,1420,7163,86,5743,98
PR,74349,FLOR DA SERRA DO SUL,1894,1509,861,4331,26,3470,41
PR,74357,ARAUCÁRIA,34159,40577,17753,96395,1360,78642,2546
PR,74365,HONÓRIO SERPA,2085,1321,1219,4696,22,3477,49
PR,74373,ASSAÍ,2903,7357,2510,13151,121,10641,260
PR,74381,IGUATU,734,853,286,1907,6,1621,28
PR,74390,ASTORGA,5895,10191,3871,20480,201,16609,322
PR,74403,IRACEMA DO OESTE,1005,858,462,2387,20,1925,42
PR,74411,ATALAIA,1253,1618,503,3424,15,2921,35
PR,74420,NOVO ITACOLOMI,879,1212,348,2522,34,2174,49
PR,74438,BALSA NOVA,3443,5055,1126,9962,128,8836,210
PR,74446,ITAPERUÇU,9546,5167,3078,18208,177,15130,240
PR,74454,BANDEIRANTES,8072,11368,5689,25722,187,20033,406
PR,74462,IVATÉ,2693,1858,907,5576,41,4669,77
PR,74470,BARBOSA FERRAZ,2440,4015,2272,9025,97,6753,201
PR,74489,LIDIANÓPOLIS,1104,1450,963,3620,31,2657,72
PR,74497,BARRACÃO,2819,2805,1520,7271,41,5751,86
PR,74500,MARIPÁ,1335,2713,699,4812,23,4113,42
PR,74519,BARRA DO JACARÉ,1103,853,492,2513,25,2021,40
PR,74527,MATO RICO,1420,927,736,3133,18,2397,32
PR,74535,BELA VISTA DO PARAÍSO,3512,6454,2266,12585,115,10319,238
PR,74543,MAUÁ DA SERRA,1680,3362,1547,6766,64,5219,113
PR,74551,BITURUNA,5147,4359,2859,12639,106,9780,168
PR,74560,MERCEDES,1167,2465,616,4325,22,3709,55
PR,74578,BOA ESPERANÇA,1105,1938,708,3851,41,3143,59
PR,74586,NOVA LARANJEIRAS,3240,2513,2203,8087,43,5884,88
PR,74594,BOCAIÚVA DO SUL,2952,3676,1792,8649,94,6857,135
PR,74608,NOVA SANTA BÁRBARA,1243,1223,650,3226,35,2576,75
PR,74616,BOM SUCESSO,1839,2156,855,5012,67,4157,95
PR,74624,PATO BRAGADO,1111,2379,573,4144,34,3571,47
PR,74632,BORRAZÓPOLIS,2219,2888,1599,6874,57,5275,111
PR,74640,PINHAL DE SÃO BENTO,1348,431,368,2173,4,1805,22
PR,74659,CAFEARA,1169,553,298,2084,12,1786,52
PR,74667,PITANGUEIRAS,767,1358,308,2490,19,2182,38
PR,74675,CALIFÓRNIA,1680,3591,1234,6721,84,5487,132
PR,74683,QUATRO PONTES,1011,1855,506,3412,11,2906,29
PR,74691,CAMBARÁ,5902,7961,3989,18700,259,14711,589
PR,74705,RAMILÂNDIA,1452,1137,848,3483,13,2635,33
PR,74713,CAMBÉ,21539,36683,12983,74219,880,61236,2134
PR,74721,RANCHO ALEGRE D'OESTE,822,1018,575,2458,21,1883,22
PR,74730,CAMBIRA,2252,2757,1046,6256,59,5210,142
PR,74748,RIO BONITO DO IGUAÇU,5583,2316,2370,10421,45,8051,107
PR,74756,CAMPINA DA LAGOA,3992,5090,2960,12342,142,9382,158
PR,74764,SANTA LÚCIA,1331,1155,664,3234,24,2570,60
PR,74772,CAMPINA GRANDE DO SUL,10153,13620,6401,31224,421,24823,629
PR,74780,CAMPO BONITO,1506,1335,993,3911,30,2918,47
PR,74799,CAMPO DO TENENTE,1342,3138,935,5541,47,4606,79
PR,74802,SANTA MARIA DO OESTE,3734,2466,2751,9091,49,6340,91
PR,74810,CAMPO LARGO,24117,42359,7759,77283,1170,69524,1878
PR,74829,SANTA MÔNICA,1297,901,538,2792,15,2254,41
PR,74837,CAMPO MOURÃO,21330,29728,14140,66727,505,52587,1024
PR,74845,SÃO MANOEL DO PARANÁ,451,1036,308,1839,21,1531,23
PR,74853,CÂNDIDO DE ABREU,3973,4833,3117,12278,109,9161,246
PR,74861,SÃO PEDRO DO IGUAÇU,1916,2277,933,5265,53,4332,86
PR,74870,CAPANEMA,7090,4563,2987,14872,106,11885,126
PR,74888,TUNAS DO PARANÁ,1850,1677,1194,4815,32,3621,62
PR,74896,CAPITÃO LEÔNIDAS MARQUES,4943,4012,2869,12056,80,9187,152
PR,74900,VENTANIA,2267,3330,1573,7338,52,5765,116
PR,74918,CARLÓPOLIS,3252,5185,2427,11215,90,8788,261
PR,74926,ALTO PARAÍSO,1140,869,717,2784,14,2067,44
PR,74934,CASCAVEL,66499,96939,39987,208704,1722,168717,3557
PR,74942,DOUTOR ULYSSES,2146,1426,1008,4697,27,3689,90
PR,74950,CASTRO,13042,27189,9890,51584,647,41694,816
PR,74969,VIRMOND,1054,1680,777,3579,23,2802,45
PR,74977,CATANDUVAS,2176,3137,1876,7341,64,5465,88
PR,74985,LARANJAL,2229,1174,1594,5074,18,3480,59
PR,74993,CENTENÁRIO DO SUL,4468,2324,1871,8895,80,7024,152
PR,75000,ITAIPULÂNDIA,3249,3222,1673,8263,39,6590,80
PR,75019,CERRO AZUL,5711,4075,2883,13077,146,10194,262
PR,75027,NOVA ESPERANÇA DO SUDOESTE,2384,1203,628,4261,15,3633,31
PR,75035,CHOPINZINHO,5924,6432,3319,16010,101,12691,234
PR,75043,PINHAIS,28551,42452,17636,91982,1192,74346,2151
PR,75051,CIANORTE,11949,29505,10585,53494,576,42909,879
PR,75060,SAUDADE DO IGUAÇU,1835,1368,894,4173,30,3279,46
PR,75078,CIDADE GAÚCHA,3680,3321,1993,9211,74,7218,143
PR,75086,ARIRANHA DO IVAÍ,1065,688,519,2315,9,1796,34
PR,75094,CLEVELÂNDIA,5621,4099,3599,13596,94,9997,183
PR,75108,ARAPUÃ,1400,1143,585,3170,10,2585,32
PR,75116,MANGUEIRINHA,6052,4081,3421,13803,85,10382,164
PR,75124,BELA VISTA DA CAROBA,1501,993,668,3214,16,2546,36
PR,75132,COLOMBO,47980,66854,27388,148077,2302,120689,3553
PR,75140,BOA VENTURA DE SÃO ROQUE,2409,1375,1042,4917,24,3875,67
PR,75159,COLORADO,7208,6917,3839,18692,232,14853,496
PR,75167,BOM JESUS DO SUL,1665,1093,717,3520,13,2803,32
PR,75175,CONGONHINHAS,2940,1857,1752,6713,51,4961,113
PR,75183,CAMPINA DO SIMÃO,1548,1022,759,3401,21,2642,51
PR,75191,CONSELHEIRO MAIRINCK,1014,1302,622,3028,19,2406,71
PR,75205,CAMPO MAGRO,5920,8564,3016,18165,291,15149,374
PR,75213,CONTENDA,3703,5627,1666,11326,157,9660,173
PR,75221,CARAMBEÍ,3412,8325,2404,14558,172,12154,245
PR,75230,CORBÉLIA,3874,7073,2234,13452,95,11218,176
PR,75248,CORONEL DOMINGOS SOARES,2168,1488,1517,5244,17,3727,54
PR,75256,CORNÉLIO PROCÓPIO,10106,18168,8429,37870,337,29441,830
PR,75264,CRUZMALTINA,922,1201,725,2910,21,2185,41
PR,75272,CORONEL VIVIDA,6729,7036,2664,16793,121,14129,243
PR,75280,CORUMBATAÍ DO SUL,1302,1226,860,3477,26,2617,63
PR,75299,CRUZEIRO DO OESTE,5832,6458,3055,15749,138,12694,266
PR,75302,ESPERANÇA NOVA,737,746,346,1872,14,1526,29
PR,75310,CRUZEIRO DO SUL,2034,1277,630,4017,22,3387,54
PR,75329,ESPIGÃO ALTO DO IGUAÇU,1497,1657,1095,4315,19,3220,47
PR,75337,CRUZ MACHADO,4175,6870,2751,14066,91,11315,179
PR,75345,FERNANDES PINHEIRO,2024,2280,1149,5564,39,4415,72
PR,75353,CURITIBA,284563,737254,170972,1243613,15212,1072641,35612
PR,75361,FOZ DO JORDÃO,1944,959,1190,4166,32,2976,41
PR,75370,CURIÚVA,3232,4541,3223,11353,149,8130,208
PR,75388,GOIOXIM,2514,1447,1482,5501,16,4019,42
PR,75396,DIAMANTE DO NORTE,1588,1714,1289,4703,36,3414,76
PR,75400,DIAMANTE D'OESTE,1650,1235,817,3781,28,2964,51
PR,75418,DOIS VIZINHOS,12917,10031,5180,28648,223,23468,297
PR,75426,GUAMIRANGA,2346,2948,1010,6465,68,5455,93
PR,75434,DOUTOR CAMARGO,1624,2413,608,4788,46,4180,97
PR,75442,IMBAÚ,2905,3113,1879,8101,77,6222,127
PR,75450,ENÉAS MARQUES,2654,1650,698,5125,30,4427,93
PR,75469,MANFRINÓPOLIS,1480,733,628,2883,12,2255,30
PR,75477,ENGENHEIRO BELTRÃO,3620,4903,2288,11045,80,8757,154
PR,75485,MARQUINHO,1527,1343,1148,4093,22,2945,53
PR,75493,FAXINAL,2959,6208,2608,12058,95,9450,188
PR,75507,PEROBAL,1938,2155,932,5186,63,4254,98
PR,75515,FÊNIX,1346,1648,955,4035,24,3080,62
PR,75523,PONTAL DO PARANÁ,4700,7225,4942,17396,195,12454,334
PR,75531,FLORAÍ,1745,1963,589,4420,54,3831,69
PR,75540,PORTO BARREIRO,1362,1053,586,3049,14,2463,34
PR,75558,FLORESTA,1616,2684,490,4904,33,4414,81
PR,75566,PRADO FERREIRA,1533,994,509,3117,26,2608,55
PR,75574,FLORESTÓPOLIS,4500,2978,2065,9747,75,7682,129
PR,75582,QUARTO CENTENÁRIO,1679,1354,839,3937,27,3098,38
PR,75590,FLÓRIDA,1037,800,389,2267,12,1878,29
PR,75604,RESERVA DO IGUAÇU,2495,1383,1654,5659,45,4005,82
PR,75612,FORMOSA DO OESTE,2093,2832,1173,6254,54,5081,102
PR,75620,RIO BRANCO DO IVAÍ,1182,1164,1099,3508,21,2409,42
PR,75639,FOZ DO IGUAÇU,58358,81904,45373,190014,1606,144641,2773
PR,75647,SERRANÓPOLIS DO IGUAÇU,1433,2105,556,4158,18,3602,46
PR,75655,FRANCISCO BELTRÃO,25501,22452,10856,60041,439,49185,793
PR,75663,TAMARANA,2438,3779,1027,7435,59,6408,132
PR,75671,GENERAL CARNEIRO,4433,2737,2698,10068,61,7370,139
PR,75698,GOIOERÊ,7572,9182,4973,22194,178,17221,289
PR,75710,GUAÍRA,7293,9829,5046,22668,199,17622,301
PR,75736,GUAIRAÇÁ,1290,2608,960,5012,59,4052,95
PR,75744,ROSÁRIO DO IVAÍ,1552,1913,1433,5020,26,3587,96
PR,75752,GUAPIRAMA,1125,1489,887,3629,30,2742,98
PR,75760,NOVA TEBAS,2286,1860,1450,5722,31,4272,95
PR,75779,GUAPOREMA,687,780,436,1924,8,1488,13
PR,75787,SULINA,1356,942,521,2882,16,2361,47
PR,75795,GUARACI,1369,2072,602,4140,32,3538,65
PR,75809,LUIZIANA,2288,2320,1285,6036,41,4751,102
PR,75817,GUARANIAÇU,3207,5521,2690,11638,76,8948,144
PR,75833,GUARAPUAVA,45652,48726,24852,122341,1143,97489,1968
PR,75850,GUARAQUEÇABA,2468,2084,2364,7026,40,4662,70
PR,75876,GUARATUBA,6596,11510,7217,25978,256,18761,399
PR,75892,IBAITI,5769,10464,5782,22645,254,16863,376
PR,75914,IBIPORÃ,8919,20811,7401,38457,446,31056,880
PR,75930,ICARAÍMA,2447,2842,1666,7114,60,5448,99
PR,75957,IGUARAÇU,1248,1532,553,3434,35,2881,66
PR,75973,IMBITUVA,4854,12711,3287,21365,194,18078,319
PR,75990,INÁCIO MARTINS,3780,2502,1783,8248,67,6465,116
PR,76015,INAJÁ,1110,828,574,2593,17,2019,64
PR,76031,IPIRANGA,2979,5707,1857,10773,90,8916,140
PR,76058,IPORÃ,3796,5218,2326,11621,114,9295,167
PR,76074,IRATI,12138,22637,8105,44016,383,35911,753
PR,76090,IRETAMA,3219,2813,1878,8123,73,6245,140
PR,76112,ITAGUAJÉ,1440,1298,816,3647,34,2831,59
PR,76139,ITAMBARACÁ,1652,2245,1142,5165,38,4023,88
PR,76155,ITAMBÉ,1648,2318,752,4821,22,4069,81
PR,76171,ITAPEJARA D'OESTE,4107,2912,1340,8517,70,7177,88
PR,76198,ITAÚNA DO SUL,1311,900,907,3192,22,2285,52
PR,76210,IVAÍ,2759,5462,1275,9691,66,8416,129
PR,76236,IVAIPORÃ,8070,10276,5219,24082,197,18863,320
PR,76252,IVATUBA,863,904,338,2151,16,1813,30
PR,76279,JABOTI,1127,1858,757,3850,37,3093,71
PR,76295,JACAREZINHO,12185,10896,7575,31514,306,23939,552
PR,76317,JAGUAPITÃ,2607,4850,2064,9846,124,7782,201
PR,76333,JAGUARIAÍVA,7279,12149,5535,25528,227,19993,338
PR,76350,JANDAIA DO SUL,4250,8889,2900,16469,148,13569,282
PR,76376,JANIÓPOLIS,2333,1787,1512,5804,42,4292,130
PR,76392,JAPIRA,1548,1451,1066,4186,53,3120,68
PR,76414,JAPURÁ,1903,3804,1017,6925,74,5908,127
PR,76430,JARDIM ALEGRE,2905,4057,2305,9512,86,7207,159
PR,76457,JARDIM OLINDA,653,372,330,1382,10,1052,17
PR,76473,JATAIZINHO,2641,4781,1814,9530,101,7716,193
PR,76490,JOAQUIM TÁVORA,2923,3578,1673,8397,76,6724,147
PR,76511,JUNDIAÍ DO SUL,1170,764,623,2616,24,1993,35
PR,76538,JUSSARA,1926,2378,1116,5588,59,4472,109
PR,76554,KALORÉ,1214,1792,665,3775,35,3110,69
PR,76570,LAPA,9698,18902,6217,35986,504,29769,665
PR,76597,LARANJEIRAS DO SUL,8897,8676,5947,24042,169,18095,353
PR,76619,LEÓPOLIS,1462,1201,775,3509,13,2734,58
PR,76635,LOANDA,4971,6901,3667,15922,125,12255,258
PR,76651,LOBATO,1613,1361,655,3709,27,3054,53
PR,76678,LONDRINA,63311,219839,34139,331325,4041,297186,9995
PR,76694,LUPIONÓPOLIS,1687,1358,816,3981,38,3165,82
PR,76716,MALLET,3837,4378,1959,10454,80,8495,200
PR,76732,MAMBORÊ,3142,5449,2400,11243,78,8843,174
PR,76759,MANDAGUAÇU,6221,6442,2830,16015,179,13185,343
PR,76775,MANDAGUARI,8035,12645,5079,26602,263,21523,580
PR,76791,MANDIRITUBA,6639,7117,3347,17632,228,14285,301
PR,76813,MANOEL RIBAS,2516,5309,2458,10473,57,8015,133
PR,76830,MARECHAL CÂNDIDO RONDON,11207,18543,6296,36801,259,30505,496
PR,76856,MARIA HELENA,1986,1716,706,4500,24,3794,68
PR,76872,MARIALVA,7886,13338,4877,26880,280,22003,499
PR,76899,MARILUZ,3358,2834,1811,8198,75,6387,120
PR,76910,MARINGÁ,70875,137480,32938,249119,2539,216181,5287
PR,76937,MARIÓPOLIS,2119,2072,809,5095,26,4286,69
PR,76953,MARMELEIRO,5086,3535,2202,10988,69,8786,96
PR,76970,MARUMBI,1442,1697,497,3730,24,3233,70
PR,76996,MATELÂNDIA,2369,7370,2787,12781,91,9994,164
PR,77011,MEDIANEIRA,10842,14802,6766,33155,269,26389,476
PR,77038,MIRADOR,916,633,511,2112,19,1601,33
PR,77054,MIRASELVA,758,776,298,1870,14,1572,24
PR,77070,MOREIRA SALES,3156,4324,1789,9529,101,7740,159
PR,77097,MORRETES,4377,6203,3753,14785,189,11032,263
PR,77119,MUNHOZ DE MELO,1187,1409,553,3236,33,2683,54
PR,77135,NOSSA SENHORA DAS GRAÇAS,1465,1042,669,3279,38,2610,65
PR,77151,NOVA ALIANÇA DO IVAÍ,599,542,337,1517,9,1180,30
PR,77178,NOVA AMÉRICA DA COLINA,1235,1122,511,2950,35,2439,47
PR,77194,NOVA CANTU,2403,2022,2082,6611,30,4529,74
PR,77216,NOVA ESPERANÇA,6797,9209,4649,21206,228,16557,323
PR,77232,NOVA FÁTIMA,2084,2463,1672,6395,67,4723,109
PR,77259,NOVA LONDRINA,3555,3612,2945,10367,105,7422,150
PR,77275,ORTIGUEIRA,7430,4672,4373,16859,133,12486,251
PR,77291,OURIZONA,1414,1006,444,2944,22,2500,58
PR,77313,PAIÇANDU,12143,9271,3287,25596,370,22309,525
PR,77330,PALMAS,10523,10241,7435,28735,212,21300,324
PR,77356,PALMEIRA,6390,14228,4734,25949,231,21215,366
PR,77372,PALMITAL,5001,3226,3702,12152,64,8450,159
PR,77399,PALOTINA,6608,11040,4129,22209,136,18080,296
PR,77410,PARAÍSO DO NORTE,4143,3208,1365,8930,60,7565,154
PR,77437,PARANACITY,2981,2845,1768,7822,77,6054,151
PR,77453,PARANAGUÁ,25982,54139,19563,103226,1323,83663,2219
PR,77470,PARANAPOEMA,1002,671,351,2063,11,1712,28
PR,77496,PARANAVAÍ,17382,29811,13225,62052,581,48827,1053
PR,77518,PATO BRANCO,19180,24391,10579,55334,409,44755,775
PR,77534,PAULA FREITAS,1457,2082,762,4385,36,3623,48
PR,77550,PAULO FRONTIN,1893,2606,900,5531,54,4631,78
PR,77577,PEABIRU,3461,4449,2453,10619,92,8166,164
PR,77593,PÉROLA D'OESTE,2236,2114,868,5314,28,4446,68
PR,77615,PIÊN,2605,4891,1084,8790,82,7706,128
PR,77631,PINHALÃO,1552,2631,1371,5686,41,4315,91
PR,77658,PINHÃO,10420,6582,6127,23618,161,17491,328
PR,77674,PIRAÍ DO SUL,4970,9488,3960,19031,280,15071,333
PR,77690,PIRAQUARA,21908,23997,12521,60697,911,48176,1360
PR,77712,PITANGA,9954,9213,6947,26591,142,19644,335
PR,77739,PLANALTINA DO PARANÁ,1491,1087,689,3357,34,2668,56
PR,77755,PLANALTO,5019,3308,2309,10816,73,8507,107
PR,77771,PONTA GROSSA,64553,119934,41309,233256,2730,191947,4730
PR,77798,PORECATU,4556,3595,2483,10922,108,8439,180
PR,77810,PORTO AMAZONAS,712,2077,730,3645,45,2915,81
PR,77836,PORTO RICO,1159,688,488,2379,12,1891,32
PR,77852,PORTO VITÓRIA,1137,1412,629,3237,17,2608,42
PR,77879,PRESIDENTE CASTELO BRANCO,1946,1173,736,3980,52,3244,73
PR,77895,PRIMEIRO DE MAIO,2730,3971,1360,8303,80,6943,162
PR,77917,PRUDENTÓPOLIS,9124,20503,6729,37204,318,30475,530
PR,77933,QUATIGUÁ,1816,3141,1131,6260,53,5129,119
PR,77950,QUATRO BARRAS,3478,7975,2309,14380,213,12071,405
PR,77976,QUERÊNCIA DO NORTE,3781,2540,2034,8566,61,6532,150
PR,77992,QUINTA DO SOL,1747,1620,953,4451,37,3498,94
PR,78018,QUITANDINHA,3579,6940,1809,12674,139,10865,207
PR,78034,RANCHO ALEGRE,1035,1443,572,3151,29,2579,72
PR,78050,REALEZA,5484,4950,2564,13282,87,10718,197
PR,78077,REBOUÇAS,4395,5070,2513,12269,131,9756,160
PR,78093,RENASCENÇA,2405,1785,817,5123,41,4306,75
PR,78115,RESERVA,6178,8804,4226,19659,162,15433,289
PR,78131,RIBEIRÃO CLARO,3253,3766,1628,8979,117,7351,215
PR,78158,RIBEIRÃO DO PINHAL,4622,3247,3294,11439,81,8145,195
PR,78174,RIO AZUL,3378,5424,1781,10845,82,9064,180
PR,78190,RIO BOM,876,1368,484,2834,28,2350,78
PR,78212,RIO BRANCO DO SUL,10611,8852,4312,24415,277,20103,363
PR,78239,RIO NEGRO,4637,13889,4334,23470,257,19136,353
PR,78255,ROLÂNDIA,10080,26275,8132,45930,512,37798,931
PR,78271,RONCADOR,3330,3001,2002,8553,69,6551,151
PR,78298,RONDON,2040,3806,1265,7279,54,6014,114
PR,78310,SABÁUDIA,1180,3147,710,5203,55,4493,111
PR,78336,SALGADO FILHO,1436,1446,787,3749,23,2962,57
PR,78352,SALTO DO ITARARÉ,1641,1597,909,4296,54,3387,95
PR,78379,SALTO DO LONTRA,5605,2653,2096,10517,73,8421,90
PR,78395,SANTA AMÉLIA,1174,1171,640,3080,39,2440,56
PR,78417,SANTA CECÍLIA DO PAVÃO,917,1437,625,3079,31,2454,69
PR,78433,SANTA CRUZ DE MONTE CASTELO,3101,2160,1322,6700,43,5378,74
PR,78450,SANTA FÉ,2993,3599,1210,7987,51,6777,134
PR,78476,SANTA INÊS,646,694,385,1754,5,1369,24
PR,78492,SANTA ISABEL DO IVAÍ,2499,2865,1563,7102,51,5539,124
PR,78514,SANTA IZABEL DO OESTE,3776,3152,1525,8598,47,7073,98
PR,78530,SANTA MARIANA,3863,3531,2522,10244,99,7722,229
PR,78557,SANTANA DO ITARARÉ,1669,1694,1014,4460,36,3446,47
PR,78573,SANTO ANTÔNIO DO SUDOESTE,6302,4991,2729,14256,74,11527,160
PR,78590,SANTO ANTÔNIO DA PLATINA,10788,13665,6460,31866,429,25406,524
PR,78611,SANTO ANTONIO DO CAIUÁ,1069,825,506,2456,18,1950,38
PR,78638,SANTO ANTÔNIO DO PARAÍSO,623,1039,569,2263,14,1694,18
PR,78654,SANTO INÁCIO,1727,1746,828,4434,43,3606,90
PR,78670,SÃO CARLOS DO IVAÍ,1345,2547,955,4988,53,4033,88
PR,78697,SÃO JERÔNIMO DA SERRA,3341,2819,2625,9077,92,6452,200
PR,78719,SÃO JOÃO,3607,3174,1296,8273,71,6977,125
PR,78735,SÃO JOÃO DO CAIUÁ,2089,1503,1183,4914,50,3731,89
PR,78751,SÃO JOÃO DO IVAÍ,3633,3485,1990,9372,78,7382,186
PR,78778,SÃO JOÃO DO TRIUNFO,5004,3758,1870,10904,105,9034,167
PR,78794,SÃO JORGE DO IVAÍ,1467,2235,687,4490,31,3803,70
PR,78816,SÃO JORGE D'OESTE,3136,2979,1238,7514,69,6276,92
PR,78832,SÃO JOSÉ DA BOA VISTA,1035,2514,1094,4750,38,3656,69
PR,78859,SÃO JOSÉ DOS PINHAIS,53446,93417,34482,188936,2688,154454,4903
PR,78875,SÃO MATEUS DO SUL,11063,14619,5565,32023,301,26458,475
PR,78891,SÃO MIGUEL DO IGUAÇU,8553,7678,4882,21497,132,16615,252
PR,78913,SÃO PEDRO DO IVAÍ,2902,2832,1400,7314,49,5914,131
PR,78930,SÃO PEDRO DO PARANÁ,779,1054,426,2323,15,1897,49
PR,78956,SÃO SEBASTIÃO DA AMOREIRA,2884,2465,1419,6955,49,5536,138
PR,78972,SÃO TOMÉ,1191,2545,705,4534,37,3829,56
PR,78999,SAPOPEMA,2101,1818,1266,5329,48,4063,96
PR,79014,SENGÉS,3689,6497,3585,14185,141,10600,273
PR,79030,SERTANEJA,1527,2300,1018,4969,37,3951,87
PR,79057,SERTANÓPOLIS,3195,6835,2802,13211,138,10409,241
PR,79073,SIQUEIRA CAMPOS,5254,6511,3291,15559,160,12268,343
PR,79090,TAMBOARA,1316,1878,650,3989,45,3339,100
PR,79111,TAPEJARA,4988,4045,2237,11578,126,9341,182
PR,79138,TEIXEIRA SOARES,2810,3156,1611,7739,54,6128,108
PR,79154,TELÊMACO BORBA,15393,22517,11091,50405,622,39314,782
PR,79170,TERRA BOA,2977,6928,2320,12520,94,10200,201
PR,79197,TERRA RICA,3750,5484,2487,12086,111,9599,254
PR,79219,TERRA ROXA,4216,5841,2417,12769,107,10352,188
PR,79235,TIBAGI,5015,5739,3744,14831,135,11087,198
PR,79251,TIJUCAS DO SUL,4331,4554,2184,11337,128,9153,140
PR,79278,TOLEDO,28916,45471,16502,93045,726,76543,1430
PR,79294,TOMAZINA,2064,3006,1457,6701,49,5244,125
PR,79316,TUNEIRAS DO OESTE,2792,2548,1212,6710,56,5498,102
PR,79332,UBIRATÃ,5570,7931,2922,16763,122,13841,218
PR,79359,UMUARAMA,21589,36482,17076,77036,673,59960,1216
PR,79375,UNIÃO DA VITÓRIA,11497,19925,9328,41824,381,32496,693
PR,79391,UNIFLOR,1052,721,257,2053,9,1796,14
PR,79413,URAÍ,3036,3672,1456,8431,78,6975,189
PR,79430,WENCESLAU BRAZ,3009,8152,3373,14875,113,11502,228
PR,79456,VERÊ,3359,2288,931,6706,63,5775,65
PR,79472,VITORINO,1639,2306,1054,5084,28,4030,57
PR,79499,XAMBRÊ,2247,1801,943,5089,38,4146,60
PR,79510,ALTÔNIA,4945,6855,2603,14807,178,12204,226
PR,79537,ASSIS CHATEAUBRIAND,8436,11461,4795,25299,202,20504,405
PR,79553,QUEDAS DO IGUAÇU,6810,10361,6466,24060,129,17594,294
PR,79570,CÉU AZUL,2248,4524,1810,8770,45,6960,143
PR,79596,GRANDES RIOS,1553,2238,1534,5416,26,3882,65
PR,79618,INDIANÓPOLIS,1046,1775,587,3519,50,2932,61
PR,79634,MATINHOS,7443,11277,8438,27886,243,19448,485
PR,79650,NOVA AURORA,3431,4247,1894,9818,95,7924,151
PR,79677,NOVA OLÍMPIA,1799,1907,798,4606,43,3808,59
PR,79693,PÉROLA,3592,3035,1327,8167,99,6840,114
PR,79715,SANTA HELENA,8759,7064,4032,20262,142,16230,265
PR,79731,TAPIRA,2013,1717,780,4610,35,3830,65
PR,79758,MARILENA,2748,1664,1434,6020,58,4586,116
PR,79774,FRANCISCO ALVES,1996,2028,922,5070,55,4148,69
PR,79790,NOVA SANTA ROSA,1539,3861,931,6436,43,5505,62
PR,79812,BOA VISTA DA APARECIDA,2727,2179,1617,6674,46,5057,105
PR,79839,BRAGANEY,1746,1937,838,4594,37,3756,36
PR,79855,CAFELÂNDIA,3670,5253,1869,11023,73,9154,158
PR,79871,TRÊS BARRAS DO PARANÁ,3212,3771,1680,8840,66,7160,111
PR,79898,VERA CRUZ DO OESTE,2134,3278,1482,7040,41,5558,105
PR,79910,PRANCHITA,1624,2084,823,4627,36,3804,60
PR,79936,TUPÃSSI,2067,3189,988,6366,35,5378,87
PR,79952,NOVA PRATA DO IGUAÇU,4217,2340,1402,8076,47,6674,70
PR,79979,JESUÍTAS,2542,3225,1047,7035,70,5988,151
PR,79995,SÃO JORGE DO PATROCÍNIO,2122,1901,736,4860,44,4124,57
PR,84514,CANTAGALO,3492,3170,2861,9706,56,6845,127
PR,84530,TURVO,5140,3482,2464,11331,64,8867,181
PR,84557,ALTAMIRA DO PARANÁ,1370,1210,1469,4109,14,2640,46
PR,84573,FIGUEIRA,2431,2376,1886,6843,52,4957,98
PR,84590,LUNARDELLI,1371,1868,825,4163,41,3338,58
PR,84611,SARANDI,27611,20475,12035,62037,816,50002,1100
PR,84638,JURANDA,1654,3167,1081,6029,51,4948,76
PR,84654,DOURADINA,2519,2266,977,5888,35,4911,91
PR,84670,SANTA TEREZINHA DE ITAIPU,4648,8508,3466,16954,129,13488,203
PR,84697,MISSAL,3716,3298,1342,8529,53,7187,120
PR,84719,SÃO JOSÉ DAS PALMEIRAS,1419,1262,535,3289,26,2754,47
RJ,58009,QUISSAMÃ,6883,4590,4147,17083,296,12936,1167
RJ,58017,ANGRA DOS REIS,41014,40997,29470,121898,2315,92428,8102
RJ,58025,QUATIS,3489,3680,1885,9853,195,7968,604
RJ,58033,ARARUAMA,25817,32739,23844,90834,1828,66990,6606
RJ,58041,BELFORD ROXO,162708,54756,68894,319962,7195,251068,26409
RJ,58050,BARRA DO PIRAÍ,26653,23062,15525,71384,1419,55859,4725
RJ,58068,CARDOSO MOREIRA,3939,3365,2776,10910,155,8134,675
RJ,58076,BARRA MANSA,53489,43203,24014,132298,2416,108284,9176
RJ,58084,VARRE-SAI,2221,3089,1729,7669,126,5940,504
RJ,58092,BOM JARDIM,5693,8334,4734,21215,384,16481,2070
RJ,58106,GUAPIMIRIM,13561,11251,9622,37843,736,28221,2673
RJ,58114,BOM JESUS DO ITABAPOANA,9113,10108,7251,28519,335,21268,1712
RJ,58122,QUEIMADOS,52555,20460,22102,104941,2248,82839,7576
RJ,58130,CABO FRIO,38884,50268,38355,139918,2927,101563,9484
RJ,58149,JAPERI,33872,12936,16095,69766,1511,53671,5352
RJ,58157,CACHOEIRAS DE MACACU,16863,12452,10183,44102,975,33919,3629
RJ,58165,COMENDADOR LEVY GASPARIAN,3754,1723,1101,7138,94,6037,466
RJ,58173,CAMBUCI,4558,3366,2500,11250,142,8750,684
RJ,58181,APERIBÉ,3152,3114,1695,8701,138,7006,602
RJ,58190,CAMPOS DOS GOYTACAZES,129689,107652,81254,355014,9596,273760,26823
RJ,58203,RIO DAS OSTRAS,24513,25894,21967,80008,1774,58041,5860
RJ,58211,CANTAGALO,4625,6543,3707,16338,286,12631,1177
RJ,58220,AREAL,3208,3498,1678,9154,195,7476,575
RJ,58238,CARMO,5767,4116,2851,13863,173,11012,956
RJ,58246,PINHEIRAL,7709,4446,2938,16321,202,13383,1026
RJ,58254,CASIMIRO DE ABREU,8409,10315,7181,28527,541,21346,2081
RJ,58262,IGUABA GRANDE,6122,7547,5781,21016,330,15235,1236
RJ,58270,CONCEIÇÃO DE MACABU,5926,4958,4263,16870,370,12607,1353
RJ,58289,SÃO FRANCISCO DE ITABAPOANA,9270,12179,11563,35833,868,24270,1953
RJ,58297,CORDEIRO,4932,5937,3773,16291,342,12518,1307
RJ,58300,CARAPEBUS,4391,3170,2549,11236,310,8687,816
RJ,58319,DUAS BARRAS,2672,3607,1839,9078,157,7239,803
RJ,58327,PORTO REAL,5377,5603,2721,14989,284,12268,1004
RJ,58335,DUQUE DE CAXIAS,290254,130097,128028,620658,14691,492630,57588
RJ,58343,SÃO JOSÉ DE UBÁ,2629,2433,1383,6945,76,5562,424
RJ,58351,ENGENHEIRO PAULO DE FRONTIN,3358,3788,1602,9690,179,8088,763
RJ,58360,TANGUÁ,11858,4480,4804,23074,402,18270,1530
RJ,58378,ITABORAÍ,82860,31252,34691,164992,3549,130301,12640
RJ,58386,MACUCO,2454,2212,1302,6558,95,5256,495
RJ,58394,ITAGUAÍ,36297,23230,19090,86783,2091,67693,6075
RJ,58408,ARMAÇÃO DOS BÚZIOS,7248,8502,5583,23164,460,17581,1371
RJ,58416,ITAOCARA,5877,7237,4054,18801,399,14747,1234
RJ,58424,SEROPÉDICA,23507,13698,11440,53783,1173,42343,3965
RJ,58432,ITAPERUNA,22321,26931,19198,74182,1198,54984,4534
RJ,58440,ITATIAIA,7988,8390,5055,23017,339,17962,1245
RJ,58459,LAJE DO MURIAÉ,2916,1611,1934,7043,106,5109,476
RJ,58467,MESQUITA,58242,32605,28178,133073,2923,104895,11125
RJ,58475,MACAÉ,55213,41302,39321,150802,3686,111481,11280
RJ,58491,MAGÉ,76202,39962,38385,172917,4088,134532,14280
RJ,58513,MANGARATIBA,10002,10870,7634,31175,568,23541,2101
RJ,58530,MARICÁ,37354,26741,20641,92348,1449,71707,6163
RJ,58556,MENDES,5213,5126,3156,14930,272,11774,1163
RJ,58572,MIGUEL PEREIRA,6973,8267,5153,22121,316,16968,1412
RJ,58599,MIRACEMA,8562,5746,6021,22142,382,16121,1431
RJ,58610,NATIVIDADE,3793,4368,2789,12017,141,9228,926
RJ,58637,NILÓPOLIS,56628,35693,24179,129561,2822,105382,10239
RJ,58653,NITERÓI,122285,149084,48032,353029,6171,304997,27457
RJ,58670,NOVA FRIBURGO,37825,59551,34540,149029,3480,114489,13633
RJ,58696,NOVA IGUAÇU,245579,139012,123614,573910,14090,450296,51615
RJ,58718,PARACAMBI,12657,10810,6245,32949,685,26704,2552
RJ,58734,PARAÍBA DO SUL,11027,11315,7769,33389,755,25620,2523
RJ,58750,PARATY,6564,10715,7053,26604,522,19551,1750
RJ,58777,PETRÓPOLIS,60779,103669,56480,244356,5112,187876,18316
RJ,58793,PIRAÍ,8843,6462,3916,20835,312,16919,1302
RJ,58815,PORCIÚNCULA,5201,3838,3926,13985,187,10059,833
RJ,58831,RESENDE,25243,37825,19381,89726,1821,70345,5456
RJ,58858,RIO BONITO,16102,14492,9393,44309,888,34916,3434
RJ,58874,RIO CLARO,5899,4345,3457,14869,212,11412,956
RJ,58890,RIO DAS FLORES,3162,2417,1503,7651,82,6148,487
RJ,58912,SANTA MARIA MADALENA,2238,3046,2182,8343,134,6161,743
RJ,58939,SANTO ANTÔNIO DE PÁDUA,10718,11351,7828,32607,498,24779,2212
RJ,58955,SÃO FIDÉLIS,7486,11990,8468,30182,441,21714,1797
RJ,58971,SÃO GONÇALO,309457,145466,147093,678439,15597,531346,60826
RJ,58998,SÃO JOÃO DA BARRA,10648,12940,7858,34508,836,26650,2226
RJ,59013,SÃO JOÃO DE MERITI,158646,81749,81300,364171,8891,282871,33585
RJ,59030,SÃO PEDRO DA ALDEIA,16725,21883,15703,59406,1226,43703,3869
RJ,59056,SÃO SEBASTIÃO DO ALTO,2708,2068,2073,7525,144,5452,532
RJ,59072,SAPUCAIA,5944,5296,3824,16418,265,12594,1089
RJ,59099,SAQUAREMA,18390,20565,17070,61322,962,44252,4335
RJ,59110,SILVA JARDIM,6243,4784,4545,17057,296,12512,1189
RJ,59137,SUMIDOURO,4169,5368,2689,13241,227,10552,788
RJ,59153,TERESÓPOLIS,25048,59235,29066,124463,2437,95397,8677
RJ,59170,TRAJANO DE MORAIS,3299,2363,2257,8816,164,6559,733
RJ,59196,TRÊS RIOS,27823,15289,12254,60511,1295,48257,3850
RJ,59218,VALENÇA,21176,17916,13876,57863,942,43987,3953
RJ,59234,VASSOURAS,9236,10464,7108,29079,441,21971,1830
RJ,59250,VOLTA REDONDA,90170,71527,41344,221207,3632,179863,14534
RJ,59277,ARRAIAL DO CABO,7531,9211,8120,26918,478,18798,1578
RJ,59293,ITALVA,3542,3961,2650,10900,150,8250,597
RJ,59315,PATY DO ALFERES,8879,6200,5223,21956,313,16733,1341
RJ,59331,SÃO JOSÉ DO VALE DO RIO PRETO,3290,7444,3520,15510,268,11990,988
RJ,60011,RIO DE JANEIRO,1626751,1577972,1110019,4837351,105407,3727332,417202
RN,16004,TENENTE LAURENTINO CRUZ,2753,687,1013,4757,55,3744,249
RN,16012,ACARI,4909,2377,1903,9734,74,7831,471
RN,16020,SERRA DO MEL,4957,1732,1033,8366,119,7333,525
RN,16039,ASSÚ,24993,6162,4501,38849,625,34348,2568
RN,16047,CAIÇARA DO NORTE,2431,973,1515,5232,73,3717,240
RN,16055,AFONSO BEZERRA,5032,1377,2389,9372,78,6983,496
RN,16063,SÃO MIGUEL DO GOSTOSO,3971,1396,1657,7510,89,5853,397
RN,16071,ÁGUA NOVA,1679,172,284,2283,21,1999,127
RN,16080,ITAJÁ,3968,687,720,5794,61,5074,358
RN,16098,ALEXANDRIA,6718,984,1875,10113,52,8238,484
RN,16101,BODÓ,1563,446,682,2903,37,2221,175
RN,16110,ALMINO AFONSO,2905,658,736,4583,49,3847,235
RN,16128,TRIUNFO POTIGUAR,2096,719,810,3846,35,3036,186
RN,16136,ALTO DO RODRIGUES,6643,1693,1792,10815,119,9023,568
RN,16144,FERNANDO PEDROZA,1764,532,625,3097,24,2472,152
RN,16152,ANGICOS,5575,1656,1674,9504,112,7830,487
RN,16160,MAJOR SALES,1810,254,636,2846,18,2210,128
RN,16179,ANTÔNIO MARTINS,3749,614,1227,5945,68,4718,287
RN,16187,VENHA-VER,1969,314,1248,3775,34,2527,210
RN,16195,APODI,18542,3400,4817,28250,299,23433,1192
RN,16209,SERRINHA DOS PINTOS,2216,664,943,4078,59,3135,196
RN,16217,AREIA BRANCA,9477,4528,2877,18927,412,16050,1633
RN,16225,TIBAU,2120,709,424,3543,55,3119,235
RN,16233,ARÊS,5645,2133,1668,10343,149,8675,748
RN,16241,SANTA MARIA,2567,754,932,4556,70,3624,233
RN,16250,CAMPO GRANDE,4798,1199,1795,8236,93,6441,351
RN,16268,RIO DO FOGO,4956,1796,3145,10539,131,7394,511
RN,16276,BAÍA FORMOSA,3496,1360,1942,7216,87,5274,331
RN,16284,PORTO DO MANGUE,2535,775,468,4087,62,3619,247
RN,16292,BARCELONA,1827,1140,624,3895,45,3271,259
RN,16306,JUNDIÁ,1962,713,573,3523,69,2950,206
RN,16314,BENTO FERNANDES,2872,611,882,4643,44,3761,234
RN,16330,BOM JESUS,3678,1727,1151,7089,93,5938,440
RN,16357,BREJINHO,4304,2052,1004,8226,165,7222,701
RN,16373,CAIÇARA DO RIO DO VENTO,1955,653,680,3538,44,2858,206
RN,16390,CAICÓ,23701,9355,8491,44416,552,35925,2317
RN,16411,CAMPO REDONDO,4980,625,1737,7940,93,6203,505
RN,16438,CANGUARETAMA,12502,3615,6118,23839,332,17721,1272
RN,16454,CARAÚBAS,10857,2302,2857,17175,233,14318,926
RN,16470,CARNAÚBA DOS DANTAS,2558,1794,913,5917,107,5004,545
RN,16497,CARNAUBAIS,4986,1187,808,7571,131,6763,459
RN,16519,CEARÁ-MIRIM,29635,6819,11084,51755,783,40671,3434
RN,16535,CERRO CORÁ,3802,1777,2314,8553,100,6239,560
RN,16551,CORONEL EZEQUIEL,2716,729,1087,4879,55,3792,292
RN,16578,CORONEL JOÃO PESSOA,2196,325,1023,3846,37,2823,265
RN,16594,CRUZETA,4267,1112,1345,7103,90,5758,289
RN,16616,CURRAIS NOVOS,13635,8089,8578,33082,447,24504,2333
RN,16632,DOUTOR SEVERIANO,3310,525,1238,5418,41,4180,304
RN,16659,ENCANTO,2784,414,449,3924,30,3475,247
RN,16675,EQUADOR,2303,998,509,4199,75,3690,314
RN,16691,ESPÍRITO SANTO,3444,1778,1834,7559,109,5725,394
RN,16713,EXTREMOZ,10199,4764,3134,19797,277,16663,1423
RN,16730,FELIPE GUERRA,4671,544,641,6196,74,5555,266
RN,16756,FLORÂNIA,4393,1444,1454,7834,86,6380,457
RN,16772,FRANCISCO DANTAS,1589,392,332,2491,23,2159,155
RN,16799,GALINHOS,982,566,545,2203,25,1658,85
RN,16810,GOIANINHA,8019,5248,3129,18197,426,15068,1375
RN,16837,GOVERNADOR DIX-SEPT ROSADO,6924,1305,1480,10610,217,9130,684
RN,16853,GROSSOS,4266,1492,698,7249,229,6551,564
RN,16870,GUAMARÉ,6910,2066,2322,12099,164,9777,637
RN,16896,IELMO MARINHO,5878,1586,1236,9344,103,8108,541
RN,16918,IPANGUAÇU,7300,1636,1527,11339,190,9812,686
RN,16934,IPUEIRA,1104,330,374,1907,20,1533,79
RN,16950,ITAÚ,3119,487,1099,4984,52,3885,227
RN,16977,JAÇANÃ,2513,1613,1630,6309,98,4679,455
RN,16993,JANDAÍRA,3218,983,1305,5898,58,4593,334
RN,17019,JANDUÍS,2476,843,980,4546,58,3566,189
RN,17035,BOA SAÚDE,3437,1631,2095,7782,124,5687,495
RN,17051,JAPI,3145,808,1110,5366,40,4256,263
RN,17078,JARDIM DE ANGICOS,1746,318,563,2762,15,2199,120
RN,17094,JARDIM DE PIRANHAS,6931,1369,2571,11425,89,8854,465
RN,17116,JARDIM DO SERIDÓ,5802,2125,1860,10504,149,8644,568
RN,17132,JOÃO CÂMARA,13355,4382,5784,25229,308,19445,1400
RN,17159,JOÃO DIAS,1478,288,533,2504,27,1971,178
RN,17175,JOSÉ DA PENHA,3326,427,1093,5193,54,4100,293
RN,17191,JUCURUTU,8126,2612,3451,15202,168,11751,845
RN,17213,MESSIAS TARGINO,2333,940,587,4108,47,3521,201
RN,17230,LAGOA D'ANTA,3145,671,1111,5271,56,4160,288
RN,17256,LAGOA DE PEDRAS,3838,915,1383,6572,91,5189,345
RN,17272,LAGOA DE VELHOS,1731,621,407,2980,30,2573,191
RN,17299,LAGOA NOVA,5783,2412,2927,11925,154,8998,649
RN,17310,LAGOA SALGADA,4260,1466,695,7129,156,6434,552
RN,17337,LAJES,4767,1387,2067,8794,75,6727,498
RN,17353,LAJES PINTADAS,2795,606,1094,4885,61,3791,329
RN,17370,LUCRÉCIA,2249,264,415,3076,24,2661,124
RN,17396,LUÍS GOMES,4743,567,2594,8306,49,5712,353
RN,17418,MACAÍBA,25719,9260,6586,46102,829,39516,3708
RN,17434,MACAU,12429,3522,3995,21303,292,17308,1065
RN,17450,MARCELINO VIEIRA,4330,541,1229,6463,45,5234,318
RN,17477,MARTINS,3251,1595,1588,6866,79,5278,353
RN,17493,MAXARANGUAPE,4377,1980,2064,9050,97,6986,532
RN,17515,FRUTUOSO GOMES,2341,430,693,3647,34,2954,149
RN,17531,MONTANHAS,5188,1046,2681,9478,92,6797,471
RN,17558,MONTE ALEGRE,8175,3325,1385,13929,206,12544,838
RN,17574,MONTE DAS GAMELEIRAS,1525,379,746,2815,22,2069,143
RN,17590,MOSSORÓ,86311,38858,16432,160017,3119,143585,15297
RN,17612,NATAL,222777,161154,67298,506566,8864,439268,46473
RN,17639,NÍSIA FLORESTA,8603,4492,2996,17940,445,14944,1404
RN,17655,NOVA CRUZ,13433,5694,7838,28704,365,20866,1374
RN,17671,OLHO D'ÁGUA DO BORGES,2712,445,1113,4477,35,3364,172
RN,17698,OURO BRANCO,2452,748,686,4119,39,3433,194
RN,17710,PARANÁ,2210,230,898,3531,22,2633,171
RN,17736,PARAÚ,2253,543,948,4014,46,3066,224
RN,17752,PARAZINHO,2772,652,1045,4740,35,3695,236
RN,17779,PARELHAS,7647,4693,1724,15391,276,13667,1051
RN,17795,PARNAMIRIM,43667,40194,20537,115232,2040,94695,8794
RN,17817,PASSA E FICA,3922,1861,1863,8293,80,6430,567
RN,17833,PASSAGEM,1905,862,1102,4113,38,3011,206
RN,17850,PATU,5339,1360,1812,9009,84,7197,414
RN,17876,PAU DOS FERROS,11614,3269,2088,18106,187,16018,948
RN,17892,PEDRA GRANDE,1858,773,1056,3955,43,2899,225
RN,17914,PEDRA PRETA,1625,414,769,2997,28,2228,161
RN,17930,PEDRO AVELINO,3256,990,1780,6402,44,4622,332
RN,17957,PEDRO VELHO,6184,1864,3436,12281,146,8845,651
RN,17973,PENDÊNCIAS,6192,1752,2618,11182,100,8564,520
RN,17990,PILÕES,2225,230,683,3301,25,2618,138
RN,18015,POÇO BRANCO,5948,1552,2137,10435,187,8298,611
RN,18031,PORTALEGRE,2801,1427,1452,6208,87,4756,441
RN,18058,SERRA CAIADA,4582,859,1738,7704,70,5966,455
RN,18074,PUREZA,3849,1152,1904,7450,103,5546,442
RN,18090,RAFAEL FERNANDES,2968,389,283,3827,29,3544,158
RN,18112,RIACHO DA CRUZ,1563,489,472,2720,29,2248,167
RN,18139,RIACHO DE SANTANA,2214,263,428,3120,24,2692,191
RN,18155,RIACHUELO,3876,960,906,6079,59,5173,278
RN,18171,RODOLFO FERNANDES,2768,585,951,4551,47,3600,200
RN,18198,RUY BARBOSA,1611,936,629,3390,21,2761,193
RN,18210,SÃO FRANCISCO DO OESTE,2154,639,239,3231,35,2992,164
RN,18236,SANTA CRUZ,13655,4847,5679,26076,337,20397,1558
RN,18252,SANTANA DO SERIDÓ,1454,339,202,2149,34,1947,120
RN,18279,SANTANA DO MATOS,6406,2162,2856,12145,119,9289,602
RN,18295,SANTO ANTÔNIO,10657,2049,4250,18214,197,13964,1061
RN,18317,SÃO BENTO DO NORTE,1713,489,961,3337,28,2376,146
RN,18333,SÃO BENTO DO TRAIRÍ,2186,702,705,3844,40,3139,211
RN,18350,SÃO FERNANDO,1933,678,362,3184,33,2822,178
RN,18376,SÃO GONÇALO DO AMARANTE,32094,13980,13208,65671,1090,52463,5299
RN,18392,SÃO JOÃO DO SABUGI,3562,698,918,5407,38,4489,191
RN,18414,SÃO JOSÉ DE MIPIBU,14413,6069,4247,27568,577,23321,2262
RN,18430,SÃO JOSÉ DO CAMPESTRE,5671,1518,2571,10574,167,8003,647
RN,18457,SÃO JOSÉ DO SERIDÓ,2299,876,548,3987,52,3439,212
RN,18473,SÃO MIGUEL,9598,1861,5852,18663,236,12811,1116
RN,18490,SÃO PAULO DO POTENGI,6487,3314,3023,13805,158,10782,823
RN,18511,SÃO PEDRO,3239,1138,1090,5904,71,4814,366
RN,18538,SÃO RAFAEL,3797,1130,1970,7373,86,5403,390
RN,18554,SÃO TOMÉ,5025,1613,1382,8610,79,7228,511
RN,18570,SÃO VICENTE,2782,859,1045,5095,57,4050,352
RN,18597,SENADOR ELÓI DE SOUZA,2979,792,1191,5330,49,4139,319
RN,18619,SENADOR GEORGINO AVELINO,1933,765,708,3655,57,2947,192
RN,18635,SERRA DE SÃO BENTO,2960,719,1401,5464,63,4063,321
RN,18651,SERRA NEGRA DO NORTE,2941,1503,1547,6300,52,4753,257
RN,18678,SERRINHA,3601,1120,1443,6664,102,5221,398
RN,18694,SEVERIANO MELO,4046,866,1896,7225,71,5329,346
RN,18716,SÍTIO NOVO,2736,618,1257,4920,63,3663,246
RN,18732,TABOLEIRO GRANDE,1463,426,365,2378,9,2013,115
RN,18759,TAIPU,5650,1487,2039,10037,146,7998,715
RN,18775,TANGARÁ,5386,2626,3211,12204,208,8993,773
RN,18791,TENENTE ANANIAS,3981,1471,2170,8081,51,5911,408
RN,18813,TIBAU DO SUL,4449,2858,2099,10221,182,8122,633
RN,18830,TIMBAÚBA DOS BATISTAS,1362,462,359,2315,25,1956,107
RN,18856,TOUROS,12591,3614,5369,23402,337,18033,1491
RN,18872,UMARIZAL,5027,1230,2307,9115,103,6808,448
RN,18899,UPANEMA,5757,2112,1900,10475,138,8575,568
RN,18910,VÁRZEA,2900,920,1000,5091,63,4091,208
RN,18937,RAFAEL GODEIRO,1851,569,348,2951,41,2603,142
RN,18953,VERA CRUZ,3879,2676,976,8456,207,7480,718
RN,18970,VIÇOSA,927,198,427,1685,26,1258,107
RN,18996,VILA FLOR,1532,367,487,2541,33,2054,122
RN,30031,BARAÚNA,9558,4160,2004,17411,301,15407,1388
RO,19,GUAJARÁ-MIRIM,9305,10284,5519,26191,172,20672,911
RO,35,PORTO VELHO,110825,117510,58204,302770,3284,244566,12947
RO,51,JI-PARANÁ,25420,34162,22760,85632,653,62872,2637
RO,78,ARIQUEMES,18287,27470,10992,58992,572,48000,1671
RO,94,CACOAL,14585,27170,16444,60230,483,43786,1548
RO,116,PIMENTA BUENO,6775,10790,7524,26161,252,18637,820
RO,132,VILHENA,14096,24055,15591,55864,584,40273,1538
RO,159,JARU,9673,16716,11896,39623,305,27727,1033
RO,175,OURO PRETO DO OESTE,8186,11711,9093,30067,214,20974,863
RO,191,PRESIDENTE MÉDICI,5217,5893,5364,17074,185,11710,415
RO,213,COSTA MARQUES,3689,2294,2510,8792,49,6282,250
RO,230,COLORADO DO OESTE,4438,5318,3384,13720,146,10336,434
RO,256,ESPIGÃO DO OESTE,6077,9309,5659,21753,221,16094,487
RO,272,CEREJEIRAS,2875,6419,4154,13864,95,9710,321
RO,299,ROLIM DE MOURA,11730,14148,10580,37972,349,27392,1165
RO,310,ALTA FLORESTA DO OESTE,5678,7022,5984,19292,147,13308,461
RO,337,ALVORADA DO OESTE,4582,3871,3986,12861,90,8875,332
RO,353,SANTA LUZIA DO OESTE,2536,2546,2249,7626,62,5377,233
RO,370,NOVA BRASILÂNDIA DO OESTE,4203,6159,3963,14840,103,10877,412
RO,396,MACHADINHO DO OESTE,7776,8171,4784,21355,169,16571,455
RO,418,SÃO MIGUEL DO GUAPORÉ,4825,5983,4259,15537,128,11278,342
RO,434,NOVA MAMORÉ,6305,5748,3300,16064,121,12764,590
RO,450,CABIXI,1597,1836,767,4396,40,3629,156
RO,477,CANDEIAS DO JAMARI,6804,4308,3807,15637,123,11830,595
RO,493,ITAPUÃ DO OESTE,2532,1648,1472,5883,42,4411,189
RO,515,NOVO HORIZONTE DO OESTE,3036,2399,2032,7696,46,5664,183
RO,531,CASTANHEIRAS,1273,793,603,2765,10,2162,86
RO,558,VALE DO PARAÍSO,2299,2318,1930,6719,34,4789,138
RO,566,URUPÁ,3340,3273,2854,9780,69,6926,244
RO,574,MIRANTE DA SERRA,2900,3317,2693,9210,68,6517,232
RO,582,SERINGUEIRAS,3196,3120,2520,9117,60,6597,221
RO,590,THEOBROMA,2469,3119,2496,8336,41,5840,211
RO,604,MINISTRO ANDREAZZA,2417,2719,2021,7382,44,5361,181
RO,612,GOVERNADOR JORGE TEIXEIRA,2388,2592,2422,7673,55,5251,216
RO,620,CACAULÂNDIA,1343,1663,682,3824,30,3142,106
RO,639,ALTO PARAÍSO,4418,4285,2404,11521,93,9117,321
RO,647,RIO CRESPO,968,1056,524,2630,13,2106,69
RO,655,CORUMBIARA,2077,2165,1729,6145,40,4416,134
RO,663,MONTE NEGRO,3245,3997,1970,9566,62,7596,292
RO,671,CAMPO NOVO DE RONDÔNIA,3026,2778,1368,7417,66,6049,179
RO,680,CUJUBIM,3081,4209,2233,9830,86,7597,221
RO,698,VALE DO ANARI,2130,2329,1072,5750,40,4678,179
RO,701,PARECIS,1227,997,1030,3347,18,2317,75
RO,710,SÃO FELIPE DO OESTE,1245,2111,1471,5027,50,3556,150
RO,728,PRIMAVERA DE RONDÔNIA,891,1050,385,2444,28,2059,90
RO,736,ALTO ALEGRE DOS PARECIS,2730,3300,2474,8792,69,6318,219
RO,744,NOVA UNIÃO,1997,2007,1415,5590,39,4175,132
RO,752,TEIXEIRÓPOLIS,1375,1550,1159,4226,39,3067,103
RO,779,BURITIS,6912,9106,4823,21625,201,16802,583
RO,787,PIMENTEIRAS DO OESTE,516,666,910,2150,11,1240,47
RO,795,SÃO FRANCISCO DO GUAPORÉ,4192,3378,2938,10869,59,7931,302
RO,809,CHUPINGUAIA,1506,1860,2030,5544,45,3514,103
RR,3000,CAROEBE,2322,2010,1116,5721,39,4605,234
RR,3018,BOA VISTA,53832,102792,25815,191058,1694,165243,6925
RR,3026,IRACEMA,2419,1304,1107,5055,27,3948,198
RR,3034,CARACARAÍ,4523,4085,3094,12178,64,9084,412
RR,3042,AMAJARI,1911,2072,1038,5228,27,4190,180
RR,3050,ALTO ALEGRE,3588,3174,1923,9159,53,7236,421
RR,3069,CANTÁ,3707,3888,2088,10153,47,8065,423
RR,3077,BONFIM,2492,3070,1537,7451,28,5914,324
RR,3085,RORAINÓPOLIS,6584,4636,3655,15557,105,11902,577
RR,3093,MUCAJAÍ,4333,3816,2241,10881,69,8640,422
RR,3107,UIRAMUTÃ,2333,1206,912,4766,14,3854,301
RR,3115,NORMANDIA,3010,1638,839,5665,19,4826,159
RR,3123,PACARAIMA,2221,3204,1758,7480,30,5722,267
RR,3131,SÃO JOÃO DA BALIZA,2012,1431,1024,4663,36,3639,160
RR,3158,SÃO LUIZ,2138,1426,1126,4871,18,3745,163
RS,84735,ÁUREA,1115,1538,362,3155,55,2793,85
RS,84743,TRÊS ARROIOS,915,1260,272,2541,24,2269,70
RS,84751,NOVA ROMA DO SUL,884,1647,326,2968,31,2642,80
RS,84760,PROGRESSO,2217,1804,894,5137,64,4243,158
RS,84778,PIRAPÓ,950,786,240,2058,27,1818,55
RS,84786,JABOTICABA,1384,1044,270,2813,27,2543,88
RS,84794,SÃO JORGE,829,1230,148,2324,37,2176,80
RS,84808,ALTO ALEGRE,740,680,121,1595,23,1474,31
RS,84816,NOVA HARTZ,4775,6705,1990,14075,192,12085,413
RS,84824,DOIS LAJEADOS,815,1514,237,2691,47,2454,78
RS,84832,SÃO DOMINGOS DO SUL,856,1244,290,2530,53,2240,87
RS,84840,TUNAS,1803,1017,772,3698,42,2926,64
RS,84859,SÃO JOÃO DA URTIGA,1481,1835,550,4101,107,3551,128
RS,84867,GUABIJU,347,734,108,1279,39,1171,51
RS,84875,QUINZE DE NOVEMBRO,1289,1395,392,3183,23,2791,84
RS,84883,DOUTOR MAURÍCIO CARDOSO,1548,2040,753,4471,38,3718,92
RS,84891,CAPELA DE SANTANA,3456,2897,1460,8230,158,6770,259
RS,84905,JAQUIRANA,1068,1221,365,2839,65,2474,120
RS,84913,VANINI,635,847,143,1726,30,1583,71
RS,84921,BOQUEIRÃO DO LEÃO,2806,1921,1177,6168,80,4991,184
RS,84930,FAGUNDES VARELA,557,1351,163,2170,28,2007,71
RS,84948,ÁGUA SANTA,1031,1507,484,3155,50,2671,83
RS,84956,SILVEIRA MARTINS,725,1039,250,2130,36,1880,80
RS,84964,IBIRAPUITÃ,1322,1338,398,3190,45,2792,87
RS,84972,IBARAMA,1495,1476,445,3582,54,3137,112
RS,84980,PANTANO GRANDE,3762,2546,1920,8603,160,6683,215
RS,84999,IPÊ,1139,3114,880,5377,67,4497,177
RS,85006,TRINDADE DO SUL,2068,1707,758,4725,66,3967,126
RS,85014,AGUDO,4808,5614,2167,13116,202,10949,325
RS,85022,ERNESTINA,1020,1122,185,2418,32,2233,59
RS,85030,AJURICABA,1855,3046,604,5681,53,5077,123
RS,85049,DEZESSEIS DE NOVEMBRO,1008,848,233,2187,30,1954,68
RS,85057,ALECRIM,2599,2212,1017,6046,60,5029,158
RS,85065,BROCHIER,1989,1344,476,3981,55,3505,117
RS,85073,ALEGRETE,22945,20072,16548,61565,665,45017,1335
RS,85081,EREBANGO,839,1062,225,2236,27,2011,83
RS,85090,ALPESTRE,2770,1981,1299,6336,113,5037,173
RS,85103,ENTRE-IJUÍS,3495,2403,1343,7507,88,6164,178
RS,85111,ALVORADA,52796,51390,27921,141929,3913,114008,5909
RS,85120,NOVA ESPERANÇA DO SUL,1240,1935,584,4012,108,3428,145
RS,85138,ANTA GORDA,1350,2706,937,5316,140,4379,183
RS,85146,PAVERAMA,3014,1701,950,5902,80,4952,157
RS,85154,ANTÔNIO PRADO,2163,6642,1716,11020,126,9304,373
RS,85162,TERRA DE AREIA,2584,3041,1612,7549,100,5937,212
RS,85170,ARATIBA,2376,2627,720,5944,75,5224,146
RS,85189,HARMONIA,1420,1819,459,3845,56,3386,91
RS,85197,ARROIO DO MEIO,5569,7642,2115,16054,255,13939,473
RS,85200,CAMPOS BORGES,1209,1195,295,2846,57,2551,90
RS,85219,ARROIO DOS RATOS,4090,3831,2364,10822,220,8458,317
RS,85227,CERRO GRANDE,1009,605,202,1904,21,1702,67
RS,85235,ARROIO DO TIGRE,4577,3744,1709,10462,184,8753,248
RS,85243,IPIRANGA DO SUL,520,1009,139,1748,26,1609,54
RS,85251,ARROIO GRANDE,6640,4942,3679,15949,313,12270,375
RS,85260,LAGOÃO,2457,1252,1138,5025,51,3887,127
RS,85278,ARVOREZINHA,3381,3232,1591,8729,205,7138,320
RS,85286,ESTAÇÃO,1280,2894,750,5182,97,4432,161
RS,85294,AUGUSTO PESTANA,2486,2574,884,6168,78,5284,146
RS,85308,ARROIO DO SAL,1770,3010,1629,6658,70,5029,179
RS,85316,BAGÉ,29740,37127,19149,90196,1619,71047,2561
RS,85324,SÃO JOSÉ DO HORTÊNCIO,1044,1890,420,3529,72,3109,103
RS,85332,BARÃO DE COTEGIPE,1746,2776,759,5554,84,4795,189
RS,85340,PINHAL,845,841,313,2089,26,1776,64
RS,85359,BARRACÃO,1665,1631,844,4338,64,3494,134
RS,85367,TRÊS CACHOEIRAS,2938,3819,1339,8365,78,7026,191
RS,85375,BARRA DO RIBEIRO,4057,3697,2342,10614,205,8272,313
RS,85383,SÃO VENDELINO,657,965,86,1802,31,1716,63
RS,85391,BARROS CASSAL,3409,2947,2201,8992,131,6791,304
RS,85405,PROTÁSIO ALVES,323,1218,120,1753,39,1633,53
RS,85413,BENTO GONÇALVES,20517,46159,13119,84024,1250,70905,2979
RS,85421,POUSO NOVO,629,618,153,1478,26,1325,52
RS,85430,BOA VISTA DO BURICÁ,2127,2521,839,5635,41,4796,107
RS,85448,EUGÊNIO DE CASTRO,966,864,292,2223,46,1931,55
RS,85456,BOM JESUS,2768,3638,2151,9007,201,6856,249
RS,85464,CRISTAL,2681,2034,687,5640,98,4953,140
RS,85472,BOM RETIRO DO SUL,3496,4235,1526,9747,184,8221,306
RS,85480,SÃO MIGUEL DAS MISSÕES,2789,1723,581,5306,106,4725,107
RS,85499,BOSSOROCA,2267,1736,1458,5696,101,4238,134
RS,85502,GLORINHA,1545,2970,594,5435,96,4841,230
RS,85510,BRAGA,1296,925,733,3090,51,2357,85
RS,85529,SEGREDO,2476,2158,1204,6056,59,4852,159
RS,85537,BUTIÁ,6254,5996,3696,16800,390,13104,464
RS,85545,ALEGRIA,1450,1294,634,3528,52,2894,98
RS,85553,CAÇAPAVA DO SUL,10925,9114,5215,26861,731,21646,876
RS,85561,SALDANHA MARINHO,1046,1173,249,2569,45,2320,56
RS,85570,CACEQUI,4502,2639,3155,10646,109,7491,241
RS,85588,SÃO JOSÉ DO HERVAL,893,634,295,1901,19,1606,60
RS,85596,CACHOEIRA DO SUL,23041,26863,16878,69658,1165,52780,1711
RS,85600,VISTA ALEGRE,1280,781,359,2484,13,2125,51
RS,85618,CACHOEIRINHA,33742,40792,17544,98006,2142,80462,3786
RS,85626,IVORÁ,608,873,220,1813,37,1593,75
RS,85634,CACIQUE DOBLE,1167,1957,593,3915,68,3322,130
RS,85642,VILA MARIA,1135,1804,441,3540,56,3099,104
RS,85650,CAIBATÉ,1734,1421,741,4059,82,3318,81
RS,85669,TAQUARUÇU DO SUL,997,1088,356,2546,39,2190,66
RS,85677,CAIÇARA,1639,1821,519,4132,45,3613,108
RS,85685,IMBÉ,6112,5893,3714,16275,176,12561,380
RS,85693,CAMAQUÃ,19517,19048,9458,50182,1031,40724,1128
RS,85707,SEDE NOVA,902,1086,438,2544,48,2106,70
RS,85715,CAMBARÁ DO SUL,1338,2542,1325,5493,104,4168,184
RS,85723,TUPANDI,1139,2008,380,3714,82,3334,105
RS,85731,CAMPINA DAS MISSÕES,2224,2000,416,4812,49,4396,123
RS,85740,RIOZINHO,1303,1727,274,3521,82,3247,135
RS,85758,CAMPINAS DO SUL,1126,2740,724,4743,33,4019,120
RS,85766,RELVADO,670,835,284,1876,22,1592,65
RS,85774,CAMPO BOM,15990,23849,7613,49960,825,42347,1683
RS,85782,IMIGRANTE,849,1265,271,2545,70,2274,90
RS,85790,CAMPO NOVO,1898,1278,589,3923,74,3334,84
RS,85804,CIDREIRA,3296,4005,3510,11304,150,7794,343
RS,85812,CANDELÁRIA,7903,10259,4566,24077,614,19511,735
RS,85820,MONTAURI,486,735,98,1397,18,1299,60
RS,85839,CÂNDIDO GODÓI,1812,3045,594,5655,72,5061,132
RS,85847,VISTA GAÚCHA,1125,882,240,2329,22,2089,60
RS,85855,CANELA,6345,15928,5180,29394,785,24214,1156
RS,85863,VISTA ALEGRE DO PRATA,350,788,127,1338,29,1211,44
RS,85871,CANGUÇU,15213,19268,8153,44714,1015,36561,1065
RS,85880,CASEIROS,830,1221,411,2613,63,2202,88
RS,85898,CANOAS,98801,91292,35220,239245,4844,204025,9088
RS,85901,ITACURUBI,1168,829,365,2440,24,2075,54
RS,85910,CARAZINHO,18028,18683,8580,47099,657,38519,1151
RS,85928,ENTRE RIOS DO SUL,1059,1015,291,2468,34,2177,69
RS,85936,CARLOS BARBOSA,5729,11753,2679,21206,290,18527,755
RS,85944,CERRO GRANDE DO SUL,2803,2822,1238,7218,139,5980,216
RS,85952,CASCA,2133,3929,1097,7496,125,6399,212
RS,85960,CAMARGO,699,1139,250,2208,38,1958,82
RS,85979,CATUÍPE,2793,3428,1203,7802,146,6599,232
RS,85987,PARAÍSO DO SUL,2217,2462,1092,5989,70,4897,148
RS,85995,CAXIAS DO SUL,75439,183173,53145,332458,5909,279313,14792
RS,86010,CERRO LARGO,4372,3840,1735,10367,120,8632,300
RS,86029,FAXINALZINHO,822,909,224,2046,31,1822,60
RS,86037,CHAPADA,3161,3247,1118,7850,151,6732,173
RS,86045,AMARAL FERRADOR,1961,1781,1041,5009,83,3968,143
RS,86053,CHIAPETTA,1342,1412,430,3276,26,2846,66
RS,86061,VILA FLORES,622,1907,158,2854,39,2696,128
RS,86070,CIRÍACO,1552,1574,663,3996,66,3333,141
RS,86088,CERRO BRANCO,1550,1462,303,3490,67,3187,108
RS,86096,COLORADO,849,1598,300,2892,55,2592,90
RS,86100,ANDRÉ DA ROCHA,279,563,119,1001,15,882,25
RS,86118,CONDOR,2128,2371,519,5187,48,4668,121
RS,86126,POÇO DAS ANTAS,813,778,168,1829,28,1661,42
RS,86134,CONSTANTINA,3168,3172,1359,8024,113,6665,212
RS,86142,TRÊS PALMEIRAS,1572,1359,672,3762,53,3090,106
RS,86150,CORONEL BICACO,2572,1820,839,5440,54,4601,155
RS,86169,NOVA ALVORADA,956,1225,196,2519,52,2323,90
RS,86177,CRISSIUMAL,4674,4372,2052,11539,142,9487,299
RS,86185,MORRO REDONDO,2158,1961,852,5226,116,4374,139
RS,86193,CRUZ ALTA,17616,18077,11675,49103,650,37428,1085
RS,86207,SANTA MARIA DO HERVAL,1920,2600,417,5181,71,4764,173
RS,86215,CRUZEIRO DO SUL,3933,4191,1339,9985,171,8646,351
RS,86223,BARÃO,1666,2205,578,4664,64,4086,151
RS,86231,DAVID CANABARRO,1530,1590,346,3684,91,3338,127
RS,86240,ELDORADO DO SUL,9893,8339,4854,24482,511,19628,885
RS,86258,DOIS IRMÃOS,8165,10369,2685,22156,323,19471,614
RS,86274,DOM FELICIANO,4216,3959,2052,10758,204,8706,327
RS,86282,ALTO FELIZ,608,1425,130,2294,29,2164,102
RS,86290,DOM PEDRITO,12797,8858,7627,30430,376,22803,772
RS,86304,AMETISTA DO SUL,2202,2086,1326,5888,104,4562,170
RS,86312,DONA FRANCISCA,1050,1388,306,2879,52,2573,83
RS,86320,ARAMBARÉ,1227,1078,347,2775,38,2428,85
RS,86339,ENCANTADO,4847,8510,2790,16891,202,14101,542
RS,86347,BARÃO DO TRIUNFO,1699,2203,1003,5112,61,4109,146
RS,86355,ENCRUZILHADA DO SUL,7699,6514,4924,20308,563,15384,608
RS,86363,BARRA DO GUARITA,1018,963,579,2663,21,2084,82
RS,86371,ERECHIM,21431,38227,12639,75925,1094,63286,2534
RS,86380,BARRA DO RIO AZUL,625,901,148,1744,21,1596,49
RS,86398,HERVAL,2738,1252,1327,5510,89,4183,104
RS,86401,BARRA FUNDA,785,1147,238,2251,26,2013,55
RS,86410,ERVAL GRANDE,1838,1579,564,4164,72,3600,111
RS,86428,BOA VISTA DAS MISSÕES,677,721,186,1641,23,1455,34
RS,86436,ERVAL SECO,2352,2237,1402,6198,55,4796,152
RS,86444,BOM PROGRESSO,796,767,201,1838,23,1637,51
RS,86452,ESMERALDA,837,1110,606,2655,42,2049,60
RS,86460,CAMPESTRE DA SERRA,472,1586,505,2740,56,2235,121
RS,86479,ESPUMOSO,4514,5489,1760,12233,154,10473,316
RS,86487,CANDIOTA,3401,2393,1609,7653,82,6044,168
RS,86495,ESTÂNCIA VELHA,10315,15704,4835,32694,590,27859,1250
RS,86509,CAPITÃO,1166,817,137,2260,55,2123,85
RS,86517,ESTEIO,29314,23175,12494,68148,1096,55654,2069
RS,86525,CARLOS GOMES,606,662,89,1399,22,1310,20
RS,86533,ESTRELA,7722,12110,4038,25056,379,21018,807
RS,86541,CENTENÁRIO,1098,1119,116,2405,28,2289,44
RS,86550,FARROUPILHA,13033,29457,7526,53156,988,45630,2152
RS,86568,CHARRUA,847,1068,579,2629,35,2050,100
RS,86576,FAXINAL DO SOTURNO,1884,2593,942,5704,105,4762,180
RS,86584,COLINAS,752,1090,153,2110,34,1957,81
RS,86592,FELIZ,3138,5429,1579,10706,163,9127,397
RS,86606,COQUEIROS DO SUL,837,1067,208,2170,17,1962,41
RS,86614,FLORES DA CUNHA,3277,15627,3591,23749,329,20158,925
RS,86622,CORONEL BARROS,874,1056,142,2138,19,1996,47
RS,86630,FONTOURA XAVIER,3850,2336,1133,7732,150,6599,263
RS,86649,COXILHA,917,1016,163,2174,23,2011,55
RS,86657,FORMIGUEIRO,2252,1993,489,5055,112,4566,209
RS,86665,DERRUBADAS,1009,1130,266,2471,15,2205,51
RS,86673,FREDERICO WESTPHALEN,8657,9806,4648,24032,300,19384,621
RS,86681,DOIS IRMÃOS DAS MISSÕES,807,643,166,1680,11,1514,53
RS,86690,GARIBALDI,6003,14655,3775,25693,393,21918,867
RS,86703,ENGENHO VELHO,535,438,85,1091,12,1006,21
RS,86711,GAURAMA,1521,2829,289,4836,61,4547,136
RS,86720,GARRUCHOS,1361,598,361,2402,25,2041,57
RS,86738,GENERAL CÂMARA,2861,2282,1382,6837,105,5455,207
RS,86746,GENTIL,458,824,149,1519,33,1370,55
RS,86754,SÃO VICENTE DO SUL,2752,2378,1753,7186,116,5433,187
RS,86762,GRAMADO DOS LOUREIROS,931,486,169,1679,29,1510,64
RS,86770,GETÚLIO VARGAS,3075,7122,2262,13055,197,10793,399
RS,86789,GRAMADO XAVIER,1201,1110,508,2915,27,2407,69
RS,86797,GIRUÁ,5136,5373,2448,13408,135,10960,316
RS,86800,HULHA NEGRA,2170,1488,839,4654,50,3815,107
RS,86819,GRAMADO,4882,17084,5134,28617,517,23483,1000
RS,86827,INHACORÁ,855,701,254,1888,27,1634,51
RS,86835,GRAVATAÍ,59800,77972,31362,182088,4631,150726,8323
RS,86843,ITAPUCA,752,665,212,1739,55,1527,55
RS,86851,GUAÍBA,28835,26498,12299,71893,1714,59594,2547
RS,86860,LAJEADO DO BUGRE,836,644,452,2009,23,1557,54
RS,86878,GUAPORÉ,4601,10153,2831,18543,364,15712,594
RS,86886,LAGOA DOS TRÊS CANTOS,505,759,113,1432,11,1319,44
RS,86894,GUARANI DAS MISSÕES,2559,2608,1175,6597,107,5422,148
RS,86908,LINDOLFO COLLOR,1865,1679,507,4319,89,3812,179
RS,86916,HORIZONTINA,4662,7264,2753,15168,144,12415,345
RS,86924,LINHA NOVA,413,713,60,1255,16,1195,53
RS,86932,CHARQUEADAS,9691,9457,3950,24355,484,20405,773
RS,86940,MANOEL VIANA,2629,1534,1603,5962,75,4359,121
RS,86959,HUMAITÁ,1608,1818,585,4168,43,3583,114
RS,86967,MAQUINÉ,2637,1973,1184,6034,97,4850,143
RS,86975,IBIAÇÁ,1010,2263,450,3899,61,3449,115
RS,86983,MARATÁ,973,855,92,2011,26,1919,65
RS,86991,IBIRAIARAS,1602,2897,911,5640,88,4729,142
RS,87009,MARIANA PIMENTEL,1029,1509,319,3035,55,2716,123
RS,87017,IBIRUBÁ,5725,7167,2591,16076,214,13485,379
RS,87025,MATO CASTELHANO,622,1249,159,2119,21,1960,68
RS,87033,IGREJINHA,8508,11915,3865,25495,452,21630,755
RS,87041,MATO LEITÃO,1354,1491,206,3192,50,2986,91
RS,87050,IJUÍ,25339,24286,11123,62781,673,51658,1360
RS,87068,MINAS DO LEÃO,1834,3054,1148,6405,131,5257,238
RS,87076,ILÓPOLIS,1185,1557,683,3645,73,2962,147
RS,87084,MONTE BELO DO SUL,816,1515,248,2689,24,2441,86
RS,87092,INDEPENDÊNCIA,1993,2463,351,5015,79,4664,129
RS,87106,MORMAÇO,944,1002,283,2362,50,2079,83
RS,87114,IRAÍ,2701,2116,1257,6304,75,5047,155
RS,87122,MORRINHOS DO SUL,1111,1290,195,2682,42,2487,44
RS,87130,ITAQUI,10810,8883,7328,27983,330,20655,632
RS,87149,MORRO REUTER,1236,2968,534,5011,71,4477,202
RS,87157,ITATIBA DO SUL,1933,1117,490,3630,23,3140,67
RS,87165,MULITERNO,728,656,126,1598,47,1472,41
RS,87173,IVOTI,4890,7971,1750,15309,240,13559,458
RS,87181,NICOLAU VERGUEIRO,549,878,190,1692,27,1502,48
RS,87190,JACUTINGA,926,1503,224,2756,33,2532,70
RS,87203,NOVA BOA VISTA,776,855,134,1828,24,1694,39
RS,87211,JAGUARÃO,7811,8618,5591,22920,364,17329,536
RS,87220,NOVA PÁDUA,222,1650,178,2144,20,1966,74
RS,87238,JAGUARI,3545,3957,2120,10145,211,8025,312
RS,87246,NOVA SANTA RITA,6588,5258,1271,13787,244,12516,426
RS,87254,JÚLIO DE CASTILHOS,6283,5618,3531,16103,237,12572,434
RS,87262,NOVO BARREIRO,1478,1337,236,3183,48,2947,84
RS,87270,LAGOA VERMELHA,6761,9458,4140,21434,407,17294,668
RS,87289,NOVO MACHADO,1108,1723,454,3366,25,2912,56
RS,87297,LAJEADO,19632,24720,8322,55318,948,46996,1696
RS,87300,NOVO TIRADENTES,709,673,139,1604,21,1465,62
RS,87319,LAVRAS DO SUL,2410,2164,1368,6252,114,4884,196
RS,87327,PARECI NOVO,963,1385,179,2638,45,2459,66
RS,87335,LIBERATO SALZANO,2045,1482,844,4610,112,3766,127
RS,87343,PASSO DO SOBRADO,2056,2095,597,4953,93,4356,112
RS,87351,MACHADINHO,1634,1909,690,4476,83,3786,160
RS,87360,PICADA CAFÉ,1194,2354,553,4292,37,3739,154
RS,87378,MARAU,7679,15438,4374,28908,528,24534,889
RS,87386,PINHAL GRANDE,1522,1383,809,3854,47,3045,93
RS,87394,MARCELINO RAMOS,1648,1828,681,4275,38,3594,80
RS,87408,PINHEIRINHO DO VALE,1604,1202,467,3387,35,2920,79
RS,87416,MARIANO MORO,843,747,191,1889,53,1698,55
RS,87424,PONTÃO,1410,1349,439,3277,19,2838,60
RS,87432,MATA,1854,1354,929,4324,87,3395,100
RS,87440,PONTE PRETA,554,878,95,1601,21,1506,53
RS,87459,MAXIMILIANO DE ALMEIDA,1278,1980,744,4212,84,3468,126
RS,87467,PORTO MAUÁ,868,949,226,2106,22,1880,41
RS,87475,MIRAGUAÍ,1828,1308,759,4039,46,3280,98
RS,87483,PORTO VERA CRUZ,688,595,140,1478,13,1338,42
RS,87491,MONTENEGRO,18020,17054,7750,45194,905,37444,1465
RS,87505,PRESIDENTE LUCENA,703,1225,197,2224,26,2027,73
RS,87513,MOSTARDAS,3751,3073,2148,9428,182,7280,274
RS,87521,QUEVEDOS,993,699,216,2009,45,1793,56
RS,87530,MUÇUM,1048,2071,280,3641,79,3361,163
RS,87548,RIO DOS ÍNDIOS,1411,808,224,2571,43,2347,85
RS,87556,NÃO-ME-TOQUE,4486,5961,1906,12861,177,10955,331
RS,87564,SAGRADA FAMÍLIA,888,793,170,1919,14,1749,54
RS,87572,NONOAI,3639,3191,857,8072,103,7215,282
RS,87580,SALVADOR DAS MISSÕES,889,1093,144,2198,25,2054,47
RS,87599,NOVA ARAÇÁ,712,2120,573,3585,64,3012,116
RS,87602,SANTA CLARA DO SUL,1923,2259,471,4915,97,4444,165
RS,87610,NOVA BASSANO,1332,4474,1044,7176,121,6132,205
RS,87629,SANTA TEREZA,508,858,179,1636,32,1457,59
RS,87637,NOVA BRÉSCIA,684,1594,330,2728,30,2398,90
RS,87645,SANTO ANTÔNIO DO PALMA,671,849,184,1769,24,1585,41
RS,87653,NOVA PALMA,1971,2371,761,5298,74,4537,121
RS,87661,SANTO ANTÔNIO DO PLANALTO,632,921,170,1790,16,1620,51
RS,87670,NOVA PETRÓPOLIS,3729,9524,2514,16599,219,14085,613
RS,87688,SANTO EXPEDITO DO SUL,817,975,178,2086,52,1908,64
RS,87696,NOVA PRATA,3379,11343,3057,18671,305,15614,587
RS,87700,SÃO JOÃO DO POLÊSINE,736,1181,302,2309,27,2007,63
RS,87718,NOVO HAMBURGO,57668,82351,30628,179740,3118,149112,5975
RS,87726,SÃO JOSÉ DOS AUSENTES,987,1159,266,2511,23,2245,76
RS,87734,OSÓRIO,12389,13752,6031,33930,647,27899,1111
RS,87742,SÃO JOSÉ DO INHACORÁ,867,902,92,1939,23,1847,55
RS,87750,PAIM FILHO,1527,1515,279,3443,32,3164,90
RS,87769,SÃO JOSÉ DAS MISSÕES,989,715,198,1972,29,1774,41
RS,87777,PALMEIRA DAS MISSÕES,9915,9470,5086,25383,301,20297,611
RS,87785,SÃO MARTINHO DA SERRA,872,1350,345,2699,49,2354,83
RS,87793,PALMITINHO,2899,1994,932,6028,51,5096,152
RS,87807,SÃO PEDRO DA SERRA,1004,1324,124,2598,48,2474,98
RS,87815,PANAMBI,10175,14188,4947,30394,374,25447,710
RS,87823,SÃO PEDRO DO BUTIÁ,1047,1004,373,2503,18,2130,61
RS,87831,PARAÍ,1094,3635,735,5779,116,5044,199
RS,87840,SÃO VALENTIM DO SUL,608,1028,174,1927,38,1753,79
RS,87858,PASSO FUNDO,50019,60584,23020,139388,2192,116368,3573
RS,87866,SÃO VALÉRIO DO SUL,1020,578,216,1884,9,1668,61
RS,87874,PEDRO OSÓRIO,3034,1920,1462,6740,141,5278,183
RS,87882,SENTINELA DO SUL,1908,1445,775,4342,99,3567,115
RS,87890,PEJUÇARA,1378,1243,568,3290,33,2722,68
RS,87904,SÉRIO,1074,560,108,1837,44,1729,51
RS,87912,PELOTAS,104132,86663,48401,253938,5285,205537,9457
RS,87920,SERTÃO SANTANA,1640,2288,435,4558,55,4123,140
RS,87939,PINHEIRO MACHADO,4597,3411,2455,11010,222,8555,325
RS,87947,SINIMBU,3462,2822,1458,8025,88,6567,195
RS,87955,PIRATINI,6904,4699,3841,16329,441,12488,444
RS,87963,TIRADENTES DO SUL,2052,1888,870,4998,60,4128,128
RS,87971,PLANALTO,2741,3244,1656,8042,157,6386,244
RS,87980,TRAVESSEIRO,881,824,250,2019,19,1769,45
RS,87998,PORTÃO,8969,9148,3665,23120,480,19455,858
RS,88005,TRÊS FORQUILHAS,1093,954,199,2342,54,2143,42
RS,88013,PORTO ALEGRE,375606,440497,223412,1097289,20270,873877,37504
RS,88021,TUPANCI DO SUL,477,592,188,1326,23,1138,46
RS,88030,PORTO LUCENA,1779,1625,714,4276,61,3562,97
RS,88048,UNIÃO DA SERRA,408,748,107,1340,23,1233,54
RS,88056,PORTO XAVIER,3227,2635,545,6704,92,6159,205
RS,88064,VALE DO SOL,3534,3442,1120,8457,146,7337,215
RS,88072,PUTINGA,977,1842,650,3735,105,3085,161
RS,88080,VALE REAL,1416,2156,280,4102,71,3822,179
RS,88099,QUARAÍ,6899,6336,4906,18758,220,13852,397
RS,88102,VILA NOVA DO SUL,1343,1279,418,3194,69,2776,85
RS,88110,REDENTORA,2694,1907,720,5511,38,4791,152
RS,88129,VITÓRIA DAS MISSÕES,1443,1135,337,3010,25,2673,70
RS,88137,RESTINGA SÊCA,3941,6041,3143,13656,211,10513,320
RS,88145,XANGRI-LÁ,2715,4724,1652,9531,153,7879,287
RS,88153,RIO GRANDE,74925,39423,29088,151561,2908,122473,5217
RS,88161,BOA VISTA DO SUL,807,1182,222,2321,43,2099,67
RS,88170,RIO PARDO,14242,9020,6123,30700,577,24577,738
RS,88188,DILERMANDO DE AGUIAR,929,1182,345,2557,30,2212,71
RS,88196,ROCA SALES,2748,3691,1085,7927,151,6842,252
RS,88200,CAPIVARI DO SUL,1411,1141,287,2972,42,2685,91
RS,88218,RODEIO BONITO,1950,2044,683,4836,37,4153,122
RS,88226,NOVA CANDELÁRIA,1064,986,226,2391,53,2165,62
RS,88234,ROLANTE,4505,8009,2077,15357,269,13280,497
RS,88242,FLORIANO PEIXOTO,684,799,186,1729,22,1543,38
RS,88250,RONDA ALTA,3290,2856,1225,7567,79,6342,117
RS,88269,CHUVISCA,1476,1824,284,3747,74,3463,89
RS,88277,RONDINHA,1917,2075,560,4696,55,4136,89
RS,88285,ESPERANÇA DO SUL,1186,1026,156,2454,22,2298,64
RS,88293,ROQUE GONZALES,2577,1930,1211,5970,77,4759,175
RS,88307,DOUTOR RICARDO,636,901,176,1825,43,1649,69
RS,88315,ROSÁRIO DO SUL,11980,10755,8757,32572,440,23815,640
RS,88323,HERVEIRAS,1321,570,184,2137,16,1953,46
RS,88331,SALVADOR DO SUL,1840,2689,670,5435,82,4765,154
RS,88340,CARAÁ,2179,2646,1276,6447,127,5171,219
RS,88358,SANANDUVA,3573,6759,1541,12480,212,10939,395
RS,88366,FAZENDA VILANOVA,1197,1170,225,2732,55,2507,85
RS,88374,SANTA BÁRBARA DO SUL,2651,3095,1530,7539,113,6009,150
RS,88382,ITAARA,1171,1750,343,3405,39,3062,102
RS,88390,SANTA CRUZ DO SUL,32446,44319,14570,96204,1803,81634,3066
RS,88404,ESTRELA VELHA,1234,1202,303,2853,56,2550,58
RS,88412,SANTA MARIA,64959,86998,39945,200590,3112,160645,5576
RS,88420,BENJAMIN CONSTANT DO SUL,943,477,194,1663,15,1469,34
RS,88439,SANTANA DA BOA VISTA,2555,2342,1835,7140,191,5305,217
RS,88447,MAÇAMBARÁ,1575,1099,522,3304,28,2782,80
RS,88455,SANTANA DO LIVRAMENTO,30294,20198,18882,71866,1039,52984,1453
RS,88463,DOM PEDRO DE ALCÂNTARA,954,918,173,2125,34,1952,46
RS,88471,SANTA ROSA,19709,23375,9366,54222,580,44856,1192
RS,88480,UNISTALDA,881,917,334,2230,36,1896,62
RS,88498,SANTA VITÓRIA DO PALMAR,8696,8380,6537,24701,447,18164,641
RS,88501,TURUÇU,1073,1487,260,2950,56,2690,74
RS,88510,SANTIAGO,13762,14900,9331,39604,640,30273,971
RS,88528,CRISTAL DO SUL,1131,786,165,2198,39,2033,77
RS,88536,SANTO ÂNGELO,24897,21305,13577,61820,730,48243,1311
RS,88544,MUITOS CAPÕES,393,1278,269,2064,45,1795,79
RS,88552,SANTO ANTÔNIO DA PATRULHA,12501,11723,5828,31818,739,25990,1027
RS,88560,NOVA RAMADA,821,962,287,2126,16,1839,40
RS,88579,SANTO ANTÔNIO DAS MISSÕES,3933,2588,2805,9627,125,6822,176
RS,88587,JARI,1441,933,314,2819,66,2505,65
RS,88595,SANTO AUGUSTO,5159,3715,2411,11699,137,9288,277
RS,88609,UBIRETAMA,587,986,100,1741,26,1641,42
RS,88617,SANTO CRISTO,4801,5539,1720,12494,164,10774,270
RS,88625,BARRA DO QUARAÍ,950,881,395,2292,24,1897,42
RS,88633,SÃO BORJA,21290,13938,13323,49862,464,36539,847
RS,88641,CERRITO,2529,1804,972,5565,142,4593,118
RS,88650,SÃO FRANCISCO DE ASSIS,6280,5189,4160,16372,357,12212,386
RS,88668,VALE VERDE,1030,1171,291,2627,57,2336,78
RS,88676,SÃO FRANCISCO DE PAULA,5490,6705,3033,16145,340,13112,577
RS,88684,NOVO CABRAIS,1311,1524,239,3205,56,2966,75
RS,88692,SÃO GABRIEL,15910,17859,11486,46791,560,35305,976
RS,88706,SETE DE SETEMBRO,822,617,93,1604,25,1511,47
RS,88714,SÃO JERÔNIMO,6604,5964,2920,16313,311,13393,514
RS,88722,TABAÍ,1606,1283,510,3527,37,3017,91
RS,88730,SÃO JOSÉ DO NORTE,9225,7476,3672,21444,400,17772,671
RS,88749,VILA LÂNGARO,696,1001,177,1983,49,1806,60
RS,88757,SÃO JOSÉ DO OURO,1711,2989,885,5922,170,5037,167
RS,88765,SENADOR SALGADO FILHO,844,1275,193,2394,31,2201,51
RS,88773,SÃO LEOPOLDO,64778,60570,29080,162652,2992,133572,5232
RS,88781,VESPASIANO CORRÊA,508,1224,269,2099,46,1830,52
RS,88790,SÃO LOURENÇO DO SUL,14420,13791,6608,35987,382,29379,786
RS,88803,MONTE ALEGRE DOS CAMPOS,705,1520,424,2785,54,2361,82
RS,88811,SÃO LUIZ GONZAGA,11148,8012,7078,27286,367,20208,681
RS,88820,MARQUES DE SOUZA,1440,1358,377,3330,56,2953,99
RS,88838,SÃO MARCOS,2735,10751,2742,17189,241,14447,720
RS,88846,CHUÍ,1718,1318,1032,4303,108,3271,127
RS,88854,SÃO MARTINHO,1848,2175,715,4939,71,4224,130
RS,88862,ARARICÁ,1574,1834,337,3959,91,3622,123
RS,88870,SÃO NICOLAU,1918,1238,1418,4768,72,3350,122
RS,88889,PASSA SETE,1877,1352,625,4030,78,3405,98
RS,88897,SÃO PAULO DAS MISSÕES,2430,1833,413,4815,49,4402,90
RS,88900,TOROPI,954,1153,221,2428,28,2207,72
RS,88919,SÃO PEDRO DO SUL,4566,5892,2636,13699,251,11063,354
RS,88927,BALNEÁRIO PINHAL,2393,3225,2587,8576,101,5989,270
RS,88935,SÃO SEBASTIÃO DO CAÍ,6577,7939,3264,18825,389,15561,656
RS,88943,MAMPITUBA,1189,1002,288,2574,41,2286,54
RS,88951,SÃO SEPÉ,8207,6234,4688,19920,333,15232,458
RS,88978,SÃO VALENTIM,1073,1495,475,3180,44,2705,93
RS,88986,ACEGUÁ,1388,1695,686,3904,51,3218,84
RS,88994,SAPIRANGA,21466,25426,9497,59127,983,49630,1755
RS,89001,ALMIRANTE TAMANDARÉ DO SUL,820,674,128,1690,20,1562,48
RS,89010,SAPUCAIA DO SUL,48484,31488,17898,102964,1805,85066,3289
RS,89028,ARROIO DO PADRE,638,1526,127,2374,25,2247,58
RS,89036,SARANDI,5673,7662,3325,17241,221,13916,360
RS,89044,BOA VISTA DO CADEADO,685,950,410,2131,31,1721,55
RS,89052,SEBERI,3686,3439,1227,8688,113,7461,223
RS,89060,BOA VISTA DO INCRA,958,780,361,2155,20,1794,36
RS,89079,SELBACH,1430,2065,723,4375,60,3652,97
RS,89087,BOZANO,861,937,185,2046,15,1861,48
RS,89095,SERAFINA CORRÊA,2880,6295,1781,11687,263,9906,468
RS,89109,CANUDOS DO VALE,1067,466,135,1714,13,1579,33
RS,89117,SERTÃO,1680,2620,711,5248,68,4537,169
RS,89125,CAPÃO BONITO DO SUL,687,684,214,1647,21,1433,41
RS,89133,SEVERIANO DE ALMEIDA,1323,1533,262,3254,42,2992,94
RS,89141,CAPÃO DO CIPÓ,1170,846,328,2433,42,2105,47
RS,89150,CAPÃO DA CANOA,10135,14302,6642,32539,510,25897,950
RS,89168,COQUEIRO BAIXO,410,689,119,1280,15,1161,47
RS,89176,SOBRADINHO,3415,5171,2258,11337,181,9079,312
RS,89184,CORONEL PILAR,405,819,126,1408,18,1282,40
RS,89192,SOLEDADE,8370,8818,4824,23035,359,18211,664
RS,89206,CRUZALTENSE,667,1003,122,1865,21,1743,52
RS,89214,TAPEJARA,3317,9437,2373,15926,257,13553,542
RS,89222,FORQUETINHA,1043,845,142,2136,46,1994,60
RS,89230,TAPERA,3363,3283,1377,8296,91,6919,182
RS,89247,SANTA CECÍLIA DO SUL,542,822,149,1600,34,1451,53
RS,89249,ITATI,953,974,251,2280,37,2029,65
RS,89257,TAPES,4950,4314,3495,13410,250,9915,401
RS,89265,JACUIZINHO,1010,630,159,1862,18,1703,45
RS,89273,TAQUARA,13322,17996,7480,40781,698,33301,1285
RS,89281,LAGOA BONITA DO SUL,1025,863,350,2297,26,1947,33
RS,89290,TAQUARI,9414,7200,3527,20956,336,17429,479
RS,89303,MATO QUEIMADO,635,630,146,1465,15,1319,39
RS,89311,TENENTE PORTELA,3932,3893,2230,10388,83,8158,250
RS,89320,NOVO XINGU,672,552,144,1408,14,1264,26
RS,89338,TORRES,8698,11814,5607,27553,471,21946,963
RS,89346,PAULO BENTO,697,1009,243,2025,21,1782,55
RS,89354,TRAMANDAÍ,11292,11438,8009,32139,512,24130,888
RS,89362,PINHAL DA SERRA,848,831,369,2127,27,1758,52
RS,89370,TRÊS COROAS,5234,9031,2488,17684,374,15196,557
RS,89389,QUATRO IRMÃOS,620,671,264,1602,16,1338,31
RS,89397,TRÊS DE MAIO,6406,9040,3932,20017,223,16085,416
RS,89400,ROLADOR,1109,630,183,2013,48,1830,43
RS,89419,TRÊS PASSOS,7602,7295,2776,18473,269,15697,531
RS,89435,TRIUNFO,7622,8087,2091,19055,497,16964,758
RS,89443,SANTA MARGARIDA DO SUL,846,1017,242,2192,25,1950,62
RS,89451,TUCUNDUVA,1521,2404,750,4863,46,4113,142
RS,89460,SÃO JOSÉ DO SUL,700,900,214,1909,42,1695,53
RS,89478,TUPANCIRETÃ,6876,5951,3754,17312,289,13558,442
RS,89486,SÃO PEDRO DAS MISSÕES,747,586,336,1728,18,1392,41
RS,89494,TUPARENDI,2379,3505,1025,7193,89,6168,195
RS,89508,TIO HUGO,952,1049,238,2335,45,2097,51
RS,89516,URUGUAIANA,29132,33806,25056,90686,878,65630,1814
RS,89524,WESTFÁLIA,1245,933,288,2565,39,2277,60
RS,89532,VACARIA,9687,24692,8815,45378,800,36563,1384
RS,89540,PINTO BANDEIRA,506,1279,222,2137,37,1915,93
RS,89559,VENÂNCIO AIRES,21519,20906,8263,53493,1123,45230,1682
RS,89567,PEDRAS ALTAS,856,568,272,1763,22,1491,45
RS,89575,VERA CRUZ,7725,7728,2418,18758,313,16340,574
RS,89591,VERANÓPOLIS,2899,11503,3081,18600,372,15519,745
RS,89613,VIADUTOS,1438,2095,255,3966,64,3711,114
RS,89630,VIAMÃO,65316,58641,32551,166973,4054,134422,6411
RS,89656,VICENTE DUTRA,1576,1552,974,4238,59,3264,77
RS,89672,PALMARES DO SUL,3951,3480,1185,9066,155,7881,295
RS,89699,VICTOR GRAEFF,902,1284,369,2646,37,2277,54
RS,89710,TAVARES,2096,1331,880,4503,66,3623,130
RS,89737,CAPÃO DO LEÃO,9094,5140,3354,18491,384,15137,519
RS,89753,SALTO DO JACUÍ,3608,2948,2199,9073,137,6874,181
RS,89770,COTIPORÃ,787,1977,280,3228,80,2948,104
RS,98213,TEUTÔNIA,9286,9680,2965,22976,365,20011,680
RS,98230,BOM PRINCÍPIO,2581,5361,1048,9372,151,8324,231
RS,98256,PAROBÉ,15031,14764,5589,37400,704,31811,1312
RS,98272,FORTALEZA DOS VALOS,1469,1695,691,3974,57,3283,62
RS,98299,JÓIA,3167,2079,1229,6704,72,5475,157
SC,80004,MONTE CARLO,2197,3030,1660,7048,59,5388,102
SC,80012,ABELARDO LUZ,4457,5194,2768,12632,74,9864,139
SC,80020,IPORÃ DO OESTE,2612,3178,820,6762,69,5942,83
SC,80039,AGROLÂNDIA,2533,3778,1007,7500,65,6493,117
SC,80047,LINDÓIA DO SUL,1280,1804,481,3655,27,3174,63
SC,80055,AGRONÔMICA,1155,2109,477,3847,39,3370,67
SC,80063,APIÚNA,2058,4051,1407,7740,89,6333,135
SC,80071,ÁGUA DOCE,1564,2652,1096,5417,37,4321,68
SC,80080,DOUTOR PEDRINHO,520,1822,388,2794,12,2406,52
SC,80098,ÁGUAS DE CHAPECÓ,2171,1456,918,4663,49,3745,69
SC,80101,JOSÉ BOITEUX,1312,1756,726,3895,31,3169,70
SC,80110,ÁGUAS MORNAS,1679,2826,325,5048,71,4723,147
SC,80128,VITOR MEIRELES,1685,1576,1041,4374,31,3333,41
SC,80136,ALFREDO WAGNER,2489,3874,969,7469,52,6500,85
SC,80144,UNIÃO DO OESTE,989,1109,352,2509,32,2157,27
SC,80152,ANCHIETA,2322,1710,1088,5271,53,4183,98
SC,80160,URUPEMA,682,1047,404,2192,25,1788,34
SC,80179,ANGELINA,2089,2076,276,4561,57,4285,63
SC,80187,IRACEMINHA,1465,1494,498,3526,31,3028,38
SC,80195,ANITA GARIBALDI,3034,2312,2126,7688,84,5562,132
SC,80209,TIMBÓ GRANDE,2251,1988,1205,5582,44,4377,94
SC,80217,ANITÁPOLIS,1110,1206,262,2657,40,2395,39
SC,80225,ABDON BATISTA,923,1012,322,2297,18,1975,22
SC,80233,ANTÔNIO CARLOS,1810,3999,343,6406,65,6063,189
SC,80241,SANTA ROSA DO SUL,2623,2692,1139,6673,78,5534,141
SC,80250,ARAQUARI,6101,6174,3625,16439,214,12814,325
SC,80268,CELSO RAMOS,1092,833,246,2227,37,1981,19
SC,80276,ARARANGUÁ,16630,20538,8244,46763,474,38519,877
SC,80284,SERRA ALTA,1162,1065,335,2640,37,2305,41
SC,80292,ARMAZÉM,2052,3124,770,6103,50,5333,107
SC,80306,COCAL DO SUL,3436,6903,1920,12817,137,10897,421
SC,80314,ARROIO TRINTA,815,1693,502,3070,12,2568,48
SC,80322,NOVA ITABERABA,1748,1512,450,3790,28,3340,52
SC,80330,ASCURRA,1149,3825,971,6161,72,5190,144
SC,80349,SANTA TEREZINHA,2217,3162,1277,6799,63,5522,80
SC,80357,ATALANTA,803,1589,387,2847,21,2460,47
SC,80365,MIRIM DOCE,775,1071,342,2229,7,1887,34
SC,80373,AURORA,1578,2413,435,4538,31,4103,81
SC,80381,CERRO NEGRO,1427,946,615,3043,14,2428,41
SC,80390,BALNEÁRIO CAMBORIÚ,15400,48410,20468,86992,822,66524,1892
SC,80403,PASSO DE TORRES,1676,2136,1013,5049,88,4036,136
SC,80411,BARRA VELHA,4697,8836,4461,18575,224,14114,357
SC,80420,BRAÇO DO TROMBUDO,659,1917,460,3084,12,2624,36
SC,80438,BENEDITO NOVO,1140,5622,1073,8060,67,6987,158
SC,80446,SUL BRASIL,1050,907,268,2277,15,2009,37
SC,80454,BIGUAÇU,12616,21567,7715,43986,658,36271,1430
SC,80462,VARGEM,1073,985,624,2734,31,2110,21
SC,80470,BLUMENAU,42869,145111,39823,238193,2496,198370,7894
SC,80489,ARABUTÃ,1355,1766,477,3687,26,3210,63
SC,80497,BOM RETIRO,2267,2935,1813,7174,55,5361,104
SC,80500,ÁGUAS FRIAS,982,958,252,2235,16,1983,27
SC,80519,BOTUVERÁ,1058,2273,367,3842,51,3475,93
SC,80527,GUATAMBÚ,2251,1777,624,4767,53,4143,62
SC,80535,BRAÇO DO NORTE,4878,13602,3316,22350,186,19034,368
SC,80543,PLANALTO ALEGRE,1349,1012,342,2769,28,2427,38
SC,80551,BRUSQUE,12080,55110,11934,81499,632,69565,1743
SC,80560,RIQUEZA,1779,1376,585,3832,28,3247,64
SC,80578,CAÇADOR,16813,22078,10858,51220,605,40362,866
SC,80586,LAJEADO GRANDE,673,618,272,1587,9,1315,15
SC,80594,CAIBI,1915,2027,793,4867,46,4074,86
SC,80608,RIO RUFINO,806,972,473,2290,14,1817,25
SC,80616,CAMBORIÚ,11298,18197,8125,39135,528,31010,987
SC,80624,PASSOS MAIA,1446,1083,791,3383,16,2592,47
SC,80632,CAMPO ALEGRE,1672,5774,1553,9209,75,7656,135
SC,80640,SÃO JOÃO DO OESTE,1500,2832,558,5040,42,4482,108
SC,80659,CAMPO BELO DO SUL,2371,2387,1180,6078,42,4898,98
SC,80667,CALMON,1307,969,1009,3341,16,2332,40
SC,80675,CAMPO ERÊ,3101,2371,1634,7279,62,5645,111
SC,80683,BALNEÁRIO BARRA DO SUL,2562,3306,1980,8062,63,6082,151
SC,80691,CAMPOS NOVOS,7000,12512,5264,25312,227,20048,309
SC,80705,PARAÍSO,1584,1295,695,3656,30,2961,52
SC,80713,CANELINHA,2196,4817,1559,8847,107,7288,168
SC,80721,SANTA HELENA,1023,840,350,2262,23,1912,26
SC,80730,CANOINHAS,9989,22218,8087,41121,337,33034,490
SC,80748,BELMONTE,952,906,385,2292,24,1907,25
SC,80756,CAPINZAL,4668,8161,2648,15948,171,13300,300
SC,80764,NOVO HORIZONTE,999,966,368,2388,20,2020,35
SC,80772,CATANDUVAS,2510,3385,1230,7267,49,6037,93
SC,80780,SÃO MIGUEL DA BOA VISTA,856,561,273,1719,8,1446,21
SC,80799,CAXAMBU DO SUL,2027,1486,566,4153,22,3587,52
SC,80802,ARVOREDO,935,861,289,2126,15,1837,26
SC,80810,CHAPECÓ,48754,62113,22356,136664,1184,114308,2257
SC,80829,IPUAÇU,2589,1265,799,4750,36,3951,61
SC,80837,CONCÓRDIA,15051,29087,9312,54680,396,45368,834
SC,80845,OURO VERDE,720,943,358,2061,15,1703,25
SC,80853,CORONEL FREITAS,3145,3661,1170,8179,74,7009,129
SC,80861,IRATI,705,795,271,1816,17,1545,28
SC,80870,CORUPÁ,2837,6529,1704,11417,96,9713,251
SC,80888,FORMOSA DO SUL,1021,818,344,2243,34,1899,26
SC,80896,CRICIÚMA,35180,75063,26033,141977,1932,115944,3769
SC,80900,MACIEIRA,712,754,387,1888,16,1501,19
SC,80918,CUNHA PORÃ,2706,4395,1285,8642,91,7357,165
SC,80926,PONTE ALTA DO NORTE,863,1140,644,2700,21,2056,32
SC,80934,CURITIBANOS,8218,14268,6784,30081,293,23297,518
SC,80942,SÃO CRISTÓVÃO DO SUL,854,1649,927,3496,30,2569,36
SC,80950,DESCANSO,2926,2938,816,6832,59,6016,93
SC,80969,VARGEM BONITA,1458,1758,717,3998,19,3281,46
SC,80977,DIONÍSIO CERQUEIRA,4185,4392,2601,11406,64,8805,164
SC,80985,BOMBINHAS,2915,5279,2341,11060,140,8719,385
SC,80993,DONA EMMA,1100,1359,360,2880,20,2520,41
SC,81000,SANGÃO,2454,3899,1265,7826,79,6561,129
SC,81019,ERVAL VELHO,1065,2022,494,3665,30,3171,54
SC,81027,CAPIVARI DE BAIXO,7291,5989,2658,16619,200,13961,481
SC,81035,FAXINAL DOS GUEDES,4443,2545,1269,8432,66,7163,109
SC,81043,CORDILHEIRA ALTA,1761,1300,402,3529,25,3127,41
SC,81051,FLORIANÓPOLIS,85791,164824,69119,335363,3716,266244,11913
SC,81060,FORQUILHINHA,5053,9690,2304,17630,227,15326,356
SC,81078,FRAIBURGO,6456,13543,6288,26956,252,20668,417
SC,81086,MORRO GRANDE,742,1637,443,2897,19,2454,56
SC,81094,GALVÃO,1269,1005,592,2968,33,2376,69
SC,81108,CORONEL MARTINS,937,790,295,2053,11,1758,20
SC,81116,GOVERNADOR CELSO RAMOS,2496,6753,1138,10941,184,9803,370
SC,81124,SÃO JOÃO DO ITAPERIÚ,763,1763,498,3101,35,2603,42
SC,81132,GAROPABA,4306,7572,2923,15419,218,12496,400
SC,81140,JARDINÓPOLIS,536,685,208,1469,16,1261,24
SC,81159,GARUVA,3100,5130,2159,10700,124,8541,187
SC,81167,ERMO,866,1368,336,2625,15,2289,40
SC,81175,GASPAR,9313,24823,6188,41673,417,35485,932
SC,81183,SÃO PEDRO DE ALCÂNTARA,975,1931,236,3276,31,3040,103
SC,81191,GRÃO-PARÁ,1737,2992,738,5627,49,4889,111
SC,81205,SANTIAGO DO SUL,546,636,195,1409,9,1214,23
SC,81213,GRAVATAL,2023,4907,1326,8464,64,7138,144
SC,81221,BELA VISTA DO TOLDO,1811,2210,785,4890,29,4105,55
SC,81230,GUABIRUBA,2472,9454,1539,13921,124,12382,332
SC,81248,CAPÃO ALTO,789,1445,582,2876,17,2294,43
SC,81256,GUARACIABA,3454,3829,1056,8515,64,7459,112
SC,81264,PAINEL,1018,941,442,2440,16,1998,23
SC,81272,GUARAMIRIM,7838,13785,4576,27041,301,22465,541
SC,81280,BOCAINA DO SUL,1271,1161,424,2913,23,2489,34
SC,81299,GUARUJÁ DO SUL,1509,1699,675,3969,33,3294,53
SC,81302,ALTO BELA VISTA,620,924,252,1839,9,1587,34
SC,81310,HERVAL D'OESTE,4435,8616,2990,16380,119,13390,220
SC,81329,FREI ROGÉRIO,918,870,421,2265,18,1844,38
SC,81337,IBICARÉ,820,1626,403,2918,19,2515,50
SC,81345,TREVISO,773,2295,572,3732,25,3160,67
SC,81353,IBIRAMA,3728,7401,2633,14208,111,11575,335
SC,81361,IOMERÊ,857,1436,430,2801,28,2371,50
SC,81370,IÇARA,13463,16944,5681,37402,493,31721,821
SC,81388,BOM JESUS,1069,783,423,2333,24,1910,34
SC,81396,ILHOTA,2472,5638,1895,10453,126,8558,322
SC,81400,IBIAM,636,866,256,1795,13,1539,24
SC,81418,IMARUÍ,4115,3276,2333,10057,99,7724,234
SC,81426,ENTRE RIOS,1492,613,561,2705,13,2144,26
SC,81434,IMBITUBA,11256,13253,7421,33390,402,25969,1058
SC,81442,PAIAL,757,670,322,1780,11,1458,20
SC,81450,IMBUIA,1937,1929,536,4513,49,3977,62
SC,81469,BOM JESUS DO OESTE,868,705,236,1853,15,1617,29
SC,81477,INDAIAL,7642,25350,6755,41240,388,34485,1105
SC,81485,SÃO BERNARDINO,1269,655,328,2287,12,1959,23
SC,81493,IPIRA,1502,1565,550,3722,47,3172,58
SC,81507,SANTA TEREZINHA DO PROGRESSO,1205,739,442,2447,26,2005,35
SC,81515,IPUMIRIM,2329,2500,718,5687,43,4969,97
SC,81523,SALTINHO,1599,962,574,3234,35,2660,64
SC,81531,IRANI,3129,2830,1134,7257,77,6123,87
SC,81540,JUPIÁ,912,672,272,1892,10,1620,26
SC,81558,IRINEÓPOLIS,3146,3149,1269,7734,53,6465,117
SC,81566,PALMEIRA,852,1346,526,2787,20,2261,43
SC,81574,ITÁ,2123,2349,1219,5834,36,4615,107
SC,81582,BANDEIRANTE,1250,983,401,2687,20,2286,33
SC,81590,ITAIÓPOLIS,4752,7681,3100,15936,144,12836,259
SC,81604,FLOR DO SERTÃO,822,467,273,1606,17,1333,27
SC,81612,ITAJAÍ,30682,73269,26405,136235,1818,109830,4061
SC,81620,CUNHATAÍ,741,696,168,1642,16,1474,21
SC,81639,ITAPEMA,6736,18782,6668,33303,341,26635,776
SC,81647,PRINCESA,1036,1012,352,2442,21,2090,21
SC,81655,ITAPIRANGA,3302,6248,1789,11599,92,9810,168
SC,81663,ITAPOÁ,3315,4945,3154,11781,119,8627,248
SC,81671,ITUPORANGA,4993,9661,2301,17381,142,15080,284
SC,81680,TIGRINHOS,985,548,268,1831,15,1563,15
SC,81698,JABORÁ,1301,1763,487,3628,24,3141,53
SC,81701,CHAPADÃO DO LAGEADO,921,1061,258,2297,16,2039,41
SC,81710,JACINTO MACHADO,2398,4918,1395,8965,78,7570,176
SC,81728,BALNEÁRIO ARROIO DO SILVA,3057,3481,1968,8775,93,6807,176
SC,81736,JAGUARUNA,5233,5602,2391,13705,161,11314,318
SC,81744,BALNEÁRIO GAIVOTA,2714,2590,1525,7074,84,5549,161
SC,81752,JARAGUÁ DO SUL,27164,62397,17417,110432,1021,93015,2433
SC,81760,BARRA BONITA,769,726,324,1864,12,1540,33
SC,81779,JOAÇABA,4839,12104,4062,21485,171,17423,309
SC,81787,BRUNÓPOLIS,1092,1090,539,2786,25,2247,40
SC,81795,JOINVILLE,102125,200780,66118,387555,5019,321437,13513
SC,81809,LUZERNA,1121,2938,600,4754,21,4154,74
SC,81817,LACERDÓPOLIS,573,1102,276,2012,16,1736,45
SC,81825,ZORTÉA,891,1315,321,2600,28,2279,45
SC,81833,LAGES,36959,55525,24643,120602,1370,95959,2105
SC,81850,LAGUNA,12130,13495,6520,33350,418,26830,787
SC,81876,LAURENTINO,1534,2928,591,5208,48,4617,107
SC,81892,LAURO MÜLLER,2428,7241,1907,12049,94,10142,379
SC,81914,LEBON RÉGIS,3969,2631,2336,9132,84,6796,112
SC,81930,LEOBERTO LEAL,1297,1229,409,3002,19,2593,48
SC,81957,LONTRAS,2165,4326,1306,8047,82,6741,168
SC,81973,LUÍS ALVES,1565,5513,1054,8342,50,7288,160
SC,81990,MAFRA,8949,24376,7613,42316,526,34703,852
SC,82015,MAJOR GERCINO,888,1406,317,2687,33,2370,43
SC,82031,MAJOR VIEIRA,1882,2774,874,5659,52,4785,77
SC,82058,MARAVILHA,6449,7783,2951,17628,160,14677,285
SC,82066,MAREMA,954,780,277,2046,16,1769,19
SC,82074,MASSARANDUBA,2660,7494,1695,12168,86,10473,233
SC,82090,MATOS COSTA,906,742,751,2446,10,1695,37
SC,82112,MELEIRO,1400,3407,844,5769,40,4925,78
SC,82139,MODELO,1427,1343,372,3205,25,2833,38
SC,82155,MONDAÍ,3007,3084,1112,7378,54,6266,121
SC,82171,MONTE CASTELO,2212,2908,1604,6895,57,5291,114
SC,82198,MORRO DA FUMAÇA,3346,7125,1719,12613,144,10894,279
SC,82210,NAVEGANTES,11036,20648,8768,41918,555,33150,911
SC,82236,NOVA ERECHIM,1221,1911,431,3651,33,3220,55
SC,82252,NOVA TRENTO,2532,5761,830,9454,107,8624,224
SC,82279,NOVA VENEZA,3216,6397,1581,11529,108,9948,227
SC,82295,ORLEANS,3116,11568,2864,18069,163,15205,358
SC,82317,OURO,1634,3271,923,5973,49,5050,96
SC,82333,PALHOÇA,28441,48851,16664,98853,1545,82189,3352
SC,82350,PALMA SOLA,2846,1645,1361,5997,58,4636,87
SC,82376,PALMITOS,4689,5460,2320,12788,110,10468,209
SC,82392,PAPANDUVA,5348,6103,2806,14581,136,11775,188
SC,82414,PAULO LOPES,1871,2582,439,5054,55,4615,107
SC,82430,PEDRAS GRANDES,1052,2144,600,3906,30,3306,80
SC,82457,PENHA,4243,9383,4464,18774,242,14310,442
SC,82473,PERITIBA,825,1515,379,2801,41,2422,41
SC,82490,PETROLÂNDIA,1837,2439,608,5035,45,4427,106
SC,82511,BALNEÁRIO PIÇARRAS,3299,6591,3304,13615,139,10311,282
SC,82538,PINHALZINHO,5143,6014,2016,13518,116,11502,229
SC,82554,PINHEIRO PRETO,772,1373,456,2669,27,2213,41
SC,82570,PIRATUBA,1465,2119,434,4122,29,3688,75
SC,82597,POMERODE,4006,14006,3129,21951,177,18822,633
SC,82619,PONTE ALTA,1273,1773,975,4104,31,3129,52
SC,82635,PONTE SERRADA,3670,2893,2044,8786,73,6742,106
SC,82651,PORTO BELO,2404,6201,2526,11550,112,9024,307
SC,82678,PORTO UNIÃO,6841,11874,5541,24860,206,19319,398
SC,82694,POUSO REDONDO,3038,5719,1913,10948,95,9035,183
SC,82716,PRAIA GRANDE,1943,2710,946,5789,62,4843,128
SC,82732,PRESIDENTE CASTELO BRANCO,380,932,151,1497,18,1346,16
SC,82759,PRESIDENTE GETÚLIO,3475,6229,1836,11925,108,10089,277
SC,82775,PRESIDENTE NEREU,615,1086,516,2274,15,1758,42
SC,82791,QUILOMBO,3371,3428,1390,8394,96,7004,109
SC,82813,RANCHO QUEIMADO,842,1397,204,2526,33,2322,50
SC,82830,RIO DAS ANTAS,1113,3184,1243,5668,51,4425,77
SC,82856,RIO DO CAMPO,1439,2787,755,5093,28,4338,84
SC,82872,RIO DO OESTE,2012,2734,623,5488,44,4865,75
SC,82899,RIO DOS CEDROS,1629,5126,1094,8088,61,6994,178
SC,82910,RIO DO SUL,10206,27964,8337,47855,399,39518,949
SC,82937,RIO FORTUNA,1153,2603,395,4252,41,3857,60
SC,82953,RIO NEGRINHO,5666,18466,6945,31869,202,24924,590
SC,82970,RODEIO,1524,5730,1334,8888,86,7554,214
SC,82996,ROMELÂNDIA,1960,1357,848,4265,44,3417,56
SC,83011,SALETE,1898,2885,1099,6046,56,4947,108
SC,83038,SALTO VELOSO,1135,1792,609,3643,17,3034,90
SC,83054,SANTA CECÍLIA,3138,6006,3123,12604,144,9481,193
SC,83070,SANTA ROSA DE LIMA,654,973,267,1959,35,1692,30
SC,83097,SANTO AMARO DA IMPERATRIZ,4770,8526,2188,16153,167,13965,502
SC,83119,SÃO BENTO DO SUL,12736,35555,9778,59647,516,49869,1062
SC,83135,SÃO BONIFÁCIO,673,1549,223,2532,35,2309,52
SC,83151,SÃO CARLOS,2830,3712,1126,7836,55,6710,113
SC,83178,SÃO DOMINGOS,3023,2813,1190,7223,81,6033,116
SC,83194,SÃO FRANCISCO DO SUL,9057,15987,7468,33739,383,26271,844
SC,83216,SÃO JOÃO BATISTA,3561,11814,3121,19045,193,15924,356
SC,83232,SÃO JOÃO DO SUL,1860,3349,863,6238,73,5375,93
SC,83259,SÃO JOAQUIM,5751,9314,3246,18821,193,15575,317
SC,83275,SÃO JOSÉ,40401,76117,27189,151160,1959,123971,5494
SC,83291,SÃO JOSÉ DO CEDRO,3718,5079,2034,11019,73,8985,115
SC,83313,SÃO JOSÉ DO CERRITO,3300,2355,1203,6987,54,5784,75
SC,83330,SÃO LOURENÇO DO OESTE,6843,7394,2939,17614,160,14675,278
SC,83356,SÃO LUDGERO,2258,4602,1234,8304,76,7070,134
SC,83372,SÃO MARTINHO,903,1787,315,3090,27,2775,58
SC,83399,SÃO MIGUEL DO OESTE,9744,12453,5793,28659,210,22866,459
SC,83410,SAUDADES,2759,3470,655,7063,69,6408,110
SC,83437,SCHROEDER,3479,6434,1641,11932,109,10291,269
SC,83453,SEARA,5007,6183,2405,13942,134,11537,213
SC,83470,SIDERÓPOLIS,2635,6030,1926,10953,106,9027,256
SC,83496,SOMBRIO,7263,9066,3715,20682,209,16967,429
SC,83518,TAIÓ,3485,7456,2041,13307,83,11266,242
SC,83534,TANGARÁ,1894,3673,1231,6975,70,5744,107
SC,83550,TIJUCAS,5319,13893,4826,24942,255,20116,649
SC,83577,TIMBÓ,4151,20182,4040,29353,230,25313,750
SC,83593,TRÊS BARRAS,4069,6829,3177,14379,119,11202,185
SC,83615,TREZE DE MAIO,1615,3458,841,6083,63,5242,106
SC,83631,TREZE TÍLIAS,981,3039,895,5025,30,4130,80
SC,83658,TROMBUDO CENTRAL,1382,2898,845,5254,39,4409,90
SC,83674,TUBARÃO,21278,37895,13357,75456,840,62099,2086
SC,83682,TUNÁPOLIS,1323,1926,463,3820,39,3357,69
SC,83690,TURVO,2421,5748,1434,9893,95,8459,195
SC,83712,URUBICI,2171,3729,1935,7979,39,6044,105
SC,83739,URUSSANGA,3317,9981,3087,16905,128,13818,392
SC,83755,VARGEÃO,1327,949,511,2862,27,2351,48
SC,83771,VIDAL RAMOS,2131,2029,609,4893,52,4284,72
SC,83798,VIDEIRA,8439,19122,7275,35869,351,28594,682
SC,83810,WITMARSUM,1159,1413,467,3154,38,2687,77
SC,83836,XANXERÊ,14142,12499,6019,33434,288,27415,486
SC,83852,XAVANTINA,1475,1631,407,3579,35,3172,31
SC,83879,XAXIM,8091,8702,3408,20775,218,17367,356
SC,83895,BOM JARDIM DA SERRA,1347,1425,690,3535,26,2845,47
SC,83909,BALNEÁRIO RINCÃO,3514,4012,2052,9843,118,7791,147
SC,83917,MARACAJÁ,2242,2417,706,5570,83,4864,122
SC,83925,PESCARIA BRAVA,3153,2564,1079,7046,73,5967,177
SC,83933,TIMBÉ DO SUL,1590,2158,659,4532,50,3873,75
SC,83950,CORREIA PINTO,4436,4833,2300,11833,102,9533,162
SC,83976,OTACÍLIO COSTA,3517,6176,2446,12470,117,10024,214
SE,31003,SANTANA DO SÃO FRANCISCO,3030,929,898,5032,61,4134,114
SE,31011,AMPARO DE SÃO FRANCISCO,1122,659,509,2341,14,1832,37
SE,31038,AQUIDABÃ,8586,2823,2463,14398,100,11935,426
SE,31054,ARACAJU,174586,132497,59755,389713,5793,329958,17082
SE,31070,ARAUÁ,4523,2041,1539,8430,99,6891,228
SE,31097,AREIA BRANCA,5994,3740,1620,11902,167,10282,381
SE,31119,BARRA DOS COQUEIROS,8445,4754,3089,17143,267,14054,588
SE,31135,BREJO GRANDE,3201,1046,1317,5723,46,4406,113
SE,31151,BOQUIM,10625,4374,3432,19255,248,15823,576
SE,31194,CAMPO DO BRITO,7062,3178,2464,13224,132,10760,388
SE,31216,CANHOBA,2595,519,609,3827,25,3218,79
SE,31232,CANINDÉ DE SÃO FRANCISCO,12922,2987,4223,20806,166,16583,508
SE,31259,CAPELA,11599,5228,3687,21700,392,18013,794
SE,31275,CARIRA,9401,2762,2466,15227,133,12761,465
SE,31291,CARMÓPOLIS,5624,3984,2573,12831,177,10258,473
SE,31313,CEDRO DE SÃO JOÃO,2583,1045,730,4500,33,3770,109
SE,31330,CRISTINÁPOLIS,6804,1803,2740,11704,98,8964,259
SE,31356,NOSSA SENHORA APARECIDA,3436,2038,927,6632,77,5705,154
SE,31372,CUMBE,1823,926,475,3362,38,2887,100
SE,31399,DIVINA PASTORA,2077,575,587,3397,54,2810,104
SE,31410,ESTÂNCIA,26231,7410,7447,43014,664,35567,1262
SE,31437,FEIRA NOVA,2839,1086,771,4858,39,4087,123
SE,31453,FREI PAULO,5003,4115,1537,11050,111,9513,284
SE,31470,GENERAL MAYNARD,1199,602,372,2270,23,1898,74
SE,31496,GARARU,5383,1320,1142,8120,78,6978,197
SE,31518,GRACCHO CARDOSO,3392,747,848,5143,29,4295,127
SE,31534,ILHA DAS FLORES,3362,1413,1523,6497,69,4974,130
SE,31550,INDIAROBA,6336,1549,2187,10470,119,8283,279
SE,31577,ITABAIANA,29937,19605,7753,60071,759,52318,2017
SE,31593,ITABAIANINHA,15458,5579,3748,25886,314,22138,787
SE,31615,ITABI,2293,965,670,4073,35,3403,110
SE,31631,ITAPORANGA D'AJUDA,13024,5288,3531,23052,412,19521,797
SE,31658,JAPARATUBA,7095,2979,1856,12413,140,10557,343
SE,31674,JAPOATÃ,5916,1751,1596,9593,99,7997,231
SE,31690,LAGARTO,40130,13493,9444,66270,744,56826,2459
SE,31712,LARANJEIRAS,10373,4939,3010,19437,411,16427,704
SE,31739,MACAMBIRA,3034,1528,760,5520,68,4760,130
SE,31755,MALHADA DOS BOIS,2126,531,578,3349,27,2771,87
SE,31771,MALHADOR,5139,2029,1355,8924,84,7569,317
SE,31798,MARUIM,7253,1791,1818,11409,168,9591,379
SE,31810,MOITA BONITA,3918,2838,1169,8342,122,7173,295
SE,31836,MONTE ALEGRE DE SERGIPE,5519,2138,1499,9508,71,8009,281
SE,31852,MURIBECA,3373,1267,1161,6056,82,4895,173
SE,31879,NEÓPOLIS,7695,2408,2485,13132,151,10647,393
SE,31895,NOSSA SENHORA DA GLÓRIA,14696,4641,3226,23321,199,20095,559
SE,31917,NOSSA SENHORA DAS DORES,9778,4776,2659,18119,274,15460,632
SE,31933,NOSSA SENHORA DE LOURDES,3510,744,648,5048,28,4400,118
SE,31950,NOSSA SENHORA DO SOCORRO,48421,27104,12707,93641,1628,80934,3781
SE,31976,PACATUBA,6000,1472,2295,10059,86,7764,206
SE,31992,PEDRA MOLE,1357,964,445,2846,21,2401,59
SE,32018,PEDRINHAS,3393,1556,1382,6576,76,5194,169
SE,32034,PINHÃO,2820,1101,836,4961,60,4125,144
SE,32050,PIRAMBU,3833,1447,1053,6594,80,5541,181
SE,32077,POÇO REDONDO,9741,4135,2992,17467,131,14475,468
SE,32093,POÇO VERDE,9183,3733,3177,16686,144,13509,449
SE,32115,PORTO DA FOLHA,12102,3601,3766,20147,194,16381,484
SE,32131,PROPRIÁ,9848,5360,3215,19061,210,15846,428
SE,32158,RIACHÃO DO DANTAS,9247,2750,2404,14993,164,12589,428
SE,32174,RIACHUELO,4130,1383,1165,6979,81,5814,220
SE,32190,RIBEIRÓPOLIS,5919,4610,1961,13044,156,11083,398
SE,32212,ROSÁRIO DO CATETE,4544,1516,1274,7703,105,6429,264
SE,32239,SALGADO,8650,2599,1776,13730,200,11954,505
SE,32255,SANTA LUZIA DO ITANHY,5734,1449,1816,9440,139,7624,302
SE,32298,SANTA ROSA DE LIMA,2082,650,608,3469,40,2861,89
SE,32310,SANTO AMARO DAS BROTAS,4756,1019,1827,7903,87,6076,214
SE,32336,SÃO CRISTÓVÃO,27933,11876,7100,50019,788,42919,2322
SE,32352,SÃO DOMINGOS,3541,2197,1348,7382,57,6034,239
SE,32379,SÃO FRANCISCO,1864,651,627,3236,28,2609,66
SE,32395,SÃO MIGUEL DO ALEIXO,1574,908,645,3248,31,2603,90
SE,32417,SIMÃO DIAS,17758,7038,4639,30915,390,26276,1090
SE,32433,SIRIRI,3418,1226,771,5659,81,4888,163
SE,32450,TELHA,1381,1010,405,2870,24,2465,50
SE,32476,TOBIAS BARRETO,20658,7270,5098,34362,293,29264,1043
SE,32492,TOMAR DO GERU,4590,2168,2185,9334,105,7149,286
SE,32514,UMBAÚBA,7955,4421,2935,16008,251,13073,446
SP,61000,EUCLIDES DA CUNHA PAULISTA,3389,1783,2418,7790,81,5372,119
SP,61018,ADAMANTINA,5780,14477,6475,27576,380,21101,464
SP,61026,BOREBI,548,996,381,1987,19,1606,43
SP,61034,ADOLFO,1132,1527,771,3558,42,2787,86
SP,61042,TARUMÃ,3533,4817,2098,10716,101,8618,167
SP,61050,AGUAÍ,6342,11184,5769,24425,364,18656,766
SP,61069,MOTUCA,1298,1357,892,3665,48,2773,70
SP,61077,ÁGUAS DA PRATA,1600,3158,1465,6423,67,4958,133
SP,61085,IARAS,1374,1214,1252,3974,43,2722,91
SP,61093,ÁGUAS DE LINDÓIA,2055,8211,3019,13763,141,10744,337
SP,61107,GUATAPARÁ,1857,1997,1222,5245,77,4023,92
SP,61115,ÁGUAS DE SÃO PEDRO,378,2028,382,2878,23,2496,67
SP,61123,DIRCE REIS,568,646,325,1595,25,1270,31
SP,61131,AGUDOS,5912,14898,6150,28612,537,22462,1115
SP,61140,ESPÍRITO SANTO DO TURVO,1273,1309,778,3443,31,2665,52
SP,61158,ALFREDO MARCONDES,1237,1683,605,3649,38,3044,86
SP,61166,ROSANA,6568,3936,5676,16634,152,10958,302
SP,61174,ALTAIR,952,1176,855,3090,42,2235,65
SP,61182,EMBAÚBA,512,1364,477,2449,28,1972,68
SP,61190,ALTINÓPOLIS,3541,5854,3310,13221,193,9911,323
SP,61204,ILHA SOLTEIRA,5888,8605,6124,21553,239,15429,697
SP,61212,ALTO ALEGRE,848,1941,850,3789,48,2939,102
SP,61220,ALUMÍNIO,4673,6116,2873,14358,245,11485,451
SP,61239,ÁLVARES FLORENCE,932,1980,742,3774,40,3032,80
SP,61247,PEDRINHAS PAULISTA,776,1275,625,2761,29,2136,56
SP,61255,ÁLVARES MACHADO,5735,7892,3605,17792,208,14187,352
SP,61263,ARAÇARIGUAMA,3815,6426,3985,14681,189,10696,266
SP,61271,ÁLVARO DE CARVALHO,1023,1045,871,3133,37,2262,157
SP,61280,BERTIOGA,10640,16482,10482,38820,421,28338,795
SP,61298,ALVINLÂNDIA,948,1039,609,2666,33,2057,37
SP,61301,SUZANÁPOLIS,1135,1059,553,2829,29,2276,53
SP,61310,AMERICANA,44206,86888,31860,172021,2852,140161,6215
SP,61328,SANTO ANTÔNIO DO ARACANGUÁ,2235,2763,957,6058,46,5101,57
SP,61336,AMÉRICO BRASILIENSE,10774,9089,5500,26830,409,21330,1058
SP,61344,CANITAR,1039,1640,853,3699,69,2846,98
SP,61352,AMÉRICO DE CAMPOS,1035,2765,767,4712,56,3945,89
SP,61360,BARRA DO CHAPÉU,2116,1115,1218,4597,60,3379,88
SP,61379,AMPARO,9150,30343,10808,52688,708,41880,1679
SP,61387,EMILIANÓPOLIS,1125,918,479,2593,33,2114,38
SP,61395,ANALÂNDIA,554,2160,660,3502,45,2842,83
SP,61409,NOVAIS,846,1645,748,3424,65,2676,120
SP,61417,ANDRADINA,13134,19121,10244,43986,523,33742,964
SP,61425,NOVA CANAÃ PAULISTA,858,679,458,2064,32,1606,37
SP,61433,ANGATUBA,5396,7438,3769,17385,248,13616,534
SP,61441,SALTINHO,637,4441,821,6119,96,5298,124
SP,61450,ANHEMBI,814,2798,1837,5596,43,3759,104
SP,61468,UBARANA,1700,1521,1055,4412,52,3357,84
SP,61476,ANHUMAS,983,1602,622,3304,35,2682,62
SP,61484,CAJATI,6949,8899,6831,23436,313,16605,444
SP,61492,APARECIDA,7649,14816,5796,29183,365,23387,557
SP,61506,CAMPINA DO MONTE ALEGRE,1383,2067,958,4570,62,3612,100
SP,61514,APARECIDA D'OESTE,1281,1655,921,3967,39,3046,71
SP,61522,ASPÁSIA,564,862,326,1801,12,1475,37
SP,61530,APIAÍ,7475,6415,6155,20666,237,14511,384
SP,61549,VARGEM,1377,3738,1689,7053,92,5364,157
SP,61557,ARAÇATUBA,33354,74423,29487,141560,1290,112073,3006
SP,61565,POTIM,3689,5180,2355,11562,157,9207,181
SP,61573,ARAÇOIABA DA SERRA,4516,11842,3899,21192,327,17293,608
SP,61581,ALAMBARI,1179,1939,780,4035,55,3255,82
SP,61590,ARAMINA,1684,1677,901,4432,53,3531,117
SP,61603,ITAOCA,1208,789,867,2947,28,2080,55
SP,61611,ARANDU,1571,2513,1059,5333,86,4274,104
SP,61620,TUIUTI,897,3051,1002,5090,49,4088,91
SP,61638,ARARAQUARA,46070,72033,34622,162073,2533,127451,6815
SP,61646,ARAPEÍ,727,1004,622,2434,20,1812,61
SP,61654,ARARAS,17029,56542,16902,94448,1205,77546,2770
SP,61662,ESTIVA GERBI,2269,3982,1457,8148,140,6691,300
SP,61670,AREALVA,1414,3248,1301,6236,108,4935,165
SP,61689,ENGENHEIRO COELHO,4221,4796,3063,12477,141,9414,256
SP,61697,AREIAS,1180,1201,869,3353,39,2484,64
SP,61700,RIBEIRÃO GRANDE,2951,2119,1454,6713,87,5259,102
SP,61719,AREIÓPOLIS,2774,3686,1815,8580,133,6765,172
SP,61727,HORTOLÂNDIA,58720,44870,27866,138585,2596,110719,4533
SP,61735,ARIRANHA,985,4539,1455,7235,79,5780,177
SP,61743,HOLAMBRA,2282,5923,1895,10383,102,8488,181
SP,61751,ARTUR NOGUEIRA,7715,16801,5690,31654,574,25964,874
SP,61760,ELISIÁRIO,611,1535,481,2718,26,2237,65
SP,61778,ARUJÁ,17863,29539,12092,62378,917,50286,1967
SP,61786,BOM SUCESSO DE ITARARÉ,1074,1215,809,3149,19,2340,32
SP,61794,ASSIS,16980,33500,16654,69656,853,53002,1669
SP,61808,PONTALINDA,1118,1369,792,3391,46,2599,66
SP,61816,ATIBAIA,15188,60757,22663,102563,1287,79900,2668
SP,61824,PARISI,553,1140,422,2180,23,1758,42
SP,61832,AURIFLAMA,3843,4730,2409,11424,173,9015,269
SP,61840,TAQUARIVAÍ,1051,2355,1238,4762,48,3524,70
SP,61859,AVAÍ,1125,1875,918,4041,47,3123,76
SP,61867,MARAPOAMA,443,1525,504,2536,15,2032,49
SP,61875,AVANHANDAVA,2475,3289,1710,7688,89,5978,125
SP,61883,SÃO JOÃO DE IRACEMA,632,582,391,1654,25,1263,24
SP,61891,AVARÉ,10521,35864,14256,63240,847,48984,1752
SP,61905,SÃO LOURENÇO DA SERRA,3025,5018,2455,11035,192,8580,345
SP,61913,BADY BASSITT,3058,5827,2531,11897,126,9366,355
SP,61921,ZACARIAS,702,984,577,2375,28,1798,84
SP,61930,BALBINOS,280,745,413,1494,22,1081,34
SP,61948,ITAPIRAPUÃ PAULISTA,1195,1110,757,3161,41,2404,58
SP,61956,BÁLSAMO,1261,4194,1125,6813,96,5688,137
SP,61964,MESÓPOLIS,497,752,402,1690,25,1288,14
SP,61972,BANANAL,2908,3273,1783,8308,103,6525,241
SP,61980,NOVA CAMPINA,2707,2407,1557,6794,37,5237,86
SP,61999,BARBOSA,1505,2526,1336,5528,55,4192,106
SP,62006,ILHA COMPRIDA,2185,3321,2563,8329,75,5766,185
SP,62014,BARÃO DE ANTONINA,736,1157,538,2521,32,1983,58
SP,62022,LOURDES,659,834,458,2021,19,1563,51
SP,62030,BARIRI,3190,14197,5959,24262,312,18303,604
SP,62049,TORRE DE PEDRA,409,1309,844,2627,27,1783,38
SP,62057,BARRA BONITA,5677,16775,6556,30325,428,23769,889
SP,62065,ARCO-ÍRIS,524,1051,409,2020,10,1611,26
SP,62073,BARRA DO TURVO,2525,1718,2851,7242,40,4391,108
SP,62081,BREJO ALEGRE,981,826,439,2358,40,1919,72
SP,62090,BARRETOS,21564,40026,20188,84994,1056,64806,2160
SP,62103,CANAS,1163,1732,678,3695,42,3017,80
SP,62111,BARRINHA,7120,8803,4721,21644,432,16923,568
SP,62120,PRACINHA,521,585,360,1499,14,1139,19
SP,62138,BARUERI,83265,95593,45259,236278,4163,191019,7998
SP,62146,PRATÂNIA,1027,2123,1037,4322,49,3285,86
SP,62154,BASTOS,3149,9649,3873,17234,290,13361,273
SP,62162,QUADRA,626,1526,730,2960,34,2230,44
SP,62170,BATATAIS,10111,22284,8884,42877,564,33993,1034
SP,62189,SANTA CRUZ DA ESPERANÇA,387,926,510,1908,10,1398,75
SP,62197,BAURU,72881,119147,52327,258307,4189,205980,9763
SP,62200,SANTA SALETE,459,790,262,1557,17,1295,29
SP,62219,BEBEDOURO,13244,29368,13328,57977,762,44649,1275
SP,62227,VITÓRIA BRASIL,638,616,247,1571,16,1324,54
SP,62235,BENTO DE ABREU,554,1062,549,2250,27,1701,58
SP,62243,IPIGUÁ,1019,1792,799,3709,40,2910,59
SP,62251,BERNARDINO DE CAMPOS,1685,4580,1948,8503,98,6555,192
SP,62260,TAQUARAL,533,1128,513,2253,36,1740,43
SP,62278,BILAC,1097,3503,1201,5979,48,4778,130
SP,62286,FERNÃO,432,697,408,1578,18,1170,23
SP,62294,BIRIGUI,15552,46968,14575,80581,1053,66006,2433
SP,62308,GAVIÃO PEIXOTO,1497,1407,692,3717,40,3025,81
SP,62316,BIRITIBA MIRIM,4534,12321,4531,22301,385,17770,530
SP,62324,JUMIRIM,400,1390,514,2356,16,1842,36
SP,62332,BOA ESPERANÇA DO SUL,3285,4324,2169,10190,150,8021,262
SP,62340,NANTES,1009,750,515,2320,20,1805,26
SP,62359,BOCAINA,1107,5557,1841,8762,79,6921,178
SP,62367,NOVA CASTILHO,367,627,293,1322,9,1029,26
SP,62375,BOFETE,1891,3325,2306,7796,86,5490,188
SP,62383,OUROESTE,2650,2887,1601,7414,101,5813,175
SP,62391,BOITUVA,7170,20925,8122,38011,549,29889,1245
SP,62405,PAULISTÂNIA,301,917,367,1617,16,1250,16
SP,62413,BOM JESUS DOS PERDÕES,2910,8434,3178,15050,205,11872,323
SP,62421,RIBEIRÃO DOS ÍNDIOS,766,789,441,2071,37,1630,38
SP,62430,BORÁ,308,498,224,1060,15,836,15
SP,62448,TRABIJU,402,791,287,1509,15,1222,14
SP,62456,BORACÉIA,1199,1561,709,3601,52,2892,80
SP,62472,BORBOREMA,1919,6493,2578,11341,133,8763,218
SP,62499,BOTUCATU,19566,49864,20175,94693,1337,74518,3751
SP,62510,BRAGANÇA PAULISTA,18003,72117,23476,117990,1380,94514,3014
SP,62553,BRAÚNA,820,2454,780,4174,33,3394,87
SP,62570,BRODOWSKI,3207,8592,3073,15528,187,12455,469
SP,62596,BROTAS,2573,10126,4494,17840,208,13346,439
SP,62618,BURI,3560,7242,3545,14779,195,11234,237
SP,62634,BURITAMA,3575,5384,2964,12397,164,9433,310
SP,62650,BURITIZAL,746,1889,633,3381,40,2748,73
SP,62677,CABRÁLIA PAULISTA,1312,1489,984,3905,49,2921,71
SP,62693,CABREÚVA,8449,16055,6471,32491,578,26020,938
SP,62715,CAÇAPAVA,13622,37666,13711,68331,1105,54620,2227
SP,62731,CACHOEIRA PAULISTA,7150,10782,5677,24578,334,18901,635
SP,62758,CACONDE,4667,5704,3640,14443,148,10803,284
SP,62774,CAFELÂNDIA,2493,7070,3416,13378,165,9962,234
SP,62790,CAIABU,1575,1268,728,3668,37,2940,60
SP,62812,CAIEIRAS,19748,27979,11906,63609,1269,51703,2707
SP,62839,CAIUÁ,1660,1191,1166,4119,39,2953,63
SP,62855,CAJAMAR,19547,21752,10501,54514,1015,44013,1699
SP,62871,CAJOBI,2073,3855,1863,8046,88,6183,167
SP,62898,CAJURU,5406,7969,4342,18575,277,14233,581
SP,62910,CAMPINAS,227776,366419,170275,809136,13592,638861,31074
SP,62936,CAMPO LIMPO PAULISTA,18439,25461,11938,59558,1103,47620,2617
SP,62952,CAMPOS DO JORDÃO,6957,20178,9928,38655,560,28727,1032
SP,62979,CAMPOS NOVOS PAULISTA,1022,1684,879,3703,42,2824,76
SP,62995,CANANÉIA,2371,4211,3335,10204,92,6869,195
SP,63010,CÂNDIDO MOTA,5232,13043,5513,24684,372,19171,524
SP,63037,CÂNDIDO RODRIGUES,489,1451,521,2548,31,2027,56
SP,63053,CAPÃO BONITO,9050,17102,9443,36779,519,27336,665
SP,63070,CAPELA DO ALTO,3051,6865,2426,12812,194,10386,276
SP,63096,CAPIVARI,5865,21083,7078,35440,508,28362,906
SP,63118,CARAGUATATUBA,18909,36820,18384,77548,1196,59164,2239
SP,63134,CARAPICUÍBA,101741,103862,55197,276921,5781,221724,10340
SP,63150,CARDOSO,3043,3957,2744,10117,122,7373,251
SP,63177,CASA BRANCA,4118,10308,5718,21035,331,15317,560
SP,63193,CÁSSIA DOS COQUEIROS,611,1271,769,2774,31,2005,92
SP,63215,CASTILHO,6154,4384,2862,13932,213,11070,319
SP,63231,CATANDUVA,15365,49492,17291,85589,1014,68298,2427
SP,63258,CATIGUÁ,1066,3503,902,5781,74,4879,236
SP,63274,CEDRAL,1367,3819,1200,6684,96,5484,202
SP,63290,CERQUEIRA CÉSAR,2536,7563,3538,14128,236,10590,255
SP,63312,CERQUILHO,4245,19286,5740,30778,463,25038,1044
SP,63339,CESÁRIO LANGE,1449,7190,2474,11725,233,9251,379
SP,63355,CHARQUEADA,1827,7757,2499,12516,155,10017,278
SP,63371,CHAVANTES,2587,4579,2172,9713,127,7541,248
SP,63398,CLEMENTINA,1263,2707,1099,5263,53,4164,141
SP,63410,COLINA,4279,6177,3521,14551,193,11030,381
SP,63436,COLÔMBIA,1864,2042,1607,5726,90,4119,123
SP,63452,CONCHAL,3536,12058,3893,20180,291,16287,402
SP,63479,CONCHAS,2641,6796,3897,13777,139,9880,304
SP,63495,CORDEIRÓPOLIS,3381,9775,3381,17385,277,14004,571
SP,63517,COROADOS,936,2259,808,4116,37,3308,76
SP,63533,CORONEL MACEDO,1592,1619,1002,4341,48,3339,80
SP,63550,CORUMBATAÍ,471,1881,320,2771,32,2451,67
SP,63576,COSMÓPOLIS,13736,18143,9919,44308,867,34389,1643
SP,63592,COSMORAMA,1662,3104,1169,6082,70,4913,77
SP,63614,COTIA,46557,67143,28069,148777,2444,120708,4564
SP,63630,CRAVINHOS,4233,14041,5354,24713,293,19359,792
SP,63657,CRISTAIS PAULISTA,1736,3386,1576,6923,72,5347,153
SP,63673,CRUZÁLIA,603,1112,466,2216,20,1750,15
SP,63690,CRUZEIRO,12583,31490,12130,59117,856,46987,2058
SP,63711,CUBATÃO,39480,31722,19660,95161,1257,75501,3042
SP,63738,CUNHA,6990,6537,5143,19391,259,14248,462
SP,63754,DESCALVADO,3241,15424,5289,25202,397,19913,851
SP,63770,DIADEMA,131507,112729,61364,325067,6027,263703,13440
SP,63797,DIVINOLÂNDIA,2170,5411,2143,10199,180,8056,295
SP,63819,DOBRADA,1629,2692,1002,5570,86,4568,161
SP,63835,DOIS CÓRREGOS,2567,11299,4543,18983,221,14440,353
SP,63851,DOLCINÓPOLIS,1104,603,454,2241,23,1787,57
SP,63878,DOURADO,1195,4227,1645,7407,113,5762,227
SP,63894,DRACENA,7421,18485,6898,33815,418,26917,593
SP,63916,DUARTINA,2574,5063,2031,10058,121,8027,269
SP,63932,DUMONT,1275,3766,1247,6508,72,5261,148
SP,63959,ECHAPORÃ,1460,2347,1344,5315,51,3971,113
SP,63975,ELDORADO,4058,3447,3982,11798,99,7816,212
SP,63991,ELIAS FAUSTO,3790,5843,3045,13283,230,10238,375
SP,64017,EMBU DAS ARTES,58376,66768,15566,149654,3127,134088,5817
SP,64033,EMBU-GUAÇU,16135,20850,11399,50960,902,39561,1674
SP,64050,ESTRELA D'OESTE,1639,3644,1420,6944,93,5524,148
SP,64076,ESTRELA DO NORTE,851,1059,585,2557,25,1972,37
SP,64092,FARTURA,3188,6129,3100,12833,154,9733,262
SP,64114,FERNANDÓPOLIS,16843,20758,11624,50933,665,39309,1043
SP,64130,FERNANDO PRESTES,1035,2561,1086,4879,96,3793,101
SP,64157,FERRAZ DE VASCONCELOS,45162,43161,24502,120731,2617,96229,5289
SP,64173,FLORA RICA,628,632,528,1820,13,1292,19
SP,64190,FLOREAL,778,1285,523,2675,29,2152,60
SP,64211,FLÓRIDA PAULISTA,2385,3978,1675,8358,118,6683,202
SP,64238,FLORÍNEA,893,1059,659,2674,25,2015,38
SP,64254,FRANCA,58044,121297,40416,229100,3256,188684,6087
SP,64270,FRANCISCO MORATO,48328,33098,24601,112572,2454,87971,4091
SP,64297,FRANCO DA ROCHA,34314,34343,20193,95780,2088,75587,4842
SP,64319,GABRIEL MONTEIRO,338,1655,498,2585,26,2087,68
SP,64335,GÁLIA,1474,2424,1515,5585,73,4070,99
SP,64351,GARÇA,5846,18833,8720,34842,542,26122,901
SP,64378,GASTÃO VIDIGAL,1185,1173,884,3333,41,2449,50
SP,64394,GENERAL SALGADO,1958,4533,1846,8565,90,6719,138
SP,64416,GETULINA,1968,3696,2539,8469,107,5930,159
SP,64432,GLICÉRIO,1280,1768,909,4076,40,3167,79
SP,64459,GUAIÇARA,2099,3969,1943,8275,118,6332,146
SP,64475,GUAIMBÉ,1561,1735,1111,4573,60,3462,106
SP,64491,GUAÍRA,8892,12676,7326,29691,304,22365,493
SP,64513,GUAPIAÇU,3754,6933,2973,14254,204,11281,390
SP,64530,GUAPIARA,5413,5206,4883,15917,160,11034,255
SP,64556,GUARÁ,5749,5564,3553,15313,169,11760,278
SP,64572,GUARAÇAÍ,1950,3082,1723,7005,100,5282,150
SP,64599,GUARACI,2793,3056,2387,8464,85,6077,143
SP,64610,GUARANI D'OESTE,677,625,348,1700,13,1352,37
SP,64637,GUARANTÃ,1415,2535,1439,5571,93,4132,89
SP,64653,GUARARAPES,5875,12238,5937,24851,265,18914,536
SP,64670,GUARAREMA,5222,12245,4115,22337,303,18222,452
SP,64696,GUARATINGUETÁ,19947,47558,18295,89300,1308,71005,2192
SP,64718,GUAREÍ,2169,4380,1918,8958,162,7040,329
SP,64734,GUARIBA,8139,13260,5934,28355,428,22421,594
SP,64750,GUARUJÁ,81188,83706,44638,221991,3792,177353,8667
SP,64777,GUARULHOS,242275,414153,158413,868515,15156,710102,38518
SP,64793,GUZOLÂNDIA,1618,1274,809,3835,49,3026,85
SP,64815,HERCULÂNDIA,2344,2798,1454,6874,68,5420,210
SP,64831,IACANGA,1479,4354,1356,7462,117,6106,156
SP,64858,IACRI,1210,2782,1165,5311,54,4146,100
SP,64874,IBATÉ,5599,12538,5205,24503,445,19298,716
SP,64890,IBIRÁ,1617,4687,1658,8249,91,6591,196
SP,64912,IBIRAREMA,1031,2633,1064,4932,90,3868,114
SP,64939,IBITINGA,9629,21343,9337,41953,575,32616,1069
SP,64955,IBIÚNA,9643,32690,13916,58286,701,44370,1336
SP,64971,ICÉM,2161,2548,1816,6705,54,4889,126
SP,64998,IEPÊ,1459,3138,1334,6112,60,4778,121
SP,65013,IGARAÇU DO TIETÊ,4913,8642,3812,18587,517,14775,703
SP,65030,IGARAPAVA,6790,7925,6371,21865,307,15494,472
SP,65056,IGARATÁ,1575,4377,1546,7733,66,6187,169
SP,65072,IGUAPE,6942,8091,7235,22989,229,15754,492
SP,65099,ILHABELA,4495,11707,5203,22051,207,16848,439
SP,65110,INDAIATUBA,37797,76102,27598,149224,2476,121626,5251
SP,65137,INDIANA,1270,2083,982,4484,70,3502,79
SP,65153,INDIAPORÃ,1334,1163,705,3296,34,2591,60
SP,65170,INÚBIA PAULISTA,595,1826,554,3076,34,2522,67
SP,65196,IPAUSSU,2029,5906,2394,10657,128,8263,200
SP,65218,IPERÓ,5746,7383,4262,18226,296,13964,539
SP,65234,IPEÚNA,915,3006,602,4674,42,4072,109
SP,65250,IPORANGA,1433,774,1204,3510,25,2306,74
SP,65277,IPUÃ,4120,4121,2261,10828,143,8567,183
SP,65293,IRACEMÁPOLIS,3698,9146,2613,16111,211,13498,443
SP,65315,IRAPUÃ,1227,2904,1313,5678,102,4365,132
SP,65331,IRAPURU,1477,2502,1277,5450,87,4173,107
SP,65358,ITABERÁ,4979,5781,2943,14057,142,11114,212
SP,65374,ITAÍ,4589,7951,3816,16902,227,13086,319
SP,65390,ITAJOBI,1640,7688,2614,12365,151,9751,272
SP,65412,ITAJU,587,1621,830,3129,42,2299,49
SP,65439,ITANHAÉM,17720,30180,20801,71360,848,50559,1811
SP,65455,ITAPECERICA DA SERRA,39971,42345,22939,110869,2163,87930,3451
SP,65471,ITAPETININGA,19342,58756,21919,104966,1644,83047,3305
SP,65498,ITAPEVA,13784,36565,16013,68137,729,52124,1046
SP,65510,ITAPEVI,59093,46950,29425,143098,3029,113673,4601
SP,65536,ITAPIRA,8294,30268,13693,55065,820,41372,1990
SP,65552,ITÁPOLIS,5250,16805,7989,31262,442,23273,776
SP,65579,ITAPORANGA,2623,5740,2657,11397,125,8740,252
SP,65595,ITAPUÍ,1757,4964,1804,8820,116,7016,179
SP,65617,ITAPURA,1742,823,1043,3726,43,2683,75
SP,65633,ITAQUAQUECETUBA,83679,74788,42516,213922,4906,171406,8033
SP,65650,ITARARÉ,6698,19493,10390,37557,396,27167,580
SP,65676,ITARIRI,2633,3594,3096,9588,93,6492,172
SP,65692,ITATIBA,11193,46313,14797,75414,1001,60617,2110
SP,65714,ITATINGA,2480,7720,3113,13897,208,10784,376
SP,65730,ITIRAPINA,2311,4866,1369,8989,145,7620,298
SP,65757,ITIRAPUÃ,1885,1898,1103,5007,41,3904,80
SP,65773,ITOBI,2146,2494,1495,6365,96,4870,134
SP,65790,ITU,22450,64888,27908,121381,1684,93473,4451
SP,65811,ITUPEVA,9315,18344,5871,35060,460,29189,1070
SP,65838,ITUVERAVA,8433,12726,8136,30285,361,22149,629
SP,65854,JABORANDI,1950,1963,875,5006,96,4131,122
SP,65870,JABOTICABAL,9184,29581,12904,53290,553,40386,1068
SP,65897,JACAREÍ,35760,86431,31538,159989,1896,128451,4364
SP,65919,JACI,1417,2535,988,5123,76,4135,107
SP,65935,JACUPIRANGA,3347,5822,4059,13600,116,9541,256
SP,65951,JAGUARIÚNA,6636,19741,7929,35927,571,27998,1050
SP,65978,JALES,9454,18540,8282,37689,470,29407,943
SP,65994,JAMBEIRO,930,2477,824,4364,43,3540,90
SP,66010,JANDIRA,26760,29637,15249,75607,1487,60358,2474
SP,66036,JARDINÓPOLIS,5801,13845,6348,27151,431,20803,726
SP,66052,JARINU,4351,9350,4568,19011,257,14443,485
SP,66079,JAÚ,14263,60440,19038,97381,1206,78343,2434
SP,66095,JERIQUARA,1101,1085,965,3240,44,2275,45
SP,66117,JOANÓPOLIS,1323,5636,2043,9269,85,7226,182
SP,66133,JOÃO RAMALHO,1155,1567,939,3782,36,2843,85
SP,66150,JOSÉ BONIFÁCIO,5799,13632,5094,25358,365,20264,468
SP,66176,JÚLIO MESQUITA,1394,1381,780,3718,70,2938,93
SP,66192,JUNDIAÍ,63650,156327,40955,276401,3910,235446,11559
SP,66214,JUNQUEIRÓPOLIS,3212,7191,2618,13534,208,10916,305
SP,66230,JUQUIÁ,3779,6548,6329,17137,161,10808,320
SP,66257,JUQUITIBA,6987,8933,5598,22372,306,16774,548
SP,66273,LAGOINHA,1151,2682,1219,5205,65,3986,88
SP,66290,LARANJAL PAULISTA,2615,12925,4261,20454,210,16193,443
SP,66311,LAVÍNIA,1528,1594,960,4253,65,3293,106
SP,66338,LAVRINHAS,1656,2811,1110,5818,84,4708,157
SP,66354,LEME,14819,39384,13200,70634,1080,57434,2151
SP,66370,LENÇÓIS PAULISTA,7546,28332,8727,46582,706,37855,1271
SP,66397,LIMEIRA,43070,115053,40433,208522,3271,168089,6695
SP,66419,LINDÓIA,821,3263,1094,5351,57,4257,116
SP,66435,LINS,8262,32094,13322,55574,620,42252,1276
SP,66451,LORENA,14654,32582,14201,63836,923,49635,1476
SP,66478,LOUVEIRA,6883,16309,3267,27681,412,24414,810
SP,66494,LUCÉLIA,3712,6741,3986,14935,176,10949,320
SP,66516,LUCIANÓPOLIS,575,873,429,1948,25,1519,46
SP,66532,LUÍS ANTÔNIO,2715,3496,2200,8823,137,6623,275
SP,66559,LUIZIÂNIA,1023,1940,1051,4115,42,3064,59
SP,66575,LUPÉRCIO,1096,1578,939,3726,39,2787,74
SP,66591,LUTÉCIA,746,1100,574,2505,36,1931,49
SP,66613,MACATUBA,2655,7263,2767,13209,219,10442,305
SP,66630,MACAUBAL,982,3730,1117,6059,113,4942,117
SP,66656,MACEDÔNIA,1141,1265,729,3256,33,2527,88
SP,66672,MAGDA,908,1257,658,2937,43,2279,71
SP,66699,MAIRINQUE,10661,15766,8147,36320,639,28173,1107
SP,66710,MAIRIPORÃ,12339,29973,12385,57378,899,44993,1782
SP,66737,MANDURI,1397,3936,1626,7216,106,5590,151
SP,66753,MARABÁ PAULISTA,1263,1093,1096,3545,24,2449,69
SP,66770,MARACAÍ,3162,5179,2173,10830,122,8657,194
SP,66796,MARIÁPOLIS,1121,1248,730,3243,69,2513,75
SP,66818,MARÍLIA,30623,93275,35797,166597,2380,130800,4522
SP,66834,MARINÓPOLIS,604,865,398,1926,20,1528,39
SP,66850,MARTINÓPOLIS,4093,9706,4498,18796,185,14298,314
SP,66877,MATÃO,15437,32801,11498,62237,826,50739,1675
SP,66893,MAUÁ,98132,125996,54966,299507,5513,244541,14900
SP,66915,MENDONÇA,1395,1835,941,4305,43,3364,91
SP,66931,MERIDIANO,1402,1334,801,3670,52,2869,81
SP,66958,MIGUELÓPOLIS,6106,5934,4624,17060,163,12436,233
SP,66974,MINEIROS DO TIETÊ,1711,5174,2027,9309,174,7282,223
SP,66990,MIRACATU,5166,5559,5892,17036,129,11144,290
SP,67016,MIRA ESTRELA,1039,887,547,2584,38,2037,73
SP,67032,MIRANDÓPOLIS,4555,9907,5304,20633,294,15329,573
SP,67059,MIRANTE DO PARANAPANEMA,5322,4630,4229,14508,119,10279,208
SP,67075,MIRASSOL,10322,20515,8383,40882,609,32499,1053
SP,67091,MIRASSOLÂNDIA,873,1832,677,3496,44,2819,70
SP,67113,MOCOCA,10886,27350,13421,53998,796,40577,1545
SP,67130,MOGI DAS CRUZES,70854,151288,53342,290917,5428,237575,10005
SP,67156,MOGI GUAÇU,25936,56268,20800,108949,1885,88149,4060
SP,67172,MOGI MIRIM,10094,39977,14017,67399,1130,53382,2181
SP,67199,MOMBUCA,593,1703,603,3022,44,2419,79
SP,67210,MONÇÕES,535,954,379,1978,42,1599,68
SP,67237,MONGAGUÁ,10879,16027,12699,41058,475,28359,978
SP,67253,MONTE ALEGRE DO SUL,931,3506,1023,5725,75,4702,190
SP,67270,MONTE ALTO,5753,21453,8555,37062,503,28507,798
SP,67296,MONTE APRAZÍVEL,3666,8687,3120,16118,203,12998,442
SP,67318,MONTE AZUL PAULISTA,3522,7805,3635,15544,233,11909,349
SP,67334,MONTE CASTELO,1419,1210,613,3331,25,2718,64
SP,67350,MONTEIRO LOBATO,959,1765,713,3543,36,2830,70
SP,67377,MONTE MOR,13948,13544,8795,38235,736,29440,1212
SP,67393,MORRO AGUDO,5987,9152,4321,20363,327,16042,576
SP,67415,MORUNGABA,1688,6117,1692,9823,114,8131,212
SP,67431,MURUTINGA DO SUL,1036,1537,829,3529,38,2700,89
SP,67458,NARANDIBA,1546,1545,834,4031,46,3197,60
SP,67474,NATIVIDADE DA SERRA,1752,2632,2079,6690,83,4611,144
SP,67490,NAZARÉ PAULISTA,2380,7242,3349,13528,176,10179,381
SP,67512,NEVES PAULISTA,2042,3652,1485,7501,141,6016,181
SP,67539,NHANDEARA,1465,4714,1631,8069,119,6438,140
SP,67555,NIPOÃ,882,1973,832,3789,42,2957,60
SP,67571,NOVA ALIANÇA,1484,2411,1032,5143,62,4111,154
SP,67598,NOVA EUROPA,2712,2957,1969,7953,107,5984,208
SP,67610,NOVA GRANADA,4808,6381,3531,15299,205,11768,374
SP,67636,NOVA GUATAPORANGA,813,650,365,1898,18,1533,52
SP,67652,NOVA INDEPENDÊNCIA,1018,1192,600,2941,47,2341,84
SP,67679,NOVA LUZITÂNIA,1053,1157,531,2817,24,2286,52
SP,67695,NOVA ODESSA,14635,17843,7433,42128,744,34695,1473
SP,67717,NOVO HORIZONTE,5308,15850,6444,28437,320,21993,515
SP,67733,NUPORANGA,1283,3091,867,5463,77,4596,145
SP,67750,OCAUÇU,1051,1493,801,3457,32,2656,80
SP,67776,ÓLEO,535,1520,631,2774,34,2143,54
SP,67792,OLÍMPIA,9326,19550,9315,39602,519,30287,892
SP,67814,ONDA VERDE,1088,1624,730,3580,41,2850,97
SP,67830,ORIENTE,1312,2697,855,5079,71,4224,144
SP,67857,ORINDIÚVA,1242,2175,1053,4638,36,3585,132
SP,67873,ORLÂNDIA,6802,16297,6328,30767,421,24439,919
SP,67890,OSASCO,170585,244611,112185,556799,8590,444614,20828
SP,67911,OSCAR BRESSANE,479,1425,671,2641,25,1970,41
SP,67938,OSVALDO CRUZ,4808,12535,6276,24511,325,18235,567
SP,67954,OURINHOS,17918,38400,18001,77151,1032,59150,1800
SP,67970,OURO VERDE,2459,2148,1153,5928,74,4775,94
SP,67997,PACAEMBU,1994,4501,2296,9015,78,6719,146
SP,68012,PALESTINA,2173,4142,1657,8247,114,6590,161
SP,68039,PALMARES PAULISTA,1504,3966,1346,7120,110,5774,194
SP,68055,PALMEIRA D'OESTE,2739,3069,1809,7855,105,6046,133
SP,68071,PALMITAL,3646,9265,3912,17309,189,13397,297
SP,68098,PANORAMA,2980,4832,2456,10617,124,8161,225
SP,68110,PARAGUAÇU PAULISTA,9127,13783,7901,32106,568,24205,727
SP,68136,PARAIBUNA,3937,6549,3299,14248,134,10949,329
SP,68152,PARAÍSO,875,3007,977,5065,47,4088,159
SP,68179,PARANAPANEMA,4721,5307,3142,13624,179,10482,275
SP,68195,PARANAPUÃ,1061,1359,462,3007,49,2545,76
SP,68217,PARAPUÃ,2098,4093,2135,8668,113,6533,229
SP,68233,PARDINHO,1045,2693,1205,5127,58,3922,126
SP,68250,PARIQUERA-AÇU,3657,6719,4139,15044,179,10905,350
SP,68276,PATROCÍNIO PAULISTA,2140,5912,2067,10380,119,8313,142
SP,68292,PAULICÉIA,1551,2406,1265,5403,92,4138,89
SP,68314,PAULÍNIA,18315,29718,12682,64127,1172,51445,2240
SP,68330,PAULO DE FARIA,1887,3000,1617,6708,44,5091,160
SP,68357,PEDERNEIRAS,7362,16471,6520,31790,540,25270,897
SP,68373,PEDRA BELA,1239,2509,1039,4939,63,3900,89
SP,68390,PEDRANÓPOLIS,963,821,366,2197,21,1831,26
SP,68411,PEDREGULHO,4690,4823,3838,13846,194,10008,301
SP,68438,PEDREIRA,6341,18265,6380,32584,453,26204,1145
SP,68454,PEDRO DE TOLEDO,2319,2655,2776,8007,87,5231,170
SP,68470,PENÁPOLIS,10831,22163,10947,45738,589,34791,1208
SP,68497,PEREIRA BARRETO,5645,8677,5381,20282,240,14901,339
SP,68519,PEREIRAS,1321,3461,1768,6762,74,4994,138
SP,68535,PERUÍBE,12777,22450,16082,53330,635,37248,1386
SP,68551,PIACATU,1099,2335,886,4475,42,3589,113
SP,68578,PIEDADE,9384,20912,8622,40381,597,31759,866
SP,68594,PILAR DO SUL,5200,10918,4370,21229,286,16859,455
SP,68616,PINDAMONHANGABA,23860,57565,22538,109239,1827,86701,3449
SP,68632,PINDORAMA,2379,6319,2313,11487,168,9174,308
SP,68659,ESPÍRITO SANTO DO PINHAL,5723,19085,7787,34003,551,26216,857
SP,68675,PINHALZINHO,1751,5899,2299,10345,118,8046,278
SP,68691,PIQUEROBI,1226,1019,707,3056,26,2349,78
SP,68713,PIQUETE,2000,6380,2228,10987,109,8759,270
SP,68730,PIRACAIA,3132,12605,4898,21328,251,16430,442
SP,68756,PIRACICABA,50128,161059,55326,279710,4243,224384,8954
SP,68772,PIRAJU,4622,11714,5804,23096,262,17292,694
SP,68799,PIRAJUÍ,2967,8275,4099,15901,206,11802,354
SP,68810,PIRANGI,1168,4930,1832,8245,136,6413,179
SP,68837,PIRAPORA DO BOM JESUS,3849,4227,2303,10747,160,8444,208
SP,68853,PIRAPOZINHO,5961,8890,4808,20269,214,15461,396
SP,68870,PIRASSUNUNGA,8391,32792,12334,55799,747,43465,1535
SP,68896,PIRATININGA,2074,4864,1607,8861,126,7254,190
SP,68918,PITANGUEIRAS,6688,11952,6547,26218,362,19671,669
SP,68934,PLANALTO,1375,1606,902,4011,38,3109,90
SP,68950,PLATINA,747,1314,648,2772,29,2124,34
SP,68977,POÁ,31159,36301,18484,91474,1782,72990,3748
SP,68993,POLONI,904,2482,1017,4536,44,3519,89
SP,69019,POMPÉIA,2635,9730,2761,15643,167,12882,350
SP,69035,PONGAÍ,618,1792,674,3163,15,2489,64
SP,69051,PONTAL,5601,14339,6757,27910,391,21153,822
SP,69078,PONTES GESTAL,597,1237,506,2399,19,1893,40
SP,69094,POPULINA,1535,1347,755,3781,50,3026,94
SP,69116,PORANGABA,1510,3323,1625,6676,67,5051,151
SP,69132,PORTO FELIZ,8015,20969,8086,38696,642,30610,984
SP,69159,PORTO FERREIRA,6722,23737,8270,40529,632,32259,1168
SP,69175,POTIRENDABA,2779,6740,2627,12717,223,10090,348
SP,69191,PRADÓPOLIS,3790,6139,2910,13537,225,10627,473
SP,69213,PRAIA GRANDE,51529,85226,46637,191982,2564,145345,6026
SP,69230,PRESIDENTE ALVES,870,1753,692,3412,35,2720,62
SP,69256,PRESIDENTE BERNARDES,3283,4869,2905,11341,118,8436,166
SP,69272,PRESIDENTE EPITÁCIO,9156,13400,8265,31829,374,23564,634
SP,69299,PRESIDENTE PRUDENTE,36406,85771,38370,165797,1786,127427,3464
SP,69310,PRESIDENTE VENCESLAU,6836,14859,7126,29700,298,22574,581
SP,69337,PROMISSÃO,8331,11592,6852,27757,377,20905,605
SP,69353,QUATÁ,1929,5587,2571,10422,135,7851,200
SP,69370,QUEIROZ,738,1440,928,3180,28,2252,46
SP,69396,QUELUZ,2611,2848,2062,7808,91,5746,196
SP,69418,QUINTANA,1327,2540,960,4980,47,4020,106
SP,69434,RAFARD,1521,4469,1196,7487,100,6291,201
SP,69450,RANCHARIA,6424,11165,5816,24111,300,18295,406
SP,69477,REDENÇÃO DA SERRA,889,1887,989,3887,45,2898,77
SP,69493,REGENTE FEIJÓ,3631,8073,3145,15315,174,12170,292
SP,69515,REGINÓPOLIS,824,2584,936,4509,62,3573,103
SP,69531,REGISTRO,12149,19199,11744,44342,411,32598,839
SP,69558,RESTINGA,2372,2251,1294,6109,80,4815,112
SP,69574,RIBEIRA,1202,1014,695,2977,26,2282,40
SP,69590,RIBEIRÃO BONITO,2040,4460,1979,8885,132,6906,274
SP,69612,RIBEIRÃO BRANCO,5006,5495,3792,14624,116,10832,215
SP,69639,RIBEIRÃO CORRENTE,1030,1888,887,3885,29,2998,51
SP,69655,RIBEIRÃO DO SUL,1465,1475,749,3812,52,3063,71
SP,69671,RIBEIRÃO PIRES,25410,41003,17053,88924,1417,71871,4041
SP,69698,RIBEIRÃO PRETO,94445,219751,94789,431167,5206,336378,16976
SP,69710,RIVERSUL,1694,1677,1289,4795,57,3506,78
SP,69736,RIFAINA,1100,1652,1313,4184,58,2871,61
SP,69752,RINCÃO,2389,3365,1796,7939,120,6143,269
SP,69779,RINÓPOLIS,1613,4034,1847,7711,71,5864,146
SP,69795,RIO CLARO,26121,81098,27481,142067,1875,114586,5492
SP,69817,RIO DAS PEDRAS,5366,13115,4843,24348,417,19505,607
SP,69833,RIO GRANDE DA SERRA,12698,12385,6573,33642,690,27069,1296
SP,69850,RIOLÂNDIA,2121,3061,1878,7275,84,5397,131
SP,69876,ROSEIRA,2125,3769,1634,7814,120,6180,166
SP,69892,RUBIÁCEA,497,1262,637,2472,29,1835,47
SP,69914,RUBINÉIA,872,1056,684,2735,41,2051,82
SP,69930,SABINO,1547,1793,1276,4827,55,3551,156
SP,69957,SAGRES,657,943,383,2036,23,1653,30
SP,69973,SALES,986,2492,994,4604,49,3610,83
SP,69990,SALES OLIVEIRA,1822,4489,928,7589,96,6661,254
SP,70017,SALESÓPOLIS,3348,7755,3092,14698,186,11606,317
SP,70033,SALMOURÃO,946,1856,990,3907,56,2917,59
SP,70050,SALTO,22280,41727,15889,83929,1221,68040,2812
SP,70076,SALTO DE PIRAPORA,7693,13588,5939,28815,617,22876,978
SP,70092,SALTO GRANDE,1677,3121,1809,6857,89,5048,161
SP,70114,SANDOVALINA,1246,1257,890,3456,18,2566,45
SP,70130,SANTA ADÉLIA,2128,6389,2872,11875,162,9003,324
SP,70157,SANTA ALBERTINA,1288,2314,1025,4803,72,3778,104
SP,70173,SANTA BÁRBARA D'OESTE,45707,58853,24489,137112,2768,112623,5295
SP,70190,ÁGUAS DE SANTA BÁRBARA,1181,2245,1395,4980,44,3585,115
SP,70211,SANTA BRANCA,2332,6464,2935,12098,139,9163,228
SP,70238,SANTA CLARA D'OESTE,603,975,473,2111,21,1638,39
SP,70254,SANTA CRUZ DA CONCEIÇÃO,736,2006,647,3520,41,2873,90
SP,70270,SANTA CRUZ DAS PALMEIRAS,4889,12062,5162,22888,302,17726,473
SP,70297,SANTA CRUZ DO RIO PARDO,5764,19455,7491,33904,469,26413,725
SP,70319,SANTA ERNESTINA,1309,2607,971,5062,65,4091,110
SP,70335,SANTA FÉ DO SUL,5323,12291,5963,24426,295,18463,554
SP,70351,SANTA GERTRUDES,4289,7936,1817,14808,222,12991,544
SP,70378,SANTA ISABEL,9203,20412,7884,39438,639,31554,1300
SP,70394,SANTA LÚCIA,3149,2664,1768,8013,127,6245,305
SP,70416,SANTA MARIA DA SERRA,963,2294,523,3926,70,3403,76
SP,70432,SANTA MERCEDES,927,982,664,2631,22,1967,36
SP,70459,SANTANA DA PONTE PENSA,463,743,308,1568,15,1260,39
SP,70475,SANTANA DE PARNAÍBA,21889,35909,13547,74565,1233,61018,1987
SP,70491,SANTA RITA D'OESTE,780,1054,480,2398,32,1918,52
SP,70513,SANTA RITA DO PASSA QUATRO,3144,12660,5056,21595,239,16539,496
SP,70530,SANTA ROSA DE VITERBO,4306,9455,4516,19359,349,14843,733
SP,70556,SANTO ANASTÁCIO,4503,7611,4362,17134,225,12772,433
SP,70572,SANTO ANDRÉ,153500,265297,110582,561954,7567,451372,25008
SP,70599,SANTO ANTÔNIO DA ALEGRIA,1826,2495,1340,5888,64,4548,163
SP,70610,SANTO ANTÔNIO DE POSSE,3093,9039,3465,16077,209,12612,271
SP,70637,SANTO ANTÔNIO DO JARDIM,1241,3078,1012,5482,52,4470,99
SP,70653,SANTO ANTÔNIO DO PINHAL,1116,3435,1275,6012,69,4737,117
SP,70670,SANTO EXPEDITO,917,1127,535,2666,33,2131,54
SP,70696,SANTÓPOLIS DO AGUAPEÍ,835,1633,722,3345,60,2623,95
SP,70718,SANTOS,76993,174554,68554,335851,3525,267297,12225
SP,70734,SÃO BENTO DO SAPUCAÍ,1591,5146,1953,8931,77,6978,164
SP,70750,SÃO BERNARDO DO CAMPO,199328,252572,109115,594761,8282,485646,25464
SP,70777,SÃO CAETANO DO SUL,22081,79619,17385,124217,1103,106832,4029
SP,70793,SÃO CARLOS,41975,89003,33988,174535,2471,140547,7098
SP,70815,SÃO FRANCISCO,880,1069,577,2608,40,2031,42
SP,70831,SÃO JOÃO DA BOA VISTA,14011,37234,13100,67105,879,54005,1881
SP,70858,SÃO JOÃO DAS DUAS PONTES,951,887,478,2407,27,1929,64
SP,70874,SÃO JOÃO DO PAU D'ALHO,789,726,319,1891,14,1572,43
SP,70890,SÃO JOAQUIM DA BARRA,9188,17963,7422,35974,519,28552,882
SP,70912,SÃO JOSÉ DA BELA VISTA,1999,2885,2083,7208,107,5125,134
SP,70939,SÃO JOSÉ DO BARREIRO,946,1644,827,3549,35,2722,97
SP,70955,SÃO JOSÉ DO RIO PARDO,10974,19849,9035,41578,637,32543,1083
SP,70971,SÃO JOSÉ DO RIO PRETO,69679,166950,62654,312894,3833,250240,9778
SP,70998,SÃO JOSÉ DOS CAMPOS,113686,253864,87508,474789,6302,387281,13429
SP,71013,SÃO LUÍS DO PARAITINGA,2355,5156,1922,9758,129,7836,196
SP,71030,SÃO MANUEL,4931,17789,6364,30588,485,24224,1019
SP,71056,SÃO MIGUEL ARCANJO,5813,12135,5807,24687,278,18880,654
SP,71072,SÃO PAULO,2347250,4142529,1761467,8787492,152847,7026025,383399
SP,71099,SÃO PEDRO,3404,14742,3615,22703,298,19088,644
SP,71110,SÃO PEDRO DO TURVO,1477,2790,1077,5476,52,4399,80
SP,71137,SÃO ROQUE,11945,30038,12782,57462,996,44680,1701
SP,71153,SÃO SEBASTIÃO,17030,24000,13709,56913,782,43204,1392
SP,71170,SÃO SEBASTIÃO DA GRAMA,2428,4335,2451,9571,114,7120,243
SP,71196,SÃO SIMÃO,2061,6418,2840,11789,102,8949,368
SP,71218,SÃO VICENTE,84698,101863,54332,254979,3981,200647,10105
SP,71234,SARAPUÍ,2250,2916,1615,7075,95,5460,199
SP,71250,SARUTAIÁ,1059,1231,878,3267,31,2389,68
SP,71277,SEBASTIANÓPOLIS DO SUL,529,1772,526,2909,29,2383,53
SP,71293,SERRA AZUL,2007,2937,1608,6798,80,5190,166
SP,71315,SERRANA,7664,15349,6405,30568,430,24163,720
SP,71331,SERRA NEGRA,3304,12755,5303,21975,188,16672,425
SP,71358,SERTÃOZINHO,17318,47175,18775,87208,1215,68433,2725
SP,71374,SETE BARRAS,3708,3566,3716,11314,107,7598,217
SP,71390,SEVERÍNIA,2787,6737,2509,12422,180,9913,209
SP,71412,SILVEIRAS,1339,2617,1160,5267,66,4107,85
SP,71439,SOCORRO,4525,16924,6595,29114,292,22519,778
SP,71455,SOROCABA,112872,226576,79777,446972,7208,367195,20539
SP,71471,SUD MENNUCCI,2078,2674,1306,6266,84,4960,124
SP,71498,SUMARÉ,63655,64557,34430,171502,3279,137072,5581
SP,71510,SUZANO,63848,89380,38987,203959,4111,164972,7633
SP,71536,TABAPUÃ,2088,4868,1667,9074,131,7407,320
SP,71552,TABATINGA,2785,5678,2841,11764,174,8923,286
SP,71579,TABOÃO DA SERRA,64559,82115,41204,198588,3460,157384,7250
SP,71595,TACIBA,1904,2000,1038,5064,49,4026,73
SP,71617,TAGUAÍ,2070,4422,1809,8507,94,6698,112
SP,71633,TAIAÇU,1286,2175,1086,4746,89,3660,110
SP,71650,TAIÚVA,832,2641,1127,4777,66,3650,111
SP,71676,TAMBAÚ,4016,8754,3865,17317,261,13452,421
SP,71692,TANABI,4372,10634,4569,20136,195,15567,366
SP,71714,TAPIRAÍ,1530,2777,2012,6562,97,4550,146
SP,71730,TAPIRATIBA,3479,4220,2293,10393,152,8100,249
SP,71757,TAQUARITINGA,10836,18135,9554,40283,754,30729,1004
SP,71773,TAQUARITUBA,5414,8651,3957,18605,266,14648,317
SP,71790,TARABAI,2247,1842,1272,5513,35,4241,117
SP,71811,TATUÍ,12529,46952,18217,82013,1273,63796,3042
SP,71838,TAUBATÉ,41712,120899,46508,220131,3668,173623,7344
SP,71854,TEJUPÁ,1214,1682,1097,4093,30,2996,70
SP,71870,TEODORO SAMPAIO,5804,6043,4463,16748,175,12285,263
SP,71897,TERRA ROXA,1723,3434,1500,6941,114,5441,170
SP,71919,TIETÊ,4069,17374,5732,28241,306,22509,760
SP,71935,TIMBURI,522,1301,606,2497,22,1891,46
SP,71951,TORRINHA,1395,4116,1606,7372,108,5766,147
SP,71978,TREMEMBÉ,4811,13554,5202,24625,345,19423,713
SP,71994,TRÊS FRONTEIRAS,1475,2149,1074,4862,53,3788,111
SP,72010,TUPÃ,9865,27128,12374,50889,498,38515,1024
SP,72036,TUPI PAULISTA,3080,5340,2309,11014,93,8705,192
SP,72052,TURIÚBA,361,904,356,1682,16,1326,45
SP,72079,TURMALINA,693,659,513,1940,19,1427,56
SP,72095,UBATUBA,14308,30113,15938,62527,775,46589,1393
SP,72117,UBIRAJARA,844,1887,791,3604,32,2813,50
SP,72133,UCHOA,1952,4045,1653,8004,102,6351,252
SP,72150,UNIÃO PAULISTA,342,882,541,1808,14,1267,29
SP,72176,URÂNIA,2375,2778,1206,6658,136,5452,163
SP,72192,URU,330,724,360,1461,16,1101,31
SP,72214,URUPÊS,2349,5513,2292,10514,127,8222,233
SP,72230,VALENTIM GENTIL,2504,4406,1824,9067,135,7243,198
SP,72257,VALINHOS,17248,46460,16693,84708,1249,68015,3058
SP,72273,VALPARAÍSO,4840,6691,3864,15859,199,11995,265
SP,72311,VARGEM GRANDE DO SUL,6761,16419,6253,30462,484,24209,545
SP,72338,VÁRZEA PAULISTA,28230,34384,14869,82734,1583,67865,3668
SP,72354,VERA CRUZ,2171,4297,1980,8805,98,6825,259
SP,72370,VINHEDO,9103,32607,6766,50792,731,44026,1585
SP,72397,VIRADOURO,3620,7019,2773,13923,213,11150,298
SP,72419,VISTA ALEGRE DO ALTO,1012,2974,1026,5186,69,4160,105
SP,72435,VOTORANTIM,26345,37489,16350,85120,1555,68770,3381
SP,72451,VOTUPORANGA,15709,35674,14455,68654,885,54199,1931
SP,72737,VARGEM GRANDE PAULISTA,10059,15554,6822,34040,589,27218,1016
TO,73008,ABREULÂNDIA,938,460,475,1929,18,1454,38
TO,73016,PIRAQUÊ,1010,652,881,2591,7,1710,41
TO,73024,RIACHINHO,1753,735,1005,3571,14,2566,64
TO,73032,DARCINÓPOLIS,1746,893,1033,3761,23,2728,66
TO,73040,PALMEIRAS DO TOCANTINS,1601,1192,1412,4317,24,2905,88
TO,73059,MAURILÂNDIA DO TOCANTINS,1526,408,874,2877,5,2003,64
TO,73067,CACHOEIRINHA,958,267,660,1941,16,1281,40
TO,73075,ANGICO,1013,715,803,2586,10,1783,45
TO,73083,PALMEIRANTE,1510,734,1021,3338,18,2317,55
TO,73091,CAMPOS LINDOS,2511,1132,1670,5448,38,3778,97
TO,73105,SÃO FÉLIX DO TOCANTINS,541,249,449,1268,6,819,23
TO,73113,LAGOA DO TOCANTINS,1417,498,732,2723,12,1991,64
TO,73121,BOM JESUS DO TOCANTINS,1416,752,579,2849,30,2270,72
TO,73130,SANTA MARIA DO TOCANTINS,926,655,555,2191,12,1636,43
TO,73148,NOVO ALEGRE,764,435,469,1720,11,1251,41
TO,73156,SANDOLÂNDIA,1197,982,1137,3391,20,2254,55
TO,73164,TAIPAS DO TOCANTINS,702,297,673,1731,12,1058,47
TO,73172,NOVO JARDIM,768,478,675,1978,7,1303,50
TO,73180,SÃO MIGUEL DO TOCANTINS,4066,1175,1644,7046,41,5402,120
TO,73199,FORTALEZA DO TABOCÃO,716,1004,557,2342,18,1785,47
TO,73202,ITAPIRATINS,1282,714,945,3018,20,2073,57
TO,73210,CENTENÁRIO,783,458,744,2055,15,1311,55
TO,73229,RECURSOLÂNDIA,1277,565,925,2855,12,1930,76
TO,73237,TUPIRATINS,807,271,513,1625,10,1112,24
TO,73245,BRASILÂNDIA DO TOCANTINS,723,495,491,1750,5,1259,36
TO,73253,JUARINA,753,473,513,1770,11,1257,20
TO,73261,PAU D'ARCO,1245,951,1058,3326,13,2268,59
TO,73270,MATEIROS,656,480,505,1712,11,1207,60
TO,73288,SÃO BENTO DO TOCANTINS,1913,937,1111,4055,26,2944,68
TO,73296,ESPERANTINA,2819,1015,1882,5889,55,4007,118
TO,73300,CARIRI DO TOCANTINS,1241,704,536,2558,22,2022,55
TO,73318,ARAGUANÃ,1815,783,1409,4107,27,2698,73
TO,73326,CARMOLÂNDIA,948,520,630,2146,9,1516,39
TO,73334,ARAGOMINAS,2027,748,1524,4395,27,2871,69
TO,73342,MURICILÂNDIA,1102,416,581,2146,9,1565,38
TO,73350,SANTA FÉ DO ARAGUAIA,1777,1557,1325,4778,28,3453,91
TO,73369,JAÚ DO TOCANTINS,1223,702,841,2833,19,1992,48
TO,73377,SUCUPIRA,566,485,378,1460,7,1082,24
TO,73385,LAGOA DA CONFUSÃO,2902,1725,1784,6529,26,4745,92
TO,73393,SÃO SALVADOR DO TOCANTINS,1062,277,972,2363,11,1391,41
TO,73407,LAJEADO,933,912,628,2538,18,1910,47
TO,73415,RIO DOS BOIS,897,469,589,2002,9,1413,38
TO,73423,CARRASCO BONITO,1676,393,1176,3318,15,2142,58
TO,73431,RIO DA CONCEIÇÃO,711,380,517,1640,6,1123,26
TO,73440,PALMAS,62971,64719,23599,157376,1438,133777,4649
TO,73458,TUPIRAMA,651,428,286,1413,9,1127,39
TO,73466,OLIVEIRA DE FÁTIMA,622,553,525,1729,7,1204,22
TO,73474,CHAPADA DE AREIA,647,569,659,1927,14,1268,38
TO,73482,CHAPADA DA NATIVIDADE,1237,553,1023,2901,13,1878,75
TO,73504,TALISMÃ,929,572,533,2074,12,1541,28
TO,73512,AGUIARNÓPOLIS,1813,807,1143,3848,32,2705,53
TO,73520,LUZINÓPOLIS,1023,499,611,2206,28,1595,45
TO,73539,SANTA TEREZINHA DO TOCANTINS,1007,487,614,2156,8,1542,40
TO,73547,SANTA RITA DO TOCANTINS,668,521,474,1695,8,1221,24
TO,73555,CRIXÁS DO TOCANTINS,553,401,330,1312,10,982,18
TO,73563,MONTE SANTO DO TOCANTINS,934,630,339,1947,10,1608,34
TO,73571,PUGMIL,778,484,373,1684,8,1311,41
TO,73580,BANDEIRANTES DO TOCANTINS,867,885,548,2345,11,1797,34
TO,73598,IPUEIRAS,724,401,447,1605,8,1158,25
TO,73601,LAVANDEIRA,594,381,443,1454,9,1011,27
TO,73610,BARRA DO OURO,1625,599,1104,3411,17,2307,66
TO,92002,BERNARDO SAYÃO,1019,1214,910,3213,16,2303,54
TO,92045,BURITI DO TOCANTINS,2837,1413,1874,6322,61,4448,137
TO,92070,ALMAS,2053,1316,1864,5392,24,3528,135
TO,92088,CASEARA,1612,828,1174,3723,22,2549,87
TO,92134,ALVORADA,2503,2296,1602,6577,37,4975,139
TO,92142,COMBINADO,1095,1442,1120,3760,31,2640,72
TO,92185,DIVINÓPOLIS DO TOCANTINS,2416,1269,954,4771,22,3817,110
TO,92193,ANANÁS,3146,1711,2148,7180,34,5032,141
TO,92240,GOIANORTE,1749,1000,1026,3878,19,2852,84
TO,92304,MARIANÓPOLIS DO TOCANTINS,1351,618,520,2557,14,2037,54
TO,92371,ARAGUACEMA,2291,822,1601,4824,20,3223,90
TO,92398,ARAGUAÇU,1893,2456,2136,6635,47,4499,103
TO,92401,NOVA ROSALÂNDIA,950,804,699,2518,15,1819,50
TO,92410,ARAGUAÍNA,46472,31966,14514,96430,831,81916,2647
TO,92436,ARAGUATINS,8299,5283,6114,20306,131,14192,479
TO,92452,ARAPOEMA,2180,1092,1470,4863,24,3393,97
TO,92479,ARRAIAS,3988,1221,3117,8577,55,5460,196
TO,92487,PEQUIZEIRO,1852,903,1191,4054,23,2863,85
TO,92509,PORTO ALEGRE DO TOCANTINS,907,470,769,2203,18,1434,39
TO,92525,PRAIA NORTE,2701,1012,2178,6055,21,3877,143
TO,92533,AURORA DO TOCANTINS,1252,711,895,2952,26,2057,68
TO,92541,SAMPAIO,1520,645,1071,3301,15,2230,50
TO,92576,AXIXÁ DO TOCANTINS,3852,2227,2297,8645,60,6348,209
TO,92584,SANTA ROSA DO TOCANTINS,1634,942,1032,3714,27,2682,79
TO,92592,BABAÇULÂNDIA,3650,1069,1757,6630,32,4873,122
TO,92606,SANTA TEREZA DO TOCANTINS,989,674,654,2383,14,1729,52
TO,92681,SÃO VALÉRIO DA NATIVIDADE,1510,711,1291,3583,17,2292,54
TO,92738,BREJINHO DE NAZARÉ,1790,1200,1013,4145,32,3132,110
TO,93114,COLINAS DO TOCANTINS,7548,8357,5793,22134,114,16341,322
TO,93130,CONCEIÇÃO DO TOCANTINS,1302,539,1525,3459,9,1934,84
TO,93211,COUTO DE MAGALHÃES,1701,936,932,3654,19,2722,66
TO,93238,CRISTALÂNDIA,2186,1571,1643,5534,35,3891,99
TO,93416,DIANÓPOLIS,5161,3204,3886,12591,85,8705,255
TO,93459,DOIS IRMÃOS DO TOCANTINS,2090,1092,1621,4927,28,3306,96
TO,93475,DUERÉ,1449,867,767,3172,21,2405,68
TO,93556,FILADÉLFIA,2988,1303,2021,6465,37,4444,116
TO,93653,FORMOSO DO ARAGUAIA,5002,3892,4488,13650,73,9162,195
TO,93858,GURUPI,21706,19184,11197,53650,355,42453,1208
TO,94056,ITACAJÁ,2127,1496,1596,5415,34,3819,162
TO,94099,ITAGUATINS,2513,755,1553,4965,21,3412,123
TO,94170,ITAPORÃ DO TOCANTINS,869,541,601,2058,16,1457,31
TO,94617,MIRACEMA DO TOCANTINS,6832,2947,4468,14695,105,10227,343
TO,94633,MIRANORTE,3864,3014,2837,9977,72,7140,190
TO,94692,MONTE DO CARMO,2098,1165,1296,4671,31,3375,81
TO,94811,NATIVIDADE,2111,2026,2455,6770,41,4315,137
TO,94838,NAZARÉ,1835,845,1284,4080,35,2796,81
TO,94994,NOVO ACORDO,1569,794,981,3439,21,2458,74
TO,95192,PARAÍSO DO TOCANTINS,10480,13074,5848,30259,219,24411,638
TO,95214,PARANÃ,3780,896,2839,7776,29,4937,232
TO,95257,PEDRO AFONSO,3688,2401,1802,8079,50,6277,138
TO,95273,PEIXE,3329,1558,2248,7309,28,5061,146
TO,95290,COLMÉIA,2429,2192,2069,6834,35,4765,109
TO,95338,GOIATINS,3545,1386,2788,8036,46,5248,271
TO,95370,PINDORAMA DO TOCANTINS,1413,1045,1147,3698,15,2551,78
TO,95478,PIUM,1469,1946,1479,4996,31,3517,71
TO,95516,PONTE ALTA DO BOM JESUS,1517,805,1041,3471,20,2430,88
TO,95532,PONTE ALTA DO TOCANTINS,1828,1621,1620,5216,36,3596,111
TO,95591,PORTO NACIONAL,17046,8879,7907,34996,268,27089,896
TO,95699,LIZARDA,1327,276,1102,2787,8,1685,74
TO,96032,SÃO SEBASTIÃO DO TOCANTINS,1694,485,1021,3273,12,2252,61
TO,96130,SÍTIO NOVO DO TOCANTINS,3947,1242,2217,7644,59,5427,179
TO,96156,TAGUATINGA,4693,2184,3489,10662,78,7173,218
TO,96199,TOCANTÍNIA,2555,834,1477,4952,18,3475,68
TO,96210,TOCANTINÓPOLIS,8277,2310,4011,15074,110,11063,366
TO,96270,GUARAÍ,6202,5592,4479,16733,106,12254,354
TO,96296,PRESIDENTE KENNEDY,1099,674,680,2549,31,1869,65
TO,96431,XAMBIOÁ,3730,2043,2344,8334,56,5990,161
TO,96490,PALMEIRÓPOLIS,1839,1752,1365,5077,21,3712,100
TO,96598,SILVANÓPOLIS,1750,1111,941,3945,25,3004,118
TO,96636,NOVA OLINDA,3488,2027,2120,7840,48,5720,157
TO,96652,WANDERLÂNDIA,3257,1446,2144,7071,52,4927,172
TO,96679,FIGUEIRÓPOLIS,1805,1244,862,3991,21,3129,59
TO,96792,RIO SONO,1814,870,869,3648,27,2779,68
TO,96830,FÁTIMA,1026,1031,833,2939,13,2106,36
TO,96857,AUGUSTINÓPOLIS,5621,2605,3112,11645,77,8533,230
TO,96954,ALIANÇA DO TOCANTINS,1872,1063,803,3845,23,3042,84
TO,96970,APARECIDA DO RIO NEGRO,1729,989,907,3742,33,2835,84
TO,96997,BARROLÂNDIA,2203,1120,1072,4491,26,3419,70
